,path,min_r,min_c,max_r,max_c,r_len,c_len,category,box_area,c_by_r,r_by_c
54,/images/8d02117d-6c71-4e47-b50a-6cc8d5eb1d55.png,52,279,200,409,148,130,trophozoite,19240,0.8783783783783784,1.1384615384615384
61,/images/8d02117d-6c71-4e47-b50a-6cc8d5eb1d55.png,441,1037,578,1155,137,118,trophozoite,16166,0.8613138686131386,1.1610169491525424
152,/images/6b14c855-8561-417c-97a4-63fa552842fd.png,76,482,219,626,143,144,schizont,20592,1.006993006993007,0.9930555555555556
156,/images/13099edb-35d9-438f-b093-2cf2ebf9d255.png,208,324,337,446,129,122,ring,15738,0.9457364341085271,1.0573770491803278
235,/images/2559636b-f01a-4414-93da-210c3b12d153.png,130,866,292,1014,162,148,schizont,23976,0.9135802469135802,1.0945945945945945
264,/images/0dcca702-a4ef-4fb3-a940-9c0c140b21c7.png,194,237,317,356,123,119,trophozoite,14637,0.967479674796748,1.0336134453781514
266,/images/0dcca702-a4ef-4fb3-a940-9c0c140b21c7.png,578,53,713,178,135,125,trophozoite,16875,0.9259259259259259,1.08
306,/images/0dcca702-a4ef-4fb3-a940-9c0c140b21c7.png,791,409,946,560,155,151,trophozoite,23405,0.9741935483870968,1.0264900662251655
307,/images/0dcca702-a4ef-4fb3-a940-9c0c140b21c7.png,676,1330,826,1461,150,131,trophozoite,19650,0.8733333333333333,1.1450381679389312
308,/images/0dcca702-a4ef-4fb3-a940-9c0c140b21c7.png,546,783,661,885,115,102,trophozoite,11730,0.8869565217391304,1.1274509803921569
344,/images/7c66d2fd-68ee-4628-b860-9d7ad25b2a80.png,228,1380,366,1498,138,118,ring,16284,0.855072463768116,1.1694915254237288
352,/images/7c66d2fd-68ee-4628-b860-9d7ad25b2a80.png,741,266,862,383,121,117,ring,14157,0.9669421487603306,1.0341880341880343
461,/images/c6d97845-8ad2-4ab7-b385-66613628df5b.png,309,441,459,564,150,123,gametocyte,18450,0.82,1.2195121951219512
470,/images/bbf687b5-c6f9-4821-b2e5-a25df1acba47.png,564,421,702,556,138,135,gametocyte,18630,0.9782608695652174,1.0222222222222221
606,/images/065af549-320a-4862-b92a-8ef750d7b5fb.png,390,258,538,424,148,166,trophozoite,24568,1.1216216216216217,0.891566265060241
656,/images/e61e6af2-7f8b-47b0-bbe7-acb2ed0299ab.png,948,1479,1047,1565,99,86,leukocyte,8514,0.8686868686868687,1.1511627906976745
665,/images/e61e6af2-7f8b-47b0-bbe7-acb2ed0299ab.png,588,45,712,199,124,154,trophozoite,19096,1.2419354838709677,0.8051948051948052
666,/images/e61e6af2-7f8b-47b0-bbe7-acb2ed0299ab.png,637,143,762,293,125,150,trophozoite,18750,1.2,0.8333333333333334
667,/images/e61e6af2-7f8b-47b0-bbe7-acb2ed0299ab.png,370,717,490,839,120,122,trophozoite,14640,1.0166666666666666,0.9836065573770492
728,/images/dcc1a193-7b74-44f8-ad8d-813751d8fa6b.png,656,1108,774,1224,118,116,trophozoite,13688,0.9830508474576272,1.0172413793103448
778,/images/27fab82c-5bf0-426f-aeb9-47da829b6629.png,879,324,1002,454,123,130,ring,15990,1.056910569105691,0.9461538461538461
788,/images/27fab82c-5bf0-426f-aeb9-47da829b6629.png,922,712,1055,832,133,120,gametocyte,15960,0.9022556390977443,1.1083333333333334
895,/images/dce55b59-c6c3-4693-aa75-6b348c8f52cd.png,354,818,473,948,119,130,ring,15470,1.0924369747899159,0.9153846153846154
1067,/images/edcb4d77-a4d3-465d-9b59-eb3087766b1c.png,320,1451,424,1549,104,98,leukocyte,10192,0.9423076923076923,1.0612244897959184
1093,/images/edcb4d77-a4d3-465d-9b59-eb3087766b1c.png,158,201,296,339,138,138,trophozoite,19044,1.0,1.0
1107,/images/edcb4d77-a4d3-465d-9b59-eb3087766b1c.png,824,1219,931,1318,107,99,trophozoite,10593,0.9252336448598131,1.0808080808080809
1108,/images/edcb4d77-a4d3-465d-9b59-eb3087766b1c.png,676,1121,815,1239,139,118,trophozoite,16402,0.8489208633093526,1.1779661016949152
1110,/images/edcb4d77-a4d3-465d-9b59-eb3087766b1c.png,32,1185,201,1331,169,146,trophozoite,24674,0.863905325443787,1.1575342465753424
1182,/images/4411fea2-d785-4eeb-80c6-c739ab6114c4.png,729,231,860,388,131,157,ring,20567,1.1984732824427482,0.8343949044585988
1589,/images/7094c11a-1e62-4f98-894e-d17d138a88e9.png,443,760,589,891,146,131,trophozoite,19126,0.8972602739726028,1.1145038167938932
1626,/images/7094c11a-1e62-4f98-894e-d17d138a88e9.png,302,141,439,284,137,143,trophozoite,19591,1.0437956204379562,0.958041958041958
1627,/images/7094c11a-1e62-4f98-894e-d17d138a88e9.png,192,1416,317,1521,125,105,trophozoite,13125,0.84,1.1904761904761905
1628,/images/7094c11a-1e62-4f98-894e-d17d138a88e9.png,0,824,131,950,131,126,trophozoite,16506,0.9618320610687023,1.0396825396825398
1629,/images/7094c11a-1e62-4f98-894e-d17d138a88e9.png,246,828,332,911,86,83,trophozoite,7138,0.9651162790697675,1.036144578313253
1630,/images/7094c11a-1e62-4f98-894e-d17d138a88e9.png,633,1224,774,1346,141,122,trophozoite,17202,0.8652482269503546,1.1557377049180328
1906,/images/02ea7aa8-c142-4a3d-939f-e77689741341.png,70,431,218,590,148,159,schizont,23532,1.0743243243243243,0.9308176100628931
2067,/images/f3bd0fcc-647d-4ca0-8c43-a16bd6ea3878.png,274,668,427,801,153,133,trophozoite,20349,0.869281045751634,1.150375939849624
2242,/images/5bf91ff9-80df-49c0-9c3e-599357d95530.png,593,843,753,976,160,133,trophozoite,21280,0.83125,1.2030075187969924
2762,/images/a89cace5-c818-4f23-a432-052b3433b81e.png,492,77,635,195,143,118,trophozoite,16874,0.8251748251748252,1.2118644067796611
2820,/images/e79bd81b-f878-4bee-9be2-d91a722c031e.png,726,1007,857,1149,131,142,trophozoite,18602,1.083969465648855,0.9225352112676056
2821,/images/e79bd81b-f878-4bee-9be2-d91a722c031e.png,245,607,399,749,154,142,trophozoite,21868,0.922077922077922,1.0845070422535212
2822,/images/e79bd81b-f878-4bee-9be2-d91a722c031e.png,184,1322,324,1459,140,137,trophozoite,19180,0.9785714285714285,1.0218978102189782
2823,/images/e79bd81b-f878-4bee-9be2-d91a722c031e.png,687,383,791,496,104,113,trophozoite,11752,1.0865384615384615,0.9203539823008849
2831,/images/e79bd81b-f878-4bee-9be2-d91a722c031e.png,394,485,510,610,116,125,trophozoite,14500,1.0775862068965518,0.928
2880,/images/a1c140f9-75d7-42a3-b767-4c01a118892b.png,402,746,539,897,137,151,leukocyte,20687,1.102189781021898,0.9072847682119205
3163,/images/729a38d6-66db-48e5-a00d-7d90d224290f.png,864,427,1033,573,169,146,trophozoite,24674,0.863905325443787,1.1575342465753424
3237,/images/96596a68-8c95-43f3-b74e-e9506c235144.png,278,794,410,907,132,113,ring,14916,0.8560606060606061,1.168141592920354
3253,/images/96596a68-8c95-43f3-b74e-e9506c235144.png,943,656,1054,775,111,119,ring,13209,1.072072072072072,0.9327731092436975
3318,/images/b901c906-91be-48c4-88ec-2c527544a258.png,472,693,607,835,135,142,schizont,19170,1.0518518518518518,0.9507042253521126
3398,/images/fd1302e2-3cd2-4a1a-9c13-00f810a9c41b.png,789,610,895,726,106,116,ring,12296,1.0943396226415094,0.9137931034482759
3680,/images/8bd71314-e38a-4670-bb25-5cd6c9acb595.png,444,589,572,715,128,126,ring,16128,0.984375,1.0158730158730158
3681,/images/8bd71314-e38a-4670-bb25-5cd6c9acb595.png,265,567,383,695,118,128,ring,15104,1.0847457627118644,0.921875
3796,/images/3e764461-22ee-44d3-925d-cd658ff7d154.png,504,791,616,910,112,119,leukocyte,13328,1.0625,0.9411764705882353
3820,/images/3e764461-22ee-44d3-925d-cd658ff7d154.png,153,9,283,143,130,134,trophozoite,17420,1.0307692307692307,0.9701492537313433
3825,/images/3e764461-22ee-44d3-925d-cd658ff7d154.png,248,1454,376,1583,128,129,ring,16512,1.0078125,0.9922480620155039
3828,/images/3e764461-22ee-44d3-925d-cd658ff7d154.png,727,464,879,588,152,124,trophozoite,18848,0.8157894736842105,1.2258064516129032
3926,/images/f09acb0c-b270-4e91-99f8-410adfa7f34a.png,815,396,940,525,125,129,ring,16125,1.032,0.9689922480620154
4299,/images/882b91b7-5906-4091-bad4-688d4375eeb5.png,585,1239,707,1384,122,145,trophozoite,17690,1.1885245901639345,0.8413793103448276
4304,/images/882b91b7-5906-4091-bad4-688d4375eeb5.png,833,1113,949,1245,116,132,trophozoite,15312,1.1379310344827587,0.8787878787878788
4306,/images/882b91b7-5906-4091-bad4-688d4375eeb5.png,77,300,223,431,146,131,trophozoite,19126,0.8972602739726028,1.1145038167938932
4311,/images/882b91b7-5906-4091-bad4-688d4375eeb5.png,668,472,793,627,125,155,trophozoite,19375,1.24,0.8064516129032258
4368,/images/84041bf9-dace-4066-9fe0-52170d08f826.png,839,758,971,879,132,121,trophozoite,15972,0.9166666666666666,1.0909090909090908
4380,/images/84041bf9-dace-4066-9fe0-52170d08f826.png,857,96,980,242,123,146,ring,17958,1.1869918699186992,0.8424657534246576
4391,/images/84041bf9-dace-4066-9fe0-52170d08f826.png,639,1012,766,1150,127,138,trophozoite,17526,1.0866141732283465,0.9202898550724637
4400,/images/84041bf9-dace-4066-9fe0-52170d08f826.png,541,267,657,404,116,137,trophozoite,15892,1.1810344827586208,0.8467153284671532
4472,/images/cf90d82f-2814-4fb7-a3ff-a86b7c5efca7.png,816,709,954,843,138,134,trophozoite,18492,0.9710144927536232,1.0298507462686568
4588,/images/98efca97-37d2-4459-aca6-375ecc0c4539.png,505,1310,654,1433,149,123,ring,18327,0.825503355704698,1.2113821138211383
4610,/images/f1de7c7e-e7d3-45ae-a66c-58538bf6cac1.png,204,160,343,290,139,130,gametocyte,18070,0.935251798561151,1.0692307692307692
4655,/images/a2d07312-2f97-40d2-8b09-7f2aca7b16fb.png,98,381,240,544,142,163,schizont,23146,1.147887323943662,0.8711656441717791
4706,/images/b91b1641-ee06-44d8-94cc-24cdb583cc37.png,185,837,323,988,138,151,trophozoite,20838,1.0942028985507246,0.9139072847682119
4716,/images/b91b1641-ee06-44d8-94cc-24cdb583cc37.png,609,1243,738,1394,129,151,trophozoite,19479,1.1705426356589148,0.8543046357615894
4786,/images/3fa1a4e3-c80d-49da-8f7b-a1abb0424f48.png,184,921,308,1057,124,136,trophozoite,16864,1.096774193548387,0.9117647058823529
4798,/images/3fa1a4e3-c80d-49da-8f7b-a1abb0424f48.png,732,1022,849,1131,117,109,ring,12753,0.9316239316239316,1.073394495412844
4955,/images/755e5bf8-e8e1-492b-a32f-f7d87cccaa40.png,663,783,810,922,147,139,schizont,20433,0.9455782312925171,1.0575539568345325
4978,/images/2cc3c4ad-670f-41b6-8910-0704cbc192ef.png,199,1187,326,1312,127,125,ring,15875,0.984251968503937,1.016
5175,/images/a777e78c-ad1f-4380-9ab2-b4f9f32b2d78.png,237,892,385,1057,148,165,trophozoite,24420,1.114864864864865,0.896969696969697
5205,/images/16a51468-9f93-45df-9ae2-5a74c25c5a4b.png,263,395,400,539,137,144,schizont,19728,1.051094890510949,0.9513888888888888
5274,/images/729733ff-a349-4a96-b636-ccabe7d7e167.png,122,573,253,724,131,151,trophozoite,19781,1.1526717557251909,0.8675496688741722
5290,/images/729733ff-a349-4a96-b636-ccabe7d7e167.png,798,1471,916,1584,118,113,trophozoite,13334,0.9576271186440678,1.0442477876106195
5291,/images/729733ff-a349-4a96-b636-ccabe7d7e167.png,836,54,963,172,127,118,trophozoite,14986,0.9291338582677166,1.076271186440678
5292,/images/729733ff-a349-4a96-b636-ccabe7d7e167.png,106,1,201,101,95,100,trophozoite,9500,1.0526315789473684,0.95
5623,/images/afa470d9-c74c-41cd-b4dc-7bf93fde8263.png,1022,120,1154,243,132,123,ring,16236,0.9318181818181818,1.0731707317073171
5749,/images/21a50e4c-b750-46b5-801f-5429ede7dea9.png,848,929,991,1079,143,150,trophozoite,21450,1.048951048951049,0.9533333333333334
5843,/images/143f5959-5b6d-4f95-bcee-9e110450fc22.png,550,703,670,799,120,96,ring,11520,0.8,1.25
5881,/images/a30da226-b452-408a-a556-bfae4d521464.png,327,1360,443,1484,116,124,trophozoite,14384,1.0689655172413792,0.9354838709677419
5904,/images/a30da226-b452-408a-a556-bfae4d521464.png,943,616,1063,746,120,130,trophozoite,15600,1.0833333333333333,0.9230769230769231
5905,/images/a30da226-b452-408a-a556-bfae4d521464.png,555,304,716,442,161,138,trophozoite,22218,0.8571428571428571,1.1666666666666667
5906,/images/a30da226-b452-408a-a556-bfae4d521464.png,555,592,693,752,138,160,trophozoite,22080,1.1594202898550725,0.8625
6029,/images/72732579-a812-4496-b2dd-ea1556924337.png,23,354,163,517,140,163,trophozoite,22820,1.1642857142857144,0.8588957055214724
6032,/images/72732579-a812-4496-b2dd-ea1556924337.png,480,136,619,299,139,163,trophozoite,22657,1.1726618705035972,0.852760736196319
6033,/images/72732579-a812-4496-b2dd-ea1556924337.png,150,1244,283,1355,133,111,trophozoite,14763,0.8345864661654135,1.1981981981981982
6035,/images/72732579-a812-4496-b2dd-ea1556924337.png,175,607,326,759,151,152,trophozoite,22952,1.0066225165562914,0.993421052631579
6036,/images/72732579-a812-4496-b2dd-ea1556924337.png,349,755,485,925,136,170,trophozoite,23120,1.25,0.8
6037,/images/72732579-a812-4496-b2dd-ea1556924337.png,444,712,594,866,150,154,trophozoite,23100,1.0266666666666666,0.974025974025974
6048,/images/72732579-a812-4496-b2dd-ea1556924337.png,757,657,888,820,131,163,trophozoite,21353,1.2442748091603053,0.803680981595092
6049,/images/72732579-a812-4496-b2dd-ea1556924337.png,963,682,1106,848,143,166,trophozoite,23738,1.1608391608391608,0.8614457831325302
6096,/images/c147584d-4c61-412a-bdaf-b02b22c18708.png,1009,421,1155,544,146,123,schizont,17958,0.8424657534246576,1.1869918699186992
6109,/images/c147584d-4c61-412a-bdaf-b02b22c18708.png,49,603,218,749,169,146,schizont,24674,0.863905325443787,1.1575342465753424
6162,/images/27cdd837-e40f-491e-8adb-61e493189832.png,688,1254,833,1413,145,159,trophozoite,23055,1.096551724137931,0.9119496855345912
6226,/images/effd6334-516f-4d48-9f3c-5272a99780fb.png,80,1165,194,1268,114,103,ring,11742,0.9035087719298246,1.1067961165048543
6425,/images/1ecb0405-a6e9-4485-819e-2fbbf2b718aa.png,180,129,349,267,169,138,trophozoite,23322,0.8165680473372781,1.2246376811594204
6426,/images/1ecb0405-a6e9-4485-819e-2fbbf2b718aa.png,263,584,406,702,143,118,trophozoite,16874,0.8251748251748252,1.2118644067796611
6427,/images/1ecb0405-a6e9-4485-819e-2fbbf2b718aa.png,439,862,603,1003,164,141,trophozoite,23124,0.8597560975609756,1.1631205673758864
6559,/images/640c4a52-3742-4f57-aee3-9e3dc0887622.png,649,852,798,988,149,136,trophozoite,20264,0.912751677852349,1.0955882352941178
6735,/images/672e4ecf-a56b-462e-b83b-76f4efaa6634.png,608,303,741,447,133,144,trophozoite,19152,1.0827067669172932,0.9236111111111112
6759,/images/672e4ecf-a56b-462e-b83b-76f4efaa6634.png,94,152,225,276,131,124,trophozoite,16244,0.9465648854961832,1.0564516129032258
6808,/images/e36cb882-c6d0-4467-812e-d18c169a9a47.png,782,215,906,328,124,113,trophozoite,14012,0.9112903225806451,1.0973451327433628
6850,/images/b21f6c6e-4b45-407a-b4c7-034a115f3ee4.png,891,62,1028,210,137,148,ring,20276,1.0802919708029197,0.9256756756756757
6868,/images/b21f6c6e-4b45-407a-b4c7-034a115f3ee4.png,552,209,669,315,117,106,trophozoite,12402,0.905982905982906,1.1037735849056605
6932,/images/a9feccda-18f2-405e-9aa1-409fa1f49fe4.png,837,233,961,358,124,125,ring,15500,1.0080645161290323,0.992
6942,/images/a9feccda-18f2-405e-9aa1-409fa1f49fe4.png,50,924,174,1041,124,117,ring,14508,0.9435483870967742,1.0598290598290598
6944,/images/a9feccda-18f2-405e-9aa1-409fa1f49fe4.png,298,1155,433,1268,135,113,ring,15255,0.837037037037037,1.1946902654867257
6997,/images/c776eb78-3323-4571-b39f-7ffc73ae63ce.png,807,771,931,879,124,108,ring,13392,0.8709677419354839,1.1481481481481481
7047,/images/8be185e7-2a1a-441c-a5c7-b50a9eb926cb.png,244,128,360,264,116,136,trophozoite,15776,1.1724137931034482,0.8529411764705882
7086,/images/8be185e7-2a1a-441c-a5c7-b50a9eb926cb.png,401,1151,528,1290,127,139,trophozoite,17653,1.094488188976378,0.9136690647482014
7318,/images/89f10192-d3dd-4996-a571-4c851dbdc983.png,220,419,366,581,146,162,trophozoite,23652,1.1095890410958904,0.9012345679012346
7413,/images/76dbce7f-dc3e-4a29-b1fe-ab9dce583080.png,797,1288,912,1403,115,115,ring,13225,1.0,1.0
7508,/images/071901eb-4c3f-404b-a747-3d0b9d0a5158.png,62,130,170,238,108,108,leukocyte,11664,1.0,1.0
7549,/images/071901eb-4c3f-404b-a747-3d0b9d0a5158.png,421,823,546,971,125,148,trophozoite,18500,1.184,0.8445945945945946
7652,/images/21cc498b-8cb2-42ed-8f80-bfa27b86ef11.png,446,170,582,302,136,132,schizont,17952,0.9705882352941176,1.0303030303030303
7695,/images/9f959520-e15e-45c2-bc29-ef3c19154d1c.png,229,793,354,933,125,140,trophozoite,17500,1.12,0.8928571428571429
7697,/images/9f959520-e15e-45c2-bc29-ef3c19154d1c.png,824,1378,940,1523,116,145,trophozoite,16820,1.25,0.8
7718,/images/9f959520-e15e-45c2-bc29-ef3c19154d1c.png,476,230,617,350,141,120,trophozoite,16920,0.851063829787234,1.175
7724,/images/9f959520-e15e-45c2-bc29-ef3c19154d1c.png,883,491,1014,630,131,139,trophozoite,18209,1.0610687022900764,0.9424460431654677
7798,/images/e726dac6-f962-449c-acff-4dd56847b685.png,406,782,551,910,145,128,trophozoite,18560,0.8827586206896552,1.1328125
7815,/images/e726dac6-f962-449c-acff-4dd56847b685.png,973,1322,1087,1442,114,120,trophozoite,13680,1.0526315789473684,0.95
7817,/images/e726dac6-f962-449c-acff-4dd56847b685.png,325,357,458,475,133,118,trophozoite,15694,0.8872180451127819,1.1271186440677967
8212,/images/6bb4892c-27a9-4642-aba1-4b73f38f757c.png,471,1307,610,1443,139,136,gametocyte,18904,0.9784172661870504,1.0220588235294117
8450,/images/ae779806-6d01-4dc6-89df-294c368db6bc.png,667,1002,835,1139,168,137,trophozoite,23016,0.8154761904761905,1.2262773722627738
8502,/images/dfc026a9-079f-4f45-8666-e0ccba5bb437.png,990,1217,1117,1340,127,123,ring,15621,0.968503937007874,1.032520325203252
8781,/images/ae17a099-18b5-4a42-a901-850ea056423e.png,87,594,218,708,131,114,ring,14934,0.8702290076335878,1.1491228070175439
8797,/images/ae17a099-18b5-4a42-a901-850ea056423e.png,734,825,862,953,128,128,ring,16384,1.0,1.0
8820,/images/ae17a099-18b5-4a42-a901-850ea056423e.png,1033,498,1138,625,105,127,ring,13335,1.2095238095238094,0.8267716535433071
8838,/images/91827f1a-9b04-4ef0-972c-12e90e60c516.png,518,141,678,292,160,151,schizont,24160,0.94375,1.0596026490066226
8873,/images/29539cb0-1c52-46b2-9302-552f8349dc71.png,199,1116,297,1224,98,108,leukocyte,10584,1.1020408163265305,0.9074074074074074
8893,/images/29539cb0-1c52-46b2-9302-552f8349dc71.png,329,1290,467,1448,138,158,trophozoite,21804,1.144927536231884,0.8734177215189873
8899,/images/29539cb0-1c52-46b2-9302-552f8349dc71.png,390,1358,544,1514,154,156,trophozoite,24024,1.0129870129870129,0.9871794871794872
8904,/images/29539cb0-1c52-46b2-9302-552f8349dc71.png,474,675,616,818,142,143,trophozoite,20306,1.0070422535211268,0.993006993006993
8905,/images/29539cb0-1c52-46b2-9302-552f8349dc71.png,249,247,401,388,152,141,trophozoite,21432,0.9276315789473685,1.0780141843971631
8961,/images/04628a94-b674-469b-aff6-b476b70df87d.png,753,451,899,588,146,137,schizont,20002,0.9383561643835616,1.0656934306569343
8984,/images/ef815e3a-02a6-4cf8-9262-45bc74c50b00.png,508,603,610,708,102,105,leukocyte,10710,1.0294117647058822,0.9714285714285714
9038,/images/ef815e3a-02a6-4cf8-9262-45bc74c50b00.png,1031,755,1176,918,145,163,trophozoite,23635,1.1241379310344828,0.8895705521472392
9083,/images/21c2a8aa-407c-4569-8212-96fcafa84138.png,836,1322,964,1479,128,157,trophozoite,20096,1.2265625,0.8152866242038217
9216,/images/6e7ed596-1b76-4998-8147-a846d53d91c5.png,550,998,699,1152,149,154,schizont,22946,1.0335570469798658,0.9675324675324676
9456,/images/e3a4b3e7-9500-4b6c-a402-b6d3f45e714b.png,165,638,308,796,143,158,schizont,22594,1.1048951048951048,0.9050632911392406
9457,/images/e3a4b3e7-9500-4b6c-a402-b6d3f45e714b.png,256,1407,379,1554,123,147,schizont,18081,1.1951219512195121,0.8367346938775511
9644,/images/d997337e-e4a8-4ef0-b8ba-975e6c43b62c.png,964,1121,1110,1268,146,147,schizont,21462,1.0068493150684932,0.9931972789115646
9721,/images/53afd70c-08a7-4b9a-b137-7003b2ecbeab.png,835,952,959,1070,124,118,trophozoite,14632,0.9516129032258065,1.0508474576271187
9926,/images/b4261fa5-876d-48ea-b6da-ec7ca5b48fe2.png,259,180,379,312,120,132,trophozoite,15840,1.1,0.9090909090909091
9927,/images/b4261fa5-876d-48ea-b6da-ec7ca5b48fe2.png,939,1303,1097,1444,158,141,trophozoite,22278,0.8924050632911392,1.1205673758865249
9987,/images/b9ccf7ca-953f-4832-9575-5e70b2a8c224.png,359,1397,498,1540,139,143,trophozoite,19877,1.0287769784172662,0.972027972027972
9988,/images/b9ccf7ca-953f-4832-9575-5e70b2a8c224.png,875,304,1018,425,143,121,trophozoite,17303,0.8461538461538461,1.1818181818181819
10060,/images/26799d2b-a289-4eff-9218-0aad77e05e41.png,262,409,418,569,156,160,schizont,24960,1.0256410256410255,0.975
10154,/images/09ecf7be-28e2-4531-b9e2-07e01c44097d.png,571,1244,682,1358,111,114,ring,12654,1.027027027027027,0.9736842105263158
10263,/images/e3ea07d7-884a-412e-874a-40fd6b856736.png,728,301,862,468,134,167,ring,22378,1.2462686567164178,0.8023952095808383
10271,/images/f91670db-be74-474c-bd72-68120aed4756.png,246,942,359,1067,113,125,ring,14125,1.1061946902654867,0.904
10297,/images/f91670db-be74-474c-bd72-68120aed4756.png,886,540,1017,662,131,122,ring,15982,0.9312977099236641,1.0737704918032787
10664,/images/20d4f65e-6c63-433a-935c-d568d577967b.png,574,300,692,418,118,118,trophozoite,13924,1.0,1.0
10787,/images/2a02cec2-a09b-483a-ad38-14359a763fa4.png,217,434,345,567,128,133,trophozoite,17024,1.0390625,0.9624060150375939
10797,/images/2a02cec2-a09b-483a-ad38-14359a763fa4.png,1007,1392,1161,1526,154,134,trophozoite,20636,0.8701298701298701,1.1492537313432836
10813,/images/2a02cec2-a09b-483a-ad38-14359a763fa4.png,633,924,742,1051,109,127,trophozoite,13843,1.165137614678899,0.8582677165354331
10821,/images/2a02cec2-a09b-483a-ad38-14359a763fa4.png,130,1433,285,1589,155,156,trophozoite,24180,1.0064516129032257,0.9935897435897436
10822,/images/2a02cec2-a09b-483a-ad38-14359a763fa4.png,441,1457,579,1600,138,143,trophozoite,19734,1.036231884057971,0.965034965034965
10868,/images/b78b88f0-154a-4b54-8aaf-85d37a42a0f9.png,402,932,543,1075,141,143,schizont,20163,1.0141843971631206,0.986013986013986
10877,/images/b78b88f0-154a-4b54-8aaf-85d37a42a0f9.png,532,224,678,352,146,128,trophozoite,18688,0.8767123287671232,1.140625
11000,/images/c442e2d6-aaf9-417a-9905-4737a1115f33.png,226,290,370,406,144,116,trophozoite,16704,0.8055555555555556,1.2413793103448276
11093,/images/98175327-da9e-4e0c-8912-ee68490a4672.png,278,1029,408,1152,130,123,ring,15990,0.9461538461538461,1.056910569105691
11226,/images/6303f964-98ef-47c6-bb2d-283aa393f918.png,394,475,549,621,155,146,ring,22630,0.9419354838709677,1.0616438356164384
11349,/images/2f6224be-50d0-4e85-94ef-88315df561b6.png,1017,726,1156,842,139,116,trophozoite,16124,0.8345323741007195,1.1982758620689655
11355,/images/2f6224be-50d0-4e85-94ef-88315df561b6.png,390,858,504,972,114,114,leukocyte,12996,1.0,1.0
11368,/images/2f6224be-50d0-4e85-94ef-88315df561b6.png,265,958,401,1081,136,123,trophozoite,16728,0.9044117647058824,1.1056910569105691
11383,/images/2f6224be-50d0-4e85-94ef-88315df561b6.png,204,476,337,606,133,130,trophozoite,17290,0.9774436090225563,1.023076923076923
11871,/images/3cdcb09b-6a8c-43ca-b1d0-c1a289202f65.png,148,516,257,644,109,128,trophozoite,13952,1.1743119266055047,0.8515625
11872,/images/3cdcb09b-6a8c-43ca-b1d0-c1a289202f65.png,75,676,222,800,147,124,trophozoite,18228,0.8435374149659864,1.185483870967742
11887,/images/2e8d6a43-0110-4bf4-8e70-20567e513b81.png,837,143,965,273,128,130,ring,16640,1.015625,0.9846153846153847
11905,/images/2e8d6a43-0110-4bf4-8e70-20567e513b81.png,222,1102,352,1219,130,117,ring,15210,0.9,1.1111111111111112
11953,/images/f8a8b148-60e4-4a5c-ae19-941b19ec0846.png,550,1047,682,1169,132,122,ring,16104,0.9242424242424242,1.0819672131147542
11968,/images/f8a8b148-60e4-4a5c-ae19-941b19ec0846.png,916,945,1061,1065,145,120,ring,17400,0.8275862068965517,1.2083333333333333
12024,/images/ca16a5ad-b106-4e84-8a43-178710e854ba.png,310,716,473,861,163,145,ring,23635,0.8895705521472392,1.1241379310344828
12092,/images/984caf56-f400-4a29-be97-a4d6b9d1468d.png,269,541,418,692,149,151,trophozoite,22499,1.0134228187919463,0.9867549668874173
12445,/images/cc94eabb-a3dc-4cfc-9fff-55c76b5b4a71.png,1049,772,1184,912,135,140,trophozoite,18900,1.037037037037037,0.9642857142857143
12458,/images/cc94eabb-a3dc-4cfc-9fff-55c76b5b4a71.png,381,1340,501,1481,120,141,gametocyte,16920,1.175,0.851063829787234
12475,/images/cc94eabb-a3dc-4cfc-9fff-55c76b5b4a71.png,922,1283,1031,1414,109,131,trophozoite,14279,1.201834862385321,0.8320610687022901
12656,/images/5a043d69-f435-46d4-8691-395c1602a76a.png,854,1321,984,1465,130,144,gametocyte,18720,1.1076923076923078,0.9027777777777778
12728,/images/68442532-9cd2-4b42-9d4f-ddf8c13bb38c.png,578,972,729,1096,151,124,schizont,18724,0.8211920529801324,1.217741935483871
12825,/images/b634137b-bc8b-4e88-b0e3-b536ad6e7e18.png,877,1124,997,1272,120,148,trophozoite,17760,1.2333333333333334,0.8108108108108109
13045,/images/555c6ea2-c76c-4e71-af57-855d940c2b37.png,227,626,358,768,131,142,schizont,18602,1.083969465648855,0.9225352112676056
13093,/images/9691c57a-ccf8-47f9-a8e9-9a324974585b.png,348,258,487,427,139,169,schizont,23491,1.2158273381294964,0.8224852071005917
13375,/images/a7f1bbb1-6058-4642-bd66-cfb90dce762e.png,727,845,867,985,140,140,trophozoite,19600,1.0,1.0
13499,/images/370277f8-436b-4103-8210-b4feb5ab95ea.png,866,512,997,649,131,137,trophozoite,17947,1.0458015267175573,0.9562043795620438
13516,/images/370277f8-436b-4103-8210-b4feb5ab95ea.png,556,917,667,1019,111,102,trophozoite,11322,0.918918918918919,1.088235294117647
13594,/images/c0c3041f-78cd-46de-8e36-0a7dad0c04c4.png,441,535,582,692,141,157,schizont,22137,1.1134751773049645,0.8980891719745223
13619,/images/d47cd049-d78b-4ba3-a7d4-399be4dd1dde.png,417,433,583,572,166,139,schizont,23074,0.8373493975903614,1.1942446043165467
13645,/images/1e86933d-6a5a-4a3c-a0f2-ca22afd767b3.png,455,1286,593,1417,138,131,trophozoite,18078,0.9492753623188406,1.0534351145038168
13646,/images/1e86933d-6a5a-4a3c-a0f2-ca22afd767b3.png,124,1397,272,1522,148,125,trophozoite,18500,0.8445945945945946,1.184
13651,/images/1e86933d-6a5a-4a3c-a0f2-ca22afd767b3.png,710,105,845,223,135,118,trophozoite,15930,0.8740740740740741,1.1440677966101696
13659,/images/1e86933d-6a5a-4a3c-a0f2-ca22afd767b3.png,975,1229,1140,1363,165,134,trophozoite,22110,0.8121212121212121,1.2313432835820894
13673,/images/1e86933d-6a5a-4a3c-a0f2-ca22afd767b3.png,548,100,680,231,132,131,trophozoite,17292,0.9924242424242424,1.0076335877862594
13705,/images/0b04ec46-5119-4cda-8c35-c4e5b6f0eed0.png,461,841,574,971,113,130,ring,14690,1.1504424778761062,0.8692307692307693
13823,/images/345cb914-7583-49df-96e3-3cf19c2ba8f1.png,335,538,461,657,126,119,trophozoite,14994,0.9444444444444444,1.0588235294117647
13893,/images/7d65d296-0f7b-41cc-9073-a547e24326c8.png,981,209,1076,304,95,95,schizont,9025,1.0,1.0
13920,/images/de00f9a5-aa8b-4679-8ec6-85528a942d6f.png,141,132,280,282,139,150,schizont,20850,1.079136690647482,0.9266666666666666
13959,/images/3061aac0-cda3-47d1-8c48-6293e9ffdf36.png,610,875,748,993,138,118,gametocyte,16284,0.855072463768116,1.1694915254237288
14100,/images/eaf4b781-b3aa-41ce-8c5e-287979b4e15a.png,896,183,994,292,98,109,ring,10682,1.1122448979591837,0.8990825688073395
14260,/images/6382976c-ee87-4916-b798-4ef1373b2df0.png,903,1014,1031,1129,128,115,ring,14720,0.8984375,1.1130434782608696
14271,/images/6382976c-ee87-4916-b798-4ef1373b2df0.png,41,360,155,483,114,123,ring,14022,1.0789473684210527,0.926829268292683
14317,/images/95bea542-6cd0-41c5-82c5-509af8c3b505.png,340,1130,481,1271,141,141,trophozoite,19881,1.0,1.0
14323,/images/95bea542-6cd0-41c5-82c5-509af8c3b505.png,886,747,1006,847,120,100,gametocyte,12000,0.8333333333333334,1.2
14325,/images/95bea542-6cd0-41c5-82c5-509af8c3b505.png,690,272,810,422,120,150,schizont,18000,1.25,0.8
14326,/images/95bea542-6cd0-41c5-82c5-509af8c3b505.png,1091,356,1200,449,109,93,schizont,10137,0.8532110091743119,1.1720430107526882
14425,/images/3b13e20f-ec0d-44ec-b2f4-eaebfa09150e.png,255,24,394,162,139,138,gametocyte,19182,0.9928057553956835,1.0072463768115942
14466,/images/3b13e20f-ec0d-44ec-b2f4-eaebfa09150e.png,358,714,468,847,110,133,trophozoite,14630,1.209090909090909,0.8270676691729323
14478,/images/3b13e20f-ec0d-44ec-b2f4-eaebfa09150e.png,625,1462,764,1600,139,138,trophozoite,19182,0.9928057553956835,1.0072463768115942
14480,/images/3b13e20f-ec0d-44ec-b2f4-eaebfa09150e.png,265,1054,381,1181,116,127,trophozoite,14732,1.0948275862068966,0.9133858267716536
14574,/images/458cb2e9-5a7f-437c-ac5d-a56f98a3efdf.png,300,837,440,968,140,131,trophozoite,18340,0.9357142857142857,1.0687022900763359
14590,/images/b8410821-a42b-47d0-8bcf-c2fc82e4e2d5.png,373,1033,505,1182,132,149,gametocyte,19668,1.128787878787879,0.8859060402684564
14608,/images/c649e1cb-4029-4433-b231-d67d68f7391a.png,927,795,1064,940,137,145,gametocyte,19865,1.0583941605839415,0.9448275862068966
14657,/images/9d155086-acf5-4c86-a9e1-94b587c46e87.png,442,1405,575,1528,133,123,trophozoite,16359,0.924812030075188,1.08130081300813
14663,/images/9d155086-acf5-4c86-a9e1-94b587c46e87.png,392,1132,501,1238,109,106,trophozoite,11554,0.9724770642201835,1.028301886792453
14837,/images/f8b6a868-60e9-4569-ae69-638a0c39834d.png,648,613,796,732,148,119,trophozoite,17612,0.8040540540540541,1.2436974789915967
14843,/images/f8b6a868-60e9-4569-ae69-638a0c39834d.png,700,416,847,561,147,145,schizont,21315,0.9863945578231292,1.013793103448276
14908,/images/3090a362-1f3d-49e9-a76e-ce76ff9c2276.png,243,473,366,584,123,111,trophozoite,13653,0.9024390243902439,1.1081081081081081
14922,/images/3090a362-1f3d-49e9-a76e-ce76ff9c2276.png,235,1037,377,1168,142,131,trophozoite,18602,0.9225352112676056,1.083969465648855
15059,/images/3003252a-2d2e-4687-ad30-9c38d68f1394.png,738,1204,872,1333,134,129,trophozoite,17286,0.9626865671641791,1.0387596899224807
15246,/images/dd7142e4-2d86-4170-a41f-e825743e8907.png,97,1292,219,1432,122,140,leukocyte,17080,1.1475409836065573,0.8714285714285714
15309,/images/2d0f600d-f94e-4907-b712-52fb37d9ed52.png,875,1080,1010,1230,135,150,trophozoite,20250,1.1111111111111112,0.9
15310,/images/2d0f600d-f94e-4907-b712-52fb37d9ed52.png,856,1298,999,1427,143,129,trophozoite,18447,0.9020979020979021,1.1085271317829457
15312,/images/2d0f600d-f94e-4907-b712-52fb37d9ed52.png,631,122,766,272,135,150,trophozoite,20250,1.1111111111111112,0.9
15350,/images/035f6c4b-0897-46ab-9c3b-5f3b0feff043.png,65,512,190,641,125,129,ring,16125,1.032,0.9689922480620154
15351,/images/035f6c4b-0897-46ab-9c3b-5f3b0feff043.png,764,1211,882,1342,118,131,ring,15458,1.1101694915254237,0.9007633587786259
15458,/images/1b7f47fc-26cd-4273-b848-88a7cbfd9f85.png,956,284,1106,436,150,152,trophozoite,22800,1.0133333333333334,0.9868421052631579
15472,/images/79f63258-24ce-4e69-a5cb-8529635a89a9.png,329,340,445,461,116,121,ring,14036,1.043103448275862,0.9586776859504132
15487,/images/79f63258-24ce-4e69-a5cb-8529635a89a9.png,954,798,1076,919,122,121,ring,14762,0.9918032786885246,1.0082644628099173
15510,/images/79f63258-24ce-4e69-a5cb-8529635a89a9.png,106,1335,217,1461,111,126,ring,13986,1.135135135135135,0.8809523809523809
15729,/images/3892b776-f49a-4368-b0fa-7e855e76ccec.png,666,367,793,501,127,134,trophozoite,17018,1.0551181102362204,0.9477611940298507
15730,/images/3892b776-f49a-4368-b0fa-7e855e76ccec.png,1058,1011,1200,1136,142,125,trophozoite,17750,0.8802816901408451,1.136
15785,/images/64113b22-03b1-4ab8-89ab-b2f32154fbbd.png,242,1047,345,1169,103,122,leukocyte,12566,1.1844660194174756,0.8442622950819673
15798,/images/64113b22-03b1-4ab8-89ab-b2f32154fbbd.png,969,1363,1082,1502,113,139,trophozoite,15707,1.2300884955752212,0.8129496402877698
15922,/images/c7c1b873-0548-4a73-9618-f60912e164df.png,802,1207,918,1315,116,108,trophozoite,12528,0.9310344827586207,1.0740740740740742
16252,/images/acdc6e12-73d9-44ba-be8c-2a56aaffef4f.png,291,1097,423,1246,132,149,schizont,19668,1.128787878787879,0.8859060402684564
16312,/images/d5009906-bce1-4353-90b4-f4c79362f4cf.png,435,1203,598,1355,163,152,trophozoite,24776,0.9325153374233128,1.0723684210526316
16321,/images/d5009906-bce1-4353-90b4-f4c79362f4cf.png,768,564,909,680,141,116,trophozoite,16356,0.8226950354609929,1.2155172413793103
16358,/images/69569ecf-cfa1-4ddd-9342-b22c23387fdb.png,158,350,312,490,154,140,gametocyte,21560,0.9090909090909091,1.1
16466,/images/9e5437c6-b0d3-473b-b7c3-8f5afeb90c7a.png,783,296,921,431,138,135,trophozoite,18630,0.9782608695652174,1.0222222222222221
16480,/images/9e5437c6-b0d3-473b-b7c3-8f5afeb90c7a.png,224,385,379,541,155,156,schizont,24180,1.0064516129032257,0.9935897435897436
16500,/images/1315c2a4-0794-4dfa-a709-e2451723d2b6.png,138,1255,267,1404,129,149,schizont,19221,1.1550387596899225,0.8657718120805369
16630,/images/a27858ef-6533-413e-bc75-cc54690261a2.png,279,829,414,972,135,143,schizont,19305,1.0592592592592593,0.9440559440559441
16631,/images/a27858ef-6533-413e-bc75-cc54690261a2.png,272,289,408,424,136,135,gametocyte,18360,0.9926470588235294,1.0074074074074073
16923,/images/f5419bc0-4415-41b6-b832-5326cfcc534b.png,497,926,632,1052,135,126,ring,17010,0.9333333333333333,1.0714285714285714
17031,/images/57e1879e-4294-45e7-9c1b-627e8cca0271.png,329,893,461,1016,132,123,trophozoite,16236,0.9318181818181818,1.0731707317073171
17043,/images/57e1879e-4294-45e7-9c1b-627e8cca0271.png,31,1196,170,1322,139,126,trophozoite,17514,0.9064748201438849,1.1031746031746033
17080,/images/883b726a-f61c-4382-9f1b-2fff302beba6.png,901,1177,1048,1336,147,159,schizont,23373,1.0816326530612246,0.9245283018867925
17096,/images/883b726a-f61c-4382-9f1b-2fff302beba6.png,181,219,310,347,129,128,trophozoite,16512,0.9922480620155039,1.0078125
17143,/images/dc3bdfe9-1565-4cda-9c4e-0979846dab60.png,287,859,416,971,129,112,gametocyte,14448,0.8682170542635659,1.1517857142857142
17148,/images/dc3bdfe9-1565-4cda-9c4e-0979846dab60.png,666,1293,799,1431,133,138,trophozoite,18354,1.037593984962406,0.9637681159420289
17263,/images/471f75c6-bd5d-4c20-bcc1-258e836f4d69.png,888,344,1033,483,145,139,trophozoite,20155,0.9586206896551724,1.0431654676258992
17264,/images/471f75c6-bd5d-4c20-bcc1-258e836f4d69.png,358,980,467,1092,109,112,ring,12208,1.0275229357798166,0.9732142857142857
17295,/images/3d302619-473d-4c5b-af43-8833ff94233f.png,587,531,717,659,130,128,trophozoite,16640,0.9846153846153847,1.015625
17312,/images/3d302619-473d-4c5b-af43-8833ff94233f.png,888,314,997,413,109,99,trophozoite,10791,0.908256880733945,1.101010101010101
17341,/images/3d302619-473d-4c5b-af43-8833ff94233f.png,963,738,1100,883,137,145,trophozoite,19865,1.0583941605839415,0.9448275862068966
17411,/images/6f4ffe7b-395f-41ea-ad61-df5e0cbd531c.png,281,672,414,799,133,127,schizont,16891,0.9548872180451128,1.047244094488189
17435,/images/f329e01b-fbd3-4fb5-9738-a7ff4c8622b8.png,613,875,745,993,132,118,gametocyte,15576,0.8939393939393939,1.11864406779661
17516,/images/56077789-8580-41b4-89d6-deea227e5c60.png,403,583,545,711,142,128,trophozoite,18176,0.9014084507042254,1.109375
17517,/images/56077789-8580-41b4-89d6-deea227e5c60.png,714,418,842,563,128,145,trophozoite,18560,1.1328125,0.8827586206896552
17789,/images/1863da5f-c595-4541-a8f4-21fe78678168.png,616,198,749,325,133,127,ring,16891,0.9548872180451128,1.047244094488189
17793,/images/1863da5f-c595-4541-a8f4-21fe78678168.png,326,342,446,472,120,130,ring,15600,1.0833333333333333,0.9230769230769231
17794,/images/1863da5f-c595-4541-a8f4-21fe78678168.png,535,1378,647,1482,112,104,ring,11648,0.9285714285714286,1.0769230769230769
17824,/images/1863da5f-c595-4541-a8f4-21fe78678168.png,291,508,412,618,121,110,ring,13310,0.9090909090909091,1.1
18023,/images/eb77e4a9-acb0-4d83-8055-2c5fcaa54b45.png,788,779,901,880,113,101,ring,11413,0.8938053097345132,1.118811881188119
18045,/images/0f0c949e-018a-4f3f-ab02-3704f49c7754.png,925,1256,1062,1372,137,116,ring,15892,0.8467153284671532,1.1810344827586208
18053,/images/0f0c949e-018a-4f3f-ab02-3704f49c7754.png,637,1082,754,1215,117,133,ring,15561,1.1367521367521367,0.8796992481203008
18173,/images/947348fe-4c70-468e-8009-3c14daeca69b.png,512,786,652,958,140,172,schizont,24080,1.2285714285714286,0.813953488372093
18440,/images/39cc33be-d752-40fe-b7a8-2e69a3517205.png,843,172,974,286,131,114,ring,14934,0.8702290076335878,1.1491228070175439
18476,/images/9b410534-3b70-4a88-9f93-205cf4e55a05.png,242,890,349,1015,107,125,trophozoite,13375,1.1682242990654206,0.856
18489,/images/9b410534-3b70-4a88-9f93-205cf4e55a05.png,354,885,493,1049,139,164,trophozoite,22796,1.1798561151079137,0.8475609756097561
18609,/images/c22f7031-9cf8-48ce-b03b-1b12d0db4951.png,332,1447,448,1545,116,98,trophozoite,11368,0.8448275862068966,1.183673469387755
18742,/images/f6f8a69a-3fd2-4684-ac77-3e83ea0fb36d.png,725,65,861,208,136,143,trophozoite,19448,1.0514705882352942,0.951048951048951
18749,/images/f6f8a69a-3fd2-4684-ac77-3e83ea0fb36d.png,240,1404,373,1533,133,129,trophozoite,17157,0.9699248120300752,1.0310077519379846
18768,/images/cc882eae-a341-4783-bd19-8bdedf798538.png,1031,437,1144,557,113,120,ring,13560,1.0619469026548674,0.9416666666666667
18777,/images/cc882eae-a341-4783-bd19-8bdedf798538.png,122,351,248,466,126,115,ring,14490,0.9126984126984127,1.0956521739130434
18865,/images/d1b48634-9ad5-46e8-b816-42d1d97c93cd.png,951,245,1069,360,118,115,trophozoite,13570,0.9745762711864406,1.0260869565217392
19102,/images/2196389c-45ec-46b5-bc6c-1f4a33df7f7c.png,410,823,562,974,152,151,trophozoite,22952,0.993421052631579,1.0066225165562914
19172,/images/bb795ddf-ce72-42d5-9006-124db4d5cf1c.png,351,1335,476,1457,125,122,trophozoite,15250,0.976,1.0245901639344261
19217,/images/064b84fe-bd21-4c27-b682-0a832272eac4.png,866,487,959,579,93,92,schizont,8556,0.989247311827957,1.0108695652173914
19310,/images/b4d22412-a495-43a9-bec0-73a2322f8dad.png,344,464,492,614,148,150,trophozoite,22200,1.0135135135135136,0.9866666666666667
19312,/images/b4d22412-a495-43a9-bec0-73a2322f8dad.png,186,1228,304,1371,118,143,trophozoite,16874,1.2118644067796611,0.8251748251748252
19356,/images/a302a6fa-f635-4ade-b72b-b6f3c2a34ec9.png,718,807,842,933,124,126,ring,15624,1.0161290322580645,0.9841269841269841
19393,/images/5487faad-24a7-46b6-92d8-479d3a8d229f.png,848,253,963,369,115,116,ring,13340,1.008695652173913,0.9913793103448276
19412,/images/5487faad-24a7-46b6-92d8-479d3a8d229f.png,61,664,191,786,130,122,ring,15860,0.9384615384615385,1.0655737704918034
19460,/images/361a3578-4cbb-422b-9e3c-b5e61395b12e.png,555,1008,670,1124,115,116,ring,13340,1.008695652173913,0.9913793103448276
19511,/images/a85cd1ae-0c94-4387-8305-84ab8d96d137.png,779,1214,922,1367,143,153,schizont,21879,1.06993006993007,0.934640522875817
19592,/images/883d9731-a04d-4f84-83c9-d3bef954759d.png,287,85,414,205,127,120,schizont,15240,0.9448818897637795,1.0583333333333333
19601,/images/883d9731-a04d-4f84-83c9-d3bef954759d.png,855,1196,993,1347,138,151,leukocyte,20838,1.0942028985507246,0.9139072847682119
19620,/images/a3ada657-de00-44db-b1e2-54ba17e39983.png,739,777,886,917,147,140,schizont,20580,0.9523809523809523,1.05
19680,/images/627d6331-7bb9-4d1a-b20d-e6541af4d0f9.png,302,722,421,862,119,140,trophozoite,16660,1.1764705882352942,0.85
19683,/images/627d6331-7bb9-4d1a-b20d-e6541af4d0f9.png,1002,468,1133,573,131,105,trophozoite,13755,0.8015267175572519,1.2476190476190476
19704,/images/627d6331-7bb9-4d1a-b20d-e6541af4d0f9.png,472,1434,613,1579,141,145,trophozoite,20445,1.0283687943262412,0.9724137931034482
19727,/images/627d6331-7bb9-4d1a-b20d-e6541af4d0f9.png,35,720,168,833,133,113,trophozoite,15029,0.849624060150376,1.176991150442478
19728,/images/627d6331-7bb9-4d1a-b20d-e6541af4d0f9.png,50,1305,173,1437,123,132,trophozoite,16236,1.0731707317073171,0.9318181818181818
19851,/images/b318889c-3c60-477c-b8f6-d18cb01a59df.png,723,1178,865,1315,142,137,trophozoite,19454,0.9647887323943662,1.0364963503649636
19894,/images/b318889c-3c60-477c-b8f6-d18cb01a59df.png,979,1394,1120,1534,141,140,trophozoite,19740,0.9929078014184397,1.0071428571428571
19899,/images/b318889c-3c60-477c-b8f6-d18cb01a59df.png,641,909,766,1040,125,131,trophozoite,16375,1.048,0.9541984732824428
19936,/images/0ca25c88-457f-4f03-bbc1-98fb6663f1d1.png,982,257,1107,396,125,139,trophozoite,17375,1.112,0.8992805755395683
19948,/images/0ca25c88-457f-4f03-bbc1-98fb6663f1d1.png,737,793,854,934,117,141,trophozoite,16497,1.205128205128205,0.8297872340425532
19949,/images/0ca25c88-457f-4f03-bbc1-98fb6663f1d1.png,233,1394,349,1527,116,133,trophozoite,15428,1.146551724137931,0.8721804511278195
20075,/images/ebfd9f67-138e-49f0-9cef-a0352069eedb.png,963,623,1110,751,147,128,trophozoite,18816,0.8707482993197279,1.1484375
20076,/images/ebfd9f67-138e-49f0-9cef-a0352069eedb.png,909,1144,1050,1279,141,135,trophozoite,19035,0.9574468085106383,1.0444444444444445
20142,/images/df49578a-60d4-4a3b-9ee0-79d9d59bc72a.png,487,185,630,326,143,141,gametocyte,20163,0.986013986013986,1.0141843971631206
20177,/images/bb337c84-f727-42a5-9c3d-934323a16c6a.png,897,515,1031,659,134,144,schizont,19296,1.0746268656716418,0.9305555555555556
20335,/images/98976666-9125-47fe-9601-43c41e58dfb4.png,648,576,821,717,173,141,trophozoite,24393,0.815028901734104,1.2269503546099292
20416,/images/781d4bea-c6a9-4b36-ae10-ba9e328c87fe.png,859,1017,1005,1172,146,155,trophozoite,22630,1.0616438356164384,0.9419354838709677
20428,/images/781d4bea-c6a9-4b36-ae10-ba9e328c87fe.png,427,751,564,899,137,148,trophozoite,20276,1.0802919708029197,0.9256756756756757
20439,/images/781d4bea-c6a9-4b36-ae10-ba9e328c87fe.png,129,807,279,963,150,156,trophozoite,23400,1.04,0.9615384615384616
20463,/images/b809b407-7b69-4334-873d-d6c49135f04a.png,716,652,856,778,140,126,trophozoite,17640,0.9,1.1111111111111112
20658,/images/d09eed76-e09b-4d90-b8f0-5a801beae41c.png,321,339,465,489,144,150,leukocyte,21600,1.0416666666666667,0.96
20715,/images/79b3a64f-2fb9-46e0-85d4-2bdd59c2075e.png,333,68,461,196,128,128,ring,16384,1.0,1.0
20730,/images/79b3a64f-2fb9-46e0-85d4-2bdd59c2075e.png,332,1408,458,1525,126,117,ring,14742,0.9285714285714286,1.0769230769230769
20897,/images/c2ec116f-f091-422c-926c-70b548a8f6ef.png,211,1286,366,1414,155,128,trophozoite,19840,0.8258064516129032,1.2109375
20898,/images/c2ec116f-f091-422c-926c-70b548a8f6ef.png,376,632,493,764,117,132,trophozoite,15444,1.1282051282051282,0.8863636363636364
21089,/images/c680004e-6ee2-43d7-877c-edc9b5ebeecc.png,208,795,351,927,143,132,trophozoite,18876,0.9230769230769231,1.0833333333333333
21090,/images/c680004e-6ee2-43d7-877c-edc9b5ebeecc.png,181,603,340,748,159,145,trophozoite,23055,0.9119496855345912,1.096551724137931
21119,/images/fb05b297-180a-4171-b633-09d5616d7534.png,407,298,547,421,140,123,trophozoite,17220,0.8785714285714286,1.1382113821138211
21154,/images/fb05b297-180a-4171-b633-09d5616d7534.png,1005,1316,1127,1465,122,149,trophozoite,18178,1.221311475409836,0.8187919463087249
21167,/images/fb05b297-180a-4171-b633-09d5616d7534.png,1029,738,1146,871,117,133,trophozoite,15561,1.1367521367521367,0.8796992481203008
21171,/images/fb05b297-180a-4171-b633-09d5616d7534.png,321,1147,438,1260,117,113,trophozoite,13221,0.9658119658119658,1.0353982300884956
21172,/images/fb05b297-180a-4171-b633-09d5616d7534.png,511,1410,631,1521,120,111,trophozoite,13320,0.925,1.0810810810810811
21254,/images/0ceb4539-5c4c-487d-9826-452a88b5d537.png,612,1128,725,1250,113,122,ring,13786,1.079646017699115,0.9262295081967213
21255,/images/fc8df086-39e0-43f8-b0c7-2d23a349539b.png,368,940,525,1090,157,150,trophozoite,23550,0.9554140127388535,1.0466666666666666
21358,/images/5077f87d-a19f-494c-b911-14ccb03bd230.png,75,207,202,329,127,122,schizont,15494,0.9606299212598425,1.040983606557377
21385,/images/5077f87d-a19f-494c-b911-14ccb03bd230.png,960,1245,1106,1364,146,119,schizont,17374,0.815068493150685,1.226890756302521
21454,/images/b701b5c5-b922-4315-b12a-aac4ec65ee8b.png,383,1050,518,1213,135,163,trophozoite,22005,1.2074074074074075,0.8282208588957055
21525,/images/7625dfc4-858a-4c8e-907c-8943d665e9a7.png,25,385,154,530,129,145,ring,18705,1.124031007751938,0.8896551724137931
21666,/images/66183740-e1e5-43c9-8539-a87028bb3621.png,254,192,334,270,80,78,trophozoite,6240,0.975,1.0256410256410255
21743,/images/f68ae8e9-e760-4106-88e0-4bdef2785f06.png,261,330,401,470,140,140,trophozoite,19600,1.0,1.0
21784,/images/f68ae8e9-e760-4106-88e0-4bdef2785f06.png,214,560,366,687,152,127,trophozoite,19304,0.8355263157894737,1.1968503937007875
21785,/images/f68ae8e9-e760-4106-88e0-4bdef2785f06.png,383,1377,509,1482,126,105,trophozoite,13230,0.8333333333333334,1.2
21810,/images/9b3fd401-dab0-440f-8498-eb3cc9ffa970.png,799,119,913,227,114,108,leukocyte,12312,0.9473684210526315,1.0555555555555556
21840,/images/9b3fd401-dab0-440f-8498-eb3cc9ffa970.png,367,898,501,1015,134,117,trophozoite,15678,0.8731343283582089,1.1452991452991452
21845,/images/9b3fd401-dab0-440f-8498-eb3cc9ffa970.png,278,1098,381,1218,103,120,gametocyte,12360,1.1650485436893203,0.8583333333333333
21849,/images/9b3fd401-dab0-440f-8498-eb3cc9ffa970.png,177,1444,293,1568,116,124,trophozoite,14384,1.0689655172413792,0.9354838709677419
21850,/images/9b3fd401-dab0-440f-8498-eb3cc9ffa970.png,387,1162,533,1286,146,124,trophozoite,18104,0.8493150684931506,1.1774193548387097
21851,/images/9b3fd401-dab0-440f-8498-eb3cc9ffa970.png,438,507,590,652,152,145,trophozoite,22040,0.9539473684210527,1.0482758620689656
21852,/images/9b3fd401-dab0-440f-8498-eb3cc9ffa970.png,255,945,366,1080,111,135,trophozoite,14985,1.2162162162162162,0.8222222222222222
21990,/images/393df10a-5d64-476b-88f5-14ac56d6ed60.png,409,716,532,817,123,101,ring,12423,0.8211382113821138,1.2178217821782178
22102,/images/ac4d6507-d710-497b-ad7c-e0dd75c1d06d.png,694,475,864,614,170,139,trophozoite,23630,0.8176470588235294,1.223021582733813
22124,/images/ca677c3c-083f-4d54-9dec-39f79f6a17d8.png,816,333,934,465,118,132,leukocyte,15576,1.11864406779661,0.8939393939393939
22151,/images/ca677c3c-083f-4d54-9dec-39f79f6a17d8.png,864,1204,997,1322,133,118,ring,15694,0.8872180451127819,1.1271186440677967
22161,/images/ca677c3c-083f-4d54-9dec-39f79f6a17d8.png,595,584,705,714,110,130,leukocyte,14300,1.1818181818181819,0.8461538461538461
22163,/images/ca677c3c-083f-4d54-9dec-39f79f6a17d8.png,504,1113,652,1237,148,124,ring,18352,0.8378378378378378,1.1935483870967742
22189,/images/ca677c3c-083f-4d54-9dec-39f79f6a17d8.png,428,278,569,404,141,126,trophozoite,17766,0.8936170212765957,1.119047619047619
22301,/images/49b03a6e-6b26-4a96-a061-e05647a02138.png,931,1365,1083,1493,152,128,trophozoite,19456,0.8421052631578947,1.1875
22315,/images/49b03a6e-6b26-4a96-a061-e05647a02138.png,762,1187,905,1307,143,120,trophozoite,17160,0.8391608391608392,1.1916666666666667
22316,/images/49b03a6e-6b26-4a96-a061-e05647a02138.png,894,638,1018,791,124,153,trophozoite,18972,1.2338709677419355,0.8104575163398693
22346,/images/78c35732-7e31-4153-842e-55ab1cd656f6.png,381,1368,494,1482,113,114,ring,12882,1.008849557522124,0.9912280701754386
22379,/images/78c35732-7e31-4153-842e-55ab1cd656f6.png,1021,861,1129,970,108,109,ring,11772,1.0092592592592593,0.9908256880733946
22407,/images/f97c7c87-5e27-45ea-9f93-3285d74091de.png,536,673,662,797,126,124,ring,15624,0.9841269841269841,1.0161290322580645
22444,/images/f97c7c87-5e27-45ea-9f93-3285d74091de.png,485,295,598,415,113,120,trophozoite,13560,1.0619469026548674,0.9416666666666667
22466,/images/99d6a7e5-128e-4455-841d-8fbd1663905e.png,472,1185,601,1339,129,154,trophozoite,19866,1.193798449612403,0.8376623376623377
22629,/images/406e05f0-4444-414c-bb40-f4cb08e75ac9.png,475,942,637,1081,162,139,gametocyte,22518,0.8580246913580247,1.1654676258992807
22660,/images/4ab47131-c2ac-461f-b95c-ac19ce24edbd.png,383,440,515,579,132,139,leukocyte,18348,1.053030303030303,0.9496402877697842
22700,/images/4ab47131-c2ac-461f-b95c-ac19ce24edbd.png,990,425,1130,554,140,129,trophozoite,18060,0.9214285714285714,1.0852713178294573
22712,/images/4ab47131-c2ac-461f-b95c-ac19ce24edbd.png,808,1264,941,1409,133,145,trophozoite,19285,1.0902255639097744,0.9172413793103448
22713,/images/4ab47131-c2ac-461f-b95c-ac19ce24edbd.png,338,109,468,225,130,116,trophozoite,15080,0.8923076923076924,1.1206896551724137
22867,/images/95d5e689-c1d1-4ae8-a659-cc20c62a99f0.png,885,297,1020,449,135,152,schizont,20520,1.125925925925926,0.8881578947368421
23072,/images/be5bb7d0-7c3f-4bb9-8bb4-f8bc8d875943.png,988,879,1129,1007,141,128,trophozoite,18048,0.9078014184397163,1.1015625
23075,/images/be5bb7d0-7c3f-4bb9-8bb4-f8bc8d875943.png,966,51,1103,180,137,129,trophozoite,17673,0.9416058394160584,1.062015503875969
23098,/images/be5bb7d0-7c3f-4bb9-8bb4-f8bc8d875943.png,895,1439,1042,1595,147,156,ring,22932,1.0612244897959184,0.9423076923076923
23138,/images/c94a5851-b846-4fde-8c89-05bec3a8ac53.png,281,364,401,495,120,131,leukocyte,15720,1.0916666666666666,0.916030534351145
23165,/images/c94a5851-b846-4fde-8c89-05bec3a8ac53.png,548,1038,682,1196,134,158,trophozoite,21172,1.1791044776119404,0.8481012658227848
23166,/images/c94a5851-b846-4fde-8c89-05bec3a8ac53.png,678,1042,824,1174,146,132,ring,19272,0.9041095890410958,1.106060606060606
23208,/images/3dcd4f1b-ce43-4a34-b1ed-076bb42963b1.png,894,994,1021,1135,127,141,trophozoite,17907,1.110236220472441,0.900709219858156
23217,/images/3dcd4f1b-ce43-4a34-b1ed-076bb42963b1.png,278,118,418,255,140,137,trophozoite,19180,0.9785714285714285,1.0218978102189782
23219,/images/3dcd4f1b-ce43-4a34-b1ed-076bb42963b1.png,491,596,613,728,122,132,trophozoite,16104,1.0819672131147542,0.9242424242424242
23236,/images/3dcd4f1b-ce43-4a34-b1ed-076bb42963b1.png,103,541,243,671,140,130,trophozoite,18200,0.9285714285714286,1.0769230769230769
23244,/images/3dcd4f1b-ce43-4a34-b1ed-076bb42963b1.png,978,381,1069,477,91,96,leukocyte,8736,1.054945054945055,0.9479166666666666
23248,/images/3dcd4f1b-ce43-4a34-b1ed-076bb42963b1.png,130,8,252,143,122,135,trophozoite,16470,1.1065573770491803,0.9037037037037037
23283,/images/157ac97a-396e-4f6c-94c6-72a4d06ccc5f.png,510,840,662,1002,152,162,schizont,24624,1.0657894736842106,0.9382716049382716
23364,/images/a7688988-2bcc-4458-83d3-5e482da5f87b.png,255,1147,391,1259,136,112,ring,15232,0.8235294117647058,1.2142857142857142
23369,/images/a7688988-2bcc-4458-83d3-5e482da5f87b.png,939,1261,1083,1380,144,119,ring,17136,0.8263888888888888,1.2100840336134453
23410,/images/8757be1e-b832-407a-8e95-62abae485b24.png,252,469,352,579,100,110,leukocyte,11000,1.1,0.9090909090909091
23418,/images/8757be1e-b832-407a-8e95-62abae485b24.png,348,1243,457,1353,109,110,leukocyte,11990,1.0091743119266054,0.990909090909091
23458,/images/8757be1e-b832-407a-8e95-62abae485b24.png,587,861,713,998,126,137,ring,17262,1.0873015873015872,0.9197080291970803
23473,/images/8757be1e-b832-407a-8e95-62abae485b24.png,329,1412,469,1557,140,145,ring,20300,1.0357142857142858,0.9655172413793104
23694,/images/79d7a014-21ff-40f1-9ac4-a69839390654.png,486,1212,625,1356,139,144,trophozoite,20016,1.0359712230215827,0.9652777777777778
23825,/images/eeb06e39-482b-443d-8cf6-b9b5c763df78.png,268,674,400,821,132,147,gametocyte,19404,1.1136363636363635,0.8979591836734694
24081,/images/505355c9-23bf-4f90-8ebc-6a7ef50964d0.png,608,1075,726,1193,118,118,ring,13924,1.0,1.0
24105,/images/505355c9-23bf-4f90-8ebc-6a7ef50964d0.png,572,700,695,817,123,117,schizont,14391,0.9512195121951219,1.0512820512820513
24165,/images/1d4cdf2e-79a0-41e9-aabe-e437a190dfc4.png,4,439,136,567,132,128,ring,16896,0.9696969696969697,1.03125
24173,/images/1d4cdf2e-79a0-41e9-aabe-e437a190dfc4.png,1049,153,1176,281,127,128,ring,16256,1.0078740157480315,0.9921875
24216,/images/194aec70-41a5-4ac3-b22f-0b6eda91f730.png,148,1254,280,1387,132,133,trophozoite,17556,1.0075757575757576,0.9924812030075187
24363,/images/4d8a4ce8-0f9c-4f21-8844-4cf0e5514bbf.png,658,254,756,361,98,107,ring,10486,1.0918367346938775,0.9158878504672897
24431,/images/b78ba2c8-ecb3-45b2-9cda-2c8088fa95d1.png,220,1426,357,1556,137,130,schizont,17810,0.948905109489051,1.0538461538461539
24451,/images/b78ba2c8-ecb3-45b2-9cda-2c8088fa95d1.png,174,418,300,551,126,133,schizont,16758,1.0555555555555556,0.9473684210526315
24462,/images/b78ba2c8-ecb3-45b2-9cda-2c8088fa95d1.png,232,39,380,159,148,120,gametocyte,17760,0.8108108108108109,1.2333333333333334
24580,/images/c03d9b87-e19b-402b-ad86-b30d6e8aeb59.png,580,319,687,426,107,107,trophozoite,11449,1.0,1.0
24594,/images/c03d9b87-e19b-402b-ad86-b30d6e8aeb59.png,1005,1052,1114,1185,109,133,trophozoite,14497,1.2201834862385321,0.8195488721804511
24620,/images/c03d9b87-e19b-402b-ad86-b30d6e8aeb59.png,282,1087,438,1247,156,160,trophozoite,24960,1.0256410256410255,0.975
24621,/images/c03d9b87-e19b-402b-ad86-b30d6e8aeb59.png,584,381,712,515,128,134,ring,17152,1.046875,0.9552238805970149
24622,/images/c03d9b87-e19b-402b-ad86-b30d6e8aeb59.png,800,118,937,248,137,130,trophozoite,17810,0.948905109489051,1.0538461538461539
24720,/images/78a5d1c3-44dd-44bc-ad5b-5e25bdcc4fae.png,1010,570,1129,712,119,142,trophozoite,16898,1.1932773109243697,0.8380281690140845
24723,/images/78a5d1c3-44dd-44bc-ad5b-5e25bdcc4fae.png,704,137,809,238,105,101,trophozoite,10605,0.9619047619047619,1.0396039603960396
24825,/images/65054b19-5c6a-4870-99a9-eef994721d3a.png,869,1316,1017,1455,148,139,schizont,20572,0.9391891891891891,1.064748201438849
24827,/images/65054b19-5c6a-4870-99a9-eef994721d3a.png,341,1022,466,1163,125,141,schizont,17625,1.128,0.8865248226950354
24862,/images/93f7e207-0d8e-47f8-8258-09a0e03dbdd6.png,372,775,525,932,153,157,trophozoite,24021,1.026143790849673,0.9745222929936306
24868,/images/93f7e207-0d8e-47f8-8258-09a0e03dbdd6.png,650,353,781,458,131,105,schizont,13755,0.8015267175572519,1.2476190476190476
24978,/images/ed0bee2f-05e0-4392-8357-19750cec577c.png,811,288,914,406,103,118,ring,12154,1.145631067961165,0.8728813559322034
25086,/images/9e74feb8-017d-4d53-8896-9ebda4327dd1.png,577,887,698,1009,121,122,ring,14762,1.0082644628099173,0.9918032786885246
25087,/images/9e74feb8-017d-4d53-8896-9ebda4327dd1.png,51,587,168,703,117,116,ring,13572,0.9914529914529915,1.0086206896551724
25128,/images/9e74feb8-017d-4d53-8896-9ebda4327dd1.png,825,1328,956,1446,131,118,ring,15458,0.9007633587786259,1.1101694915254237
25218,/images/90171428-f208-428a-b40e-f57ee3bea457.png,1019,814,1155,940,136,126,trophozoite,17136,0.9264705882352942,1.0793650793650793
25234,/images/90171428-f208-428a-b40e-f57ee3bea457.png,295,980,411,1121,116,141,trophozoite,16356,1.2155172413793103,0.8226950354609929
25283,/images/587e5464-d70b-4279-8562-010279f6efbd.png,423,1406,554,1517,131,111,ring,14541,0.8473282442748091,1.1801801801801801
25291,/images/587e5464-d70b-4279-8562-010279f6efbd.png,365,1273,490,1390,125,117,ring,14625,0.936,1.0683760683760684
25295,/images/587e5464-d70b-4279-8562-010279f6efbd.png,837,1019,961,1142,124,123,ring,15252,0.9919354838709677,1.008130081300813
25451,/images/5f742392-278d-461c-a848-08def2c28878.png,893,177,1015,299,122,122,trophozoite,14884,1.0,1.0
25459,/images/5f742392-278d-461c-a848-08def2c28878.png,199,1194,342,1314,143,120,trophozoite,17160,0.8391608391608392,1.1916666666666667
25658,/images/770b8ca4-8377-479b-9ad5-5455ec3b44f8.png,199,1235,326,1390,127,155,trophozoite,19685,1.220472440944882,0.8193548387096774
25737,/images/1f8edb2a-40bc-4beb-aa6b-884d2473df0f.png,920,272,1078,419,158,147,leukocyte,23226,0.930379746835443,1.0748299319727892
25843,/images/14b68d86-ac7f-419d-b4a5-6b0b1d9aaa18.png,816,199,976,330,160,131,trophozoite,20960,0.81875,1.2213740458015268
25844,/images/14b68d86-ac7f-419d-b4a5-6b0b1d9aaa18.png,198,1337,332,1485,134,148,trophozoite,19832,1.1044776119402986,0.9054054054054054
25851,/images/14b68d86-ac7f-419d-b4a5-6b0b1d9aaa18.png,347,404,473,533,126,129,ring,16254,1.0238095238095237,0.9767441860465116
25886,/images/461a3ed6-039f-4a70-97cf-c474ecf51ccd.png,633,1366,772,1527,139,161,schizont,22379,1.158273381294964,0.8633540372670807
25911,/images/4811fdf2-d7e8-475e-a840-45dda5282bf3.png,374,409,518,558,144,149,schizont,21456,1.0347222222222223,0.9664429530201343
25963,/images/e683144c-0465-43a2-86b1-3cf52599d5e0.png,804,1437,907,1522,103,85,leukocyte,8755,0.8252427184466019,1.2117647058823529
25967,/images/e683144c-0465-43a2-86b1-3cf52599d5e0.png,785,86,921,199,136,113,trophozoite,15368,0.8308823529411765,1.2035398230088497
25989,/images/e683144c-0465-43a2-86b1-3cf52599d5e0.png,800,856,952,1010,152,154,trophozoite,23408,1.013157894736842,0.987012987012987
26138,/images/27388ff2-4000-4c9a-a2e3-addc448a5f92.png,227,309,371,471,144,162,schizont,23328,1.125,0.8888888888888888
26157,/images/04de27ff-0d36-4da3-a829-e93851d76981.png,189,529,331,663,142,134,gametocyte,19028,0.9436619718309859,1.0597014925373134
26278,/images/52767904-4cdc-4821-ba68-8cd0c28f9023.png,233,872,388,1017,155,145,trophozoite,22475,0.9354838709677419,1.0689655172413792
26327,/images/580210c2-a8ed-4720-b71c-a77945968abc.png,536,1346,660,1473,124,127,ring,15748,1.0241935483870968,0.9763779527559056
26407,/images/d532e31c-10ce-4313-9a36-bd5e01230254.png,738,322,875,438,137,116,ring,15892,0.8467153284671532,1.1810344827586208
26419,/images/d532e31c-10ce-4313-9a36-bd5e01230254.png,851,1115,985,1252,134,137,ring,18358,1.0223880597014925,0.9781021897810219
26495,/images/cdb086a8-2bf8-4436-b1ef-96cdd801f247.png,869,294,994,427,125,133,gametocyte,16625,1.064,0.9398496240601504
26520,/images/b2f05937-b965-4c4b-b86e-f50e95d9d691.png,901,830,1051,986,150,156,gametocyte,23400,1.04,0.9615384615384616
26537,/images/4935818a-7e7a-4f44-a3b6-b361d1abfe16.png,933,717,1059,835,126,118,trophozoite,14868,0.9365079365079365,1.0677966101694916
26620,/images/5893e081-04f2-4e33-9851-bed5f0e4d333.png,253,544,394,682,141,138,gametocyte,19458,0.9787234042553191,1.0217391304347827
26644,/images/16ec6e1f-5020-40b3-ba26-51c340d03ee7.png,219,177,363,320,144,143,trophozoite,20592,0.9930555555555556,1.006993006993007
26695,/images/c1423156-82b3-4dd3-8e74-08eb7ed8e1d6.png,218,833,348,951,130,118,schizont,15340,0.9076923076923077,1.1016949152542372
27000,/images/1f337b61-1b0d-4539-91f9-73d4a0798a4a.png,385,1398,521,1514,136,116,ring,15776,0.8529411764705882,1.1724137931034482
27011,/images/1f337b61-1b0d-4539-91f9-73d4a0798a4a.png,281,92,412,233,131,141,trophozoite,18471,1.0763358778625953,0.9290780141843972
27317,/images/9f38055f-4fe6-47fd-a6dd-c0743db4eccf.png,412,245,537,357,125,112,trophozoite,14000,0.896,1.1160714285714286
27520,/images/f5869ba8-6253-426b-93f3-82af59a86144.png,752,1384,874,1511,122,127,trophozoite,15494,1.040983606557377,0.9606299212598425
27525,/images/f5869ba8-6253-426b-93f3-82af59a86144.png,52,199,202,322,150,123,trophozoite,18450,0.82,1.2195121951219512
27618,/images/715761a2-745e-4743-9849-956a034ad3c4.png,352,1336,494,1495,142,159,trophozoite,22578,1.119718309859155,0.8930817610062893
27658,/images/18dbe7c4-89d2-42a6-a969-1e951ab313b1.png,845,1223,969,1336,124,113,ring,14012,0.9112903225806451,1.0973451327433628
27665,/images/18dbe7c4-89d2-42a6-a969-1e951ab313b1.png,592,364,711,476,119,112,ring,13328,0.9411764705882353,1.0625
27669,/images/18dbe7c4-89d2-42a6-a969-1e951ab313b1.png,271,97,388,218,117,121,ring,14157,1.0341880341880343,0.9669421487603306
27762,/images/e3c1442a-717f-41dd-bf97-81e1233ac9fa.png,988,614,1084,712,96,98,ring,9408,1.0208333333333333,0.9795918367346939
27783,/images/e3c1442a-717f-41dd-bf97-81e1233ac9fa.png,834,309,984,437,150,128,trophozoite,19200,0.8533333333333334,1.171875
27851,/images/948c94ad-395c-41f4-9a68-8a1dcb76888c.png,1044,510,1173,630,129,120,ring,15480,0.9302325581395349,1.075
27868,/images/948c94ad-395c-41f4-9a68-8a1dcb76888c.png,854,1118,974,1242,120,124,ring,14880,1.0333333333333334,0.967741935483871
27872,/images/948c94ad-395c-41f4-9a68-8a1dcb76888c.png,104,253,220,358,116,105,ring,12180,0.9051724137931034,1.1047619047619048
27951,/images/46f5bd4f-8bea-48d1-a1da-4dea28e3b814.png,899,61,1026,169,127,108,gametocyte,13716,0.8503937007874016,1.1759259259259258
27989,/images/c4d34e35-4db2-41de-ba77-1a94aa9ef788.png,243,723,379,840,136,117,trophozoite,15912,0.8602941176470589,1.1623931623931625
28188,/images/c244166d-12ca-445f-9ed9-a13d9caa412f.png,486,898,629,1046,143,148,trophozoite,21164,1.034965034965035,0.9662162162162162
28252,/images/036404d1-b9fc-497b-bbe1-f4d9c5ac3ce0.png,496,1363,622,1476,126,113,ring,14238,0.8968253968253969,1.1150442477876106
28258,/images/036404d1-b9fc-497b-bbe1-f4d9c5ac3ce0.png,871,1159,990,1272,119,113,ring,13447,0.9495798319327731,1.0530973451327434
28267,/images/036404d1-b9fc-497b-bbe1-f4d9c5ac3ce0.png,88,141,214,258,126,117,ring,14742,0.9285714285714286,1.0769230769230769
28307,/images/34e024a5-5698-42d4-972f-fee234b4bd64.png,802,551,906,653,104,102,leukocyte,10608,0.9807692307692307,1.0196078431372548
28350,/images/34e024a5-5698-42d4-972f-fee234b4bd64.png,988,1156,1130,1279,142,123,trophozoite,17466,0.8661971830985915,1.1544715447154472
28366,/images/34e024a5-5698-42d4-972f-fee234b4bd64.png,669,1,795,109,126,108,ring,13608,0.8571428571428571,1.1666666666666667
28507,/images/dc4270fb-e5c2-414f-96e9-6769ba1d77e4.png,307,112,444,234,137,122,gametocyte,16714,0.8905109489051095,1.1229508196721312
28594,/images/dbdfad64-110c-421f-a1c7-f68fd9e82d67.png,1002,1084,1124,1195,122,111,trophozoite,13542,0.9098360655737705,1.0990990990990992
28746,/images/151f3af5-5e6e-4bcd-9389-4974fc68813e.png,355,903,473,1033,118,130,trophozoite,15340,1.1016949152542372,0.9076923076923077
29093,/images/4c13e22e-dfd1-4fa1-b373-be9d0c272c0f.png,140,571,290,718,150,147,trophozoite,22050,0.98,1.0204081632653061
29295,/images/3850f2a5-ab62-49d3-8135-68d60baa676b.png,663,1079,813,1242,150,163,leukocyte,24450,1.0866666666666667,0.9202453987730062
29372,/images/30167dc1-f739-4036-b5c4-5fad435c2c67.png,85,20,213,134,128,114,ring,14592,0.890625,1.1228070175438596
29390,/images/b4e5e08d-6427-46f3-aca8-a4df165a151d.png,990,1310,1109,1435,119,125,ring,14875,1.050420168067227,0.952
29437,/images/b4e5e08d-6427-46f3-aca8-a4df165a151d.png,326,435,460,561,134,126,ring,16884,0.9402985074626866,1.0634920634920635
29497,/images/8cc6fe77-5f2f-4670-b4ac-1b49550241a8.png,1081,1279,1174,1379,93,100,leukocyte,9300,1.075268817204301,0.93
29534,/images/8cc6fe77-5f2f-4670-b4ac-1b49550241a8.png,456,120,603,261,147,141,trophozoite,20727,0.9591836734693877,1.0425531914893618
29535,/images/8cc6fe77-5f2f-4670-b4ac-1b49550241a8.png,151,218,296,334,145,116,trophozoite,16820,0.8,1.25
29536,/images/8cc6fe77-5f2f-4670-b4ac-1b49550241a8.png,252,424,376,571,124,147,trophozoite,18228,1.185483870967742,0.8435374149659864
29620,/images/42845335-4ab2-4963-806d-0985d1382a31.png,117,60,249,182,132,122,trophozoite,16104,0.9242424242424242,1.0819672131147542
29634,/images/42845335-4ab2-4963-806d-0985d1382a31.png,809,24,962,178,153,154,leukocyte,23562,1.0065359477124183,0.9935064935064936
29635,/images/42845335-4ab2-4963-806d-0985d1382a31.png,113,359,263,501,150,142,trophozoite,21300,0.9466666666666667,1.056338028169014
29771,/images/7ef90770-6aeb-45eb-9744-49c5247dde30.png,403,427,522,562,119,135,trophozoite,16065,1.134453781512605,0.8814814814814815
29784,/images/7ef90770-6aeb-45eb-9744-49c5247dde30.png,477,670,609,807,132,137,trophozoite,18084,1.0378787878787878,0.9635036496350365
29789,/images/7ef90770-6aeb-45eb-9744-49c5247dde30.png,652,1082,798,1219,146,137,trophozoite,20002,0.9383561643835616,1.0656934306569343
29790,/images/7ef90770-6aeb-45eb-9744-49c5247dde30.png,34,524,156,659,122,135,trophozoite,16470,1.1065573770491803,0.9037037037037037
29836,/images/9cdee92c-6267-4188-a41e-125bc0abb9ae.png,717,1152,825,1264,108,112,ring,12096,1.037037037037037,0.9642857142857143
29840,/images/9cdee92c-6267-4188-a41e-125bc0abb9ae.png,33,1130,160,1252,127,122,ring,15494,0.9606299212598425,1.040983606557377
29854,/images/9cdee92c-6267-4188-a41e-125bc0abb9ae.png,484,492,605,622,121,130,ring,15730,1.0743801652892562,0.9307692307692308
30071,/images/81c3c8f0-d5a9-4dda-afd5-e86f6afd9424.png,35,681,191,820,156,139,trophozoite,21684,0.8910256410256411,1.1223021582733812
30086,/images/81c3c8f0-d5a9-4dda-afd5-e86f6afd9424.png,1012,181,1107,280,95,99,leukocyte,9405,1.0421052631578946,0.9595959595959596
30102,/images/81c3c8f0-d5a9-4dda-afd5-e86f6afd9424.png,723,171,870,315,147,144,trophozoite,21168,0.9795918367346939,1.0208333333333333
30123,/images/81c3c8f0-d5a9-4dda-afd5-e86f6afd9424.png,627,956,777,1102,150,146,trophozoite,21900,0.9733333333333334,1.0273972602739727
30124,/images/81c3c8f0-d5a9-4dda-afd5-e86f6afd9424.png,304,321,419,453,115,132,trophozoite,15180,1.1478260869565218,0.8712121212121212
30195,/images/a1669b59-fe09-4fe6-ba9f-06bec6725502.png,488,616,619,735,131,119,trophozoite,15589,0.9083969465648855,1.1008403361344539
30207,/images/a1669b59-fe09-4fe6-ba9f-06bec6725502.png,2,324,131,467,129,143,trophozoite,18447,1.1085271317829457,0.9020979020979021
30208,/images/a1669b59-fe09-4fe6-ba9f-06bec6725502.png,927,57,1079,179,152,122,trophozoite,18544,0.8026315789473685,1.2459016393442623
30250,/images/f81806a8-5883-446c-be78-f0145b12dbdd.png,651,337,768,470,117,133,schizont,15561,1.1367521367521367,0.8796992481203008
30265,/images/cecbf663-0751-4e7f-b298-770c88afc2c1.png,961,70,1079,196,118,126,ring,14868,1.0677966101694916,0.9365079365079365
30280,/images/cecbf663-0751-4e7f-b298-770c88afc2c1.png,343,495,488,632,145,137,trophozoite,19865,0.9448275862068966,1.0583941605839415
30326,/images/cecbf663-0751-4e7f-b298-770c88afc2c1.png,524,216,639,355,115,139,trophozoite,15985,1.208695652173913,0.8273381294964028
30333,/images/cecbf663-0751-4e7f-b298-770c88afc2c1.png,2,317,120,445,118,128,trophozoite,15104,1.0847457627118644,0.921875
30353,/images/4aad9589-6b32-4522-bcd7-ca04687a02ca.png,512,1193,630,1322,118,129,gametocyte,15222,1.0932203389830508,0.9147286821705426
30374,/images/58d75854-be99-484e-89f0-4ab208fe07e0.png,1050,254,1169,362,119,108,ring,12852,0.907563025210084,1.1018518518518519
30380,/images/58d75854-be99-484e-89f0-4ab208fe07e0.png,911,1323,1039,1458,128,135,trophozoite,17280,1.0546875,0.9481481481481482
30384,/images/58d75854-be99-484e-89f0-4ab208fe07e0.png,214,61,336,174,122,113,ring,13786,0.9262295081967213,1.079646017699115
30422,/images/dedbb10c-43f1-45fb-bb40-3ce2fb874015.png,144,324,271,447,127,123,ring,15621,0.968503937007874,1.032520325203252
30423,/images/dedbb10c-43f1-45fb-bb40-3ce2fb874015.png,524,968,638,1083,114,115,ring,13110,1.0087719298245614,0.991304347826087
30443,/images/dedbb10c-43f1-45fb-bb40-3ce2fb874015.png,1008,1045,1133,1182,125,137,ring,17125,1.096,0.9124087591240876
30629,/images/f939782b-f5a2-40a3-9c22-6c6d7e18edc3.png,932,1086,1047,1198,115,112,leukocyte,12880,0.9739130434782609,1.0267857142857142
30659,/images/f939782b-f5a2-40a3-9c22-6c6d7e18edc3.png,105,445,241,588,136,143,trophozoite,19448,1.0514705882352942,0.951048951048951
30686,/images/f939782b-f5a2-40a3-9c22-6c6d7e18edc3.png,348,672,494,816,146,144,trophozoite,21024,0.9863013698630136,1.0138888888888888
30706,/images/8e0dfc1f-e3eb-4a3f-a1c4-249bdfbfaa27.png,138,1422,238,1531,100,109,leukocyte,10900,1.09,0.9174311926605505
30767,/images/8e0dfc1f-e3eb-4a3f-a1c4-249bdfbfaa27.png,682,125,818,236,136,111,trophozoite,15096,0.8161764705882353,1.2252252252252251
30768,/images/8e0dfc1f-e3eb-4a3f-a1c4-249bdfbfaa27.png,283,32,412,168,129,136,trophozoite,17544,1.054263565891473,0.9485294117647058
30833,/images/93a306b8-594a-4c7f-8b4a-127fb6ad8f1a.png,603,411,758,557,155,146,trophozoite,22630,0.9419354838709677,1.0616438356164384
30870,/images/fbc1f360-4382-48bb-a32e-3f5f2f9dbe57.png,74,786,209,911,135,125,trophozoite,16875,0.9259259259259259,1.08
30888,/images/fbc1f360-4382-48bb-a32e-3f5f2f9dbe57.png,947,998,1063,1137,116,139,gametocyte,16124,1.1982758620689655,0.8345323741007195
30902,/images/fbc1f360-4382-48bb-a32e-3f5f2f9dbe57.png,725,1,843,131,118,130,ring,15340,1.1016949152542372,0.9076923076923077
30903,/images/fbc1f360-4382-48bb-a32e-3f5f2f9dbe57.png,367,252,483,376,116,124,ring,14384,1.0689655172413792,0.9354838709677419
30904,/images/fbc1f360-4382-48bb-a32e-3f5f2f9dbe57.png,462,242,560,363,98,121,ring,11858,1.2346938775510203,0.8099173553719008
30943,/images/533c47c9-02a6-419b-961b-81797f022f6c.png,1012,791,1133,914,121,123,trophozoite,14883,1.0165289256198347,0.983739837398374
30962,/images/533c47c9-02a6-419b-961b-81797f022f6c.png,190,1167,326,1283,136,116,trophozoite,15776,0.8529411764705882,1.1724137931034482
30970,/images/533c47c9-02a6-419b-961b-81797f022f6c.png,542,478,664,598,122,120,ring,14640,0.9836065573770492,1.0166666666666666
31089,/images/9c48fdf4-621d-4f40-bcd7-6a28cd530de7.png,1036,258,1176,390,140,132,trophozoite,18480,0.9428571428571428,1.0606060606060606
31097,/images/9c48fdf4-621d-4f40-bcd7-6a28cd530de7.png,210,270,338,419,128,149,trophozoite,19072,1.1640625,0.8590604026845637
31195,/images/1976cd04-d24f-457c-b423-7e4cdb05de9e.png,1056,605,1163,725,107,120,ring,12840,1.1214953271028036,0.8916666666666667
31257,/images/db7c5ec1-fefe-4e9d-83c1-da8fb982f1e2.png,333,957,471,1073,138,116,ring,16008,0.8405797101449275,1.1896551724137931
31274,/images/db7c5ec1-fefe-4e9d-83c1-da8fb982f1e2.png,45,783,162,913,117,130,ring,15210,1.1111111111111112,0.9
31347,/images/04fb49a2-07b8-4cdf-b6f7-df5c3688e5f8.png,989,1076,1115,1192,126,116,ring,14616,0.9206349206349206,1.0862068965517242
31357,/images/04fb49a2-07b8-4cdf-b6f7-df5c3688e5f8.png,600,321,731,440,131,119,ring,15589,0.9083969465648855,1.1008403361344539
31374,/images/04fb49a2-07b8-4cdf-b6f7-df5c3688e5f8.png,369,779,504,893,135,114,ring,15390,0.8444444444444444,1.1842105263157894
31394,/images/04fb49a2-07b8-4cdf-b6f7-df5c3688e5f8.png,154,465,286,591,132,126,ring,16632,0.9545454545454546,1.0476190476190477
31433,/images/6695a204-e39c-4418-b904-3f080fdbe7e8.png,536,74,678,213,142,139,trophozoite,19738,0.9788732394366197,1.0215827338129497
31438,/images/6695a204-e39c-4418-b904-3f080fdbe7e8.png,905,1331,1016,1453,111,122,leukocyte,13542,1.0990990990990992,0.9098360655737705
31444,/images/6695a204-e39c-4418-b904-3f080fdbe7e8.png,968,341,1108,484,140,143,trophozoite,20020,1.0214285714285714,0.9790209790209791
31451,/images/6695a204-e39c-4418-b904-3f080fdbe7e8.png,836,567,971,716,135,149,trophozoite,20115,1.1037037037037036,0.9060402684563759
31456,/images/6695a204-e39c-4418-b904-3f080fdbe7e8.png,588,677,737,807,149,130,trophozoite,19370,0.87248322147651,1.146153846153846
31470,/images/6695a204-e39c-4418-b904-3f080fdbe7e8.png,520,244,657,386,137,142,trophozoite,19454,1.0364963503649636,0.9647887323943662
31472,/images/6695a204-e39c-4418-b904-3f080fdbe7e8.png,190,631,347,766,157,135,trophozoite,21195,0.8598726114649682,1.162962962962963
31640,/images/0d7bf56f-3b5a-40bd-971c-2ca33dd89b2c.png,992,1048,1151,1191,159,143,ring,22737,0.89937106918239,1.1118881118881119
31645,/images/0d7bf56f-3b5a-40bd-971c-2ca33dd89b2c.png,64,1337,175,1472,111,135,trophozoite,14985,1.2162162162162162,0.8222222222222222
31647,/images/0d7bf56f-3b5a-40bd-971c-2ca33dd89b2c.png,54,783,177,905,123,122,trophozoite,15006,0.991869918699187,1.0081967213114753
31815,/images/63ed5931-d93e-4f9b-a6f3-152713cb560e.png,637,278,777,406,140,128,ring,17920,0.9142857142857143,1.09375
31878,/images/f62d4fb6-df7c-446c-94a8-d5aede0b1e0c.png,946,969,1072,1117,126,148,trophozoite,18648,1.1746031746031746,0.8513513513513513
31922,/images/9eb66577-7857-43dc-a879-8f2c9d7f780f.png,586,584,695,698,109,114,leukocyte,12426,1.0458715596330275,0.956140350877193
31985,/images/9eb66577-7857-43dc-a879-8f2c9d7f780f.png,815,151,952,294,137,143,trophozoite,19591,1.0437956204379562,0.958041958041958
31988,/images/9eb66577-7857-43dc-a879-8f2c9d7f780f.png,394,168,525,306,131,138,trophozoite,18078,1.0534351145038168,0.9492753623188406
32072,/images/b8a4d467-c40c-4ebf-91dd-1c19d0f2a7ae.png,88,293,238,413,150,120,trophozoite,18000,0.8,1.25
32107,/images/9258fe22-6406-4d00-b6f0-3f9492925405.png,143,299,252,398,109,99,gametocyte,10791,0.908256880733945,1.101010101010101
32203,/images/07346d2e-a6e6-4dc0-95f1-9f7d8d7e3f66.png,469,784,613,954,144,170,schizont,24480,1.1805555555555556,0.8470588235294118
32383,/images/a6526894-e290-482d-ac43-f1df34864817.png,530,628,683,760,153,132,trophozoite,20196,0.8627450980392157,1.1590909090909092
32474,/images/3911fcd2-4e26-4ad9-aaf0-d1c5bf41defc.png,420,926,531,1035,111,109,ring,12099,0.9819819819819819,1.018348623853211
32477,/images/3911fcd2-4e26-4ad9-aaf0-d1c5bf41defc.png,388,359,530,489,142,130,ring,18460,0.9154929577464789,1.0923076923076922
32493,/images/d31dd2c0-ae8e-4499-86bb-7cabb6e438b9.png,537,333,684,483,147,150,gametocyte,22050,1.0204081632653061,0.98
32557,/images/318de807-7232-4ab1-843e-a901547c0125.png,614,446,741,570,127,124,gametocyte,15748,0.9763779527559056,1.0241935483870968
32726,/images/0154dd8e-72f8-4d78-a4dd-93e139577bd1.png,856,210,968,335,112,125,ring,14000,1.1160714285714286,0.896
32749,/images/eef2ac0b-42de-4bc3-a3c3-d5fcd597fbe4.png,325,687,452,808,127,121,ring,15367,0.952755905511811,1.0495867768595042
32751,/images/eef2ac0b-42de-4bc3-a3c3-d5fcd597fbe4.png,901,1383,1034,1509,133,126,ring,16758,0.9473684210526315,1.0555555555555556
32764,/images/eef2ac0b-42de-4bc3-a3c3-d5fcd597fbe4.png,772,836,909,967,137,131,leukocyte,17947,0.9562043795620438,1.0458015267175573
32963,/images/d1924af6-7512-4ccc-9c6b-adbbaa8db41f.png,51,641,192,775,141,134,trophozoite,18894,0.950354609929078,1.0522388059701493
32976,/images/d1924af6-7512-4ccc-9c6b-adbbaa8db41f.png,776,398,907,539,131,141,trophozoite,18471,1.0763358778625953,0.9290780141843972
32977,/images/d1924af6-7512-4ccc-9c6b-adbbaa8db41f.png,806,1352,922,1493,116,141,trophozoite,16356,1.2155172413793103,0.8226950354609929
33099,/images/6231d81d-9e84-4a5a-8cb8-47c6a37a0176.png,923,1115,1042,1232,119,117,ring,13923,0.9831932773109243,1.017094017094017
33102,/images/6231d81d-9e84-4a5a-8cb8-47c6a37a0176.png,461,204,548,292,87,88,ring,7656,1.0114942528735633,0.9886363636363636
33246,/images/877d5e7f-19b6-40e7-81bd-c92f25e72503.png,774,663,939,814,165,151,trophozoite,24915,0.9151515151515152,1.0927152317880795
33252,/images/877d5e7f-19b6-40e7-81bd-c92f25e72503.png,258,532,428,673,170,141,gametocyte,23970,0.8294117647058824,1.2056737588652482
33424,/images/244ac6fa-8a92-4214-9cf4-ae0811d9ec7e.png,802,1257,916,1390,114,133,ring,15162,1.1666666666666667,0.8571428571428571
33435,/images/244ac6fa-8a92-4214-9cf4-ae0811d9ec7e.png,761,479,896,600,135,121,ring,16335,0.8962962962962963,1.115702479338843
33453,/images/244ac6fa-8a92-4214-9cf4-ae0811d9ec7e.png,438,1141,546,1269,108,128,ring,13824,1.1851851851851851,0.84375
33565,/images/255d5f0c-87fc-4337-bb51-07c440df4f1b.png,204,238,340,392,136,154,schizont,20944,1.1323529411764706,0.8831168831168831
33585,/images/255d5f0c-87fc-4337-bb51-07c440df4f1b.png,397,622,553,763,156,141,trophozoite,21996,0.9038461538461539,1.1063829787234043
33587,/images/00c8364b-8c85-4502-bcfe-64736fe76815.png,229,1367,339,1481,110,114,ring,12540,1.0363636363636364,0.9649122807017544
33588,/images/00c8364b-8c85-4502-bcfe-64736fe76815.png,147,895,282,1016,135,121,ring,16335,0.8962962962962963,1.115702479338843
33645,/images/84ee2ea3-9edd-4672-a1b3-f09c607d833a.png,180,362,299,484,119,122,ring,14518,1.0252100840336134,0.9754098360655737
33688,/images/84ee2ea3-9edd-4672-a1b3-f09c607d833a.png,614,1312,743,1447,129,135,ring,17415,1.0465116279069768,0.9555555555555556
33755,/images/441d7843-b20b-4c10-84e3-e6d32621e880.png,321,1319,469,1454,148,135,trophozoite,19980,0.9121621621621622,1.0962962962962963
33757,/images/441d7843-b20b-4c10-84e3-e6d32621e880.png,855,462,988,585,133,123,trophozoite,16359,0.924812030075188,1.08130081300813
33778,/images/cb08956d-dd6a-4e13-817b-40a0a93068f1.png,352,707,471,838,119,131,trophozoite,15589,1.1008403361344539,0.9083969465648855
33784,/images/cb08956d-dd6a-4e13-817b-40a0a93068f1.png,145,1329,295,1478,150,149,trophozoite,22350,0.9933333333333333,1.0067114093959733
33862,/images/b9de8b1a-f96a-4eb5-bc05-84ad43a054f3.png,307,578,446,692,139,114,gametocyte,15846,0.8201438848920863,1.219298245614035
34020,/images/1012abf2-cb05-4337-86c5-513ec4ca904d.png,779,1174,906,1299,127,125,ring,15875,0.984251968503937,1.016
34044,/images/1012abf2-cb05-4337-86c5-513ec4ca904d.png,262,587,394,717,132,130,trophozoite,17160,0.9848484848484849,1.0153846153846153
34137,/images/de5d19b7-e670-4ac7-843b-7ce7bcebdf45.png,75,1318,203,1425,128,107,trophozoite,13696,0.8359375,1.1962616822429906
34184,/images/f1cda808-69a9-4d10-ba0a-6607c98e362d.png,62,909,192,1044,130,135,trophozoite,17550,1.0384615384615385,0.9629629629629629
34186,/images/f1cda808-69a9-4d10-ba0a-6607c98e362d.png,355,462,490,580,135,118,ring,15930,0.8740740740740741,1.1440677966101696
34187,/images/f1cda808-69a9-4d10-ba0a-6607c98e362d.png,1016,772,1123,892,107,120,trophozoite,12840,1.1214953271028036,0.8916666666666667
34188,/images/f1cda808-69a9-4d10-ba0a-6607c98e362d.png,986,871,1106,990,120,119,trophozoite,14280,0.9916666666666667,1.0084033613445378
34236,/images/4767bfcc-fe87-4962-8c40-6ce8d9363cdf.png,1019,1162,1151,1327,132,165,schizont,21780,1.25,0.8
34237,/images/259da25f-40f3-4d37-bca9-a9c807af1547.png,468,51,609,203,141,152,trophozoite,21432,1.0780141843971631,0.9276315789473685
34252,/images/259da25f-40f3-4d37-bca9-a9c807af1547.png,200,128,345,265,145,137,trophozoite,19865,0.9448275862068966,1.0583941605839415
34267,/images/259da25f-40f3-4d37-bca9-a9c807af1547.png,255,685,424,821,169,136,trophozoite,22984,0.8047337278106509,1.2426470588235294
34269,/images/259da25f-40f3-4d37-bca9-a9c807af1547.png,687,1123,824,1294,137,171,trophozoite,23427,1.2481751824817517,0.8011695906432749
34270,/images/259da25f-40f3-4d37-bca9-a9c807af1547.png,950,905,1070,1031,120,126,trophozoite,15120,1.05,0.9523809523809523
34322,/images/0d2aba33-6920-4001-bd54-59fe0bf9f50e.png,723,677,877,828,154,151,schizont,23254,0.9805194805194806,1.0198675496688743
34433,/images/b4bde4e8-f48b-4ae2-be01-86d8c91d0af9.png,79,839,198,953,119,114,ring,13566,0.957983193277311,1.043859649122807
34457,/images/b4bde4e8-f48b-4ae2-be01-86d8c91d0af9.png,341,476,464,592,123,116,ring,14268,0.943089430894309,1.0603448275862069
34458,/images/b4bde4e8-f48b-4ae2-be01-86d8c91d0af9.png,532,467,664,599,132,132,ring,17424,1.0,1.0
34535,/images/fa1f9f89-cecb-4972-842c-d14c632f89a9.png,562,245,703,369,141,124,trophozoite,17484,0.8794326241134752,1.1370967741935485
34540,/images/fa1f9f89-cecb-4972-842c-d14c632f89a9.png,16,1466,183,1600,167,134,trophozoite,22378,0.8023952095808383,1.2462686567164178
34579,/images/a0eedcb9-b85c-4612-b945-7e8227f53c35.png,1036,115,1162,244,126,129,ring,16254,1.0238095238095237,0.9767441860465116
34619,/images/a0eedcb9-b85c-4612-b945-7e8227f53c35.png,39,995,164,1109,125,114,ring,14250,0.912,1.0964912280701755
34851,/images/4fc9a597-aaa8-43b0-ad1c-2eabbe442e84.png,827,93,986,247,159,154,trophozoite,24486,0.9685534591194969,1.0324675324675325
34852,/images/4fc9a597-aaa8-43b0-ad1c-2eabbe442e84.png,385,218,514,335,129,117,trophozoite,15093,0.9069767441860465,1.1025641025641026
34854,/images/4fc9a597-aaa8-43b0-ad1c-2eabbe442e84.png,165,782,304,909,139,127,trophozoite,17653,0.9136690647482014,1.094488188976378
34855,/images/4fc9a597-aaa8-43b0-ad1c-2eabbe442e84.png,410,1244,533,1369,123,125,trophozoite,15375,1.016260162601626,0.984
34861,/images/4fc9a597-aaa8-43b0-ad1c-2eabbe442e84.png,118,1487,224,1598,106,111,gametocyte,11766,1.0471698113207548,0.954954954954955
34866,/images/4fc9a597-aaa8-43b0-ad1c-2eabbe442e84.png,1047,295,1188,417,141,122,trophozoite,17202,0.8652482269503546,1.1557377049180328
34933,/images/a4fbb9f2-9b75-4fdc-877d-2feaafac25b3.png,928,535,1064,663,136,128,trophozoite,17408,0.9411764705882353,1.0625
35240,/images/a9159b11-ba49-4885-902e-00c8d5095b98.png,223,123,363,263,140,140,trophozoite,19600,1.0,1.0
35269,/images/a9159b11-ba49-4885-902e-00c8d5095b98.png,986,530,1114,648,128,118,trophozoite,15104,0.921875,1.0847457627118644
35272,/images/a9159b11-ba49-4885-902e-00c8d5095b98.png,190,1367,349,1500,159,133,trophozoite,21147,0.8364779874213837,1.1954887218045114
35310,/images/516bf1d5-5d00-4985-926c-3993e9bc3ff5.png,507,843,658,1005,151,162,schizont,24462,1.0728476821192052,0.9320987654320988
35336,/images/452482bc-24a3-413e-ba03-fad4c9d61f3c.png,150,1158,271,1271,121,113,ring,13673,0.9338842975206612,1.0707964601769913
35337,/images/452482bc-24a3-413e-ba03-fad4c9d61f3c.png,394,255,528,363,134,108,ring,14472,0.8059701492537313,1.2407407407407407
35364,/images/452482bc-24a3-413e-ba03-fad4c9d61f3c.png,550,1234,681,1362,131,128,leukocyte,16768,0.9770992366412213,1.0234375
35653,/images/45f18ac0-f097-4b20-a99d-8837cf488822.png,122,430,255,573,133,143,trophozoite,19019,1.0751879699248121,0.9300699300699301
35812,/images/bb2042c5-35e1-43cc-8171-7de81b764361.png,620,505,738,622,118,117,trophozoite,13806,0.9915254237288136,1.0085470085470085
35935,/images/f8242b97-b8d5-48b5-b808-0b0f75a5de97.png,963,1310,1115,1451,152,141,schizont,21432,0.9276315789473685,1.0780141843971631
36027,/images/5836500a-221e-40ca-a8be-caaa37f7d300.png,172,498,272,594,100,96,ring,9600,0.96,1.0416666666666667
36170,/images/749df49e-5212-49ea-9e88-7d66f258f1df.png,893,391,1032,525,139,134,trophozoite,18626,0.9640287769784173,1.037313432835821
36215,/images/17c06a23-bb77-49cb-9ffb-fbfc75fcc715.png,704,1241,839,1377,135,136,schizont,18360,1.0074074074074073,0.9926470588235294
36325,/images/81fed4a1-9d48-4938-90c9-c8bf3f5e6b1f.png,457,999,573,1113,116,114,ring,13224,0.9827586206896551,1.0175438596491229
36407,/images/4a0a05e1-11ad-4bfc-bfa3-adf3b9bd0b56.png,193,1328,329,1462,136,134,ring,18224,0.9852941176470589,1.0149253731343284
36408,/images/4a0a05e1-11ad-4bfc-bfa3-adf3b9bd0b56.png,594,1364,721,1475,127,111,ring,14097,0.8740157480314961,1.1441441441441442
36447,/images/cfe6086f-eb0b-4cb0-a430-8cd7de6556e2.png,338,515,487,662,149,147,trophozoite,21903,0.9865771812080537,1.0136054421768708
36450,/images/cfe6086f-eb0b-4cb0-a430-8cd7de6556e2.png,17,1237,133,1371,116,134,trophozoite,15544,1.1551724137931034,0.8656716417910447
36456,/images/cfe6086f-eb0b-4cb0-a430-8cd7de6556e2.png,945,1415,1079,1537,134,122,trophozoite,16348,0.9104477611940298,1.098360655737705
36457,/images/cfe6086f-eb0b-4cb0-a430-8cd7de6556e2.png,246,908,373,1050,127,142,schizont,18034,1.1181102362204725,0.8943661971830986
36462,/images/cfe6086f-eb0b-4cb0-a430-8cd7de6556e2.png,592,641,735,762,143,121,trophozoite,17303,0.8461538461538461,1.1818181818181819
36467,/images/cfe6086f-eb0b-4cb0-a430-8cd7de6556e2.png,107,925,270,1058,163,133,trophozoite,21679,0.8159509202453987,1.2255639097744362
36469,/images/cfe6086f-eb0b-4cb0-a430-8cd7de6556e2.png,968,45,1072,163,104,118,trophozoite,12272,1.1346153846153846,0.8813559322033898
36737,/images/aa2dfa24-2dc3-4279-a232-f84780ace190.png,817,1011,948,1145,131,134,trophozoite,17554,1.0229007633587786,0.9776119402985075
36751,/images/aa2dfa24-2dc3-4279-a232-f84780ace190.png,965,54,1110,190,145,136,gametocyte,19720,0.9379310344827586,1.0661764705882353
36762,/images/aa2dfa24-2dc3-4279-a232-f84780ace190.png,488,1155,629,1273,141,118,trophozoite,16638,0.8368794326241135,1.194915254237288
36802,/images/dfac6c92-8f0f-429a-8caf-9b7732bf78da.png,145,1149,270,1274,125,125,ring,15625,1.0,1.0
36804,/images/dfac6c92-8f0f-429a-8caf-9b7732bf78da.png,229,348,349,475,120,127,ring,15240,1.0583333333333333,0.9448818897637795
36847,/images/3de03fa2-3ad3-43fc-8435-b2a80bdd7550.png,498,165,621,300,123,135,ring,16605,1.0975609756097562,0.9111111111111111
36853,/images/3de03fa2-3ad3-43fc-8435-b2a80bdd7550.png,859,806,986,927,127,121,ring,15367,0.952755905511811,1.0495867768595042
36858,/images/3de03fa2-3ad3-43fc-8435-b2a80bdd7550.png,392,446,521,571,129,125,ring,16125,0.9689922480620154,1.032
36977,/images/b2e34f5f-904e-4473-9dc7-c6bc1ce12640.png,903,343,1044,462,141,119,trophozoite,16779,0.8439716312056738,1.184873949579832
36978,/images/b2e34f5f-904e-4473-9dc7-c6bc1ce12640.png,292,1328,408,1449,116,121,trophozoite,14036,1.043103448275862,0.9586776859504132
37166,/images/d6942996-5664-4370-ad87-2bdcbd49ac16.png,262,979,358,1069,96,90,ring,8640,0.9375,1.0666666666666667
37337,/images/4d88e2d2-5aad-410c-9bbc-702ee9496995.png,744,1391,899,1528,155,137,schizont,21235,0.8838709677419355,1.1313868613138687
37731,/images/fe0c5e48-f65e-488c-9c3c-1ea7c7835c0c.png,886,862,994,981,108,119,ring,12852,1.1018518518518519,0.907563025210084
37740,/images/fe0c5e48-f65e-488c-9c3c-1ea7c7835c0c.png,154,278,278,392,124,114,ring,14136,0.9193548387096774,1.087719298245614
37742,/images/fe0c5e48-f65e-488c-9c3c-1ea7c7835c0c.png,693,566,814,697,121,131,ring,15851,1.0826446280991735,0.9236641221374046
37803,/images/8d56197c-21d7-4cb6-92df-80637efd129b.png,665,1328,800,1496,135,168,trophozoite,22680,1.2444444444444445,0.8035714285714286
37933,/images/56a57a8d-c9b9-432a-a3b0-32a09355806c.png,466,178,612,318,146,140,trophozoite,20440,0.958904109589041,1.042857142857143
38219,/images/1d9d4dac-66f9-4c87-b714-d723d5b15fa9.png,872,1168,1023,1299,151,131,schizont,19781,0.8675496688741722,1.1526717557251909
38223,/images/1d9d4dac-66f9-4c87-b714-d723d5b15fa9.png,635,1098,779,1254,144,156,schizont,22464,1.0833333333333333,0.9230769230769231
38237,/images/1d9d4dac-66f9-4c87-b714-d723d5b15fa9.png,1,1263,135,1421,134,158,trophozoite,21172,1.1791044776119404,0.8481012658227848
38285,/images/b834cbf7-ff97-49d9-9561-566c9343735c.png,836,1021,997,1156,161,135,gametocyte,21735,0.8385093167701864,1.1925925925925926
38400,/images/674b0fd3-f247-4b7f-97f7-3e6c57c9ba9e.png,588,875,708,1008,120,133,trophozoite,15960,1.1083333333333334,0.9022556390977443
38596,/images/f8b14fc4-dd6b-4ad0-a96d-c62845f48681.png,243,219,381,355,138,136,trophozoite,18768,0.9855072463768116,1.0147058823529411
38641,/images/3b601a1b-26d8-4873-afcf-fdd1b1e0010c.png,664,391,805,548,141,157,schizont,22137,1.1134751773049645,0.8980891719745223
38785,/images/b426ef1d-4a59-4f90-b593-50226af60a60.png,424,825,565,969,141,144,trophozoite,20304,1.0212765957446808,0.9791666666666666
38786,/images/b426ef1d-4a59-4f90-b593-50226af60a60.png,814,479,944,608,130,129,ring,16770,0.9923076923076923,1.0077519379844961
38794,/images/b426ef1d-4a59-4f90-b593-50226af60a60.png,809,1289,935,1419,126,130,trophozoite,16380,1.0317460317460319,0.9692307692307692
38853,/images/d79b4e90-c45d-4f5d-a498-49c3e323c291.png,655,76,757,176,102,100,leukocyte,10200,0.9803921568627451,1.02
38928,/images/d79b4e90-c45d-4f5d-a498-49c3e323c291.png,492,620,592,742,100,122,trophozoite,12200,1.22,0.819672131147541
39123,/images/7bde7de1-889b-4218-b0e1-e2c04f6a7986.png,948,346,1081,486,133,140,trophozoite,18620,1.0526315789473684,0.95
39125,/images/7bde7de1-889b-4218-b0e1-e2c04f6a7986.png,905,1425,1028,1543,123,118,ring,14514,0.959349593495935,1.0423728813559323
39140,/images/7bde7de1-889b-4218-b0e1-e2c04f6a7986.png,932,231,1038,350,106,119,trophozoite,12614,1.1226415094339623,0.8907563025210085
39148,/images/7bde7de1-889b-4218-b0e1-e2c04f6a7986.png,727,205,871,325,144,120,trophozoite,17280,0.8333333333333334,1.2
39205,/images/2aeb7b85-7df9-4a63-8d37-2eecaaa190e7.png,1054,178,1168,315,114,137,trophozoite,15618,1.2017543859649122,0.8321167883211679
39206,/images/2aeb7b85-7df9-4a63-8d37-2eecaaa190e7.png,672,1005,794,1147,122,142,trophozoite,17324,1.1639344262295082,0.8591549295774648
39250,/images/f7cced00-9b41-45ec-9fdf-fb9e1a74da90.png,673,1249,811,1369,138,120,ring,16560,0.8695652173913043,1.15
39251,/images/f7cced00-9b41-45ec-9fdf-fb9e1a74da90.png,911,1086,1033,1208,122,122,ring,14884,1.0,1.0
39268,/images/f7cced00-9b41-45ec-9fdf-fb9e1a74da90.png,64,583,192,706,128,123,ring,15744,0.9609375,1.0406504065040652
39338,/images/17ef5841-bd19-4610-ba47-7d321231847b.png,982,303,1130,426,148,123,trophozoite,18204,0.831081081081081,1.2032520325203253
39365,/images/fbcb2ef0-3c97-4d7a-8b96-0147c73f3941.png,383,1242,512,1362,129,120,ring,15480,0.9302325581395349,1.075
39376,/images/fbcb2ef0-3c97-4d7a-8b96-0147c73f3941.png,788,332,919,457,131,125,ring,16375,0.9541984732824428,1.048
39384,/images/fbcb2ef0-3c97-4d7a-8b96-0147c73f3941.png,620,148,734,253,114,105,ring,11970,0.9210526315789473,1.0857142857142856
39504,/images/5a631871-2fc7-4a68-9c39-f3b9a0bf4a04.png,101,206,227,331,126,125,trophozoite,15750,0.9920634920634921,1.008
39563,/images/5a631871-2fc7-4a68-9c39-f3b9a0bf4a04.png,900,528,1057,687,157,159,trophozoite,24963,1.0127388535031847,0.9874213836477987
39643,/images/04d21589-b777-43c2-86b5-038cbf8c3a4e.png,915,994,1026,1112,111,118,trophozoite,13098,1.063063063063063,0.940677966101695
39646,/images/04d21589-b777-43c2-86b5-038cbf8c3a4e.png,1039,1315,1181,1434,142,119,trophozoite,16898,0.8380281690140845,1.1932773109243697
39663,/images/04d21589-b777-43c2-86b5-038cbf8c3a4e.png,772,894,879,1007,107,113,leukocyte,12091,1.0560747663551402,0.9469026548672567
39666,/images/04d21589-b777-43c2-86b5-038cbf8c3a4e.png,644,39,809,171,165,132,trophozoite,21780,0.8,1.25
39668,/images/04d21589-b777-43c2-86b5-038cbf8c3a4e.png,755,787,888,918,133,131,trophozoite,17423,0.9849624060150376,1.015267175572519
39670,/images/04d21589-b777-43c2-86b5-038cbf8c3a4e.png,372,242,490,374,118,132,trophozoite,15576,1.11864406779661,0.8939393939393939
39730,/images/56adbb1e-96a8-40a5-a5a2-243c97ea889b.png,140,684,272,799,132,115,trophozoite,15180,0.8712121212121212,1.1478260869565218
39756,/images/56adbb1e-96a8-40a5-a5a2-243c97ea889b.png,133,279,224,370,91,91,trophozoite,8281,1.0,1.0
39786,/images/5c68070c-3391-4db6-8c01-94175105dbea.png,596,437,734,575,138,138,gametocyte,19044,1.0,1.0
39819,/images/5c68070c-3391-4db6-8c01-94175105dbea.png,553,97,705,240,152,143,ring,21736,0.9407894736842105,1.062937062937063
39823,/images/5c68070c-3391-4db6-8c01-94175105dbea.png,929,1052,1070,1212,141,160,ring,22560,1.1347517730496455,0.88125
39869,/images/af2e63a3-9fde-46aa-a867-81c5c259d1dc.png,340,47,475,165,135,118,trophozoite,15930,0.8740740740740741,1.1440677966101696
39873,/images/af2e63a3-9fde-46aa-a867-81c5c259d1dc.png,300,873,473,1016,173,143,trophozoite,24739,0.8265895953757225,1.2097902097902098
39874,/images/af2e63a3-9fde-46aa-a867-81c5c259d1dc.png,860,952,990,1108,130,156,trophozoite,20280,1.2,0.8333333333333334
40043,/images/8a4aadac-cf5c-4a79-b875-271b3fbfd230.png,447,159,580,300,133,141,gametocyte,18753,1.0601503759398496,0.9432624113475178
40046,/images/6fd30823-3b77-40c9-ba5d-e1eda9660674.png,642,871,788,1021,146,150,schizont,21900,1.0273972602739727,0.9733333333333334
40047,/images/6fd30823-3b77-40c9-ba5d-e1eda9660674.png,275,1044,396,1188,121,144,schizont,17424,1.1900826446280992,0.8402777777777778
40165,/images/b34e65f6-c32e-42f1-a437-4a037c75a231.png,7,778,135,897,128,119,ring,15232,0.9296875,1.0756302521008403
40306,/images/eb86033f-4f1c-4e8c-ae84-e8e4c7e08626.png,648,1040,770,1157,122,117,trophozoite,14274,0.9590163934426229,1.0427350427350428
40328,/images/eb86033f-4f1c-4e8c-ae84-e8e4c7e08626.png,824,335,970,481,146,146,trophozoite,21316,1.0,1.0
40332,/images/eb86033f-4f1c-4e8c-ae84-e8e4c7e08626.png,665,317,785,458,120,141,trophozoite,16920,1.175,0.851063829787234
40342,/images/eb86033f-4f1c-4e8c-ae84-e8e4c7e08626.png,1053,1413,1174,1536,121,123,trophozoite,14883,1.0165289256198347,0.983739837398374
40344,/images/eb86033f-4f1c-4e8c-ae84-e8e4c7e08626.png,319,383,449,531,130,148,trophozoite,19240,1.1384615384615384,0.8783783783783784
40345,/images/eb86033f-4f1c-4e8c-ae84-e8e4c7e08626.png,312,75,462,218,150,143,trophozoite,21450,0.9533333333333334,1.048951048951049
40416,/images/db249e5a-4142-432c-8288-bacd10d7273d.png,1031,989,1158,1129,127,140,trophozoite,17780,1.1023622047244095,0.9071428571428571
40466,/images/db249e5a-4142-432c-8288-bacd10d7273d.png,618,1038,732,1162,114,124,ring,14136,1.087719298245614,0.9193548387096774
40554,/images/e3ade58d-086c-47fa-9120-76beacb45395.png,354,727,505,849,151,122,schizont,18422,0.8079470198675497,1.2377049180327868
40733,/images/252071ac-e9f2-41d2-abbb-87ef01b8a997.png,958,572,1079,713,121,141,trophozoite,17061,1.165289256198347,0.8581560283687943
40873,/images/550cf4ce-b641-44a3-8487-3e16d4049187.png,656,1463,769,1568,113,105,trophozoite,11865,0.9292035398230089,1.0761904761904761
40901,/images/550cf4ce-b641-44a3-8487-3e16d4049187.png,841,902,937,997,96,95,leukocyte,9120,0.9895833333333334,1.0105263157894737
40914,/images/550cf4ce-b641-44a3-8487-3e16d4049187.png,113,158,241,283,128,125,trophozoite,16000,0.9765625,1.024
40926,/images/550cf4ce-b641-44a3-8487-3e16d4049187.png,428,1397,564,1526,136,129,trophozoite,17544,0.9485294117647058,1.054263565891473
40927,/images/550cf4ce-b641-44a3-8487-3e16d4049187.png,237,1452,383,1579,146,127,trophozoite,18542,0.8698630136986302,1.1496062992125984
40928,/images/550cf4ce-b641-44a3-8487-3e16d4049187.png,385,950,526,1063,141,113,trophozoite,15933,0.8014184397163121,1.247787610619469
40929,/images/550cf4ce-b641-44a3-8487-3e16d4049187.png,402,314,528,447,126,133,trophozoite,16758,1.0555555555555556,0.9473684210526315
41091,/images/e871f52c-77a6-4813-80d4-95bd97985f1a.png,233,557,388,692,155,135,trophozoite,20925,0.8709677419354839,1.1481481481481481
41094,/images/e871f52c-77a6-4813-80d4-95bd97985f1a.png,131,187,290,342,159,155,schizont,24645,0.9748427672955975,1.0258064516129033
41120,/images/2240b991-48f6-4c59-9b62-5a8b5e541fae.png,158,1294,276,1428,118,134,trophozoite,15812,1.1355932203389831,0.8805970149253731
41126,/images/2240b991-48f6-4c59-9b62-5a8b5e541fae.png,1020,1375,1155,1513,135,138,trophozoite,18630,1.0222222222222221,0.9782608695652174
41151,/images/2240b991-48f6-4c59-9b62-5a8b5e541fae.png,7,250,132,368,125,118,ring,14750,0.944,1.0593220338983051
41168,/images/2240b991-48f6-4c59-9b62-5a8b5e541fae.png,409,1219,541,1343,132,124,trophozoite,16368,0.9393939393939394,1.064516129032258
41291,/images/2374ae5b-c2df-4db5-afea-c54180aa22e3.png,532,1381,676,1515,144,134,trophozoite,19296,0.9305555555555556,1.0746268656716418
41298,/images/2374ae5b-c2df-4db5-afea-c54180aa22e3.png,539,904,669,1049,130,145,trophozoite,18850,1.1153846153846154,0.896551724137931
41299,/images/2374ae5b-c2df-4db5-afea-c54180aa22e3.png,582,669,714,827,132,158,trophozoite,20856,1.196969696969697,0.8354430379746836
41302,/images/2374ae5b-c2df-4db5-afea-c54180aa22e3.png,165,190,324,329,159,139,trophozoite,22101,0.8742138364779874,1.143884892086331
41303,/images/2374ae5b-c2df-4db5-afea-c54180aa22e3.png,32,655,159,800,127,145,trophozoite,18415,1.141732283464567,0.8758620689655172
41339,/images/a065c50b-341d-4803-b4b0-0fe8f04fdbb5.png,434,1017,585,1140,151,123,trophozoite,18573,0.8145695364238411,1.2276422764227641
41350,/images/a065c50b-341d-4803-b4b0-0fe8f04fdbb5.png,566,418,696,539,130,121,trophozoite,15730,0.9307692307692308,1.0743801652892562
41356,/images/a065c50b-341d-4803-b4b0-0fe8f04fdbb5.png,712,193,836,313,124,120,trophozoite,14880,0.967741935483871,1.0333333333333334
41359,/images/a065c50b-341d-4803-b4b0-0fe8f04fdbb5.png,170,1047,297,1151,127,104,trophozoite,13208,0.8188976377952756,1.2211538461538463
41360,/images/a065c50b-341d-4803-b4b0-0fe8f04fdbb5.png,79,965,202,1110,123,145,trophozoite,17835,1.1788617886178863,0.8482758620689655
41433,/images/c4494d4f-732f-431a-8a9d-62403f0b74fe.png,280,1090,392,1211,112,121,ring,13552,1.0803571428571428,0.9256198347107438
41472,/images/c4494d4f-732f-431a-8a9d-62403f0b74fe.png,476,1400,596,1541,120,141,ring,16920,1.175,0.851063829787234
41629,/images/0fcd1ebe-ee4a-40a0-b787-29cee18bfa1b.png,404,724,540,868,136,144,trophozoite,19584,1.0588235294117647,0.9444444444444444
42029,/images/46a03374-64c7-49ac-81c9-c3d62542bbf3.png,22,692,137,824,115,132,trophozoite,15180,1.1478260869565218,0.8712121212121212
42030,/images/46a03374-64c7-49ac-81c9-c3d62542bbf3.png,995,260,1132,421,137,161,trophozoite,22057,1.1751824817518248,0.8509316770186336
42033,/images/46a03374-64c7-49ac-81c9-c3d62542bbf3.png,89,752,178,855,89,103,trophozoite,9167,1.1573033707865168,0.8640776699029126
42174,/images/04c07425-57c7-415c-a0bc-36857bbd4049.png,206,1030,308,1137,102,107,gametocyte,10914,1.0490196078431373,0.9532710280373832
42207,/images/b618e87e-6059-496f-b0f6-e158f676a1fb.png,180,1356,331,1499,151,143,gametocyte,21593,0.9470198675496688,1.055944055944056
42208,/images/b618e87e-6059-496f-b0f6-e158f676a1fb.png,790,521,918,663,128,142,gametocyte,18176,1.109375,0.9014084507042254
42210,/images/ca734448-0d52-42fa-b41c-17b2939e58ae.png,617,527,725,627,108,100,leukocyte,10800,0.9259259259259259,1.08
42249,/images/ca734448-0d52-42fa-b41c-17b2939e58ae.png,564,1071,674,1175,110,104,leukocyte,11440,0.9454545454545454,1.0576923076923077
42318,/images/5c5b7965-1a44-44b8-aa43-660823e61821.png,942,109,1091,230,149,121,gametocyte,18029,0.8120805369127517,1.2314049586776858
42320,/images/5c5b7965-1a44-44b8-aa43-660823e61821.png,629,493,730,574,101,81,leukocyte,8181,0.801980198019802,1.2469135802469136
42331,/images/5c5b7965-1a44-44b8-aa43-660823e61821.png,458,1246,605,1403,147,157,trophozoite,23079,1.0680272108843538,0.9363057324840764
42341,/images/5c5b7965-1a44-44b8-aa43-660823e61821.png,64,772,212,928,148,156,trophozoite,23088,1.054054054054054,0.9487179487179487
42342,/images/5c5b7965-1a44-44b8-aa43-660823e61821.png,135,1080,293,1208,158,128,trophozoite,20224,0.810126582278481,1.234375
42343,/images/5c5b7965-1a44-44b8-aa43-660823e61821.png,853,1408,986,1542,133,134,trophozoite,17822,1.0075187969924813,0.9925373134328358
42494,/images/29648565-fe28-4517-ba72-68df0c82c9c5.png,864,1307,980,1433,116,126,trophozoite,14616,1.0862068965517242,0.9206349206349206
42562,/images/9a25f103-1683-47d1-8b07-ac20fe0b3ee9.png,798,1316,955,1445,157,129,gametocyte,20253,0.821656050955414,1.2170542635658914
42581,/images/184b376b-03cb-4c2d-af51-fc1a62196293.png,161,1188,287,1317,126,129,ring,16254,1.0238095238095237,0.9767441860465116
42691,/images/3abbc4d3-1d7e-40c9-9963-33732da7cc50.png,514,1139,609,1238,95,99,trophozoite,9405,1.0421052631578946,0.9595959595959596
42757,/images/a6f8a029-44ee-4fe3-b807-38d137347729.png,569,1292,680,1410,111,118,ring,13098,1.063063063063063,0.940677966101695
42786,/images/7c68c343-a7d3-4d26-b330-a5bb97ab8d9c.png,305,933,436,1094,131,161,leukocyte,21091,1.2290076335877862,0.8136645962732919
42807,/images/7029feb3-9ffe-46e4-9883-6a9df84f7b62.png,1033,906,1145,1022,112,116,leukocyte,12992,1.0357142857142858,0.9655172413793104
42834,/images/7029feb3-9ffe-46e4-9883-6a9df84f7b62.png,7,1113,141,1251,134,138,trophozoite,18492,1.0298507462686568,0.9710144927536232
42836,/images/7029feb3-9ffe-46e4-9883-6a9df84f7b62.png,290,315,397,433,107,118,trophozoite,12626,1.102803738317757,0.9067796610169492
42837,/images/7029feb3-9ffe-46e4-9883-6a9df84f7b62.png,453,306,580,446,127,140,trophozoite,17780,1.1023622047244095,0.9071428571428571
42922,/images/7d4c2160-317f-48d1-a60a-788ec300b3e8.png,966,1116,1105,1243,139,127,ring,17653,0.9136690647482014,1.094488188976378
42923,/images/7d4c2160-317f-48d1-a60a-788ec300b3e8.png,358,270,475,392,117,122,ring,14274,1.0427350427350428,0.9590163934426229
43050,/images/1345dc89-a3d9-4b71-8a75-b3bff01ba518.png,514,286,656,432,142,146,schizont,20732,1.028169014084507,0.9726027397260274
43111,/images/340a1727-0df7-4e6f-9c0e-9c5deddbfca2.png,773,995,943,1140,170,145,trophozoite,24650,0.8529411764705882,1.1724137931034482
43216,/images/fe1ee954-ba71-47b3-954a-d20ab940cd7b.png,644,390,792,556,148,166,leukocyte,24568,1.1216216216216217,0.891566265060241
43341,/images/36569710-a574-40be-ad42-897a6e74a128.png,488,237,631,364,143,127,trophozoite,18161,0.8881118881118881,1.125984251968504
43342,/images/36569710-a574-40be-ad42-897a6e74a128.png,280,466,415,584,135,118,trophozoite,15930,0.8740740740740741,1.1440677966101696
43344,/images/36569710-a574-40be-ad42-897a6e74a128.png,661,1093,789,1232,128,139,trophozoite,17792,1.0859375,0.920863309352518
43407,/images/367663b2-5d09-4020-ab0a-c2200e7a1c8c.png,116,557,248,682,132,125,ring,16500,0.946969696969697,1.056
43409,/images/367663b2-5d09-4020-ab0a-c2200e7a1c8c.png,401,752,531,873,130,121,ring,15730,0.9307692307692308,1.0743801652892562
43427,/images/367663b2-5d09-4020-ab0a-c2200e7a1c8c.png,931,1298,1048,1417,117,119,ring,13923,1.017094017094017,0.9831932773109243
43429,/images/367663b2-5d09-4020-ab0a-c2200e7a1c8c.png,917,379,1031,489,114,110,ring,12540,0.9649122807017544,1.0363636363636364
43593,/images/e0ef520d-7b65-485d-9888-e6859f189f70.png,222,485,344,627,122,142,trophozoite,17324,1.1639344262295082,0.8591549295774648
43641,/images/a4851ed0-1499-4eae-9157-dcd34773254f.png,866,1190,997,1299,131,109,ring,14279,0.8320610687022901,1.201834862385321
43642,/images/a4851ed0-1499-4eae-9157-dcd34773254f.png,25,971,161,1108,136,137,ring,18632,1.0073529411764706,0.9927007299270073
43763,/images/ef83ed4c-2724-4d5f-8abe-1a18d25cea35.png,109,335,260,500,151,165,trophozoite,24915,1.0927152317880795,0.9151515151515152
43798,/images/ef83ed4c-2724-4d5f-8abe-1a18d25cea35.png,740,100,895,250,155,150,trophozoite,23250,0.967741935483871,1.0333333333333334
43818,/images/c84edeb4-311c-4e82-88f9-ae0505b3ad13.png,463,521,600,659,137,138,trophozoite,18906,1.0072992700729928,0.9927536231884058
43830,/images/c84edeb4-311c-4e82-88f9-ae0505b3ad13.png,849,209,995,329,146,120,trophozoite,17520,0.821917808219178,1.2166666666666666
43839,/images/c84edeb4-311c-4e82-88f9-ae0505b3ad13.png,299,1029,432,1170,133,141,trophozoite,18753,1.0601503759398496,0.9432624113475178
43966,/images/d7c7eb2c-2acd-4f86-8a5a-09ab3dd02d16.png,997,92,1138,220,141,128,trophozoite,18048,0.9078014184397163,1.1015625
44319,/images/b197093e-2928-46a4-8e35-fa5ea7ea6dac.png,245,966,380,1080,135,114,gametocyte,15390,0.8444444444444444,1.1842105263157894
44495,/images/b6573be3-9e04-49c3-9f48-6a145d065363.png,979,1366,1103,1496,124,130,ring,16120,1.0483870967741935,0.9538461538461539
44775,/images/6795acae-e84d-4e97-b9a1-b4f4f0a72cfd.png,540,171,669,296,129,125,ring,16125,0.9689922480620154,1.032
44788,/images/6795acae-e84d-4e97-b9a1-b4f4f0a72cfd.png,842,658,952,773,110,115,ring,12650,1.0454545454545454,0.9565217391304348
44924,/images/83ec8923-6232-40d7-ba1f-a1b8bf7cb66c.png,882,628,972,740,90,112,ring,10080,1.2444444444444445,0.8035714285714286
45086,/images/56fbae44-4677-47f8-9c3a-22dac043c115.png,622,1009,739,1121,117,112,ring,13104,0.9572649572649573,1.0446428571428572
45107,/images/56fbae44-4677-47f8-9c3a-22dac043c115.png,52,461,157,560,105,99,ring,10395,0.9428571428571428,1.0606060606060606
45157,/images/2596eb32-1323-41e9-8c0f-64819abcfc73.png,344,1360,485,1483,141,123,trophozoite,17343,0.8723404255319149,1.146341463414634
45161,/images/2596eb32-1323-41e9-8c0f-64819abcfc73.png,272,1273,391,1414,119,141,trophozoite,16779,1.184873949579832,0.8439716312056738
45177,/images/2596eb32-1323-41e9-8c0f-64819abcfc73.png,548,293,691,430,143,137,trophozoite,19591,0.958041958041958,1.0437956204379562
45273,/images/9e793460-d94c-47ac-b3a7-0d6ad86357da.png,697,751,842,879,145,128,schizont,18560,0.8827586206896552,1.1328125
45579,/images/e597f7ce-46c6-4dce-9063-50a2703fdd45.png,368,1361,488,1474,120,113,ring,13560,0.9416666666666667,1.0619469026548674
45602,/images/e597f7ce-46c6-4dce-9063-50a2703fdd45.png,514,1104,625,1213,111,109,ring,12099,0.9819819819819819,1.018348623853211
45757,/images/584d62ed-4329-45dd-94ce-e929d8b2bb74.png,52,1115,203,1241,151,126,ring,19026,0.8344370860927153,1.1984126984126984
45857,/images/7db1373d-5bbf-47e6-ab40-30cba7678745.png,866,220,1010,366,144,146,gametocyte,21024,1.0138888888888888,0.9863013698630136
45887,/images/939ad732-d7c5-4339-b087-4335b49d6a3c.png,502,221,644,355,142,134,trophozoite,19028,0.9436619718309859,1.0597014925373134
46201,/images/d8632217-ec33-4d0a-98e6-427824c58869.png,112,738,248,871,136,133,trophozoite,18088,0.9779411764705882,1.0225563909774436
46209,/images/d8632217-ec33-4d0a-98e6-427824c58869.png,548,970,681,1112,133,142,trophozoite,18886,1.0676691729323309,0.9366197183098591
46211,/images/d8632217-ec33-4d0a-98e6-427824c58869.png,95,23,242,152,147,129,trophozoite,18963,0.8775510204081632,1.1395348837209303
46215,/images/d8632217-ec33-4d0a-98e6-427824c58869.png,546,968,678,1110,132,142,trophozoite,18744,1.0757575757575757,0.9295774647887324
46216,/images/d8632217-ec33-4d0a-98e6-427824c58869.png,165,1342,281,1441,116,99,leukocyte,11484,0.853448275862069,1.1717171717171717
46217,/images/d8632217-ec33-4d0a-98e6-427824c58869.png,190,1439,295,1523,105,84,leukocyte,8820,0.8,1.25
46318,/images/e11515b4-9527-4c23-a0ba-43719bacca0d.png,537,1369,655,1498,118,129,trophozoite,15222,1.0932203389830508,0.9147286821705426
46319,/images/e11515b4-9527-4c23-a0ba-43719bacca0d.png,959,843,1074,970,115,127,trophozoite,14605,1.1043478260869566,0.905511811023622
46427,/images/bbecf1a8-a728-4c83-87f8-4dfbac0a1e03.png,839,1386,954,1512,115,126,leukocyte,14490,1.0956521739130434,0.9126984126984127
46438,/images/bbecf1a8-a728-4c83-87f8-4dfbac0a1e03.png,952,434,1085,573,133,139,gametocyte,18487,1.0451127819548873,0.9568345323741008
46447,/images/bbecf1a8-a728-4c83-87f8-4dfbac0a1e03.png,714,1432,842,1579,128,147,trophozoite,18816,1.1484375,0.8707482993197279
46452,/images/bbecf1a8-a728-4c83-87f8-4dfbac0a1e03.png,949,41,1108,175,159,134,trophozoite,21306,0.8427672955974843,1.1865671641791045
46457,/images/bbecf1a8-a728-4c83-87f8-4dfbac0a1e03.png,575,1099,702,1253,127,154,trophozoite,19558,1.2125984251968505,0.8246753246753247
46458,/images/bbecf1a8-a728-4c83-87f8-4dfbac0a1e03.png,677,559,820,687,143,128,ring,18304,0.8951048951048951,1.1171875
46467,/images/bbecf1a8-a728-4c83-87f8-4dfbac0a1e03.png,738,922,866,1063,128,141,trophozoite,18048,1.1015625,0.9078014184397163
46468,/images/bbecf1a8-a728-4c83-87f8-4dfbac0a1e03.png,453,47,603,188,150,141,trophozoite,21150,0.94,1.0638297872340425
46479,/images/21417261-475a-456f-b03f-57ac85a6e106.png,295,1033,420,1161,125,128,ring,16000,1.024,0.9765625
46485,/images/21417261-475a-456f-b03f-57ac85a6e106.png,582,1009,708,1137,126,128,ring,16128,1.0158730158730158,0.984375
46496,/images/21417261-475a-456f-b03f-57ac85a6e106.png,772,885,897,1017,125,132,ring,16500,1.056,0.946969696969697
46572,/images/edd09b2e-2673-4405-8ac0-e476e003e96a.png,1037,837,1170,956,133,119,schizont,15827,0.8947368421052632,1.1176470588235294
46583,/images/edd09b2e-2673-4405-8ac0-e476e003e96a.png,847,706,993,857,146,151,trophozoite,22046,1.0342465753424657,0.9668874172185431
46791,/images/02fb5e19-6f94-4787-bb78-e550a29a3cbd.png,863,155,1019,305,156,150,schizont,23400,0.9615384615384616,1.04
46949,/images/9e0e1928-d19a-4100-b093-0b962ac09e05.png,691,1260,828,1418,137,158,trophozoite,21646,1.1532846715328466,0.8670886075949367
46951,/images/9e0e1928-d19a-4100-b093-0b962ac09e05.png,1022,1326,1172,1450,150,124,trophozoite,18600,0.8266666666666667,1.2096774193548387
46974,/images/9ebd623d-5534-4dd9-bff8-cdedf322db35.png,997,1208,1116,1336,119,128,ring,15232,1.0756302521008403,0.9296875
47014,/images/9ebd623d-5534-4dd9-bff8-cdedf322db35.png,187,801,310,923,123,122,trophozoite,15006,0.991869918699187,1.0081967213114753
47047,/images/997eabd9-55bf-4683-83c4-4cee4673a4ef.png,1011,528,1138,664,127,136,trophozoite,17272,1.0708661417322836,0.9338235294117647
47059,/images/997eabd9-55bf-4683-83c4-4cee4673a4ef.png,79,212,208,331,129,119,trophozoite,15351,0.9224806201550387,1.084033613445378
47060,/images/997eabd9-55bf-4683-83c4-4cee4673a4ef.png,603,295,744,445,141,150,trophozoite,21150,1.0638297872340425,0.94
47108,/images/820bbfea-3dae-46fc-b61a-3d0ed2ea01c2.png,564,1089,703,1258,139,169,schizont,23491,1.2158273381294964,0.8224852071005917
47219,/images/58ced55c-bf0d-4204-b6b2-4f8992d92779.png,26,41,133,138,107,97,leukocyte,10379,0.9065420560747663,1.1030927835051547
47228,/images/58ced55c-bf0d-4204-b6b2-4f8992d92779.png,932,1102,1072,1222,140,120,trophozoite,16800,0.8571428571428571,1.1666666666666667
47247,/images/58ced55c-bf0d-4204-b6b2-4f8992d92779.png,154,753,304,877,150,124,trophozoite,18600,0.8266666666666667,1.2096774193548387
47255,/images/58ced55c-bf0d-4204-b6b2-4f8992d92779.png,41,338,165,440,124,102,trophozoite,12648,0.8225806451612904,1.2156862745098038
47411,/images/477e541c-0519-4542-9b13-8ee7922644d3.png,367,236,514,395,147,159,ring,23373,1.0816326530612246,0.9245283018867925
47456,/images/f7231477-f2c1-439a-9c8b-204de07686a4.png,643,519,797,661,154,142,trophozoite,21868,0.922077922077922,1.0845070422535212
47639,/images/78ac1e98-7062-4e27-8d58-25c392cae889.png,792,708,926,846,134,138,gametocyte,18492,1.0298507462686568,0.9710144927536232
47706,/images/afbb264e-ff60-443a-83f5-49d09be1b835.png,122,1098,272,1246,150,148,schizont,22200,0.9866666666666667,1.0135135135135136
47748,/images/6b5ed184-cb15-4d54-93bb-9a3ca00184a1.png,113,1160,258,1324,145,164,trophozoite,23780,1.1310344827586207,0.8841463414634146
47847,/images/5a105b89-c592-4d78-b208-7db6c6572752.png,85,1172,203,1291,118,119,ring,14042,1.0084745762711864,0.9915966386554622
47909,/images/ab27173b-6e30-4957-bd68-29194328fd39.png,232,61,355,175,123,114,trophozoite,14022,0.926829268292683,1.0789473684210527
47929,/images/ab27173b-6e30-4957-bd68-29194328fd39.png,503,655,644,818,141,163,trophozoite,22983,1.1560283687943262,0.8650306748466258
47930,/images/ab27173b-6e30-4957-bd68-29194328fd39.png,487,1061,598,1183,111,122,trophozoite,13542,1.0990990990990992,0.9098360655737705
47931,/images/ab27173b-6e30-4957-bd68-29194328fd39.png,589,1115,705,1235,116,120,trophozoite,13920,1.0344827586206897,0.9666666666666667
47945,/images/ab27173b-6e30-4957-bd68-29194328fd39.png,961,238,1101,378,140,140,trophozoite,19600,1.0,1.0
47972,/images/eba73bff-fbe1-436d-9a5f-0a61331a0ea2.png,355,1021,445,1104,90,83,leukocyte,7470,0.9222222222222223,1.0843373493975903
47990,/images/eba73bff-fbe1-436d-9a5f-0a61331a0ea2.png,658,16,818,159,160,143,trophozoite,22880,0.89375,1.118881118881119
47991,/images/eba73bff-fbe1-436d-9a5f-0a61331a0ea2.png,168,1304,314,1432,146,128,trophozoite,18688,0.8767123287671232,1.140625
48027,/images/eba73bff-fbe1-436d-9a5f-0a61331a0ea2.png,911,605,1020,729,109,124,ring,13516,1.1376146788990826,0.8790322580645161
48057,/images/1d4f06e1-9c9b-487e-84cd-e7e50cc754da.png,636,1357,764,1510,128,153,schizont,19584,1.1953125,0.8366013071895425
48076,/images/1d4f06e1-9c9b-487e-84cd-e7e50cc754da.png,836,632,993,790,157,158,schizont,24806,1.0063694267515924,0.9936708860759493
48094,/images/05717db9-f1ef-4101-a9f7-7a007e83b1c9.png,901,390,1039,505,138,115,ring,15870,0.8333333333333334,1.2
48130,/images/05717db9-f1ef-4101-a9f7-7a007e83b1c9.png,967,616,1108,730,141,114,ring,16074,0.8085106382978723,1.236842105263158
48190,/images/913099c5-8085-4908-bf4b-1f098bbfcf66.png,127,907,243,1042,116,135,ring,15660,1.1637931034482758,0.8592592592592593
48198,/images/913099c5-8085-4908-bf4b-1f098bbfcf66.png,548,644,673,775,125,131,trophozoite,16375,1.048,0.9541984732824428
48199,/images/913099c5-8085-4908-bf4b-1f098bbfcf66.png,963,152,1108,288,145,136,trophozoite,19720,0.9379310344827586,1.0661764705882353
48200,/images/913099c5-8085-4908-bf4b-1f098bbfcf66.png,1018,365,1158,483,140,118,trophozoite,16520,0.8428571428571429,1.1864406779661016
48204,/images/913099c5-8085-4908-bf4b-1f098bbfcf66.png,288,143,424,274,136,131,trophozoite,17816,0.9632352941176471,1.0381679389312977
48239,/images/71204a6d-814e-44b6-9cee-7b979f478021.png,176,1052,304,1178,128,126,trophozoite,16128,0.984375,1.0158730158730158
48274,/images/71204a6d-814e-44b6-9cee-7b979f478021.png,274,1176,406,1305,132,129,trophozoite,17028,0.9772727272727273,1.0232558139534884
48302,/images/6fa2b30f-9b89-46ac-9b79-c0bc105d4271.png,278,1419,369,1517,91,98,leukocyte,8918,1.0769230769230769,0.9285714285714286
48339,/images/6fa2b30f-9b89-46ac-9b79-c0bc105d4271.png,276,739,387,868,111,129,leukocyte,14319,1.162162162162162,0.8604651162790697
48361,/images/6fa2b30f-9b89-46ac-9b79-c0bc105d4271.png,1042,815,1191,937,149,122,trophozoite,18178,0.8187919463087249,1.221311475409836
48362,/images/6fa2b30f-9b89-46ac-9b79-c0bc105d4271.png,954,441,1087,603,133,162,trophozoite,21546,1.218045112781955,0.8209876543209876
48363,/images/6fa2b30f-9b89-46ac-9b79-c0bc105d4271.png,772,254,911,377,139,123,trophozoite,17097,0.8848920863309353,1.1300813008130082
48364,/images/6fa2b30f-9b89-46ac-9b79-c0bc105d4271.png,0,229,145,370,145,141,trophozoite,20445,0.9724137931034482,1.0283687943262412
48447,/images/e13f2327-fbf4-4d84-a8c1-09cb1e449c8c.png,993,590,1126,723,133,133,trophozoite,17689,1.0,1.0
48486,/images/9c4cb048-d64a-4b7f-84ff-ca28a8084fc7.png,459,649,598,816,139,167,trophozoite,23213,1.2014388489208634,0.8323353293413174
48570,/images/f3d84be2-8af0-4d62-9f72-23d3dc08cbbe.png,223,305,389,452,166,147,gametocyte,24402,0.8855421686746988,1.129251700680272
48587,/images/55836297-fc8e-4e00-9767-0d12b86e4604.png,880,579,991,710,111,131,ring,14541,1.1801801801801801,0.8473282442748091
48596,/images/55836297-fc8e-4e00-9767-0d12b86e4604.png,496,946,607,1069,111,123,ring,13653,1.1081081081081081,0.9024390243902439
48598,/images/55836297-fc8e-4e00-9767-0d12b86e4604.png,194,1213,313,1341,119,128,ring,15232,1.0756302521008403,0.9296875
48901,/images/5dec0204-af81-44ef-a942-8a173669c123.png,599,814,689,913,90,99,leukocyte,8910,1.1,0.9090909090909091
48918,/images/5dec0204-af81-44ef-a942-8a173669c123.png,69,392,188,501,119,109,ring,12971,0.9159663865546218,1.091743119266055
48926,/images/5dec0204-af81-44ef-a942-8a173669c123.png,430,334,559,455,129,121,trophozoite,15609,0.937984496124031,1.0661157024793388
48929,/images/5dec0204-af81-44ef-a942-8a173669c123.png,301,380,457,518,156,138,gametocyte,21528,0.8846153846153846,1.1304347826086956
48956,/images/5dec0204-af81-44ef-a942-8a173669c123.png,484,116,612,234,128,118,trophozoite,15104,0.921875,1.0847457627118644
48964,/images/5dec0204-af81-44ef-a942-8a173669c123.png,992,1189,1131,1348,139,159,trophozoite,22101,1.143884892086331,0.8742138364779874
49202,/images/a9daf82a-a46d-4296-bd72-2c374ed0a193.png,927,945,1055,1074,128,129,trophozoite,16512,1.0078125,0.9922480620155039
49226,/images/a9daf82a-a46d-4296-bd72-2c374ed0a193.png,247,1067,385,1183,138,116,trophozoite,16008,0.8405797101449275,1.1896551724137931
49229,/images/a9daf82a-a46d-4296-bd72-2c374ed0a193.png,295,1358,426,1498,131,140,trophozoite,18340,1.0687022900763359,0.9357142857142857
49330,/images/28c96a4a-4549-4761-99e4-ace4ea7e7ac9.png,733,1063,869,1179,136,116,schizont,15776,0.8529411764705882,1.1724137931034482
49413,/images/f2574be3-81c6-4fc3-8a40-0230d1264f52.png,831,1245,982,1384,151,139,trophozoite,20989,0.9205298013245033,1.0863309352517985
49414,/images/f2574be3-81c6-4fc3-8a40-0230d1264f52.png,318,805,442,935,124,130,trophozoite,16120,1.0483870967741935,0.9538461538461539
49424,/images/f2574be3-81c6-4fc3-8a40-0230d1264f52.png,229,262,359,389,130,127,trophozoite,16510,0.9769230769230769,1.0236220472440944
49433,/images/f2574be3-81c6-4fc3-8a40-0230d1264f52.png,920,319,1057,449,137,130,trophozoite,17810,0.948905109489051,1.0538461538461539
49436,/images/f2574be3-81c6-4fc3-8a40-0230d1264f52.png,625,96,746,233,121,137,trophozoite,16577,1.1322314049586777,0.8832116788321168
49717,/images/9842445c-5899-4189-9f2e-3a3a179fdad3.png,983,1276,1108,1401,125,125,trophozoite,15625,1.0,1.0
49820,/images/5e17f8e6-fd8d-426c-b444-1515d14f04b7.png,990,1188,1092,1272,102,84,trophozoite,8568,0.8235294117647058,1.2142857142857142
49821,/images/5e17f8e6-fd8d-426c-b444-1515d14f04b7.png,665,50,786,178,121,128,trophozoite,15488,1.0578512396694215,0.9453125
49822,/images/5e17f8e6-fd8d-426c-b444-1515d14f04b7.png,169,1440,311,1575,142,135,trophozoite,19170,0.9507042253521126,1.0518518518518518
49823,/images/5e17f8e6-fd8d-426c-b444-1515d14f04b7.png,844,133,957,258,113,125,trophozoite,14125,1.1061946902654867,0.904
49824,/images/5e17f8e6-fd8d-426c-b444-1515d14f04b7.png,1019,1095,1116,1198,97,103,trophozoite,9991,1.0618556701030928,0.941747572815534
50006,/images/b1145408-feae-4637-b4cf-3e70b99cc62d.png,123,105,230,215,107,110,leukocyte,11770,1.02803738317757,0.9727272727272728
50020,/images/b1145408-feae-4637-b4cf-3e70b99cc62d.png,330,554,445,685,115,131,trophozoite,15065,1.1391304347826088,0.8778625954198473
50036,/images/b1145408-feae-4637-b4cf-3e70b99cc62d.png,332,1320,450,1443,118,123,trophozoite,14514,1.0423728813559323,0.959349593495935
50059,/images/b1145408-feae-4637-b4cf-3e70b99cc62d.png,884,374,1008,519,124,145,trophozoite,17980,1.1693548387096775,0.8551724137931035
50145,/images/4cccfcf0-cac9-46f0-870c-0eabfdc781ba.png,170,28,298,155,128,127,ring,16256,0.9921875,1.0078740157480315
50157,/images/4cccfcf0-cac9-46f0-870c-0eabfdc781ba.png,418,1470,526,1558,108,88,leukocyte,9504,0.8148148148148148,1.2272727272727273
50176,/images/4cccfcf0-cac9-46f0-870c-0eabfdc781ba.png,588,682,674,777,86,95,gametocyte,8170,1.1046511627906976,0.9052631578947369
50179,/images/4cccfcf0-cac9-46f0-870c-0eabfdc781ba.png,881,1397,1018,1546,137,149,trophozoite,20413,1.0875912408759123,0.9194630872483222
50437,/images/a2de1248-7bc0-44dc-b508-70a357eedd68.png,241,261,364,390,123,129,schizont,15867,1.048780487804878,0.9534883720930233
50446,/images/a2de1248-7bc0-44dc-b508-70a357eedd68.png,647,40,760,154,113,114,trophozoite,12882,1.008849557522124,0.9912280701754386
50490,/images/833b1d3e-d389-4d0f-8638-6aca5b89f917.png,533,382,658,514,125,132,schizont,16500,1.056,0.946969696969697
50540,/images/e98ea067-82b5-4a0d-87bf-b4bbdc10ddab.png,690,1428,835,1574,145,146,trophozoite,21170,1.006896551724138,0.9931506849315068
50652,/images/c956e531-6805-4fe1-b61c-8b96a9815a77.png,583,1108,694,1242,111,134,trophozoite,14874,1.2072072072072073,0.8283582089552238
50669,/images/c956e531-6805-4fe1-b61c-8b96a9815a77.png,1,1280,119,1419,118,139,trophozoite,16402,1.1779661016949152,0.8489208633093526
50893,/images/0906111b-bac7-4541-a6dc-da435c0724a8.png,849,1316,966,1453,117,137,leukocyte,16029,1.170940170940171,0.8540145985401459
50902,/images/0906111b-bac7-4541-a6dc-da435c0724a8.png,546,163,683,296,137,133,trophozoite,18221,0.9708029197080292,1.0300751879699248
50905,/images/0906111b-bac7-4541-a6dc-da435c0724a8.png,512,1188,603,1294,91,106,trophozoite,9646,1.164835164835165,0.8584905660377359
50907,/images/0906111b-bac7-4541-a6dc-da435c0724a8.png,829,558,954,693,125,135,trophozoite,16875,1.08,0.9259259259259259
50911,/images/0906111b-bac7-4541-a6dc-da435c0724a8.png,1015,705,1149,839,134,134,trophozoite,17956,1.0,1.0
50925,/images/ef8fcfa4-8466-4186-8c69-f5f4904eb489.png,205,1328,322,1442,117,114,leukocyte,13338,0.9743589743589743,1.0263157894736843
51055,/images/93f40356-5676-45d3-8e83-8028708c93ba.png,645,132,770,257,125,125,gametocyte,15625,1.0,1.0
51074,/images/93f40356-5676-45d3-8e83-8028708c93ba.png,718,590,876,724,158,134,trophozoite,21172,0.8481012658227848,1.1791044776119404
51087,/images/93f40356-5676-45d3-8e83-8028708c93ba.png,310,1389,428,1525,118,136,trophozoite,16048,1.152542372881356,0.8676470588235294
51140,/images/d64cd75a-df26-44d5-ac25-69061a4e4d57.png,1028,763,1150,888,122,125,ring,15250,1.0245901639344261,0.976
51216,/images/ad8731b7-0dae-4983-9dc6-dec31767d761.png,669,298,801,429,132,131,trophozoite,17292,0.9924242424242424,1.0076335877862594
51217,/images/ad8731b7-0dae-4983-9dc6-dec31767d761.png,297,1321,422,1437,125,116,ring,14500,0.928,1.0775862068965518
51264,/images/216f9d43-6869-4ba1-9106-4f5ea6aac223.png,1013,50,1146,165,133,115,trophozoite,15295,0.8646616541353384,1.1565217391304348
51276,/images/216f9d43-6869-4ba1-9106-4f5ea6aac223.png,850,529,978,652,128,123,trophozoite,15744,0.9609375,1.0406504065040652
51416,/images/b4f3b2a4-f4b9-48de-ac5d-0e681b77be27.png,681,183,788,285,107,102,ring,10914,0.9532710280373832,1.0490196078431373
51417,/images/b4f3b2a4-f4b9-48de-ac5d-0e681b77be27.png,964,1102,1049,1193,85,91,trophozoite,7735,1.0705882352941176,0.9340659340659341
51515,/images/baa87bf8-786c-444c-81e8-9fa0a41d8149.png,4,968,125,1099,121,131,trophozoite,15851,1.0826446280991735,0.9236641221374046
51643,/images/d0347b49-8f98-4632-a384-1a4f57ac6374.png,495,418,586,514,91,96,trophozoite,8736,1.054945054945055,0.9479166666666666
51670,/images/592c941a-aa54-4971-b499-dc47356f80a3.png,26,640,156,756,130,116,trophozoite,15080,0.8923076923076924,1.1206896551724137
51687,/images/592c941a-aa54-4971-b499-dc47356f80a3.png,756,1424,857,1536,101,112,trophozoite,11312,1.108910891089109,0.9017857142857143
51688,/images/592c941a-aa54-4971-b499-dc47356f80a3.png,701,934,841,1061,140,127,trophozoite,17780,0.9071428571428571,1.1023622047244095
51691,/images/592c941a-aa54-4971-b499-dc47356f80a3.png,249,891,357,1014,108,123,trophozoite,13284,1.1388888888888888,0.8780487804878049
51708,/images/592c941a-aa54-4971-b499-dc47356f80a3.png,703,700,820,822,117,122,gametocyte,14274,1.0427350427350428,0.9590163934426229
51751,/images/592c941a-aa54-4971-b499-dc47356f80a3.png,324,839,478,984,154,145,trophozoite,22330,0.9415584415584416,1.0620689655172413
51757,/images/f07174a5-f799-4286-ac43-5b0f5c5777ac.png,379,340,492,458,113,118,ring,13334,1.0442477876106195,0.9576271186440678
51778,/images/f07174a5-f799-4286-ac43-5b0f5c5777ac.png,280,120,403,240,123,120,ring,14760,0.975609756097561,1.025
51835,/images/f07174a5-f799-4286-ac43-5b0f5c5777ac.png,292,753,430,908,138,155,trophozoite,21390,1.1231884057971016,0.8903225806451613
51837,/images/f07174a5-f799-4286-ac43-5b0f5c5777ac.png,501,1340,611,1456,110,116,trophozoite,12760,1.0545454545454545,0.9482758620689655
51910,/images/d67398c5-8b0e-463f-a04e-8583c820786c.png,41,333,179,454,138,121,trophozoite,16698,0.8768115942028986,1.140495867768595
51924,/images/4f62b14e-c6f4-4155-8f50-881558f83fae.png,251,1075,349,1181,98,106,ring,10388,1.0816326530612246,0.9245283018867925
51939,/images/4f62b14e-c6f4-4155-8f50-881558f83fae.png,864,32,991,144,127,112,leukocyte,14224,0.8818897637795275,1.1339285714285714
52035,/images/6c3f81d7-5670-46bd-9eaa-9b426413abb7.png,890,714,1006,848,116,134,trophozoite,15544,1.1551724137931034,0.8656716417910447
52049,/images/de6d3020-9347-473b-9146-8909627790f6.png,1016,511,1142,643,126,132,trophozoite,16632,1.0476190476190477,0.9545454545454546
52069,/images/de6d3020-9347-473b-9146-8909627790f6.png,813,1338,938,1477,125,139,trophozoite,17375,1.112,0.8992805755395683
52072,/images/de6d3020-9347-473b-9146-8909627790f6.png,573,463,693,587,120,124,trophozoite,14880,1.0333333333333334,0.967741935483871
52086,/images/de6d3020-9347-473b-9146-8909627790f6.png,1019,237,1150,356,131,119,ring,15589,0.9083969465648855,1.1008403361344539
52093,/images/de6d3020-9347-473b-9146-8909627790f6.png,27,658,148,771,121,113,gametocyte,13673,0.9338842975206612,1.0707964601769913
52120,/images/de6d3020-9347-473b-9146-8909627790f6.png,884,677,1021,811,137,134,trophozoite,18358,0.9781021897810219,1.0223880597014925
52187,/images/f4c00b8c-d675-4255-8277-ca65bd757f51.png,46,936,159,1069,113,133,trophozoite,15029,1.176991150442478,0.849624060150376
52200,/images/f4c00b8c-d675-4255-8277-ca65bd757f51.png,402,428,533,550,131,122,trophozoite,15982,0.9312977099236641,1.0737704918032787
52296,/images/4903d9c7-de88-426a-b42d-a7e797e5ebcd.png,846,1125,1008,1264,162,139,trophozoite,22518,0.8580246913580247,1.1654676258992807
52352,/images/a2a20600-f851-4db7-90f9-6f7be027c8b5.png,106,350,216,469,110,119,leukocyte,13090,1.0818181818181818,0.9243697478991597
52419,/images/a2a20600-f851-4db7-90f9-6f7be027c8b5.png,873,1203,1015,1335,142,132,trophozoite,18744,0.9295774647887324,1.0757575757575757
52503,/images/d1144956-5a0c-4bd2-b67d-8498c82d6a12.png,818,792,942,918,124,126,trophozoite,15624,1.0161290322580645,0.9841269841269841
52511,/images/d1144956-5a0c-4bd2-b67d-8498c82d6a12.png,950,471,1057,604,107,133,trophozoite,14231,1.2429906542056075,0.8045112781954887
52611,/images/0546d843-d778-4aca-b8b5-bfe23d7c87da.png,742,770,854,868,112,98,ring,10976,0.875,1.1428571428571428
52612,/images/0546d843-d778-4aca-b8b5-bfe23d7c87da.png,462,817,572,932,110,115,ring,12650,1.0454545454545454,0.9565217391304348
52662,/images/3f390b82-8859-4c27-bbfe-d1b242477f63.png,888,271,1013,399,125,128,trophozoite,16000,1.024,0.9765625
52837,/images/58f7e1da-3478-48f4-958c-e9b1cb8696aa.png,325,114,452,245,127,131,trophozoite,16637,1.031496062992126,0.9694656488549618
52866,/images/58f7e1da-3478-48f4-958c-e9b1cb8696aa.png,630,684,765,798,135,114,ring,15390,0.8444444444444444,1.1842105263157894
52868,/images/58f7e1da-3478-48f4-958c-e9b1cb8696aa.png,653,359,780,487,127,128,trophozoite,16256,1.0078740157480315,0.9921875
52908,/images/abb2f9d6-26fa-4328-983c-959ef6717c05.png,456,1077,584,1192,128,115,ring,14720,0.8984375,1.1130434782608696
52929,/images/abb2f9d6-26fa-4328-983c-959ef6717c05.png,621,1345,762,1477,141,132,trophozoite,18612,0.9361702127659575,1.0681818181818181
52971,/images/e81bf478-27ff-458c-ac30-9e1f8480bc5c.png,792,536,926,647,134,111,trophozoite,14874,0.8283582089552238,1.2072072072072073
53067,/images/69b5b3de-ec64-4e5d-bcc2-44f495e06e76.png,531,1403,648,1529,117,126,trophozoite,14742,1.0769230769230769,0.9285714285714286
53115,/images/04a567df-5463-4043-81f1-d726223c19a9.png,434,232,561,361,127,129,gametocyte,16383,1.015748031496063,0.9844961240310077
53189,/images/801296d9-3403-426f-859e-5c532858e025.png,530,777,674,924,144,147,trophozoite,21168,1.0208333333333333,0.9795918367346939
53288,/images/d8f7e159-b7e3-49e4-86e8-aed8c5fbcd97.png,137,843,229,956,92,113,ring,10396,1.2282608695652173,0.8141592920353983
53355,/images/f23ae29e-1bda-4784-b10c-d736757d39b8.png,790,935,918,1081,128,146,schizont,18688,1.140625,0.8767123287671232
53499,/images/43158031-a335-4533-9c20-48bebba90123.png,152,165,269,290,117,125,trophozoite,14625,1.0683760683760684,0.936
53513,/images/43158031-a335-4533-9c20-48bebba90123.png,616,146,749,298,133,152,trophozoite,20216,1.1428571428571428,0.875
53636,/images/7bcd3735-3134-46d1-8ca2-d4379f2d51c0.png,530,1365,664,1483,134,118,trophozoite,15812,0.8805970149253731,1.1355932203389831
53641,/images/7bcd3735-3134-46d1-8ca2-d4379f2d51c0.png,870,1297,1009,1416,139,119,ring,16541,0.8561151079136691,1.1680672268907564
53644,/images/7bcd3735-3134-46d1-8ca2-d4379f2d51c0.png,792,1109,932,1235,140,126,ring,17640,0.9,1.1111111111111112
53684,/images/6f67a66b-56ec-4c36-ae7c-f250d3b86a23.png,551,1415,673,1539,122,124,trophozoite,15128,1.0163934426229508,0.9838709677419355
53697,/images/6f67a66b-56ec-4c36-ae7c-f250d3b86a23.png,607,787,722,900,115,113,trophozoite,12995,0.9826086956521739,1.0176991150442478
53721,/images/6f67a66b-56ec-4c36-ae7c-f250d3b86a23.png,52,895,161,1019,109,124,trophozoite,13516,1.1376146788990826,0.8790322580645161
53731,/images/6f67a66b-56ec-4c36-ae7c-f250d3b86a23.png,108,57,226,182,118,125,trophozoite,14750,1.0593220338983051,0.944
53732,/images/6f67a66b-56ec-4c36-ae7c-f250d3b86a23.png,1026,940,1146,1069,120,129,trophozoite,15480,1.075,0.9302325581395349
53737,/images/6f67a66b-56ec-4c36-ae7c-f250d3b86a23.png,809,1411,970,1566,161,155,trophozoite,24955,0.9627329192546584,1.038709677419355
53780,/images/76b24246-8571-4e7b-8815-b185414a2c51.png,509,1367,640,1497,131,130,trophozoite,17030,0.9923664122137404,1.0076923076923077
53832,/images/f24c8fe0-a534-44cf-9995-b2b314d945ba.png,965,1079,1101,1192,136,113,gametocyte,15368,0.8308823529411765,1.2035398230088497
53960,/images/540a5fee-175b-4b92-bf62-1ea9b59c86c6.png,294,719,397,807,103,88,trophozoite,9064,0.8543689320388349,1.1704545454545454
53961,/images/540a5fee-175b-4b92-bf62-1ea9b59c86c6.png,480,178,592,270,112,92,trophozoite,10304,0.8214285714285714,1.2173913043478262
54092,/images/d9345456-b76d-46cc-b81e-46d4a0a7b652.png,707,197,828,329,121,132,trophozoite,15972,1.0909090909090908,0.9166666666666666
54102,/images/d9345456-b76d-46cc-b81e-46d4a0a7b652.png,376,1406,485,1520,109,114,trophozoite,12426,1.0458715596330275,0.956140350877193
54111,/images/d9345456-b76d-46cc-b81e-46d4a0a7b652.png,197,1393,313,1518,116,125,trophozoite,14500,1.0775862068965518,0.928
54180,/images/c415532c-4cce-4580-9fcd-623c172a1abd.png,482,727,607,859,125,132,trophozoite,16500,1.056,0.946969696969697
54430,/images/22a464ef-c3da-4d56-b37e-e22e95d945e7.png,650,272,772,393,122,121,trophozoite,14762,0.9918032786885246,1.0082644628099173
54432,/images/22a464ef-c3da-4d56-b37e-e22e95d945e7.png,463,53,593,172,130,119,trophozoite,15470,0.9153846153846154,1.0924369747899159
54616,/images/59dc7da9-35d1-421e-a61b-1e9637bfbfa1.png,626,928,752,1068,126,140,trophozoite,17640,1.1111111111111112,0.9
54622,/images/6473ddb6-ad56-48a2-81e8-c7cb45f06825.png,94,542,218,665,124,123,trophozoite,15252,0.9919354838709677,1.008130081300813
54631,/images/6473ddb6-ad56-48a2-81e8-c7cb45f06825.png,1000,639,1136,777,136,138,trophozoite,18768,1.0147058823529411,0.9855072463768116
54671,/images/6473ddb6-ad56-48a2-81e8-c7cb45f06825.png,683,480,803,598,120,118,trophozoite,14160,0.9833333333333333,1.0169491525423728
54677,/images/6473ddb6-ad56-48a2-81e8-c7cb45f06825.png,867,1424,989,1568,122,144,gametocyte,17568,1.180327868852459,0.8472222222222222
54720,/images/10891eed-b0f2-4dd0-90cb-da185f6761b2.png,966,591,1104,721,138,130,trophozoite,17940,0.9420289855072463,1.0615384615384615
54754,/images/10891eed-b0f2-4dd0-90cb-da185f6761b2.png,558,1419,682,1564,124,145,trophozoite,17980,1.1693548387096775,0.8551724137931035
54768,/images/10891eed-b0f2-4dd0-90cb-da185f6761b2.png,374,147,502,288,128,141,gametocyte,18048,1.1015625,0.9078014184397163
54811,/images/b6364a57-72a9-43f3-8d02-9f53a992dc95.png,400,1238,537,1366,137,128,trophozoite,17536,0.9343065693430657,1.0703125
54820,/images/b6364a57-72a9-43f3-8d02-9f53a992dc95.png,994,440,1111,570,117,130,trophozoite,15210,1.1111111111111112,0.9
54829,/images/b6364a57-72a9-43f3-8d02-9f53a992dc95.png,159,48,288,183,129,135,trophozoite,17415,1.0465116279069768,0.9555555555555556
54910,/images/8f84a2c9-ca38-4405-a488-12fcd101278b.png,412,775,548,912,136,137,trophozoite,18632,1.0073529411764706,0.9927007299270073
54924,/images/f1872d08-f8a6-4b21-aa29-f56bbf607883.png,946,1253,1080,1371,134,118,ring,15812,0.8805970149253731,1.1355932203389831
55084,/images/1f8f08ea-b5b3-4f68-94d4-3cc071b7dce8.png,700,151,782,242,82,91,trophozoite,7462,1.1097560975609757,0.9010989010989011
55165,/images/29d4b75f-d400-4702-a9ac-e5a4ed1a1db1.png,1023,249,1150,360,127,111,trophozoite,14097,0.8740157480314961,1.1441441441441442
55167,/images/29d4b75f-d400-4702-a9ac-e5a4ed1a1db1.png,683,1381,817,1509,134,128,gametocyte,17152,0.9552238805970149,1.046875
55267,/images/8ad7ba46-5db8-4ba9-b3e0-3cac52f7efc3.png,804,1247,933,1370,129,123,trophozoite,15867,0.9534883720930233,1.048780487804878
55278,/images/8ad7ba46-5db8-4ba9-b3e0-3cac52f7efc3.png,315,779,431,904,116,125,trophozoite,14500,1.0775862068965518,0.928
55379,/images/4fb83278-adc5-4424-9f45-b6d0db2955b6.png,604,487,692,574,88,87,trophozoite,7656,0.9886363636363636,1.0114942528735633
55399,/images/d67655e6-0a80-4a86-b552-1f5e85788377.png,841,75,930,170,89,95,gametocyte,8455,1.0674157303370786,0.9368421052631579
55426,/images/d67655e6-0a80-4a86-b552-1f5e85788377.png,463,42,571,165,108,123,trophozoite,13284,1.1388888888888888,0.8780487804878049
55469,/images/d67655e6-0a80-4a86-b552-1f5e85788377.png,342,1430,444,1545,102,115,trophozoite,11730,1.1274509803921569,0.8869565217391304
55493,/images/43072c64-4c08-47cd-ae8a-b74d31f80008.png,164,894,287,1002,123,108,schizont,13284,0.8780487804878049,1.1388888888888888
55512,/images/43072c64-4c08-47cd-ae8a-b74d31f80008.png,55,1467,193,1581,138,114,trophozoite,15732,0.8260869565217391,1.2105263157894737
55574,/images/a27b451d-44a6-4740-861a-9e7e99915563.png,537,290,657,405,120,115,gametocyte,13800,0.9583333333333334,1.0434782608695652
55698,/images/c32b8bb8-c89d-4ae9-9c77-5b9356ca35a1.png,473,165,569,258,96,93,trophozoite,8928,0.96875,1.032258064516129
55707,/images/c32b8bb8-c89d-4ae9-9c77-5b9356ca35a1.png,460,668,555,773,95,105,ring,9975,1.105263157894737,0.9047619047619048
55762,/images/68f34a9c-f73d-4238-8f55-4b05a8a2154c.png,655,1457,760,1576,105,119,trophozoite,12495,1.1333333333333333,0.8823529411764706
55784,/images/68f34a9c-f73d-4238-8f55-4b05a8a2154c.png,770,538,874,664,104,126,trophozoite,13104,1.2115384615384615,0.8253968253968254
55832,/images/68f34a9c-f73d-4238-8f55-4b05a8a2154c.png,406,1222,555,1359,149,137,trophozoite,20413,0.9194630872483222,1.0875912408759123
55907,/images/afd39466-aafa-4d81-9520-483727418723.png,827,761,964,872,137,111,trophozoite,15207,0.8102189781021898,1.2342342342342343
55939,/images/afd39466-aafa-4d81-9520-483727418723.png,433,762,550,891,117,129,trophozoite,15093,1.1025641025641026,0.9069767441860465
56002,/images/4c460388-e0c1-4970-8527-c9e5b42bea49.png,116,755,245,887,129,132,gametocyte,17028,1.0232558139534884,0.9772727272727273
56017,/images/177a3141-fa93-426a-9b52-7da71547ce44.png,822,898,967,1019,145,121,trophozoite,17545,0.8344827586206897,1.1983471074380165
56041,/images/177a3141-fa93-426a-9b52-7da71547ce44.png,687,1277,828,1397,141,120,trophozoite,16920,0.851063829787234,1.175
56046,/images/177a3141-fa93-426a-9b52-7da71547ce44.png,166,803,311,922,145,119,trophozoite,17255,0.8206896551724138,1.218487394957983
56105,/images/ffb7be9a-65df-4f0b-99ae-cfd34e81cd34.png,464,821,626,951,162,130,trophozoite,21060,0.8024691358024691,1.2461538461538462
56124,/images/50d9fc90-8642-4bb6-91a7-0069a7e37392.png,798,1306,922,1436,124,130,gametocyte,16120,1.0483870967741935,0.9538461538461539
56143,/images/50d9fc90-8642-4bb6-91a7-0069a7e37392.png,524,1119,647,1258,123,139,trophozoite,17097,1.1300813008130082,0.8848920863309353
56186,/images/137d540f-d71e-47e8-bd9b-6cd0a6433c33.png,13,1444,131,1566,118,122,trophozoite,14396,1.0338983050847457,0.9672131147540983
56188,/images/137d540f-d71e-47e8-bd9b-6cd0a6433c33.png,758,37,882,175,124,138,ring,17112,1.1129032258064515,0.8985507246376812
56237,/images/b600b38d-225b-46a5-b6f8-b607430f6a10.png,755,1089,884,1225,129,136,trophozoite,17544,1.054263565891473,0.9485294117647058
56238,/images/b600b38d-225b-46a5-b6f8-b607430f6a10.png,306,295,422,432,116,137,trophozoite,15892,1.1810344827586208,0.8467153284671532
56243,/images/b600b38d-225b-46a5-b6f8-b607430f6a10.png,262,3,384,136,122,133,ring,16226,1.0901639344262295,0.9172932330827067
56314,/images/6b473806-e936-4b19-98cf-a2b94cac35ff.png,363,693,489,843,126,150,trophozoite,18900,1.1904761904761905,0.84
56345,/images/4372709c-f356-4906-be17-415384d916e8.png,549,331,688,450,139,119,trophozoite,16541,0.8561151079136691,1.1680672268907564
56354,/images/4372709c-f356-4906-be17-415384d916e8.png,861,237,987,364,126,127,trophozoite,16002,1.007936507936508,0.9921259842519685
56417,/images/c10b125d-10c2-474a-9c6a-5249935c638e.png,665,945,807,1084,142,139,gametocyte,19738,0.9788732394366197,1.0215827338129497
56532,/images/ac8df764-c8d8-4312-916d-70bfb37574b4.png,910,840,1045,977,135,137,gametocyte,18495,1.0148148148148148,0.9854014598540146
56545,/images/ac8df764-c8d8-4312-916d-70bfb37574b4.png,323,1077,454,1211,131,134,gametocyte,17554,1.0229007633587786,0.9776119402985075
56562,/images/ac8df764-c8d8-4312-916d-70bfb37574b4.png,24,374,163,490,139,116,ring,16124,0.8345323741007195,1.1982758620689655
56620,/images/a824b499-3736-4581-bbdc-be1b3b4cf756.png,836,1205,980,1342,144,137,trophozoite,19728,0.9513888888888888,1.051094890510949
56621,/images/a824b499-3736-4581-bbdc-be1b3b4cf756.png,290,315,450,471,160,156,trophozoite,24960,0.975,1.0256410256410255
56669,/images/4adcaa26-aa1f-47b5-bdf0-18c9f814f576.png,492,745,647,882,155,137,trophozoite,21235,0.8838709677419355,1.1313868613138687
56715,/images/89b3d781-2f81-4d23-bed4-84da064df7f3.png,728,1416,861,1525,133,109,ring,14497,0.8195488721804511,1.2201834862385321
56747,/images/b3606d0e-6fe5-478a-bb4b-64d7c4889d86.png,92,1166,221,1321,129,155,trophozoite,19995,1.2015503875968991,0.832258064516129
56804,/images/0dcbf2c9-f959-4703-a72b-f6a81e66c2ea.png,929,892,1056,1034,127,142,trophozoite,18034,1.1181102362204725,0.8943661971830986
56813,/images/0dcbf2c9-f959-4703-a72b-f6a81e66c2ea.png,998,337,1119,468,121,131,ring,15851,1.0826446280991735,0.9236641221374046
56816,/images/0dcbf2c9-f959-4703-a72b-f6a81e66c2ea.png,918,1392,1037,1519,119,127,trophozoite,15113,1.0672268907563025,0.937007874015748
56858,/images/a588091c-5e4c-4e61-914d-e96f3ee3e505.png,358,867,467,976,109,109,gametocyte,11881,1.0,1.0
56862,/images/a588091c-5e4c-4e61-914d-e96f3ee3e505.png,356,382,482,508,126,126,trophozoite,15876,1.0,1.0
56869,/images/a588091c-5e4c-4e61-914d-e96f3ee3e505.png,729,1397,861,1524,132,127,ring,16764,0.9621212121212122,1.0393700787401574
56900,/images/f28e6d66-af71-40c1-b30c-da71d7230a3f.png,120,213,248,346,128,133,gametocyte,17024,1.0390625,0.9624060150375939
57069,/images/9e82c996-2cfa-418d-9482-8ee23e9d0a5d.png,604,412,702,503,98,91,trophozoite,8918,0.9285714285714286,1.0769230769230769
57070,/images/9e82c996-2cfa-418d-9482-8ee23e9d0a5d.png,791,1293,888,1386,97,93,trophozoite,9021,0.9587628865979382,1.043010752688172
57139,/images/7d041c38-11f2-4186-8a24-29d7d0f5c3cf.png,517,596,631,723,114,127,trophozoite,14478,1.1140350877192982,0.8976377952755905
57197,/images/7c870293-2665-4a6b-a4fa-336959051dfc.png,475,846,604,988,129,142,trophozoite,18318,1.1007751937984496,0.9084507042253521
57324,/images/aaade430-4c49-4038-97b7-f8cdd937db57.png,244,490,371,644,127,154,trophozoite,19558,1.2125984251968505,0.8246753246753247
57349,/images/a88a48b6-f85c-45c1-b42f-79716c8463f1.png,963,1267,1088,1402,125,135,trophozoite,16875,1.08,0.9259259259259259
57426,/images/00d04a90-80e5-4bce-9511-1b64eabb7a47.png,183,1366,316,1497,133,131,trophozoite,17423,0.9849624060150376,1.015267175572519
57480,/images/00d04a90-80e5-4bce-9511-1b64eabb7a47.png,57,374,179,490,122,116,trophozoite,14152,0.9508196721311475,1.0517241379310345
57544,/images/8190ec37-9a5e-419f-89ed-fbfb079370db.png,949,290,1085,414,136,124,gametocyte,16864,0.9117647058823529,1.096774193548387
57557,/images/8190ec37-9a5e-419f-89ed-fbfb079370db.png,577,123,702,258,125,135,trophozoite,16875,1.08,0.9259259259259259
57586,/images/8190ec37-9a5e-419f-89ed-fbfb079370db.png,96,923,212,1044,116,121,trophozoite,14036,1.043103448275862,0.9586776859504132
57600,/images/8190ec37-9a5e-419f-89ed-fbfb079370db.png,95,1471,207,1600,112,129,trophozoite,14448,1.1517857142857142,0.8682170542635659
57644,/images/d32022fa-e492-4b31-a776-9435cfdef6d6.png,86,597,211,740,125,143,trophozoite,17875,1.144,0.8741258741258742
57648,/images/d32022fa-e492-4b31-a776-9435cfdef6d6.png,361,1260,508,1379,147,119,ring,17493,0.8095238095238095,1.2352941176470589
57749,/images/5c037ffc-f515-48b3-b231-c110fbd2b8ca.png,185,837,271,935,86,98,ring,8428,1.1395348837209303,0.8775510204081632
57808,/images/c9ad92d4-b408-4506-916e-def47b2e6ed0.png,215,638,352,762,137,124,trophozoite,16988,0.9051094890510949,1.1048387096774193
57833,/images/c9ad92d4-b408-4506-916e-def47b2e6ed0.png,952,210,1072,345,120,135,trophozoite,16200,1.125,0.8888888888888888
57851,/images/f4c2b43f-a2e7-4746-8034-0b34aebba8ee.png,1004,1230,1127,1358,123,128,trophozoite,15744,1.0406504065040652,0.9609375
57866,/images/f4c2b43f-a2e7-4746-8034-0b34aebba8ee.png,903,276,1029,406,126,130,trophozoite,16380,1.0317460317460319,0.9692307692307692
57880,/images/f4c2b43f-a2e7-4746-8034-0b34aebba8ee.png,362,160,481,281,119,121,trophozoite,14399,1.0168067226890756,0.9834710743801653
58002,/images/7942691b-6376-4c75-ae8a-ddf65454dcb2.png,585,871,735,1019,150,148,trophozoite,22200,0.9866666666666667,1.0135135135135136
58034,/images/a7c91b63-b97c-4f4b-8d34-7ad2b08d7a17.png,637,731,762,834,125,103,ring,12875,0.824,1.2135922330097086
58110,/images/e9916e11-9be6-4dec-9df6-2e7d1a8e1735.png,246,1041,375,1171,129,130,trophozoite,16770,1.0077519379844961,0.9923076923076923
58161,/images/d615b706-8f50-4d96-8de5-6858897528d0.png,726,647,856,784,130,137,trophozoite,17810,1.0538461538461539,0.948905109489051
58163,/images/d615b706-8f50-4d96-8de5-6858897528d0.png,589,925,722,1065,133,140,trophozoite,18620,1.0526315789473684,0.95
58166,/images/d615b706-8f50-4d96-8de5-6858897528d0.png,770,1228,916,1354,146,126,trophozoite,18396,0.863013698630137,1.1587301587301588
58170,/images/d615b706-8f50-4d96-8de5-6858897528d0.png,881,67,1011,215,130,148,gametocyte,19240,1.1384615384615384,0.8783783783783784
58176,/images/d615b706-8f50-4d96-8de5-6858897528d0.png,767,824,899,955,132,131,trophozoite,17292,0.9924242424242424,1.0076335877862594
58205,/images/2f68686f-1fe8-46e7-ad92-a08e3523ea79.png,584,283,703,408,119,125,trophozoite,14875,1.050420168067227,0.952
58206,/images/2f68686f-1fe8-46e7-ad92-a08e3523ea79.png,217,1396,345,1515,128,119,trophozoite,15232,0.9296875,1.0756302521008403
58224,/images/2f68686f-1fe8-46e7-ad92-a08e3523ea79.png,932,505,1083,632,151,127,trophozoite,19177,0.8410596026490066,1.188976377952756
58378,/images/50f2f514-6c8e-4c79-b3b3-0be56dd0b78b.png,594,807,715,942,121,135,trophozoite,16335,1.115702479338843,0.8962962962962963
58422,/images/7eae1169-e294-4594-8e03-1366d23ff2d1.png,999,629,1118,762,119,133,ring,15827,1.1176470588235294,0.8947368421052632
58425,/images/7eae1169-e294-4594-8e03-1366d23ff2d1.png,685,692,814,799,129,107,trophozoite,13803,0.8294573643410853,1.205607476635514
58528,/images/5cac6ddf-c8c6-45de-bce0-a1db64b14fb5.png,425,1308,523,1410,98,102,trophozoite,9996,1.0408163265306123,0.9607843137254902
58588,/images/7fd2d254-b062-4f3d-8970-687e73c5a00a.png,464,663,617,793,153,130,trophozoite,19890,0.8496732026143791,1.176923076923077
58610,/images/a4d7a7e1-5ae1-486d-b6ee-c9af1476ccad.png,157,1079,271,1193,114,114,trophozoite,12996,1.0,1.0
58614,/images/a4d7a7e1-5ae1-486d-b6ee-c9af1476ccad.png,532,78,670,194,138,116,trophozoite,16008,0.8405797101449275,1.1896551724137931
58693,/images/a4d7a7e1-5ae1-486d-b6ee-c9af1476ccad.png,1004,716,1147,850,143,134,trophozoite,19162,0.9370629370629371,1.0671641791044777
58725,/images/e4827c85-311a-4df1-89c2-99dad0c3558c.png,734,250,847,354,113,104,leukocyte,11752,0.9203539823008849,1.0865384615384615
58775,/images/e4827c85-311a-4df1-89c2-99dad0c3558c.png,41,290,168,417,127,127,trophozoite,16129,1.0,1.0
58777,/images/e4827c85-311a-4df1-89c2-99dad0c3558c.png,286,412,406,535,120,123,trophozoite,14760,1.025,0.975609756097561
58815,/images/434523fd-d4d9-4961-a7c2-d71d6ae68e13.png,846,1102,963,1221,117,119,trophozoite,13923,1.017094017094017,0.9831932773109243
58833,/images/434523fd-d4d9-4961-a7c2-d71d6ae68e13.png,310,732,431,865,121,133,ring,16093,1.0991735537190082,0.9097744360902256
58928,/images/8a7deb24-d2b4-4acf-86c4-3aadd39157fa.png,814,216,946,354,132,138,trophozoite,18216,1.0454545454545454,0.9565217391304348
59063,/images/5e2cea49-0823-49d1-83cf-8fd1559cdd93.png,719,44,846,163,127,119,ring,15113,0.937007874015748,1.0672268907563025
59069,/images/5e2cea49-0823-49d1-83cf-8fd1559cdd93.png,819,1438,946,1556,127,118,trophozoite,14986,0.9291338582677166,1.076271186440678
59171,/images/4736f545-1f1f-4d77-9241-d69cbf4dae35.png,206,1299,288,1374,82,75,leukocyte,6150,0.9146341463414634,1.0933333333333333
59234,/images/03c8da48-04b9-4520-b674-44a0ecd35688.png,549,765,644,861,95,96,ring,9120,1.0105263157894737,0.9895833333333334
59325,/images/03c8da48-04b9-4520-b674-44a0ecd35688.png,471,548,589,644,118,96,trophozoite,11328,0.8135593220338984,1.2291666666666667
59351,/images/565513be-2c20-4ee3-94f3-093869515d3d.png,135,917,265,1030,130,113,trophozoite,14690,0.8692307692307693,1.1504424778761062
59373,/images/565513be-2c20-4ee3-94f3-093869515d3d.png,900,1365,1012,1482,112,117,leukocyte,13104,1.0446428571428572,0.9572649572649573
59502,/images/6bfe6a90-8a69-4171-8e7f-42dc9417c6d9.png,664,317,775,444,111,127,trophozoite,14097,1.1441441441441442,0.8740157480314961
59515,/images/6bfe6a90-8a69-4171-8e7f-42dc9417c6d9.png,278,1351,402,1488,124,137,trophozoite,16988,1.1048387096774193,0.9051094890510949
59561,/images/6bfe6a90-8a69-4171-8e7f-42dc9417c6d9.png,673,1383,787,1493,114,110,schizont,12540,0.9649122807017544,1.0363636363636364
59595,/images/faead1c7-bb2c-4adf-bfce-9ff36cd2cf6a.png,911,714,1027,845,116,131,trophozoite,15196,1.1293103448275863,0.8854961832061069
59667,/images/a2754679-68b0-40f4-be01-bafad5ac1261.png,952,1338,1055,1465,103,127,trophozoite,13081,1.233009708737864,0.8110236220472441
59708,/images/a2754679-68b0-40f4-be01-bafad5ac1261.png,163,43,277,179,114,136,ring,15504,1.1929824561403508,0.8382352941176471
59763,/images/f77d7469-d083-4c2d-a4ea-5a9ff162e3e2.png,375,1366,507,1493,132,127,trophozoite,16764,0.9621212121212122,1.0393700787401574
59792,/images/f77d7469-d083-4c2d-a4ea-5a9ff162e3e2.png,131,703,233,827,102,124,trophozoite,12648,1.2156862745098038,0.8225806451612904
59824,/images/acb16781-11ad-4327-874a-5c9c35dcb085.png,371,30,485,164,114,134,trophozoite,15276,1.1754385964912282,0.8507462686567164
59841,/images/acb16781-11ad-4327-874a-5c9c35dcb085.png,290,584,420,706,130,122,trophozoite,15860,0.9384615384615385,1.0655737704918034
59842,/images/acb16781-11ad-4327-874a-5c9c35dcb085.png,25,250,170,382,145,132,trophozoite,19140,0.9103448275862069,1.0984848484848484
59846,/images/acb16781-11ad-4327-874a-5c9c35dcb085.png,1084,630,1200,755,116,125,ring,14500,1.0775862068965518,0.928
59857,/images/1519257c-e3e5-4474-908f-8665b3cf1258.png,23,1096,130,1226,107,130,trophozoite,13910,1.2149532710280373,0.823076923076923
59879,/images/1519257c-e3e5-4474-908f-8665b3cf1258.png,262,247,393,374,131,127,trophozoite,16637,0.9694656488549618,1.031496062992126
59880,/images/1519257c-e3e5-4474-908f-8665b3cf1258.png,936,241,1071,364,135,123,trophozoite,16605,0.9111111111111111,1.0975609756097562
59890,/images/1519257c-e3e5-4474-908f-8665b3cf1258.png,198,1394,305,1514,107,120,trophozoite,12840,1.1214953271028036,0.8916666666666667
59916,/images/1519257c-e3e5-4474-908f-8665b3cf1258.png,1076,1194,1195,1317,119,123,trophozoite,14637,1.0336134453781514,0.967479674796748
59988,/images/f0fe292d-85ae-4c3a-a676-037dde2594e6.png,463,621,603,750,140,129,trophozoite,18060,0.9214285714285714,1.0852713178294573
59989,/images/f0fe292d-85ae-4c3a-a676-037dde2594e6.png,320,1236,475,1374,155,138,trophozoite,21390,0.8903225806451613,1.1231884057971016
60114,/images/ec60ab26-3343-4c5f-9667-cdae999c7d86.png,663,99,791,236,128,137,trophozoite,17536,1.0703125,0.9343065693430657
60170,/images/214f1d15-a081-476e-992d-6c3a77f03d59.png,129,194,244,310,115,116,trophozoite,13340,1.008695652173913,0.9913793103448276
60204,/images/214f1d15-a081-476e-992d-6c3a77f03d59.png,523,1326,628,1431,105,105,trophozoite,11025,1.0,1.0
60266,/images/7abc0d26-dd66-4ef4-8c4e-4a661e589a7f.png,177,445,317,570,140,125,trophozoite,17500,0.8928571428571429,1.12
60296,/images/7abc0d26-dd66-4ef4-8c4e-4a661e589a7f.png,560,157,681,272,121,115,ring,13915,0.9504132231404959,1.0521739130434782
60306,/images/7abc0d26-dd66-4ef4-8c4e-4a661e589a7f.png,947,1231,1097,1351,150,120,trophozoite,18000,0.8,1.25
60308,/images/7abc0d26-dd66-4ef4-8c4e-4a661e589a7f.png,436,1032,587,1168,151,136,trophozoite,20536,0.9006622516556292,1.1102941176470589
60333,/images/1c87b997-a8e6-48ca-bf40-19b9a7fd6a96.png,122,39,222,161,100,122,trophozoite,12200,1.22,0.819672131147541
60371,/images/1c87b997-a8e6-48ca-bf40-19b9a7fd6a96.png,612,1187,757,1310,145,123,schizont,17835,0.8482758620689655,1.1788617886178863
60508,/images/93b47b14-7f78-4b31-8897-d63a81fdab01.png,585,1035,681,1136,96,101,trophozoite,9696,1.0520833333333333,0.9504950495049505
60531,/images/f5c395f1-f94c-440d-8221-cc656e52c0b1.png,112,487,263,609,151,122,gametocyte,18422,0.8079470198675497,1.2377049180327868
60536,/images/f5c395f1-f94c-440d-8221-cc656e52c0b1.png,89,583,227,703,138,120,trophozoite,16560,0.8695652173913043,1.15
60585,/images/58065a0c-d4c5-40fd-bcdc-037f61788482.png,241,1089,391,1219,150,130,trophozoite,19500,0.8666666666666667,1.1538461538461537
60586,/images/58065a0c-d4c5-40fd-bcdc-037f61788482.png,780,578,926,718,146,140,trophozoite,20440,0.958904109589041,1.042857142857143
60596,/images/724e0c34-32cd-41f1-ae37-586038bc67ab.png,693,1309,802,1432,109,123,gametocyte,13407,1.128440366972477,0.8861788617886179
60623,/images/724e0c34-32cd-41f1-ae37-586038bc67ab.png,534,326,641,453,107,127,trophozoite,13589,1.1869158878504673,0.84251968503937
60653,/images/724e0c34-32cd-41f1-ae37-586038bc67ab.png,107,67,250,189,143,122,trophozoite,17446,0.8531468531468531,1.1721311475409837
60656,/images/724e0c34-32cd-41f1-ae37-586038bc67ab.png,359,1185,471,1310,112,125,trophozoite,14000,1.1160714285714286,0.896
60740,/images/45651e76-4bd0-45e5-895b-edec65f51987.png,383,898,490,997,107,99,trophozoite,10593,0.9252336448598131,1.0808080808080809
60771,/images/645cd195-af50-409f-8da9-6e7c7f18ea09.png,814,1041,942,1167,128,126,trophozoite,16128,0.984375,1.0158730158730158
60802,/images/645cd195-af50-409f-8da9-6e7c7f18ea09.png,408,100,546,239,138,139,trophozoite,19182,1.0072463768115942,0.9928057553956835
60803,/images/645cd195-af50-409f-8da9-6e7c7f18ea09.png,327,168,477,299,150,131,trophozoite,19650,0.8733333333333333,1.1450381679389312
60861,/images/11b72c7b-5c52-44b7-adb7-21eacc25e441.png,911,437,1029,555,118,118,trophozoite,13924,1.0,1.0
60970,/images/5397d8e2-bb09-42e7-9861-65ffad0fe94e.png,73,981,204,1109,131,128,schizont,16768,0.9770992366412213,1.0234375
61012,/images/3d1429ed-4619-41f7-8ff3-d698ad28034c.png,790,725,908,840,118,115,schizont,13570,0.9745762711864406,1.0260869565217392
61087,/images/6e86206f-dafe-4c28-bacc-7b83b2d40f0c.png,510,756,661,896,151,140,trophozoite,21140,0.9271523178807947,1.0785714285714285
61129,/images/80da32ce-8c22-470e-9f35-558c5f7a5df9.png,999,765,1114,874,115,109,trophozoite,12535,0.9478260869565217,1.055045871559633
61133,/images/80da32ce-8c22-470e-9f35-558c5f7a5df9.png,2,481,139,597,137,116,ring,15892,0.8467153284671532,1.1810344827586208
61135,/images/80da32ce-8c22-470e-9f35-558c5f7a5df9.png,726,582,862,698,136,116,trophozoite,15776,0.8529411764705882,1.1724137931034482
61163,/images/80da32ce-8c22-470e-9f35-558c5f7a5df9.png,646,187,769,302,123,115,trophozoite,14145,0.9349593495934959,1.0695652173913044
61166,/images/80da32ce-8c22-470e-9f35-558c5f7a5df9.png,471,1439,598,1584,127,145,trophozoite,18415,1.141732283464567,0.8758620689655172
61214,/images/0da07970-3146-479c-8a07-f61ed32814a9.png,347,1467,482,1584,135,117,schizont,15795,0.8666666666666667,1.1538461538461537
61418,/images/e16c0dab-780d-4035-872e-1bb91e49f9d2.png,805,341,892,441,87,100,trophozoite,8700,1.1494252873563218,0.87
61477,/images/7e837856-3519-4dc0-b357-4cdcfd30b4eb.png,478,597,585,701,107,104,ring,11128,0.9719626168224299,1.0288461538461537
61562,/images/4a717a39-80f8-4b75-a25e-c46d65d7dcd5.png,923,1136,1047,1270,124,134,trophozoite,16616,1.0806451612903225,0.9253731343283582
61575,/images/4a717a39-80f8-4b75-a25e-c46d65d7dcd5.png,165,294,297,419,132,125,trophozoite,16500,0.946969696969697,1.056
61637,/images/a3c0a876-be12-4ede-8aed-18b32a64401b.png,327,1211,459,1327,132,116,trophozoite,15312,0.8787878787878788,1.1379310344827587
61644,/images/a3c0a876-be12-4ede-8aed-18b32a64401b.png,737,179,853,310,116,131,trophozoite,15196,1.1293103448275863,0.8854961832061069
61711,/images/12269960-075f-40ca-9630-49ea2ce78294.png,904,106,1033,228,129,122,trophozoite,15738,0.9457364341085271,1.0573770491803278
61720,/images/12269960-075f-40ca-9630-49ea2ce78294.png,74,1398,203,1513,129,115,ring,14835,0.8914728682170543,1.1217391304347826
61812,/images/985627c9-7b85-40de-a106-eb9cc47b47cb.png,161,508,293,643,132,135,trophozoite,17820,1.0227272727272727,0.9777777777777777
61856,/images/5f300fd1-7eec-41ac-bbd1-0f4a943c757c.png,111,118,245,274,134,156,trophozoite,20904,1.164179104477612,0.8589743589743589
61857,/images/5f300fd1-7eec-41ac-bbd1-0f4a943c757c.png,206,956,354,1115,148,159,leukocyte,23532,1.0743243243243243,0.9308176100628931
61890,/images/f32b21ae-5ca7-490b-bc40-6db9396d933c.png,824,70,956,195,132,125,trophozoite,16500,0.946969696969697,1.056
61911,/images/f32b21ae-5ca7-490b-bc40-6db9396d933c.png,1042,1287,1167,1419,125,132,trophozoite,16500,1.056,0.946969696969697
61917,/images/f32b21ae-5ca7-490b-bc40-6db9396d933c.png,739,1423,857,1547,118,124,gametocyte,14632,1.0508474576271187,0.9516129032258065
61922,/images/f32b21ae-5ca7-490b-bc40-6db9396d933c.png,169,1424,296,1550,127,126,trophozoite,16002,0.9921259842519685,1.007936507936508
61968,/images/c66a3e52-0f3f-4c81-bab9-0303499549f7.png,950,1401,1084,1526,134,125,trophozoite,16750,0.9328358208955224,1.072
62045,/images/bdb5d571-27bc-4a42-ae45-aa5a9af40a81.png,252,265,393,419,141,154,trophozoite,21714,1.0921985815602837,0.9155844155844156
62092,/images/7f528918-27d4-421f-ab57-0cf9c693e697.png,412,592,553,720,141,128,trophozoite,18048,0.9078014184397163,1.1015625
62100,/images/f5c51193-8a27-4ef3-83ad-771395d63caf.png,928,191,1059,315,131,124,trophozoite,16244,0.9465648854961832,1.0564516129032258
62116,/images/f5c51193-8a27-4ef3-83ad-771395d63caf.png,641,233,758,379,117,146,trophozoite,17082,1.2478632478632479,0.8013698630136986
62171,/images/a63fa2c7-3ec8-4bb7-bde6-a39e09d2f806.png,432,876,563,1032,131,156,gametocyte,20436,1.1908396946564885,0.8397435897435898
62269,/images/59f5699f-885f-4004-b783-a60060144e43.png,363,72,493,206,130,134,trophozoite,17420,1.0307692307692307,0.9701492537313433
62354,/images/e0ff3476-226f-4125-b182-8e524d5503dd.png,821,864,910,955,89,91,trophozoite,8099,1.0224719101123596,0.978021978021978
62377,/images/9af1ee02-87fd-42bc-963e-fa9ac3eb45bb.png,732,433,855,544,123,111,leukocyte,13653,0.9024390243902439,1.1081081081081081
62394,/images/9af1ee02-87fd-42bc-963e-fa9ac3eb45bb.png,286,629,421,766,135,137,trophozoite,18495,1.0148148148148148,0.9854014598540146
62395,/images/9af1ee02-87fd-42bc-963e-fa9ac3eb45bb.png,436,1338,566,1464,130,126,trophozoite,16380,0.9692307692307692,1.0317460317460319
62401,/images/9af1ee02-87fd-42bc-963e-fa9ac3eb45bb.png,500,383,636,508,136,125,trophozoite,17000,0.9191176470588235,1.088
62427,/images/9af1ee02-87fd-42bc-963e-fa9ac3eb45bb.png,695,619,817,737,122,118,trophozoite,14396,0.9672131147540983,1.0338983050847457
62448,/images/7dfbfeaf-e3b1-4159-8dcd-d7f731280ac8.png,197,1311,316,1413,119,102,ring,12138,0.8571428571428571,1.1666666666666667
62464,/images/7dfbfeaf-e3b1-4159-8dcd-d7f731280ac8.png,140,1407,247,1532,107,125,trophozoite,13375,1.1682242990654206,0.856
62472,/images/7dfbfeaf-e3b1-4159-8dcd-d7f731280ac8.png,432,422,555,564,123,142,trophozoite,17466,1.1544715447154472,0.8661971830985915
62476,/images/7dfbfeaf-e3b1-4159-8dcd-d7f731280ac8.png,168,1196,307,1318,139,122,ring,16958,0.8776978417266187,1.139344262295082
62516,/images/7dfbfeaf-e3b1-4159-8dcd-d7f731280ac8.png,112,850,237,989,125,139,schizont,17375,1.112,0.8992805755395683
62534,/images/7dfbfeaf-e3b1-4159-8dcd-d7f731280ac8.png,385,1417,514,1559,129,142,trophozoite,18318,1.1007751937984496,0.9084507042253521
62576,/images/9ecf2006-8d49-4ae8-a14b-ed8b3b14ee7c.png,629,875,759,1010,130,135,schizont,17550,1.0384615384615385,0.9629629629629629
62583,/images/f7a4334a-4332-4de8-b39b-22da907976f2.png,764,1090,881,1212,117,122,trophozoite,14274,1.0427350427350428,0.9590163934426229
62590,/images/f7a4334a-4332-4de8-b39b-22da907976f2.png,298,269,405,395,107,126,schizont,13482,1.1775700934579438,0.8492063492063492
62631,/images/f7a4334a-4332-4de8-b39b-22da907976f2.png,892,1111,1019,1226,127,115,trophozoite,14605,0.905511811023622,1.1043478260869566
62654,/images/f7a4334a-4332-4de8-b39b-22da907976f2.png,648,106,752,230,104,124,trophozoite,12896,1.1923076923076923,0.8387096774193549
62701,/images/9e1b0217-0926-4fd1-bb9e-a815c05deb59.png,902,685,1018,795,116,110,ring,12760,0.9482758620689655,1.0545454545454545
62724,/images/9e1b0217-0926-4fd1-bb9e-a815c05deb59.png,838,787,969,919,131,132,trophozoite,17292,1.0076335877862594,0.9924242424242424
62759,/images/e1937e32-85d5-4cd8-bb4a-b9cf8ee7ceeb.png,497,135,627,262,130,127,trophozoite,16510,0.9769230769230769,1.0236220472440944
62764,/images/e1937e32-85d5-4cd8-bb4a-b9cf8ee7ceeb.png,644,249,794,398,150,149,leukocyte,22350,0.9933333333333333,1.0067114093959733
62799,/images/631340cc-cedf-4bca-a3d8-a0731a5482b4.png,770,175,899,297,129,122,ring,15738,0.9457364341085271,1.0573770491803278
62818,/images/631340cc-cedf-4bca-a3d8-a0731a5482b4.png,50,945,156,1076,106,131,ring,13886,1.2358490566037736,0.8091603053435115
63062,/images/6afd8203-d61a-4e9b-a4cf-dcb53a16b57c.png,543,966,669,1079,126,113,gametocyte,14238,0.8968253968253969,1.1150442477876106
63112,/images/d82c657e-5678-41da-9a6e-3ad29430b759.png,81,554,212,684,131,130,trophozoite,17030,0.9923664122137404,1.0076923076923077
63146,/images/d82c657e-5678-41da-9a6e-3ad29430b759.png,725,159,833,288,108,129,trophozoite,13932,1.1944444444444444,0.8372093023255814
63198,/images/f0804a5e-e7f5-4cf2-a5df-b65e66502bf1.png,614,703,746,862,132,159,gametocyte,20988,1.2045454545454546,0.8301886792452831
63271,/images/d3283f5b-3b3a-40ea-800b-79960ca851cb.png,591,734,729,848,138,114,ring,15732,0.8260869565217391,1.2105263157894737
63325,/images/43bc935a-f655-45e1-a64d-fcb8b78267a6.png,492,447,632,600,140,153,gametocyte,21420,1.0928571428571427,0.9150326797385621
63331,/images/9f4bc3b4-abb0-4bcb-baa8-ec9f25e2b9c6.png,232,486,363,607,131,121,ring,15851,0.9236641221374046,1.0826446280991735
63351,/images/9f4bc3b4-abb0-4bcb-baa8-ec9f25e2b9c6.png,773,351,900,487,127,136,trophozoite,17272,1.0708661417322836,0.9338235294117647
63365,/images/9f4bc3b4-abb0-4bcb-baa8-ec9f25e2b9c6.png,135,909,244,1017,109,108,trophozoite,11772,0.9908256880733946,1.0092592592592593
63367,/images/9f4bc3b4-abb0-4bcb-baa8-ec9f25e2b9c6.png,1063,1366,1187,1495,124,129,leukocyte,15996,1.0403225806451613,0.9612403100775194
63397,/images/289ef1b7-02d5-42e9-a401-687688181306.png,12,862,142,985,130,123,trophozoite,15990,0.9461538461538461,1.056910569105691
63412,/images/289ef1b7-02d5-42e9-a401-687688181306.png,1045,357,1157,493,112,136,trophozoite,15232,1.2142857142857142,0.8235294117647058
63420,/images/289ef1b7-02d5-42e9-a401-687688181306.png,215,84,353,234,138,150,leukocyte,20700,1.0869565217391304,0.92
63647,/images/d9c9479e-f1ea-4d6e-861f-843ff9a90d19.png,806,1357,933,1468,127,111,trophozoite,14097,0.8740157480314961,1.1441441441441442
63677,/images/d9c9479e-f1ea-4d6e-861f-843ff9a90d19.png,543,632,664,742,121,110,trophozoite,13310,0.9090909090909091,1.1
63739,/images/06401963-8b02-46c5-ab2a-3d70bd01623f.png,681,96,814,222,133,126,trophozoite,16758,0.9473684210526315,1.0555555555555556
63762,/images/06401963-8b02-46c5-ab2a-3d70bd01623f.png,524,39,637,163,113,124,trophozoite,14012,1.0973451327433628,0.9112903225806451
63808,/images/6013bff0-dc4b-4bde-9409-0f6139c3495c.png,132,1054,267,1194,135,140,trophozoite,18900,1.037037037037037,0.9642857142857143
63812,/images/6013bff0-dc4b-4bde-9409-0f6139c3495c.png,621,975,746,1091,125,116,trophozoite,14500,0.928,1.0775862068965518
63829,/images/6013bff0-dc4b-4bde-9409-0f6139c3495c.png,134,862,261,986,127,124,trophozoite,15748,0.9763779527559056,1.0241935483870968
63946,/images/5e974892-0ebe-4037-8427-ea8616d6d3b8.png,996,706,1131,829,135,123,trophozoite,16605,0.9111111111111111,1.0975609756097562
63947,/images/5e974892-0ebe-4037-8427-ea8616d6d3b8.png,481,121,596,228,115,107,trophozoite,12305,0.9304347826086956,1.074766355140187
64009,/images/03cbfcf2-8da6-462c-b30d-16d63357371f.png,1039,993,1140,1102,101,109,ring,11009,1.0792079207920793,0.926605504587156
64031,/images/03cbfcf2-8da6-462c-b30d-16d63357371f.png,838,647,968,776,130,129,trophozoite,16770,0.9923076923076923,1.0077519379844961
64053,/images/03cbfcf2-8da6-462c-b30d-16d63357371f.png,744,1276,860,1415,116,139,trophozoite,16124,1.1982758620689655,0.8345323741007195
64098,/images/0d3c2521-da55-4df5-bf06-56b3bd4fb2fc.png,524,355,643,471,119,116,gametocyte,13804,0.9747899159663865,1.0258620689655173
64109,/images/0d3c2521-da55-4df5-bf06-56b3bd4fb2fc.png,226,75,367,203,141,128,trophozoite,18048,0.9078014184397163,1.1015625
64144,/images/0d3c2521-da55-4df5-bf06-56b3bd4fb2fc.png,753,1342,861,1463,108,121,trophozoite,13068,1.1203703703703705,0.8925619834710744
64188,/images/2a91387a-d30f-418d-ac3a-f7cfa6836261.png,274,405,397,527,123,122,ring,15006,0.991869918699187,1.0081967213114753
64202,/images/2a91387a-d30f-418d-ac3a-f7cfa6836261.png,519,502,649,635,130,133,trophozoite,17290,1.023076923076923,0.9774436090225563
64216,/images/2a91387a-d30f-418d-ac3a-f7cfa6836261.png,933,1362,1049,1477,116,115,ring,13340,0.9913793103448276,1.008695652173913
64233,/images/2a91387a-d30f-418d-ac3a-f7cfa6836261.png,681,260,805,379,124,119,ring,14756,0.9596774193548387,1.0420168067226891
64314,/images/0a7bfa8a-ee52-4f7a-b9c5-2919ecfa93ef.png,430,849,572,963,142,114,trophozoite,16188,0.8028169014084507,1.2456140350877194
64473,/images/34a70114-d3e3-4351-b8db-f6caab17e743.png,803,439,933,568,130,129,trophozoite,16770,0.9923076923076923,1.0077519379844961
64492,/images/6ba5d0b8-cdc7-4266-9d78-db76faa312e9.png,881,216,997,315,116,99,trophozoite,11484,0.853448275862069,1.1717171717171717
64507,/images/6ba5d0b8-cdc7-4266-9d78-db76faa312e9.png,923,1435,1043,1545,120,110,trophozoite,13200,0.9166666666666666,1.0909090909090908
64539,/images/6ba5d0b8-cdc7-4266-9d78-db76faa312e9.png,475,874,599,990,124,116,gametocyte,14384,0.9354838709677419,1.0689655172413792
64548,/images/6ba5d0b8-cdc7-4266-9d78-db76faa312e9.png,71,555,191,672,120,117,ring,14040,0.975,1.0256410256410255
64560,/images/6ba5d0b8-cdc7-4266-9d78-db76faa312e9.png,308,69,443,190,135,121,trophozoite,16335,0.8962962962962963,1.115702479338843
64674,/images/6dfafdf1-f588-4e80-8cf8-0126e1bf7af9.png,606,612,715,702,109,90,ring,9810,0.8256880733944955,1.211111111111111
64730,/images/76021d69-8919-4688-95ef-7418eff620cc.png,797,273,910,411,113,138,trophozoite,15594,1.2212389380530972,0.8188405797101449
64761,/images/76021d69-8919-4688-95ef-7418eff620cc.png,535,727,658,839,123,112,trophozoite,13776,0.9105691056910569,1.0982142857142858
64793,/images/a74b6d6a-7e04-40ac-9292-d62f13f7ded3.png,774,287,896,402,122,115,gametocyte,14030,0.9426229508196722,1.0608695652173914
64912,/images/dec61ae1-5037-4c3a-8952-15371becca7d.png,219,1141,330,1253,111,112,schizont,12432,1.009009009009009,0.9910714285714286
64987,/images/dec61ae1-5037-4c3a-8952-15371becca7d.png,381,805,521,945,140,140,trophozoite,19600,1.0,1.0
65168,/images/5e042380-6ef2-496f-8231-0ca550fbfa71.png,787,101,918,239,131,138,trophozoite,18078,1.0534351145038168,0.9492753623188406
65188,/images/5e042380-6ef2-496f-8231-0ca550fbfa71.png,630,1022,757,1149,127,127,trophozoite,16129,1.0,1.0
65207,/images/50715879-2300-4dba-8f4a-3314ff8cfcce.png,674,916,796,1045,122,129,trophozoite,15738,1.0573770491803278,0.9457364341085271
65215,/images/50715879-2300-4dba-8f4a-3314ff8cfcce.png,988,531,1113,663,125,132,trophozoite,16500,1.056,0.946969696969697
65226,/images/50715879-2300-4dba-8f4a-3314ff8cfcce.png,550,14,691,147,141,133,trophozoite,18753,0.9432624113475178,1.0601503759398496
65283,/images/45ac9409-5537-44ed-90cd-5c8a1ae0e1e0.png,626,784,770,935,144,151,schizont,21744,1.0486111111111112,0.9536423841059603
65316,/images/24418314-f7a4-49fc-a03e-ec597ca6796e.png,28,490,133,619,105,129,trophozoite,13545,1.2285714285714286,0.813953488372093
65319,/images/24418314-f7a4-49fc-a03e-ec597ca6796e.png,242,798,374,931,132,133,trophozoite,17556,1.0075757575757576,0.9924812030075187
65325,/images/24418314-f7a4-49fc-a03e-ec597ca6796e.png,147,19,256,120,109,101,trophozoite,11009,0.926605504587156,1.0792079207920793
65345,/images/24418314-f7a4-49fc-a03e-ec597ca6796e.png,635,1446,776,1590,141,144,trophozoite,20304,1.0212765957446808,0.9791666666666666
65353,/images/24418314-f7a4-49fc-a03e-ec597ca6796e.png,1036,1154,1158,1253,122,99,trophozoite,12078,0.8114754098360656,1.2323232323232323
65363,/images/24418314-f7a4-49fc-a03e-ec597ca6796e.png,165,1058,281,1192,116,134,trophozoite,15544,1.1551724137931034,0.8656716417910447
65411,/images/b523daee-317b-461d-bdc1-07b4add4d488.png,71,764,200,889,129,125,gametocyte,16125,0.9689922480620154,1.032
65415,/images/b523daee-317b-461d-bdc1-07b4add4d488.png,531,963,663,1090,132,127,trophozoite,16764,0.9621212121212122,1.0393700787401574
65531,/images/da49db57-0c2f-4213-b322-c88c19fb9296.png,1013,706,1106,789,93,83,ring,7719,0.8924731182795699,1.1204819277108433
65548,/images/01b38a56-13eb-447b-89ee-fc21cb40dcc1.png,1020,807,1137,930,117,123,trophozoite,14391,1.0512820512820513,0.9512195121951219
65574,/images/01b38a56-13eb-447b-89ee-fc21cb40dcc1.png,666,1156,798,1286,132,130,trophozoite,17160,0.9848484848484849,1.0153846153846153
65621,/images/01b38a56-13eb-447b-89ee-fc21cb40dcc1.png,811,9,934,143,123,134,trophozoite,16482,1.089430894308943,0.917910447761194
65695,/images/397f37bc-a3a4-4257-9430-c8fc5716f8b1.png,281,513,407,634,126,121,schizont,15246,0.9603174603174603,1.0413223140495869
65696,/images/c54fcef1-0c51-4426-9a93-15ec5f2bf58a.png,79,956,194,1089,115,133,trophozoite,15295,1.1565217391304348,0.8646616541353384
65714,/images/c54fcef1-0c51-4426-9a93-15ec5f2bf58a.png,127,359,250,490,123,131,trophozoite,16113,1.065040650406504,0.9389312977099237
65728,/images/c54fcef1-0c51-4426-9a93-15ec5f2bf58a.png,572,1213,698,1354,126,141,ring,17766,1.119047619047619,0.8936170212765957
65870,/images/d7581cb0-7a12-471d-a3d8-68dcea362213.png,992,1084,1122,1204,130,120,ring,15600,0.9230769230769231,1.0833333333333333
65887,/images/d7581cb0-7a12-471d-a3d8-68dcea362213.png,860,905,970,1035,110,130,gametocyte,14300,1.1818181818181819,0.8461538461538461
65893,/images/d7581cb0-7a12-471d-a3d8-68dcea362213.png,233,87,363,210,130,123,trophozoite,15990,0.9461538461538461,1.056910569105691
65896,/images/d7581cb0-7a12-471d-a3d8-68dcea362213.png,188,573,317,696,129,123,gametocyte,15867,0.9534883720930233,1.048780487804878
65960,/images/25c6cfb1-01d0-4864-87f9-02b7593683c7.png,738,839,873,964,135,125,trophozoite,16875,0.9259259259259259,1.08
65971,/images/25c6cfb1-01d0-4864-87f9-02b7593683c7.png,31,352,151,468,120,116,trophozoite,13920,0.9666666666666667,1.0344827586206897
65973,/images/25c6cfb1-01d0-4864-87f9-02b7593683c7.png,72,427,208,556,136,129,trophozoite,17544,0.9485294117647058,1.054263565891473
66005,/images/25c6cfb1-01d0-4864-87f9-02b7593683c7.png,646,1388,761,1510,115,122,trophozoite,14030,1.0608695652173914,0.9426229508196722
66077,/images/c8af0297-ce1f-40ea-bf44-9256dcdae4e9.png,788,391,928,509,140,118,ring,16520,0.8428571428571429,1.1864406779661016
66086,/images/c8af0297-ce1f-40ea-bf44-9256dcdae4e9.png,154,743,301,882,147,139,trophozoite,20433,0.9455782312925171,1.0575539568345325
66202,/images/14005767-9296-4b48-8a9d-bbe9b2040005.png,374,1282,510,1393,136,111,gametocyte,15096,0.8161764705882353,1.2252252252252251
66322,/images/fcdf6632-c03f-49a8-9fb3-42e87c99b9d0.png,581,36,708,153,127,117,ring,14859,0.9212598425196851,1.0854700854700854
66334,/images/fcdf6632-c03f-49a8-9fb3-42e87c99b9d0.png,210,1006,348,1119,138,113,trophozoite,15594,0.8188405797101449,1.2212389380530972
66343,/images/fcdf6632-c03f-49a8-9fb3-42e87c99b9d0.png,144,908,293,1029,149,121,trophozoite,18029,0.8120805369127517,1.2314049586776858
66441,/images/5f66d20c-fbfe-44ec-a01b-8a09da24807e.png,155,93,279,224,124,131,trophozoite,16244,1.0564516129032258,0.9465648854961832
66566,/images/b87fb62d-2c36-4f68-aba9-37fcd7d46eef.png,516,644,629,766,113,122,trophozoite,13786,1.079646017699115,0.9262295081967213
66567,/images/b87fb62d-2c36-4f68-aba9-37fcd7d46eef.png,375,1079,514,1200,139,121,trophozoite,16819,0.8705035971223022,1.1487603305785123
66618,/images/087f2c9c-188d-43cc-a94c-0eb8f10ac092.png,243,323,355,460,112,137,trophozoite,15344,1.2232142857142858,0.8175182481751825
66664,/images/b88fe674-fb9a-41d4-b100-cb1c86440d44.png,290,161,406,281,116,120,trophozoite,13920,1.0344827586206897,0.9666666666666667
66692,/images/b88fe674-fb9a-41d4-b100-cb1c86440d44.png,613,56,750,196,137,140,ring,19180,1.0218978102189782,0.9785714285714285
66702,/images/b88fe674-fb9a-41d4-b100-cb1c86440d44.png,600,385,733,508,133,123,trophozoite,16359,0.924812030075188,1.08130081300813
66726,/images/334bf865-e3fb-4200-bd53-d9ff5808ed9f.png,339,746,459,883,120,137,trophozoite,16440,1.1416666666666666,0.8759124087591241
66899,/images/9acf303a-fcba-4e52-be3e-8d061aa5e72a.png,804,525,937,637,133,112,trophozoite,14896,0.8421052631578947,1.1875
66922,/images/9acf303a-fcba-4e52-be3e-8d061aa5e72a.png,917,1376,1031,1511,114,135,trophozoite,15390,1.1842105263157894,0.8444444444444444
66943,/images/9acf303a-fcba-4e52-be3e-8d061aa5e72a.png,998,1301,1131,1419,133,118,trophozoite,15694,0.8872180451127819,1.1271186440677967
67057,/images/1fe1e118-adb8-4b10-a41e-1e5814e8f067.png,569,588,710,740,141,152,trophozoite,21432,1.0780141843971631,0.9276315789473685
67144,/images/be6fe358-dee1-4dcf-9b0d-5d8612aba577.png,32,696,172,826,140,130,leukocyte,18200,0.9285714285714286,1.0769230769230769
67162,/images/be6fe358-dee1-4dcf-9b0d-5d8612aba577.png,467,155,607,283,140,128,ring,17920,0.9142857142857143,1.09375
67196,/images/be6fe358-dee1-4dcf-9b0d-5d8612aba577.png,350,744,482,868,132,124,trophozoite,16368,0.9393939393939394,1.064516129032258
67273,/images/5f491efd-a21c-4a80-aaba-70b8876238ac.png,815,311,971,445,156,134,gametocyte,20904,0.8589743589743589,1.164179104477612
67328,/images/49c4dbd3-6269-4d4c-9648-a2146c57bab1.png,691,202,827,327,136,125,trophozoite,17000,0.9191176470588235,1.088
67332,/images/49c4dbd3-6269-4d4c-9648-a2146c57bab1.png,980,860,1124,988,144,128,gametocyte,18432,0.8888888888888888,1.125
67341,/images/49c4dbd3-6269-4d4c-9648-a2146c57bab1.png,792,1157,932,1282,140,125,trophozoite,17500,0.8928571428571429,1.12
67392,/images/266180ed-77a3-4284-8292-50a49fc47fce.png,84,1293,220,1430,136,137,trophozoite,18632,1.0073529411764706,0.9927007299270073
67395,/images/266180ed-77a3-4284-8292-50a49fc47fce.png,487,1055,628,1183,141,128,trophozoite,18048,0.9078014184397163,1.1015625
67424,/images/8e72e20e-e714-4db6-a1da-c05a409257d4.png,305,611,419,742,114,131,trophozoite,14934,1.1491228070175439,0.8702290076335878
67436,/images/8e72e20e-e714-4db6-a1da-c05a409257d4.png,440,251,560,364,120,113,trophozoite,13560,0.9416666666666667,1.0619469026548674
67456,/images/8e72e20e-e714-4db6-a1da-c05a409257d4.png,211,180,322,301,111,121,trophozoite,13431,1.09009009009009,0.9173553719008265
67497,/images/75660b56-51c2-45a9-9c15-e18d12a3af8c.png,1024,574,1152,690,128,116,gametocyte,14848,0.90625,1.103448275862069
67546,/images/45902b63-be9a-49ae-9ede-3a8015671bc4.png,537,997,676,1128,139,131,ring,18209,0.9424460431654677,1.0610687022900764
67599,/images/59542a24-b409-4c95-8608-d9691a741526.png,366,996,503,1112,137,116,trophozoite,15892,0.8467153284671532,1.1810344827586208
67609,/images/59542a24-b409-4c95-8608-d9691a741526.png,751,1359,896,1478,145,119,trophozoite,17255,0.8206896551724138,1.218487394957983
67614,/images/59542a24-b409-4c95-8608-d9691a741526.png,56,21,206,160,150,139,trophozoite,20850,0.9266666666666666,1.079136690647482
67699,/images/2b128a1a-95ed-408b-b9f8-8795cc814d80.png,946,1404,1090,1544,144,140,trophozoite,20160,0.9722222222222222,1.0285714285714285
67713,/images/2b128a1a-95ed-408b-b9f8-8795cc814d80.png,615,1135,746,1280,131,145,trophozoite,18995,1.1068702290076335,0.903448275862069
67771,/images/48e2f0bd-2164-40c3-af43-1f2708359978.png,563,784,710,945,147,161,leukocyte,23667,1.0952380952380953,0.9130434782608695
67796,/images/48e2f0bd-2164-40c3-af43-1f2708359978.png,453,1301,607,1444,154,143,trophozoite,22022,0.9285714285714286,1.0769230769230769
67841,/images/04de3a31-fc09-40be-9c2c-9830c57f809d.png,992,1340,1116,1482,124,142,schizont,17608,1.1451612903225807,0.8732394366197183
67876,/images/41ebf9a1-24dc-454e-8bf8-508218f5ee57.png,838,283,959,396,121,113,gametocyte,13673,0.9338842975206612,1.0707964601769913
67902,/images/41ebf9a1-24dc-454e-8bf8-508218f5ee57.png,96,647,216,777,120,130,schizont,15600,1.0833333333333333,0.9230769230769231
67912,/images/41ebf9a1-24dc-454e-8bf8-508218f5ee57.png,1079,1251,1193,1378,114,127,trophozoite,14478,1.1140350877192982,0.8976377952755905
67969,/images/bcaefb02-682a-41b9-acc7-e6cc010f5b30.png,371,1226,507,1343,136,117,trophozoite,15912,0.8602941176470589,1.1623931623931625
68018,/images/bcaefb02-682a-41b9-acc7-e6cc010f5b30.png,590,914,743,1069,153,155,trophozoite,23715,1.0130718954248366,0.9870967741935484
68023,/images/bcaefb02-682a-41b9-acc7-e6cc010f5b30.png,288,1312,428,1462,140,150,trophozoite,21000,1.0714285714285714,0.9333333333333333
68121,/images/5dec94a3-e3ca-4a58-9702-88e5a83ef612.png,602,484,701,599,99,115,trophozoite,11385,1.1616161616161615,0.8608695652173913
68131,/images/5dec94a3-e3ca-4a58-9702-88e5a83ef612.png,403,443,527,568,124,125,trophozoite,15500,1.0080645161290323,0.992
68133,/images/5dec94a3-e3ca-4a58-9702-88e5a83ef612.png,518,559,642,677,124,118,gametocyte,14632,0.9516129032258065,1.0508474576271187
68193,/images/ff1b23d0-3cef-459b-b81f-39bfcdb6526f.png,675,334,802,459,127,125,trophozoite,15875,0.984251968503937,1.016
68203,/images/ff1b23d0-3cef-459b-b81f-39bfcdb6526f.png,38,424,162,549,124,125,trophozoite,15500,1.0080645161290323,0.992
68211,/images/ff1b23d0-3cef-459b-b81f-39bfcdb6526f.png,1029,241,1161,377,132,136,trophozoite,17952,1.0303030303030303,0.9705882352941176
68353,/images/0f735cca-051c-4048-a1fa-cb36f389e12f.png,619,857,750,1011,131,154,trophozoite,20174,1.1755725190839694,0.8506493506493507
68410,/images/040112be-3c8d-49aa-93f1-522f94a592ff.png,257,1353,371,1461,114,108,trophozoite,12312,0.9473684210526315,1.0555555555555556
68483,/images/74261741-4d6e-4dba-8ad4-4fbdf919c30f.png,78,319,197,446,119,127,trophozoite,15113,1.0672268907563025,0.937007874015748
68490,/images/74261741-4d6e-4dba-8ad4-4fbdf919c30f.png,307,570,428,703,121,133,trophozoite,16093,1.0991735537190082,0.9097744360902256
68521,/images/74261741-4d6e-4dba-8ad4-4fbdf919c30f.png,893,155,1008,290,115,135,trophozoite,15525,1.173913043478261,0.8518518518518519
68526,/images/74261741-4d6e-4dba-8ad4-4fbdf919c30f.png,1006,456,1143,584,137,128,trophozoite,17536,0.9343065693430657,1.0703125
68574,/images/32700bc7-7a86-49d3-aded-ccaaed4ddc5c.png,151,126,296,249,145,123,trophozoite,17835,0.8482758620689655,1.1788617886178863
68617,/images/31653d0f-c4e6-4e12-8005-518c2de34687.png,541,1425,655,1566,114,141,trophozoite,16074,1.236842105263158,0.8085106382978723
68634,/images/31653d0f-c4e6-4e12-8005-518c2de34687.png,93,204,218,330,125,126,trophozoite,15750,1.008,0.9920634920634921
68687,/images/77e76e62-2c71-4b52-9b21-0d1bcde9f9bf.png,966,667,1072,798,106,131,ring,13886,1.2358490566037736,0.8091603053435115
68782,/images/eb5f4f2f-2275-4a80-84a5-78a1eaf4ce4d.png,450,720,596,866,146,146,trophozoite,21316,1.0,1.0
68791,/images/aa3ad405-828e-4986-8251-20fd981f34d3.png,868,847,988,974,120,127,ring,15240,1.0583333333333333,0.9448818897637795
68841,/images/aa3ad405-828e-4986-8251-20fd981f34d3.png,142,1319,278,1455,136,136,trophozoite,18496,1.0,1.0
68846,/images/aa3ad405-828e-4986-8251-20fd981f34d3.png,175,364,306,503,131,139,leukocyte,18209,1.0610687022900764,0.9424460431654677
68906,/images/6347dd6a-cfdf-4cb5-bc50-cff5403cfecb.png,535,672,655,819,120,147,ring,17640,1.225,0.8163265306122449
68956,/images/bbaa004f-05dc-4cb8-8768-e148085bb0f9.png,705,1026,856,1170,151,144,trophozoite,21744,0.9536423841059603,1.0486111111111112
68965,/images/bbaa004f-05dc-4cb8-8768-e148085bb0f9.png,259,107,391,243,132,136,trophozoite,17952,1.0303030303030303,0.9705882352941176
68973,/images/bbaa004f-05dc-4cb8-8768-e148085bb0f9.png,867,112,987,262,120,150,trophozoite,18000,1.25,0.8
69037,/images/b5246b58-6f40-4c9e-8024-f49b0ed6bdbd.png,223,617,346,741,123,124,ring,15252,1.008130081300813,0.9919354838709677
69071,/images/de2b8835-552c-4f01-98b7-67bc4910062e.png,144,369,264,488,120,119,schizont,14280,0.9916666666666667,1.0084033613445378
69150,/images/de2b8835-552c-4f01-98b7-67bc4910062e.png,776,346,858,447,82,101,trophozoite,8282,1.2317073170731707,0.8118811881188119
69195,/images/f274b784-b995-4a7e-a2c2-6cc31c24c4b4.png,328,1312,431,1433,103,121,trophozoite,12463,1.174757281553398,0.8512396694214877
69227,/images/f274b784-b995-4a7e-a2c2-6cc31c24c4b4.png,27,61,113,154,86,93,leukocyte,7998,1.0813953488372092,0.9247311827956989
69390,/images/2ac343e4-c889-47c1-8fe2-461b626def76.png,523,766,658,930,135,164,trophozoite,22140,1.2148148148148148,0.823170731707317
69452,/images/fde0fd54-49cc-42e1-90c6-6b612cd062d8.png,270,495,369,590,99,95,gametocyte,9405,0.9595959595959596,1.0421052631578946
69453,/images/fde0fd54-49cc-42e1-90c6-6b612cd062d8.png,485,962,585,1063,100,101,ring,10100,1.01,0.9900990099009901
69461,/images/664c570b-4822-413c-9724-11b1d91fac44.png,525,462,663,586,138,124,trophozoite,17112,0.8985507246376812,1.1129032258064515
69481,/images/664c570b-4822-413c-9724-11b1d91fac44.png,1022,1305,1160,1437,138,132,leukocyte,18216,0.9565217391304348,1.0454545454545454
69517,/images/664c570b-4822-413c-9724-11b1d91fac44.png,57,1022,184,1133,127,111,trophozoite,14097,0.8740157480314961,1.1441441441441442
69639,/images/4a49841f-216c-4815-8140-b8762c4f6603.png,136,882,297,1020,161,138,trophozoite,22218,0.8571428571428571,1.1666666666666667
69665,/images/f0713bee-2a71-4ced-b953-4041ea99496a.png,875,561,998,683,123,122,ring,15006,0.991869918699187,1.0081967213114753
69683,/images/f0713bee-2a71-4ced-b953-4041ea99496a.png,472,1228,593,1331,121,103,gametocyte,12463,0.8512396694214877,1.174757281553398
69700,/images/f0713bee-2a71-4ced-b953-4041ea99496a.png,74,616,208,749,134,133,trophozoite,17822,0.9925373134328358,1.0075187969924813
69816,/images/2bd15b6e-fe2d-49f3-b394-940d024d1f91.png,352,1119,495,1256,143,137,trophozoite,19591,0.958041958041958,1.0437956204379562
69970,/images/089c9744-f906-41d8-908d-1e37919a8658.png,373,1381,507,1512,134,131,gametocyte,17554,0.9776119402985075,1.0229007633587786
69986,/images/3e36698f-8c09-4c8b-8948-737310bf97e5.png,320,1249,437,1382,117,133,trophozoite,15561,1.1367521367521367,0.8796992481203008
70106,/images/c742ee2c-6814-46cd-af56-ae87bb9972f4.png,768,918,872,1026,104,108,trophozoite,11232,1.0384615384615385,0.9629629629629629
70110,/images/c742ee2c-6814-46cd-af56-ae87bb9972f4.png,625,589,764,732,139,143,leukocyte,19877,1.0287769784172662,0.972027972027972
70190,/images/b338766f-19b9-4874-bcc5-ae22b3c533e6.png,50,666,170,797,120,131,trophozoite,15720,1.0916666666666666,0.916030534351145
70201,/images/b338766f-19b9-4874-bcc5-ae22b3c533e6.png,633,323,768,465,135,142,gametocyte,19170,1.0518518518518518,0.9507042253521126
70204,/images/b338766f-19b9-4874-bcc5-ae22b3c533e6.png,523,284,650,416,127,132,trophozoite,16764,1.0393700787401574,0.9621212121212122
70238,/images/a5c3b3f8-7ceb-4573-a400-a76b9479af46.png,435,360,574,498,139,138,trophozoite,19182,0.9928057553956835,1.0072463768115942
70308,/images/90246988-0d6d-4bf8-8a76-94107de4121e.png,237,1376,351,1512,114,136,trophozoite,15504,1.1929824561403508,0.8382352941176471
70331,/images/90246988-0d6d-4bf8-8a76-94107de4121e.png,244,45,384,171,140,126,trophozoite,17640,0.9,1.1111111111111112
70342,/images/90246988-0d6d-4bf8-8a76-94107de4121e.png,905,45,1037,159,132,114,trophozoite,15048,0.8636363636363636,1.1578947368421053
70374,/images/4876c9d0-b386-48fb-84e8-91bf87529161.png,765,206,891,322,126,116,ring,14616,0.9206349206349206,1.0862068965517242
70634,/images/4ce5a070-9ede-4bb1-9ca2-1bae5746776b.png,1040,1392,1106,1461,66,69,leukocyte,4554,1.0454545454545454,0.9565217391304348
70635,/images/4ce5a070-9ede-4bb1-9ca2-1bae5746776b.png,486,799,619,928,133,129,gametocyte,17157,0.9699248120300752,1.0310077519379846
70666,/images/7521ec48-57b5-48a8-a5d6-8280ad5da19c.png,998,102,1116,248,118,146,ring,17228,1.2372881355932204,0.8082191780821918
70680,/images/7521ec48-57b5-48a8-a5d6-8280ad5da19c.png,326,1063,455,1207,129,144,gametocyte,18576,1.1162790697674418,0.8958333333333334
70683,/images/7521ec48-57b5-48a8-a5d6-8280ad5da19c.png,476,1394,608,1545,132,151,trophozoite,19932,1.143939393939394,0.8741721854304636
70693,/images/8ab5c462-045e-4b59-b53a-9b2bc3ed2487.png,947,566,1065,694,118,128,ring,15104,1.0847457627118644,0.921875
70725,/images/8ab5c462-045e-4b59-b53a-9b2bc3ed2487.png,163,609,310,729,147,120,trophozoite,17640,0.8163265306122449,1.225
70744,/images/8ab5c462-045e-4b59-b53a-9b2bc3ed2487.png,720,495,856,643,136,148,trophozoite,20128,1.088235294117647,0.918918918918919
70772,/images/b62d47f9-2ff5-4902-abdc-b3610acfc7ba.png,916,698,1038,827,122,129,trophozoite,15738,1.0573770491803278,0.9457364341085271
70809,/images/b62d47f9-2ff5-4902-abdc-b3610acfc7ba.png,204,1338,321,1475,117,137,trophozoite,16029,1.170940170940171,0.8540145985401459
70851,/images/bf002a25-6535-4621-be19-56d468be5413.png,1031,1080,1154,1208,123,128,trophozoite,15744,1.0406504065040652,0.9609375
70901,/images/bf002a25-6535-4621-be19-56d468be5413.png,861,365,966,489,105,124,trophozoite,13020,1.180952380952381,0.8467741935483871
70944,/images/deaa1931-5f97-45bf-8c00-be6ddeb37b9a.png,711,1105,844,1225,133,120,trophozoite,15960,0.9022556390977443,1.1083333333333334
70999,/images/deaa1931-5f97-45bf-8c00-be6ddeb37b9a.png,761,972,891,1101,130,129,trophozoite,16770,0.9923076923076923,1.0077519379844961
71010,/images/deaa1931-5f97-45bf-8c00-be6ddeb37b9a.png,195,176,315,292,120,116,trophozoite,13920,0.9666666666666667,1.0344827586206897
71086,/images/2dbf6f69-e020-4948-9e49-4b33edb7cebd.png,6,334,131,452,125,118,gametocyte,14750,0.944,1.0593220338983051
71157,/images/b666fcc2-d0b2-441e-bc5a-c660345eeb5d.png,446,768,572,900,126,132,trophozoite,16632,1.0476190476190477,0.9545454545454546
71202,/images/4fac16e1-8e62-499b-a66b-c4c890372914.png,572,764,720,912,148,148,schizont,21904,1.0,1.0
71253,/images/86495bbf-687b-429c-b9d3-6c2681ade7e2.png,579,1263,702,1391,123,128,trophozoite,15744,1.0406504065040652,0.9609375
71271,/images/445d0db9-e830-4ceb-a845-b23d819e6097.png,799,1190,918,1329,119,139,trophozoite,16541,1.1680672268907564,0.8561151079136691
71276,/images/445d0db9-e830-4ceb-a845-b23d819e6097.png,850,191,966,320,116,129,trophozoite,14964,1.1120689655172413,0.8992248062015504
71444,/images/bcb447c9-5d37-414f-a513-d7076b04a532.png,924,727,1036,839,112,112,trophozoite,12544,1.0,1.0
71473,/images/191071ab-6515-428c-9f05-8e4309542b75.png,54,147,185,275,131,128,trophozoite,16768,0.9770992366412213,1.0234375
71484,/images/191071ab-6515-428c-9f05-8e4309542b75.png,228,588,367,707,139,119,trophozoite,16541,0.8561151079136691,1.1680672268907564
71507,/images/191071ab-6515-428c-9f05-8e4309542b75.png,396,426,537,540,141,114,trophozoite,16074,0.8085106382978723,1.236842105263158
71586,/images/b9c6db13-ca3a-4937-8ecf-e537047ed858.png,446,738,596,896,150,158,trophozoite,23700,1.0533333333333332,0.9493670886075949
71631,/images/390ad256-e1ed-476a-9f14-2dc34e0da632.png,548,862,667,1006,119,144,trophozoite,17136,1.2100840336134453,0.8263888888888888
71634,/images/5c99cd97-39f6-4809-9528-9d380cc16b16.png,980,334,1088,441,108,107,leukocyte,11556,0.9907407407407407,1.0093457943925233
71658,/images/5c99cd97-39f6-4809-9528-9d380cc16b16.png,153,878,283,1000,130,122,trophozoite,15860,0.9384615384615385,1.0655737704918034
71830,/images/093a831a-bf71-4333-bc06-942ae70cb164.png,265,1125,396,1254,131,129,trophozoite,16899,0.9847328244274809,1.0155038759689923
71831,/images/093a831a-bf71-4333-bc06-942ae70cb164.png,471,1332,596,1461,125,129,trophozoite,16125,1.032,0.9689922480620154
71871,/images/61575482-91e1-4db9-83c7-687b7ddbbfc4.png,693,241,827,367,134,126,trophozoite,16884,0.9402985074626866,1.0634920634920635
71929,/images/61575482-91e1-4db9-83c7-687b7ddbbfc4.png,727,1079,854,1203,127,124,trophozoite,15748,0.9763779527559056,1.0241935483870968
71973,/images/61575482-91e1-4db9-83c7-687b7ddbbfc4.png,351,1260,492,1378,141,118,trophozoite,16638,0.8368794326241135,1.194915254237288
72037,/images/6ad3efc9-4392-4cee-98a5-186564a96373.png,942,398,1069,526,127,128,trophozoite,16256,1.0078740157480315,0.9921875
72041,/images/64b0e49a-0e48-447d-8872-c1dd255e7a21.png,717,31,833,154,116,123,trophozoite,14268,1.0603448275862069,0.943089430894309
72080,/images/64b0e49a-0e48-447d-8872-c1dd255e7a21.png,463,487,584,619,121,132,trophozoite,15972,1.0909090909090908,0.9166666666666666
72204,/images/7d4d0646-26b5-46fa-ab25-452d986e887b.png,960,655,1083,768,123,113,leukocyte,13899,0.9186991869918699,1.0884955752212389
72468,/images/a15e0fa8-2620-4f66-896e-175115c9dc3d.png,1035,1211,1132,1310,97,99,trophozoite,9603,1.0206185567010309,0.9797979797979798
72524,/images/22516db4-8687-4051-90c4-2bb1ca3204a5.png,665,956,743,1040,78,84,leukocyte,6552,1.0769230769230769,0.9285714285714286
72564,/images/01b99da8-b66b-464b-a7ee-1cadab8db18b.png,519,708,635,832,116,124,trophozoite,14384,1.0689655172413792,0.9354838709677419
72676,/images/6ab870ba-b24b-49a9-9570-8eafe63aa74e.png,1011,268,1142,384,131,116,gametocyte,15196,0.8854961832061069,1.1293103448275863
72682,/images/6ab870ba-b24b-49a9-9570-8eafe63aa74e.png,64,1157,198,1291,134,134,leukocyte,17956,1.0,1.0
72686,/images/6ab870ba-b24b-49a9-9570-8eafe63aa74e.png,343,168,479,277,136,109,trophozoite,14824,0.8014705882352942,1.2477064220183487
72704,/images/6ab870ba-b24b-49a9-9570-8eafe63aa74e.png,689,509,839,649,150,140,trophozoite,21000,0.9333333333333333,1.0714285714285714
72739,/images/caeb2d62-1166-43f0-8eac-5b8fc48f02eb.png,972,52,1094,187,122,135,trophozoite,16470,1.1065573770491803,0.9037037037037037
72759,/images/caeb2d62-1166-43f0-8eac-5b8fc48f02eb.png,926,827,1045,951,119,124,trophozoite,14756,1.0420168067226891,0.9596774193548387
72779,/images/caeb2d62-1166-43f0-8eac-5b8fc48f02eb.png,742,628,879,752,137,124,trophozoite,16988,0.9051094890510949,1.1048387096774193
72803,/images/caeb2d62-1166-43f0-8eac-5b8fc48f02eb.png,644,669,775,829,131,160,trophozoite,20960,1.2213740458015268,0.81875
72825,/images/31435107-c77d-42f8-a619-75cba6a5161b.png,659,791,797,924,138,133,leukocyte,18354,0.9637681159420289,1.037593984962406
72868,/images/31435107-c77d-42f8-a619-75cba6a5161b.png,926,1066,1071,1200,145,134,trophozoite,19430,0.9241379310344827,1.0820895522388059
72881,/images/31435107-c77d-42f8-a619-75cba6a5161b.png,847,927,974,1079,127,152,trophozoite,19304,1.1968503937007875,0.8355263157894737
72917,/images/a20d0b4b-6e2e-4507-bc22-f321dedc4ed9.png,249,320,386,436,137,116,trophozoite,15892,0.8467153284671532,1.1810344827586208
72926,/images/a20d0b4b-6e2e-4507-bc22-f321dedc4ed9.png,780,805,900,952,120,147,trophozoite,17640,1.225,0.8163265306122449
72935,/images/a20d0b4b-6e2e-4507-bc22-f321dedc4ed9.png,906,1331,1056,1477,150,146,trophozoite,21900,0.9733333333333334,1.0273972602739727
72937,/images/a20d0b4b-6e2e-4507-bc22-f321dedc4ed9.png,563,723,706,856,143,133,trophozoite,19019,0.9300699300699301,1.0751879699248121
72944,/images/a20d0b4b-6e2e-4507-bc22-f321dedc4ed9.png,1059,1417,1161,1522,102,105,ring,10710,1.0294117647058822,0.9714285714285714
72959,/images/a20d0b4b-6e2e-4507-bc22-f321dedc4ed9.png,146,590,295,714,149,124,ring,18476,0.8322147651006712,1.2016129032258065
72980,/images/2bd26501-2fbc-4c1a-bef0-4ad57e02b4d0.png,88,559,211,679,123,120,trophozoite,14760,0.975609756097561,1.025
73029,/images/2bd26501-2fbc-4c1a-bef0-4ad57e02b4d0.png,148,475,281,618,133,143,trophozoite,19019,1.0751879699248121,0.9300699300699301
73035,/images/2bd26501-2fbc-4c1a-bef0-4ad57e02b4d0.png,369,670,506,791,137,121,trophozoite,16577,0.8832116788321168,1.1322314049586777
73045,/images/2bd26501-2fbc-4c1a-bef0-4ad57e02b4d0.png,644,942,744,1058,100,116,trophozoite,11600,1.16,0.8620689655172413
73184,/images/85546330-4efd-43e2-87aa-d53a30220bfc.png,644,49,786,167,142,118,trophozoite,16756,0.8309859154929577,1.2033898305084745
73190,/images/85546330-4efd-43e2-87aa-d53a30220bfc.png,1077,31,1197,156,120,125,trophozoite,15000,1.0416666666666667,0.96
73216,/images/85546330-4efd-43e2-87aa-d53a30220bfc.png,432,1353,578,1479,146,126,trophozoite,18396,0.863013698630137,1.1587301587301588
73276,/images/67a4fb91-6f38-4ca2-8f20-6b2f5f1b29a7.png,519,123,633,251,114,128,trophozoite,14592,1.1228070175438596,0.890625
73297,/images/67a4fb91-6f38-4ca2-8f20-6b2f5f1b29a7.png,454,859,583,985,129,126,trophozoite,16254,0.9767441860465116,1.0238095238095237
73299,/images/67a4fb91-6f38-4ca2-8f20-6b2f5f1b29a7.png,718,234,846,350,128,116,trophozoite,14848,0.90625,1.103448275862069
73345,/images/c890ee00-daa5-4b20-9cd5-930748ecc4e0.png,532,1350,641,1464,109,114,trophozoite,12426,1.0458715596330275,0.956140350877193
73357,/images/c890ee00-daa5-4b20-9cd5-930748ecc4e0.png,163,441,287,570,124,129,ring,15996,1.0403225806451613,0.9612403100775194
73392,/images/c890ee00-daa5-4b20-9cd5-930748ecc4e0.png,91,252,228,366,137,114,trophozoite,15618,0.8321167883211679,1.2017543859649122
73458,/images/58594235-0d32-4a4e-91cd-4c800eaaaa73.png,571,830,686,964,115,134,trophozoite,15410,1.1652173913043478,0.8582089552238806
73478,/images/5f2b32bd-fdca-4d6f-b13a-ee9f83626c8d.png,172,1258,296,1391,124,133,trophozoite,16492,1.0725806451612903,0.9323308270676691
73486,/images/5f2b32bd-fdca-4d6f-b13a-ee9f83626c8d.png,498,1162,612,1293,114,131,trophozoite,14934,1.1491228070175439,0.8702290076335878
73588,/images/7624ac36-1cf9-42fb-844d-376078309553.png,536,793,692,942,156,149,trophozoite,23244,0.9551282051282052,1.0469798657718121
73684,/images/f11d05e4-538a-4024-8711-b08a4ce3c540.png,673,288,791,411,118,123,trophozoite,14514,1.0423728813559323,0.959349593495935
73688,/images/f11d05e4-538a-4024-8711-b08a4ce3c540.png,198,535,309,633,111,98,ring,10878,0.8828828828828829,1.1326530612244898
73709,/images/f11d05e4-538a-4024-8711-b08a4ce3c540.png,960,1389,1077,1515,117,126,ring,14742,1.0769230769230769,0.9285714285714286
73726,/images/f11d05e4-538a-4024-8711-b08a4ce3c540.png,664,564,786,674,122,110,trophozoite,13420,0.9016393442622951,1.1090909090909091
73865,/images/3eba916c-998b-40a7-993c-7ed916c2a04c.png,983,970,1080,1065,97,95,trophozoite,9215,0.979381443298969,1.0210526315789474
73884,/images/2ae3e6e6-7482-4ab8-ad73-b530b5c2ee3b.png,92,271,223,397,131,126,gametocyte,16506,0.9618320610687023,1.0396825396825398
73903,/images/2ae3e6e6-7482-4ab8-ad73-b530b5c2ee3b.png,308,504,452,621,144,117,gametocyte,16848,0.8125,1.2307692307692308
73968,/images/2ae3e6e6-7482-4ab8-ad73-b530b5c2ee3b.png,297,870,401,997,104,127,trophozoite,13208,1.2211538461538463,0.8188976377952756
74035,/images/fe436c09-b680-4f4c-8faf-aa10a55a335b.png,807,1268,932,1394,125,126,trophozoite,15750,1.008,0.9920634920634921
74063,/images/fe436c09-b680-4f4c-8faf-aa10a55a335b.png,721,686,835,801,114,115,trophozoite,13110,1.0087719298245614,0.991304347826087
74110,/images/9fe8bdc8-847d-434e-93e5-ae14ff3b45e1.png,725,1158,857,1288,132,130,gametocyte,17160,0.9848484848484849,1.0153846153846153
74139,/images/9fe8bdc8-847d-434e-93e5-ae14ff3b45e1.png,438,988,580,1120,142,132,schizont,18744,0.9295774647887324,1.0757575757575757
74142,/images/9fe8bdc8-847d-434e-93e5-ae14ff3b45e1.png,473,324,621,451,148,127,trophozoite,18796,0.8581081081081081,1.1653543307086613
74151,/images/9fe8bdc8-847d-434e-93e5-ae14ff3b45e1.png,154,734,288,884,134,150,trophozoite,20100,1.1194029850746268,0.8933333333333333
74173,/images/4e43fc22-dc08-4cde-b3ce-ce8a4f377c47.png,231,755,342,863,111,108,trophozoite,11988,0.972972972972973,1.0277777777777777
74177,/images/4e43fc22-dc08-4cde-b3ce-ce8a4f377c47.png,1025,1121,1145,1250,120,129,trophozoite,15480,1.075,0.9302325581395349
74208,/images/4e43fc22-dc08-4cde-b3ce-ce8a4f377c47.png,779,759,888,874,109,115,ring,12535,1.055045871559633,0.9478260869565217
74227,/images/4e43fc22-dc08-4cde-b3ce-ce8a4f377c47.png,967,490,1081,615,114,125,trophozoite,14250,1.0964912280701755,0.912
74308,/images/8939e14b-fcdf-48b1-acb9-6514a2fc2fc0.png,453,761,579,890,126,129,trophozoite,16254,1.0238095238095237,0.9767441860465116
74318,/images/8939e14b-fcdf-48b1-acb9-6514a2fc2fc0.png,189,1367,307,1496,118,129,trophozoite,15222,1.0932203389830508,0.9147286821705426
74338,/images/8939e14b-fcdf-48b1-acb9-6514a2fc2fc0.png,561,21,701,176,140,155,trophozoite,21700,1.1071428571428572,0.9032258064516129
74339,/images/8939e14b-fcdf-48b1-acb9-6514a2fc2fc0.png,622,931,759,1097,137,166,trophozoite,22742,1.2116788321167884,0.8253012048192772
74401,/images/06a3effb-996c-4767-afd2-6aa3b697cb4e.png,943,1232,1071,1348,128,116,trophozoite,14848,0.90625,1.103448275862069
74420,/images/06a3effb-996c-4767-afd2-6aa3b697cb4e.png,1057,564,1169,697,112,133,trophozoite,14896,1.1875,0.8421052631578947
74440,/images/06a3effb-996c-4767-afd2-6aa3b697cb4e.png,415,179,560,340,145,161,trophozoite,23345,1.110344827586207,0.9006211180124224
74442,/images/06a3effb-996c-4767-afd2-6aa3b697cb4e.png,340,36,471,179,131,143,trophozoite,18733,1.0916030534351144,0.916083916083916
74446,/images/06a3effb-996c-4767-afd2-6aa3b697cb4e.png,419,1344,564,1493,145,149,trophozoite,21605,1.0275862068965518,0.9731543624161074
74497,/images/cbb58718-6319-48db-b84b-78ac9b12ff89.png,998,1015,1141,1141,143,126,trophozoite,18018,0.8811188811188811,1.1349206349206349
74590,/images/bbedfcbe-9528-4ba9-9d86-4ebba7589ac5.png,519,594,638,718,119,124,trophozoite,14756,1.0420168067226891,0.9596774193548387
74601,/images/bbedfcbe-9528-4ba9-9d86-4ebba7589ac5.png,463,660,595,794,132,134,ring,17688,1.0151515151515151,0.9850746268656716
74754,/images/c53fd511-31bd-4901-baac-3b44891f6744.png,555,1012,677,1128,122,116,ring,14152,0.9508196721311475,1.0517241379310345
74770,/images/c53fd511-31bd-4901-baac-3b44891f6744.png,66,311,190,423,124,112,ring,13888,0.9032258064516129,1.1071428571428572
74854,/images/81edcae1-65bf-4752-b0e4-494376b71e49.png,293,595,403,729,110,134,trophozoite,14740,1.2181818181818183,0.8208955223880597
74857,/images/81edcae1-65bf-4752-b0e4-494376b71e49.png,1045,1054,1157,1160,112,106,trophozoite,11872,0.9464285714285714,1.0566037735849056
74889,/images/81edcae1-65bf-4752-b0e4-494376b71e49.png,25,592,159,750,134,158,trophozoite,21172,1.1791044776119404,0.8481012658227848
74890,/images/81edcae1-65bf-4752-b0e4-494376b71e49.png,349,419,494,569,145,150,trophozoite,21750,1.0344827586206897,0.9666666666666667
74900,/images/81edcae1-65bf-4752-b0e4-494376b71e49.png,1100,144,1200,260,100,116,trophozoite,11600,1.16,0.8620689655172413
74912,/images/dd090806-e4ac-4a78-b2ee-55a30626369c.png,1031,1135,1158,1268,127,133,trophozoite,16891,1.047244094488189,0.9548872180451128
75033,/images/9147a21d-0de2-4c04-88da-b788311696ac.png,688,721,823,861,135,140,gametocyte,18900,1.037037037037037,0.9642857142857143
75147,/images/7fdc8be8-7579-4a5c-b369-8a07ee0a8b7d.png,933,1224,1069,1349,136,125,trophozoite,17000,0.9191176470588235,1.088
75180,/images/7fdc8be8-7579-4a5c-b369-8a07ee0a8b7d.png,889,389,1034,531,145,142,trophozoite,20590,0.9793103448275862,1.0211267605633803
75199,/images/61dfc937-a428-44b4-94fb-d682bdb8dff0.png,595,455,725,575,130,120,trophozoite,15600,0.9230769230769231,1.0833333333333333
75227,/images/61dfc937-a428-44b4-94fb-d682bdb8dff0.png,847,835,974,950,127,115,gametocyte,14605,0.905511811023622,1.1043478260869566
75328,/images/9ec1dcec-87c2-4aca-8e6b-0db3cd05509c.png,411,278,533,401,122,123,gametocyte,15006,1.0081967213114753,0.991869918699187
75333,/images/9ec1dcec-87c2-4aca-8e6b-0db3cd05509c.png,693,1136,852,1279,159,143,trophozoite,22737,0.89937106918239,1.1118881118881119
75429,/images/468c261d-f5d8-423f-883e-48af2bbbc5d1.png,18,597,157,720,139,123,trophozoite,17097,0.8848920863309353,1.1300813008130082
75444,/images/468c261d-f5d8-423f-883e-48af2bbbc5d1.png,942,1288,1071,1439,129,151,trophozoite,19479,1.1705426356589148,0.8543046357615894
75492,/images/6c20abb2-c4bb-4de0-8774-03f4d30ce93d.png,459,796,610,955,151,159,trophozoite,24009,1.0529801324503312,0.949685534591195
75512,/images/fa4f8d1a-cb3a-4722-a566-6c7072f30606.png,92,1231,225,1363,133,132,trophozoite,17556,0.9924812030075187,1.0075757575757576
75632,/images/c35ee701-fde2-46b5-b178-1fe3f1ea7da2.png,763,742,873,852,110,110,trophozoite,12100,1.0,1.0
75633,/images/c35ee701-fde2-46b5-b178-1fe3f1ea7da2.png,664,1183,765,1284,101,101,trophozoite,10201,1.0,1.0
75706,/images/d12c5f45-6b20-46d6-a66f-c5a4683c25b3.png,273,835,397,965,124,130,trophozoite,16120,1.0483870967741935,0.9538461538461539
75792,/images/f48bf825-13c4-42fc-8dd8-10cc4ae6b202.png,454,176,582,313,128,137,trophozoite,17536,1.0703125,0.9343065693430657
75882,/images/3006096f-ceeb-42be-b69e-785179d7438b.png,757,667,891,792,134,125,trophozoite,16750,0.9328358208955224,1.072
75896,/images/3006096f-ceeb-42be-b69e-785179d7438b.png,149,737,279,873,130,136,ring,17680,1.0461538461538462,0.9558823529411765
75916,/images/3006096f-ceeb-42be-b69e-785179d7438b.png,465,171,585,287,120,116,ring,13920,0.9666666666666667,1.0344827586206897
75920,/images/3006096f-ceeb-42be-b69e-785179d7438b.png,346,1149,480,1288,134,139,trophozoite,18626,1.037313432835821,0.9640287769784173
75933,/images/034c8d57-04d5-4786-93a4-6ae8fde2c258.png,530,54,666,180,136,126,trophozoite,17136,0.9264705882352942,1.0793650793650793
75991,/images/034c8d57-04d5-4786-93a4-6ae8fde2c258.png,449,215,567,350,118,135,trophozoite,15930,1.1440677966101696,0.8740740740740741
76002,/images/4c7d2382-a962-4237-a053-955eea3decd8.png,643,610,762,723,119,113,trophozoite,13447,0.9495798319327731,1.0530973451327434
76038,/images/4c7d2382-a962-4237-a053-955eea3decd8.png,741,743,874,877,133,134,trophozoite,17822,1.0075187969924813,0.9925373134328358
76061,/images/4c7d2382-a962-4237-a053-955eea3decd8.png,1017,633,1148,750,131,117,trophozoite,15327,0.8931297709923665,1.1196581196581197
76075,/images/4c7d2382-a962-4237-a053-955eea3decd8.png,547,212,665,342,118,130,trophozoite,15340,1.1016949152542372,0.9076923076923077
76114,/images/16244280-6c74-47d3-b544-9fd6831a6bf9.png,562,782,678,892,116,110,ring,12760,0.9482758620689655,1.0545454545454545
76172,/images/16244280-6c74-47d3-b544-9fd6831a6bf9.png,256,1154,377,1278,121,124,trophozoite,15004,1.024793388429752,0.9758064516129032
76226,/images/90a82250-1f68-48c9-9af9-15f18bf8c974.png,605,546,733,673,128,127,schizont,16256,0.9921875,1.0078740157480315
76321,/images/1574565f-f45b-4160-947e-25ce1a81aaca.png,144,791,290,928,146,137,trophozoite,20002,0.9383561643835616,1.0656934306569343
76324,/images/3dad6483-ac30-4d2b-b045-9f24fe6ff75e.png,652,367,764,489,112,122,ring,13664,1.0892857142857142,0.9180327868852459
76357,/images/3dad6483-ac30-4d2b-b045-9f24fe6ff75e.png,900,1368,1040,1490,140,122,trophozoite,17080,0.8714285714285714,1.1475409836065573
76358,/images/3dad6483-ac30-4d2b-b045-9f24fe6ff75e.png,14,961,137,1087,123,126,trophozoite,15498,1.024390243902439,0.9761904761904762
76381,/images/3dad6483-ac30-4d2b-b045-9f24fe6ff75e.png,641,1209,763,1353,122,144,trophozoite,17568,1.180327868852459,0.8472222222222222
76393,/images/3dad6483-ac30-4d2b-b045-9f24fe6ff75e.png,1070,958,1175,1079,105,121,trophozoite,12705,1.1523809523809523,0.8677685950413223
76427,/images/34df8890-272d-423a-ae78-ff8d068d3306.png,180,1206,311,1341,131,135,trophozoite,17685,1.0305343511450382,0.9703703703703703
76435,/images/34df8890-272d-423a-ae78-ff8d068d3306.png,342,149,470,285,128,136,trophozoite,17408,1.0625,0.9411764705882353
76450,/images/34df8890-272d-423a-ae78-ff8d068d3306.png,724,856,829,979,105,123,schizont,12915,1.1714285714285715,0.8536585365853658
76458,/images/34df8890-272d-423a-ae78-ff8d068d3306.png,646,746,748,839,102,93,trophozoite,9486,0.9117647058823529,1.096774193548387
76487,/images/34df8890-272d-423a-ae78-ff8d068d3306.png,829,469,987,602,158,133,trophozoite,21014,0.8417721518987342,1.1879699248120301
76497,/images/34df8890-272d-423a-ae78-ff8d068d3306.png,220,449,331,569,111,120,trophozoite,13320,1.0810810810810811,0.925
76530,/images/38c69905-8a4f-451a-8d0a-b855dc88dd16.png,114,343,251,456,137,113,trophozoite,15481,0.8248175182481752,1.2123893805309736
76551,/images/38c69905-8a4f-451a-8d0a-b855dc88dd16.png,704,556,835,677,131,121,trophozoite,15851,0.9236641221374046,1.0826446280991735
76582,/images/4184a235-d209-4151-86e9-6c77e7938dab.png,480,1072,591,1197,111,125,trophozoite,13875,1.1261261261261262,0.888
76741,/images/3317d733-ec0d-45e6-b631-40457392f343.png,646,941,744,1046,98,105,trophozoite,10290,1.0714285714285714,0.9333333333333333
76957,/images/51e86aa9-caa0-4297-94e8-34a57d7f7e36.png,998,104,1138,217,140,113,trophozoite,15820,0.8071428571428572,1.238938053097345
77008,/images/51e86aa9-caa0-4297-94e8-34a57d7f7e36.png,196,225,312,359,116,134,trophozoite,15544,1.1551724137931034,0.8656716417910447
77241,/images/07a80340-f65e-4f58-9317-94bb6ebd5a28.png,632,308,748,429,116,121,ring,14036,1.043103448275862,0.9586776859504132
77261,/images/07a80340-f65e-4f58-9317-94bb6ebd5a28.png,1029,835,1132,949,103,114,ring,11742,1.1067961165048543,0.9035087719298246
77289,/images/07a80340-f65e-4f58-9317-94bb6ebd5a28.png,229,1011,344,1152,115,141,trophozoite,16215,1.2260869565217392,0.8156028368794326
77351,/images/3ff98212-7c2a-46cd-afb7-34a2479bed07.png,585,245,680,346,95,101,trophozoite,9595,1.063157894736842,0.9405940594059405
77385,/images/3ff98212-7c2a-46cd-afb7-34a2479bed07.png,517,1172,651,1319,134,147,trophozoite,19698,1.0970149253731343,0.9115646258503401
77413,/images/c7ec51d5-9f45-4209-8357-39e9a984a733.png,881,50,1001,163,120,113,gametocyte,13560,0.9416666666666667,1.0619469026548674
77495,/images/a11ed7d0-12f6-468f-abad-5cba7d968123.png,404,699,539,828,135,129,trophozoite,17415,0.9555555555555556,1.0465116279069768
77496,/images/a11ed7d0-12f6-468f-abad-5cba7d968123.png,316,697,404,779,88,82,leukocyte,7216,0.9318181818181818,1.0731707317073171
77508,/images/2d2e81f3-e329-4765-9ba1-2c95f12dc9f3.png,1022,1313,1148,1427,126,114,trophozoite,14364,0.9047619047619048,1.105263157894737
77536,/images/2d2e81f3-e329-4765-9ba1-2c95f12dc9f3.png,505,873,626,1016,121,143,gametocyte,17303,1.1818181818181819,0.8461538461538461
77549,/images/2d2e81f3-e329-4765-9ba1-2c95f12dc9f3.png,335,1037,440,1162,105,125,trophozoite,13125,1.1904761904761905,0.84
77557,/images/2d2e81f3-e329-4765-9ba1-2c95f12dc9f3.png,729,807,853,931,124,124,trophozoite,15376,1.0,1.0
77615,/images/f20a4fcf-ea8e-4c14-883d-d26a9e08ce25.png,378,422,520,596,142,174,gametocyte,24708,1.2253521126760563,0.8160919540229885
77640,/images/07d15855-eb9b-46a9-b894-7cfe4d097826.png,570,119,705,249,135,130,ring,17550,0.9629629629629629,1.0384615384615385
77656,/images/07d15855-eb9b-46a9-b894-7cfe4d097826.png,608,532,730,663,122,131,trophozoite,15982,1.0737704918032787,0.9312977099236641
77721,/images/4849866a-73a2-4fcf-a407-2d0a25a09a89.png,994,756,1124,876,130,120,trophozoite,15600,0.9230769230769231,1.0833333333333333
77732,/images/4849866a-73a2-4fcf-a407-2d0a25a09a89.png,647,978,775,1116,128,138,trophozoite,17664,1.078125,0.927536231884058
77783,/images/4849866a-73a2-4fcf-a407-2d0a25a09a89.png,389,1275,506,1413,117,138,trophozoite,16146,1.1794871794871795,0.8478260869565217
77833,/images/6bc7b53c-5a98-48ef-a9de-59a476707ea4.png,892,1103,1018,1221,126,118,trophozoite,14868,0.9365079365079365,1.0677966101694916
77858,/images/6bc7b53c-5a98-48ef-a9de-59a476707ea4.png,731,13,882,135,151,122,trophozoite,18422,0.8079470198675497,1.2377049180327868
77915,/images/464055b6-3351-4636-a919-8be9840fb850.png,57,712,172,836,115,124,schizont,14260,1.0782608695652174,0.9274193548387096
77973,/images/c691c8ef-d3c7-47b6-a941-f6a1089f21a9.png,961,710,1094,826,133,116,trophozoite,15428,0.8721804511278195,1.146551724137931
77994,/images/c691c8ef-d3c7-47b6-a941-f6a1089f21a9.png,275,262,379,369,104,107,trophozoite,11128,1.0288461538461537,0.9719626168224299
78106,/images/105af41b-13cc-4ad1-8a1f-8bc4d47cdd94.png,692,869,839,1008,147,139,trophozoite,20433,0.9455782312925171,1.0575539568345325
78107,/images/105af41b-13cc-4ad1-8a1f-8bc4d47cdd94.png,105,645,265,800,160,155,trophozoite,24800,0.96875,1.032258064516129
78154,/images/bb137718-20ba-457d-8ffe-4f9420ecaab6.png,1000,139,1140,268,140,129,trophozoite,18060,0.9214285714285714,1.0852713178294573
78155,/images/bb137718-20ba-457d-8ffe-4f9420ecaab6.png,988,207,1109,342,121,135,trophozoite,16335,1.115702479338843,0.8962962962962963
78217,/images/2bed2796-75a9-4d93-bb2d-e3ccbe1a5cbe.png,460,789,604,912,144,123,trophozoite,17712,0.8541666666666666,1.170731707317073
78218,/images/2bed2796-75a9-4d93-bb2d-e3ccbe1a5cbe.png,736,183,830,276,94,93,trophozoite,8742,0.9893617021276596,1.010752688172043
78247,/images/adff6e1d-ba9d-4c7b-a8fe-1ec458eaeeb8.png,182,779,308,912,126,133,ring,16758,1.0555555555555556,0.9473684210526315
78270,/images/adff6e1d-ba9d-4c7b-a8fe-1ec458eaeeb8.png,994,77,1121,202,127,125,schizont,15875,0.984251968503937,1.016
78276,/images/adff6e1d-ba9d-4c7b-a8fe-1ec458eaeeb8.png,1013,882,1137,1011,124,129,trophozoite,15996,1.0403225806451613,0.9612403100775194
78278,/images/adff6e1d-ba9d-4c7b-a8fe-1ec458eaeeb8.png,31,1012,131,1131,100,119,ring,11900,1.19,0.8403361344537815
78385,/images/24115f58-a7d6-4022-a95a-86b515a78d3e.png,882,873,965,958,83,85,trophozoite,7055,1.0240963855421688,0.9764705882352941
78386,/images/24115f58-a7d6-4022-a95a-86b515a78d3e.png,218,282,321,373,103,91,trophozoite,9373,0.883495145631068,1.1318681318681318
78387,/images/24115f58-a7d6-4022-a95a-86b515a78d3e.png,229,761,326,857,97,96,trophozoite,9312,0.9896907216494846,1.0104166666666667
78543,/images/c94827ce-d619-4705-a68a-df63a2c95ffa.png,406,969,507,1082,101,113,trophozoite,11413,1.118811881188119,0.8938053097345132
78610,/images/c5084fb8-2b62-464c-8a77-1a07ea653266.png,580,496,704,644,124,148,trophozoite,18352,1.1935483870967742,0.8378378378378378
78642,/images/3612aa3b-2906-44a6-9c80-6144511a35ce.png,509,736,645,878,136,142,schizont,19312,1.0441176470588236,0.9577464788732394
78678,/images/fd1c4c7a-24bc-43f2-b84f-fee182207aee.png,490,1266,616,1407,126,141,trophozoite,17766,1.119047619047619,0.8936170212765957
78727,/images/76a8a5f5-1328-4539-a131-baf877f40cf3.png,444,642,610,786,166,144,trophozoite,23904,0.8674698795180723,1.1527777777777777
78746,/images/dc6ac71b-2616-431e-bfd5-4c38139e4ddd.png,553,601,679,727,126,126,trophozoite,15876,1.0,1.0
78798,/images/9174f910-3859-4839-8e30-2c3b25269322.png,105,202,226,345,121,143,trophozoite,17303,1.1818181818181819,0.8461538461538461
78851,/images/4d0a1598-e4dd-45c4-8a90-dd7c780fe1da.png,851,843,965,960,114,117,trophozoite,13338,1.0263157894736843,0.9743589743589743
78953,/images/6144887d-a1c1-46db-91a1-f7ff5bf8c8a5.png,202,884,332,1003,130,119,trophozoite,15470,0.9153846153846154,1.0924369747899159
78955,/images/6144887d-a1c1-46db-91a1-f7ff5bf8c8a5.png,245,1457,356,1575,111,118,trophozoite,13098,1.063063063063063,0.940677966101695
79015,/images/6144887d-a1c1-46db-91a1-f7ff5bf8c8a5.png,942,1240,1089,1359,147,119,trophozoite,17493,0.8095238095238095,1.2352941176470589
79076,/images/036e008f-07a1-4e92-899d-1822dc390ccb.png,455,792,590,923,135,131,trophozoite,17685,0.9703703703703703,1.0305343511450382
79136,/images/1c90231b-2830-42d9-884e-7301edb16933.png,107,712,232,855,125,143,trophozoite,17875,1.144,0.8741258741258742
79171,/images/1c90231b-2830-42d9-884e-7301edb16933.png,351,13,501,146,150,133,trophozoite,19950,0.8866666666666667,1.1278195488721805
79240,/images/eb0173a3-7e5e-4f53-8124-03d9d6317844.png,500,681,640,807,140,126,trophozoite,17640,0.9,1.1111111111111112
79259,/images/05ac7b2a-6a77-4464-926b-8570f7c01693.png,279,989,394,1127,115,138,trophozoite,15870,1.2,0.8333333333333334
79299,/images/05ac7b2a-6a77-4464-926b-8570f7c01693.png,235,744,381,865,146,121,trophozoite,17666,0.8287671232876712,1.2066115702479339
79306,/images/05ac7b2a-6a77-4464-926b-8570f7c01693.png,1065,49,1182,168,117,119,trophozoite,13923,1.017094017094017,0.9831932773109243
79317,/images/05ac7b2a-6a77-4464-926b-8570f7c01693.png,21,830,153,953,132,123,trophozoite,16236,0.9318181818181818,1.0731707317073171
79386,/images/dcb21739-3c36-459d-b3cc-1be5871d6fe7.png,187,107,304,226,117,119,trophozoite,13923,1.017094017094017,0.9831932773109243
79453,/images/a2fc0093-8645-43c7-bdee-ec8ca9484815.png,351,814,475,936,124,122,ring,15128,0.9838709677419355,1.0163934426229508
79497,/images/a2fc0093-8645-43c7-bdee-ec8ca9484815.png,575,1029,691,1170,116,141,gametocyte,16356,1.2155172413793103,0.8226950354609929
79505,/images/a2fc0093-8645-43c7-bdee-ec8ca9484815.png,322,1007,461,1126,139,119,trophozoite,16541,0.8561151079136691,1.1680672268907564
79516,/images/a2fc0093-8645-43c7-bdee-ec8ca9484815.png,725,920,857,1067,132,147,trophozoite,19404,1.1136363636363635,0.8979591836734694
79546,/images/161978c3-3a05-47a5-9fee-be7d25693eae.png,988,150,1103,266,115,116,trophozoite,13340,1.008695652173913,0.9913793103448276
79562,/images/161978c3-3a05-47a5-9fee-be7d25693eae.png,50,459,170,567,120,108,trophozoite,12960,0.9,1.1111111111111112
79682,/images/a4409217-be11-4478-90a5-b406057d154d.png,693,1122,794,1205,101,83,trophozoite,8383,0.8217821782178217,1.216867469879518
79754,/images/03b9d6ad-39ca-4097-a98b-77f02b3c00a7.png,20,725,144,833,124,108,trophozoite,13392,0.8709677419354839,1.1481481481481481
79762,/images/03b9d6ad-39ca-4097-a98b-77f02b3c00a7.png,110,644,242,794,132,150,trophozoite,19800,1.1363636363636365,0.88
79829,/images/fc15659f-6264-4dd5-ab17-43d89fb297b9.png,249,1338,381,1478,132,140,trophozoite,18480,1.0606060606060606,0.9428571428571428
79894,/images/a054a8e2-55f2-4508-97df-207f76b89be2.png,775,498,901,626,126,128,trophozoite,16128,1.0158730158730158,0.984375
79895,/images/a054a8e2-55f2-4508-97df-207f76b89be2.png,341,706,473,839,132,133,trophozoite,17556,1.0075757575757576,0.9924812030075187
79980,/images/e640ae51-cbf1-4a84-b7cf-d38b17f59c2f.png,979,211,1097,334,118,123,trophozoite,14514,1.0423728813559323,0.959349593495935
80001,/images/e640ae51-cbf1-4a84-b7cf-d38b17f59c2f.png,310,1187,434,1333,124,146,trophozoite,18104,1.1774193548387097,0.8493150684931506
80049,/images/38d1b930-dd97-4248-9160-e9389a1a8dd7.png,469,756,631,910,162,154,trophozoite,24948,0.9506172839506173,1.051948051948052
80109,/images/99e979d4-ee97-4d7f-9da6-00bead40db4d.png,308,808,406,900,98,92,trophozoite,9016,0.9387755102040817,1.065217391304348
11963,/images/f8a8b148-60e4-4a5c-ae19-941b19ec0846.png,449,628,563,731,114,103,red blood cell,11742,0.9035087719298246,1.1067961165048543
50474,/images/833b1d3e-d389-4d0f-8638-6aca5b89f917.png,1025,484,1128,592,103,108,red blood cell,11124,1.0485436893203883,0.9537037037037037
23047,/images/0d095f3a-9243-472b-90b4-0ce8309e778c.png,7,1353,106,1466,99,113,red blood cell,11187,1.1414141414141414,0.8761061946902655
23646,/images/79d7a014-21ff-40f1-9ac4-a69839390654.png,33,0,136,92,103,92,red blood cell,9476,0.8932038834951457,1.1195652173913044
1268,/images/6d91d1f0-636b-4f5a-a526-7c17fc857190.png,870,729,986,832,116,103,red blood cell,11948,0.8879310344827587,1.1262135922330097
61456,/images/7e837856-3519-4dc0-b357-4cdcfd30b4eb.png,303,647,405,759,102,112,red blood cell,11424,1.0980392156862746,0.9107142857142857
38788,/images/b426ef1d-4a59-4f90-b593-50226af60a60.png,585,376,692,496,107,120,red blood cell,12840,1.1214953271028036,0.8916666666666667
58007,/images/a7c91b63-b97c-4f4b-8d34-7ad2b08d7a17.png,779,1259,893,1379,114,120,red blood cell,13680,1.0526315789473684,0.95
66964,/images/9acf303a-fcba-4e52-be3e-8d061aa5e72a.png,856,142,951,224,95,82,red blood cell,7790,0.8631578947368421,1.1585365853658536
56465,/images/d75933ed-d26e-4d1f-bda3-96bc0d77fb36.png,610,1456,718,1573,108,117,red blood cell,12636,1.0833333333333333,0.9230769230769231
15881,/images/c7c1b873-0548-4a73-9618-f60912e164df.png,434,488,530,594,96,106,red blood cell,10176,1.1041666666666667,0.9056603773584906
12866,/images/b10ea12f-cd36-4f2c-994a-67d1665269ab.png,970,73,1081,199,111,126,red blood cell,13986,1.135135135135135,0.8809523809523809
2485,/images/a23f5539-bfe6-4885-9a0e-dba972475ea9.png,993,1204,1097,1301,104,97,red blood cell,10088,0.9326923076923077,1.0721649484536082
10791,/images/2a02cec2-a09b-483a-ad38-14359a763fa4.png,194,596,310,699,116,103,red blood cell,11948,0.8879310344827587,1.1262135922330097
45019,/images/13bab3c3-3f79-44d9-a287-0ae6d71eff31.png,537,58,654,197,117,139,red blood cell,16263,1.188034188034188,0.841726618705036
3499,/images/ad36bd67-594b-4f63-93e3-886af0bc618e.png,807,489,917,621,110,132,red blood cell,14520,1.2,0.8333333333333334
31555,/images/a0b277cb-20bc-4921-a6bd-5ccd5b91d14f.png,651,129,776,258,125,129,red blood cell,16125,1.032,0.9689922480620154
9921,/images/b4261fa5-876d-48ea-b6da-ec7ca5b48fe2.png,928,87,1043,198,115,111,red blood cell,12765,0.9652173913043478,1.0360360360360361
71072,/images/2dbf6f69-e020-4948-9e49-4b33edb7cebd.png,339,126,467,246,128,120,red blood cell,15360,0.9375,1.0666666666666667
47292,/images/1dd3e6dd-343f-4cc9-b0ed-e4d27fb36f0a.png,667,1212,787,1333,120,121,red blood cell,14520,1.0083333333333333,0.9917355371900827
26587,/images/4935818a-7e7a-4f44-a3b6-b361d1abfe16.png,105,830,221,969,116,139,red blood cell,16124,1.1982758620689655,0.8345323741007195
47984,/images/eba73bff-fbe1-436d-9a5f-0a61331a0ea2.png,995,259,1113,380,118,121,red blood cell,14278,1.0254237288135593,0.9752066115702479
71787,/images/093a831a-bf71-4333-bc06-942ae70cb164.png,317,427,414,524,97,97,red blood cell,9409,1.0,1.0
34228,/images/4767bfcc-fe87-4962-8c40-6ce8d9363cdf.png,598,1159,718,1265,120,106,red blood cell,12720,0.8833333333333333,1.1320754716981132
15831,/images/c7c1b873-0548-4a73-9618-f60912e164df.png,748,530,862,636,114,106,red blood cell,12084,0.9298245614035088,1.0754716981132075
70518,/images/8cca114a-ed05-4b87-95b7-fae02487f08c.png,1084,370,1193,477,109,107,red blood cell,11663,0.981651376146789,1.0186915887850467
34425,/images/b4bde4e8-f48b-4ae2-be01-86d8c91d0af9.png,944,321,1041,425,97,104,red blood cell,10088,1.0721649484536082,0.9326923076923077
6256,/images/f4a27dfd-4c52-459f-96b5-ee6b452a3395.png,671,167,788,273,117,106,red blood cell,12402,0.905982905982906,1.1037735849056605
8463,/images/e234ce8b-4ec4-4d93-9068-d7854d77ddf4.png,880,1280,993,1396,113,116,red blood cell,13108,1.0265486725663717,0.9741379310344828
21547,/images/49efc89d-9cba-44f7-8257-7f911b73f68a.png,259,957,357,1074,98,117,red blood cell,11466,1.1938775510204083,0.8376068376068376
51449,/images/baa87bf8-786c-444c-81e8-9fa0a41d8149.png,233,1057,338,1154,105,97,red blood cell,10185,0.9238095238095239,1.0824742268041236
48890,/images/fed6ba05-36a5-45dc-a4e1-9baa7de2c622.png,94,704,194,795,100,91,red blood cell,9100,0.91,1.098901098901099
21908,/images/d57b3894-c912-47e8-b00a-e1a2a7aba644.png,428,1178,555,1281,127,103,red blood cell,13081,0.8110236220472441,1.233009708737864
79442,/images/a2fc0093-8645-43c7-bdee-ec8ca9484815.png,1042,368,1153,465,111,97,red blood cell,10767,0.8738738738738738,1.1443298969072164
57301,/images/aaade430-4c49-4038-97b7-f8cdd937db57.png,450,643,543,735,93,92,red blood cell,8556,0.989247311827957,1.0108695652173914
18597,/images/c22f7031-9cf8-48ce-b03b-1b12d0db4951.png,114,1338,215,1420,101,82,red blood cell,8282,0.8118811881188119,1.2317073170731707
60023,/images/49288109-80e9-4ec8-96d1-26a0166b8883.png,68,375,182,495,114,120,red blood cell,13680,1.0526315789473684,0.95
41967,/images/46a03374-64c7-49ac-81c9-c3d62542bbf3.png,328,315,428,417,100,102,red blood cell,10200,1.02,0.9803921568627451
52198,/images/f4c00b8c-d675-4255-8277-ca65bd757f51.png,283,573,379,664,96,91,red blood cell,8736,0.9479166666666666,1.054945054945055
44704,/images/867f30da-2568-4480-9968-cece78c61c64.png,601,1483,703,1596,102,113,red blood cell,11526,1.107843137254902,0.9026548672566371
16762,/images/4823c1fe-a7f9-4b92-959f-0d9be09cd14b.png,290,398,372,491,82,93,red blood cell,7626,1.1341463414634145,0.8817204301075269
119,/images/10be6380-cbbb-4886-8b9e-ff56b1710576.png,499,945,609,1049,110,104,red blood cell,11440,0.9454545454545454,1.0576923076923077
33092,/images/6231d81d-9e84-4a5a-8cb8-47c6a37a0176.png,70,931,157,1024,87,93,red blood cell,8091,1.0689655172413792,0.9354838709677419
4767,/images/3fa1a4e3-c80d-49da-8f7b-a1abb0424f48.png,835,742,919,820,84,78,red blood cell,6552,0.9285714285714286,1.0769230769230769
74034,/images/fe436c09-b680-4f4c-8faf-aa10a55a335b.png,539,869,634,964,95,95,red blood cell,9025,1.0,1.0
35130,/images/a6ba808f-ec60-42a5-ad91-7b32412ab708.png,358,1464,478,1596,120,132,red blood cell,15840,1.1,0.9090909090909091
2065,/images/f3bd0fcc-647d-4ca0-8c43-a16bd6ea3878.png,364,319,462,432,98,113,red blood cell,11074,1.153061224489796,0.8672566371681416
39262,/images/f7cced00-9b41-45ec-9fdf-fb9e1a74da90.png,508,822,627,935,119,113,red blood cell,13447,0.9495798319327731,1.0530973451327434
31063,/images/9c48fdf4-621d-4f40-bcd7-6a28cd530de7.png,334,846,436,960,102,114,red blood cell,11628,1.1176470588235294,0.8947368421052632
49204,/images/a9daf82a-a46d-4296-bd72-2c374ed0a193.png,740,891,843,1011,103,120,red blood cell,12360,1.1650485436893203,0.8583333333333333
6079,/images/c147584d-4c61-412a-bdaf-b02b22c18708.png,741,1317,850,1436,109,119,red blood cell,12971,1.091743119266055,0.9159663865546218
69380,/images/2ac343e4-c889-47c1-8fe2-461b626def76.png,742,1146,838,1248,96,102,red blood cell,9792,1.0625,0.9411764705882353
20139,/images/df49578a-60d4-4a3b-9ee0-79d9d59bc72a.png,319,557,448,676,129,119,red blood cell,15351,0.9224806201550387,1.084033613445378
71481,/images/191071ab-6515-428c-9f05-8e4309542b75.png,880,546,975,650,95,104,red blood cell,9880,1.0947368421052632,0.9134615384615384
32733,/images/eef2ac0b-42de-4bc3-a3c3-d5fcd597fbe4.png,242,1043,351,1137,109,94,red blood cell,10246,0.8623853211009175,1.1595744680851063
69972,/images/089c9744-f906-41d8-908d-1e37919a8658.png,6,299,105,421,99,122,red blood cell,12078,1.2323232323232323,0.8114754098360656
67246,/images/5f491efd-a21c-4a80-aaba-70b8876238ac.png,1022,114,1133,224,111,110,red blood cell,12210,0.990990990990991,1.009090909090909
73459,/images/58594235-0d32-4a4e-91cd-4c800eaaaa73.png,158,1516,229,1598,71,82,red blood cell,5822,1.1549295774647887,0.8658536585365854
62900,/images/4b346035-b8c0-46ca-8fdb-a01b1421ee4a.png,445,1448,546,1550,101,102,red blood cell,10302,1.00990099009901,0.9901960784313726
66740,/images/334bf865-e3fb-4200-bd53-d9ff5808ed9f.png,84,384,184,472,100,88,red blood cell,8800,0.88,1.1363636363636365
27969,/images/c4d34e35-4db2-41de-ba77-1a94aa9ef788.png,239,75,356,200,117,125,red blood cell,14625,1.0683760683760684,0.936
31390,/images/04fb49a2-07b8-4cdf-b6f7-df5c3688e5f8.png,356,277,456,386,100,109,red blood cell,10900,1.09,0.9174311926605505
4401,/images/84041bf9-dace-4066-9fe0-52170d08f826.png,672,223,777,329,105,106,red blood cell,11130,1.0095238095238095,0.9905660377358491
13290,/images/030f3421-ed3f-4bf1-8f27-4d02590bffbc.png,313,1329,406,1422,93,93,red blood cell,8649,1.0,1.0
36231,/images/c3209548-7f7c-4afd-b47c-b42a72b1ebf7.png,523,775,656,887,133,112,red blood cell,14896,0.8421052631578947,1.1875
61346,/images/e16c0dab-780d-4035-872e-1bb91e49f9d2.png,853,996,952,1104,99,108,red blood cell,10692,1.0909090909090908,0.9166666666666666
34081,/images/de5d19b7-e670-4ac7-843b-7ce7bcebdf45.png,208,184,306,295,98,111,red blood cell,10878,1.1326530612244898,0.8828828828828829
57244,/images/6d05ed67-43e2-43af-9d57-70c7a6eeef5e.png,987,785,1107,886,120,101,red blood cell,12120,0.8416666666666667,1.188118811881188
65252,/images/45ac9409-5537-44ed-90cd-5c8a1ae0e1e0.png,147,865,254,968,107,103,red blood cell,11021,0.9626168224299065,1.0388349514563107
46676,/images/da111ca5-520f-4ea8-97ad-ae5fce58ee91.png,924,800,1039,908,115,108,red blood cell,12420,0.9391304347826087,1.0648148148148149
41460,/images/c4494d4f-732f-431a-8a9d-62403f0b74fe.png,119,441,223,545,104,104,red blood cell,10816,1.0,1.0
17304,/images/3d302619-473d-4c5b-af43-8833ff94233f.png,420,1120,522,1211,102,91,red blood cell,9282,0.8921568627450981,1.120879120879121
46436,/images/bbecf1a8-a728-4c83-87f8-4dfbac0a1e03.png,1009,163,1101,267,92,104,red blood cell,9568,1.1304347826086956,0.8846153846153846
30721,/images/8e0dfc1f-e3eb-4a3f-a1c4-249bdfbfaa27.png,540,291,652,400,112,109,red blood cell,12208,0.9732142857142857,1.0275229357798166
7217,/images/89f10192-d3dd-4996-a571-4c851dbdc983.png,421,1444,535,1548,114,104,red blood cell,11856,0.9122807017543859,1.0961538461538463
77302,/images/07a80340-f65e-4f58-9317-94bb6ebd5a28.png,285,1500,374,1593,89,93,red blood cell,8277,1.0449438202247192,0.956989247311828
34850,/images/4fc9a597-aaa8-43b0-ad1c-2eabbe442e84.png,746,52,850,177,104,125,red blood cell,13000,1.2019230769230769,0.832
58671,/images/a4d7a7e1-5ae1-486d-b6ee-c9af1476ccad.png,635,1113,725,1203,90,90,red blood cell,8100,1.0,1.0
12615,/images/0901f9d1-be4f-4c19-8e83-dd724dded9f5.png,639,296,756,416,117,120,red blood cell,14040,1.0256410256410255,0.975
67213,/images/5f491efd-a21c-4a80-aaba-70b8876238ac.png,688,1298,786,1388,98,90,red blood cell,8820,0.9183673469387755,1.0888888888888888
17432,/images/f329e01b-fbd3-4fb5-9738-a7ff4c8622b8.png,184,278,316,407,132,129,red blood cell,17028,0.9772727272727273,1.0232558139534884
65053,/images/ff3b9d4d-373c-48ef-a75a-d23e2c2ade87.png,563,845,661,939,98,94,red blood cell,9212,0.9591836734693877,1.0425531914893618
37940,/images/56a57a8d-c9b9-432a-a3b0-32a09355806c.png,347,1500,450,1598,103,98,red blood cell,10094,0.9514563106796117,1.0510204081632653
50877,/images/0906111b-bac7-4541-a6dc-da435c0724a8.png,526,70,643,198,117,128,red blood cell,14976,1.0940170940170941,0.9140625
55011,/images/7beee655-6156-43b8-b185-dbae0eaf7f45.png,750,1228,859,1325,109,97,red blood cell,10573,0.8899082568807339,1.1237113402061856
42442,/images/29648565-fe28-4517-ba72-68df0c82c9c5.png,497,1100,611,1215,114,115,red blood cell,13110,1.0087719298245614,0.991304347826087
43518,/images/2d857091-efcd-41c0-ba3f-226de90445c4.png,413,836,548,952,135,116,red blood cell,15660,0.8592592592592593,1.1637931034482758
12462,/images/cc94eabb-a3dc-4cfc-9fff-55c76b5b4a71.png,51,1269,165,1386,114,117,red blood cell,13338,1.0263157894736843,0.9743589743589743
60445,/images/93b47b14-7f78-4b31-8897-d63a81fdab01.png,252,639,358,738,106,99,red blood cell,10494,0.9339622641509434,1.0707070707070707
50113,/images/e98baeb2-aa58-4cce-8c61-66685dd2b239.png,48,1346,162,1463,114,117,red blood cell,13338,1.0263157894736843,0.9743589743589743
20942,/images/c2ec116f-f091-422c-926c-70b548a8f6ef.png,11,1381,98,1458,87,77,red blood cell,6699,0.8850574712643678,1.12987012987013
61821,/images/5f300fd1-7eec-41ac-bbd1-0f4a943c757c.png,376,1134,478,1228,102,94,red blood cell,9588,0.9215686274509803,1.0851063829787233
53581,/images/7c1cd7c7-7452-4428-a98e-dd7675c8ddea.png,184,1070,318,1199,134,129,red blood cell,17286,0.9626865671641791,1.0387596899224807
19178,/images/bb795ddf-ce72-42d5-9006-124db4d5cf1c.png,642,474,749,591,107,117,red blood cell,12519,1.0934579439252337,0.9145299145299145
7683,/images/9f959520-e15e-45c2-bc29-ef3c19154d1c.png,133,441,229,538,96,97,red blood cell,9312,1.0104166666666667,0.9896907216494846
70567,/images/8cca114a-ed05-4b87-95b7-fae02487f08c.png,1004,1456,1113,1559,109,103,red blood cell,11227,0.944954128440367,1.058252427184466
65178,/images/5e042380-6ef2-496f-8231-0ca550fbfa71.png,1099,764,1199,863,100,99,red blood cell,9900,0.99,1.0101010101010102
39179,/images/2aeb7b85-7df9-4a63-8d37-2eecaaa190e7.png,1040,1308,1155,1401,115,93,red blood cell,10695,0.808695652173913,1.2365591397849462
32279,/images/1c406ce1-023b-47fc-a2cd-5ea2e255de65.png,682,1245,804,1356,122,111,red blood cell,13542,0.9098360655737705,1.0990990990990992
53873,/images/540a5fee-175b-4b92-bf62-1ea9b59c86c6.png,941,369,1041,461,100,92,red blood cell,9200,0.92,1.0869565217391304
74529,/images/cbb58718-6319-48db-b84b-78ac9b12ff89.png,993,181,1127,307,134,126,red blood cell,16884,0.9402985074626866,1.0634920634920635
69531,/images/664c570b-4822-413c-9724-11b1d91fac44.png,641,422,730,509,89,87,red blood cell,7743,0.9775280898876404,1.0229885057471264
22613,/images/406e05f0-4444-414c-bb40-f4cb08e75ac9.png,209,723,317,853,108,130,red blood cell,14040,1.2037037037037037,0.8307692307692308
73882,/images/2ae3e6e6-7482-4ab8-ad73-b530b5c2ee3b.png,413,6,529,125,116,119,red blood cell,13804,1.0258620689655173,0.9747899159663865
68467,/images/74261741-4d6e-4dba-8ad4-4fbdf919c30f.png,1008,260,1115,361,107,101,red blood cell,10807,0.9439252336448598,1.0594059405940595
65699,/images/c54fcef1-0c51-4426-9a93-15ec5f2bf58a.png,435,1432,525,1523,90,91,red blood cell,8190,1.011111111111111,0.989010989010989
3301,/images/b901c906-91be-48c4-88ec-2c527544a258.png,117,355,250,466,133,111,red blood cell,14763,0.8345864661654135,1.1981981981981982
22501,/images/bfe65b11-8aff-46aa-908b-1e989d25fdc4.png,48,1471,158,1577,110,106,red blood cell,11660,0.9636363636363636,1.0377358490566038
38959,/images/5939f341-a886-4f63-ae87-2219d000a1d4.png,723,998,842,1113,119,115,red blood cell,13685,0.9663865546218487,1.0347826086956522
20596,/images/0f2a6cda-afec-437b-8803-8d3176b072c1.png,861,906,1002,1047,141,141,red blood cell,19881,1.0,1.0
67099,/images/4272cbd7-5b0a-4bf7-b690-dee1c128f07b.png,748,809,844,903,96,94,red blood cell,9024,0.9791666666666666,1.0212765957446808
43977,/images/d7c7eb2c-2acd-4f86-8a5a-09ab3dd02d16.png,560,1254,669,1358,109,104,red blood cell,11336,0.9541284403669725,1.0480769230769231
35377,/images/452482bc-24a3-413e-ba03-fad4c9d61f3c.png,691,1326,782,1414,91,88,red blood cell,8008,0.967032967032967,1.0340909090909092
67840,/images/04de3a31-fc09-40be-9c2c-9830c57f809d.png,226,1160,337,1286,111,126,red blood cell,13986,1.135135135135135,0.8809523809523809
23591,/images/79d7a014-21ff-40f1-9ac4-a69839390654.png,495,191,593,284,98,93,red blood cell,9114,0.9489795918367347,1.053763440860215
23320,/images/e5731221-814c-4894-a44e-e46b71460fa4.png,912,455,1035,570,123,115,red blood cell,14145,0.9349593495934959,1.0695652173913044
54870,/images/8f84a2c9-ca38-4405-a488-12fcd101278b.png,479,110,589,224,110,114,red blood cell,12540,1.0363636363636364,0.9649122807017544
49969,/images/05804cf0-f854-4099-97c2-df287f7c8a8c.png,265,663,390,776,125,113,red blood cell,14125,0.904,1.1061946902654867
38347,/images/674b0fd3-f247-4b7f-97f7-3e6c57c9ba9e.png,981,1030,1086,1128,105,98,red blood cell,10290,0.9333333333333333,1.0714285714285714
72079,/images/64b0e49a-0e48-447d-8872-c1dd255e7a21.png,843,1305,961,1422,118,117,red blood cell,13806,0.9915254237288136,1.0085470085470085
53250,/images/d8f7e159-b7e3-49e4-86e8-aed8c5fbcd97.png,747,494,841,590,94,96,red blood cell,9024,1.0212765957446808,0.9791666666666666
24998,/images/ed0bee2f-05e0-4392-8357-19750cec577c.png,331,469,427,569,96,100,red blood cell,9600,1.0416666666666667,0.96
48848,/images/fed6ba05-36a5-45dc-a4e1-9baa7de2c622.png,459,503,556,590,97,87,red blood cell,8439,0.8969072164948454,1.1149425287356323
78963,/images/6144887d-a1c1-46db-91a1-f7ff5bf8c8a5.png,171,1037,277,1153,106,116,red blood cell,12296,1.0943396226415094,0.9137931034482759
1404,/images/6d91d1f0-636b-4f5a-a526-7c17fc857190.png,460,1020,546,1127,86,107,red blood cell,9202,1.244186046511628,0.8037383177570093
74942,/images/dd090806-e4ac-4a78-b2ee-55a30626369c.png,843,620,949,713,106,93,red blood cell,9858,0.8773584905660378,1.1397849462365592
11772,/images/082e1f81-4f49-44ad-b5bb-9dfc155b2ed8.png,920,1375,1025,1478,105,103,red blood cell,10815,0.9809523809523809,1.0194174757281553
79634,/images/a4409217-be11-4478-90a5-b406057d154d.png,671,155,795,269,124,114,red blood cell,14136,0.9193548387096774,1.087719298245614
42917,/images/7d4c2160-317f-48d1-a60a-788ec300b3e8.png,244,1120,377,1237,133,117,red blood cell,15561,0.8796992481203008,1.1367521367521367
71011,/images/deaa1931-5f97-45bf-8c00-be6ddeb37b9a.png,1064,1391,1184,1487,120,96,red blood cell,11520,0.8,1.25
15623,/images/84d7545e-c3a8-4b1f-9a39-36aab78c8699.png,22,49,143,170,121,121,red blood cell,14641,1.0,1.0
23038,/images/0d095f3a-9243-472b-90b4-0ce8309e778c.png,773,918,882,1044,109,126,red blood cell,13734,1.1559633027522935,0.8650793650793651
7058,/images/8be185e7-2a1a-441c-a5c7-b50a9eb926cb.png,77,591,201,704,124,113,red blood cell,14012,0.9112903225806451,1.0973451327433628
69328,/images/3f8c5ae1-b9fd-464b-8e91-98143ddd8d29.png,259,701,374,797,115,96,red blood cell,11040,0.8347826086956521,1.1979166666666667
1578,/images/0ac747cd-ff32-49bf-bc1a-3e9b7702ce9c.png,455,322,553,428,98,106,red blood cell,10388,1.0816326530612246,0.9245283018867925
66028,/images/25c6cfb1-01d0-4864-87f9-02b7593683c7.png,858,843,948,918,90,75,red blood cell,6750,0.8333333333333334,1.2
23226,/images/3dcd4f1b-ce43-4a34-b1ed-076bb42963b1.png,266,1152,367,1270,101,118,red blood cell,11918,1.1683168316831682,0.8559322033898306
24449,/images/b78ba2c8-ecb3-45b2-9cda-2c8088fa95d1.png,657,898,790,1032,133,134,red blood cell,17822,1.0075187969924813,0.9925373134328358
37653,/images/205306da-0ed8-475a-ace6-f2f81d4be88a.png,288,1111,373,1200,85,89,red blood cell,7565,1.0470588235294118,0.9550561797752809
23475,/images/6fb707b1-5c07-479f-8385-5404bf5747b0.png,1077,581,1192,702,115,121,red blood cell,13915,1.0521739130434782,0.9504132231404959
2305,/images/fe851c88-692d-4199-87e0-d19d9c4eb591.png,897,258,1001,362,104,104,red blood cell,10816,1.0,1.0
39947,/images/8271d0d8-9985-43eb-94b3-c702adca139f.png,460,928,564,1031,104,103,red blood cell,10712,0.9903846153846154,1.0097087378640777
20191,/images/bb337c84-f727-42a5-9c3d-934323a16c6a.png,941,151,1067,281,126,130,red blood cell,16380,1.0317460317460319,0.9692307692307692
69209,/images/f274b784-b995-4a7e-a2c2-6cc31c24c4b4.png,522,1310,641,1438,119,128,red blood cell,15232,1.0756302521008403,0.9296875
2102,/images/e94a811d-3145-4313-ba42-2d5ed283179f.png,664,72,780,171,116,99,red blood cell,11484,0.853448275862069,1.1717171717171717
77567,/images/2d2e81f3-e329-4765-9ba1-2c95f12dc9f3.png,589,1024,669,1109,80,85,red blood cell,6800,1.0625,0.9411764705882353
32184,/images/25cfca07-2101-484f-b312-a927395f2651.png,377,341,482,458,105,117,red blood cell,12285,1.1142857142857143,0.8974358974358975
17886,/images/eb77e4a9-acb0-4d83-8055-2c5fcaa54b45.png,1039,738,1148,836,109,98,red blood cell,10682,0.8990825688073395,1.1122448979591837
53349,/images/f23ae29e-1bda-4784-b10c-d736757d39b8.png,682,921,794,1057,112,136,red blood cell,15232,1.2142857142857142,0.8235294117647058
65648,/images/397f37bc-a3a4-4257-9430-c8fc5716f8b1.png,271,138,365,239,94,101,red blood cell,9494,1.074468085106383,0.9306930693069307
72663,/images/6ab870ba-b24b-49a9-9570-8eafe63aa74e.png,920,448,1012,546,92,98,red blood cell,9016,1.065217391304348,0.9387755102040817
53575,/images/7c1cd7c7-7452-4428-a98e-dd7675c8ddea.png,790,435,896,536,106,101,red blood cell,10706,0.9528301886792453,1.0495049504950495
23159,/images/c94a5851-b846-4fde-8c89-05bec3a8ac53.png,565,681,688,805,123,124,red blood cell,15252,1.008130081300813,0.9919354838709677
32267,/images/f4722a74-35e7-42bd-8ef6-dfff04b9cd22.png,1018,436,1142,563,124,127,red blood cell,15748,1.0241935483870968,0.9763779527559056
1202,/images/5ff7c0c8-d208-4e7d-958d-ca3c2260ff39.png,810,1042,911,1147,101,105,red blood cell,10605,1.0396039603960396,0.9619047619047619
73874,/images/2ae3e6e6-7482-4ab8-ad73-b530b5c2ee3b.png,588,806,707,926,119,120,red blood cell,14280,1.0084033613445378,0.9916666666666667
52860,/images/58f7e1da-3478-48f4-958c-e9b1cb8696aa.png,7,599,109,710,102,111,red blood cell,11322,1.088235294117647,0.918918918918919
44698,/images/867f30da-2568-4480-9968-cece78c61c64.png,772,1152,878,1254,106,102,red blood cell,10812,0.9622641509433962,1.0392156862745099
21268,/images/fc8df086-39e0-43f8-b0c7-2d23a349539b.png,625,620,739,754,114,134,red blood cell,15276,1.1754385964912282,0.8507462686567164
55037,/images/1f8f08ea-b5b3-4f68-94d4-3cc071b7dce8.png,488,593,586,700,98,107,red blood cell,10486,1.0918367346938775,0.9158878504672897
12864,/images/b10ea12f-cd36-4f2c-994a-67d1665269ab.png,316,932,414,1026,98,94,red blood cell,9212,0.9591836734693877,1.0425531914893618
55446,/images/d67655e6-0a80-4a86-b552-1f5e85788377.png,205,1344,292,1425,87,81,red blood cell,7047,0.9310344827586207,1.0740740740740742
34170,/images/f1cda808-69a9-4d10-ba0a-6607c98e362d.png,761,1338,898,1471,137,133,red blood cell,18221,0.9708029197080292,1.0300751879699248
61074,/images/6e86206f-dafe-4c28-bacc-7b83b2d40f0c.png,139,1407,262,1527,123,120,red blood cell,14760,0.975609756097561,1.025
73343,/images/c890ee00-daa5-4b20-9cd5-930748ecc4e0.png,897,1012,999,1118,102,106,red blood cell,10812,1.0392156862745099,0.9622641509433962
8848,/images/91827f1a-9b04-4ef0-972c-12e90e60c516.png,613,884,733,995,120,111,red blood cell,13320,0.925,1.0810810810810811
28947,/images/b12ae3b1-613c-4c0e-9163-3c5cc314abf5.png,137,1240,267,1369,130,129,red blood cell,16770,0.9923076923076923,1.0077519379844961
33456,/images/9bd40bc6-4949-42d3-b38f-d60422932f65.png,250,98,362,217,112,119,red blood cell,13328,1.0625,0.9411764705882353
72240,/images/7d4d0646-26b5-46fa-ab25-452d986e887b.png,1004,1388,1106,1477,102,89,red blood cell,9078,0.8725490196078431,1.146067415730337
71577,/images/b9c6db13-ca3a-4937-8ecf-e537047ed858.png,332,1150,434,1262,102,112,red blood cell,11424,1.0980392156862746,0.9107142857142857
26604,/images/5893e081-04f2-4e33-9851-bed5f0e4d333.png,446,618,556,741,110,123,red blood cell,13530,1.1181818181818182,0.8943089430894309
18423,/images/39cc33be-d752-40fe-b7a8-2e69a3517205.png,914,82,1007,198,93,116,red blood cell,10788,1.2473118279569892,0.8017241379310345
69518,/images/664c570b-4822-413c-9724-11b1d91fac44.png,323,514,417,617,94,103,red blood cell,9682,1.0957446808510638,0.912621359223301
23771,/images/6b2ff7ca-c5b3-415c-9481-7b14efc6d7ef.png,788,266,909,397,121,131,red blood cell,15851,1.0826446280991735,0.9236641221374046
33490,/images/795d0331-da56-4d45-a58a-54803408ffd9.png,994,845,1130,973,136,128,red blood cell,17408,0.9411764705882353,1.0625
4464,/images/cf90d82f-2814-4fb7-a3ff-a86b7c5efca7.png,536,483,662,615,126,132,red blood cell,16632,1.0476190476190477,0.9545454545454546
13472,/images/370277f8-436b-4103-8210-b4feb5ab95ea.png,679,65,773,167,94,102,red blood cell,9588,1.0851063829787233,0.9215686274509803
49573,/images/bd7937db-fca2-44d0-8538-460110210927.png,7,1098,116,1201,109,103,red blood cell,11227,0.944954128440367,1.058252427184466
58475,/images/5cac6ddf-c8c6-45de-bce0-a1db64b14fb5.png,321,108,433,216,112,108,red blood cell,12096,0.9642857142857143,1.037037037037037
49462,/images/f2574be3-81c6-4fc3-8a40-0230d1264f52.png,530,447,622,543,92,96,red blood cell,8832,1.0434782608695652,0.9583333333333334
18066,/images/0f0c949e-018a-4f3f-ab02-3704f49c7754.png,955,358,1064,452,109,94,red blood cell,10246,0.8623853211009175,1.1595744680851063
43398,/images/aabca37c-f9ef-4415-aab6-3246caa348e9.png,177,394,286,505,109,111,red blood cell,12099,1.018348623853211,0.9819819819819819
53528,/images/43158031-a335-4533-9c20-48bebba90123.png,864,1383,950,1485,86,102,red blood cell,8772,1.186046511627907,0.8431372549019608
63545,/images/44b4a765-104e-4182-8871-e933c83c91ef.png,12,981,110,1082,98,101,red blood cell,9898,1.030612244897959,0.9702970297029703
72799,/images/caeb2d62-1166-43f0-8eac-5b8fc48f02eb.png,412,1420,506,1521,94,101,red blood cell,9494,1.074468085106383,0.9306930693069307
49407,/images/f2574be3-81c6-4fc3-8a40-0230d1264f52.png,221,558,334,679,113,121,red blood cell,13673,1.0707964601769913,0.9338842975206612
2962,/images/00a02700-2ea2-4590-9e15-ffc9160fd3de.png,151,974,258,1086,107,112,red blood cell,11984,1.0467289719626167,0.9553571428571429
43021,/images/6c7095cd-ab6b-4f53-bd94-905d0cc95840.png,416,4,510,108,94,104,red blood cell,9776,1.1063829787234043,0.9038461538461539
36680,/images/21f001d6-f568-4ea4-82da-fab54c77c419.png,604,1289,709,1383,105,94,red blood cell,9870,0.8952380952380953,1.1170212765957446
37245,/images/2fdbd9bc-bbaf-44c2-b40c-d193709639fa.png,320,637,437,762,117,125,red blood cell,14625,1.0683760683760684,0.936
30441,/images/dedbb10c-43f1-45fb-bb40-3ce2fb874015.png,803,565,914,695,111,130,red blood cell,14430,1.1711711711711712,0.8538461538461538
57577,/images/8190ec37-9a5e-419f-89ed-fbfb079370db.png,446,822,547,934,101,112,red blood cell,11312,1.108910891089109,0.9017857142857143
54852,/images/b6364a57-72a9-43f3-8d02-9f53a992dc95.png,990,356,1075,436,85,80,red blood cell,6800,0.9411764705882353,1.0625
35517,/images/3e33ee12-ef02-4287-8318-7ad3b284a617.png,1072,208,1175,313,103,105,red blood cell,10815,1.0194174757281553,0.9809523809523809
68885,/images/6347dd6a-cfdf-4cb5-bc50-cff5403cfecb.png,373,1432,495,1547,122,115,red blood cell,14030,0.9426229508196722,1.0608695652173914
38213,/images/1d9d4dac-66f9-4c87-b714-d723d5b15fa9.png,756,718,854,821,98,103,red blood cell,10094,1.0510204081632653,0.9514563106796117
34725,/images/6294153c-6db3-4f2b-a8ff-9c087225e737.png,298,392,407,496,109,104,red blood cell,11336,0.9541284403669725,1.0480769230769231
79900,/images/0b923ab7-ebff-4079-a4bb-af7da89f374e.png,211,936,345,1045,134,109,red blood cell,14606,0.8134328358208955,1.2293577981651376
58622,/images/a4d7a7e1-5ae1-486d-b6ee-c9af1476ccad.png,966,1213,1076,1325,110,112,red blood cell,12320,1.018181818181818,0.9821428571428571
36928,/images/b2e34f5f-904e-4473-9dc7-c6bc1ce12640.png,411,791,507,882,96,91,red blood cell,8736,0.9479166666666666,1.054945054945055
78579,/images/c5084fb8-2b62-464c-8a77-1a07ea653266.png,58,122,183,255,125,133,red blood cell,16625,1.064,0.9398496240601504
51713,/images/592c941a-aa54-4971-b499-dc47356f80a3.png,27,98,108,181,81,83,red blood cell,6723,1.0246913580246915,0.9759036144578314
12331,/images/3b55c42f-ad59-422f-ba99-4f4f4ca9cb2e.png,369,964,473,1074,104,110,red blood cell,11440,1.0576923076923077,0.9454545454545454
15720,/images/3892b776-f49a-4368-b0fa-7e855e76ccec.png,669,106,781,224,112,118,red blood cell,13216,1.0535714285714286,0.9491525423728814
9833,/images/3859deaf-6ae1-49a3-9051-898d0f0d7de6.png,370,1033,466,1117,96,84,red blood cell,8064,0.875,1.1428571428571428
24737,/images/78a5d1c3-44dd-44bc-ad5b-5e25bdcc4fae.png,1040,877,1151,1007,111,130,red blood cell,14430,1.1711711711711712,0.8538461538461538
36001,/images/5836500a-221e-40ca-a8be-caaa37f7d300.png,111,78,209,171,98,93,red blood cell,9114,0.9489795918367347,1.053763440860215
58859,/images/434523fd-d4d9-4961-a7c2-d71d6ae68e13.png,239,980,326,1069,87,89,red blood cell,7743,1.0229885057471264,0.9775280898876404
12480,/images/cc94eabb-a3dc-4cfc-9fff-55c76b5b4a71.png,244,366,340,468,96,102,red blood cell,9792,1.0625,0.9411764705882353
14191,/images/c186dcd1-af61-455f-9619-1fdd8c881b06.png,972,1009,1096,1115,124,106,red blood cell,13144,0.8548387096774194,1.169811320754717
23297,/images/e5731221-814c-4894-a44e-e46b71460fa4.png,946,1209,1062,1310,116,101,red blood cell,11716,0.8706896551724138,1.1485148514851484
51633,/images/d0347b49-8f98-4632-a384-1a4f57ac6374.png,496,1396,591,1506,95,110,red blood cell,10450,1.1578947368421053,0.8636363636363636
8693,/images/92e4fd7b-79ef-49c2-a52b-9ef13dd720ef.png,110,140,234,276,124,136,red blood cell,16864,1.096774193548387,0.9117647058823529
68929,/images/bbaa004f-05dc-4cb8-8768-e148085bb0f9.png,909,18,1011,128,102,110,red blood cell,11220,1.0784313725490196,0.9272727272727272
37277,/images/2fdbd9bc-bbaf-44c2-b40c-d193709639fa.png,839,398,937,518,98,120,red blood cell,11760,1.2244897959183674,0.8166666666666667
40196,/images/ef1a9020-5e45-450d-a237-165114308592.png,798,1162,930,1288,132,126,red blood cell,16632,0.9545454545454546,1.0476190476190477
53557,/images/7c1cd7c7-7452-4428-a98e-dd7675c8ddea.png,701,647,810,753,109,106,red blood cell,11554,0.9724770642201835,1.028301886792453
43052,/images/340a1727-0df7-4e6f-9c0e-9c5deddbfca2.png,342,1376,456,1489,114,113,red blood cell,12882,0.9912280701754386,1.008849557522124
69076,/images/de2b8835-552c-4f01-98b7-67bc4910062e.png,454,1151,553,1256,99,105,red blood cell,10395,1.0606060606060606,0.9428571428571428
76540,/images/38c69905-8a4f-451a-8d0a-b855dc88dd16.png,248,678,339,769,91,91,red blood cell,8281,1.0,1.0
58943,/images/7aae78ce-ac97-478d-983c-c0ec290171df.png,724,823,853,930,129,107,red blood cell,13803,0.8294573643410853,1.205607476635514
44210,/images/8b494b40-cab5-49d3-893d-c805000fbe88.png,779,78,880,176,101,98,red blood cell,9898,0.9702970297029703,1.030612244897959
38256,/images/b834cbf7-ff97-49d9-9561-566c9343735c.png,405,547,527,659,122,112,red blood cell,13664,0.9180327868852459,1.0892857142857142
27701,/images/18dbe7c4-89d2-42a6-a969-1e951ab313b1.png,500,379,600,497,100,118,red blood cell,11800,1.18,0.847457627118644
35261,/images/a9159b11-ba49-4885-902e-00c8d5095b98.png,670,1119,753,1219,83,100,red blood cell,8300,1.2048192771084338,0.83
48481,/images/9c4cb048-d64a-4b7f-84ff-ca28a8084fc7.png,643,1122,752,1256,109,134,red blood cell,14606,1.2293577981651376,0.8134328358208955
4051,/images/a5e05ba8-0c19-41e3-92d5-10e42a03b85e.png,14,1140,124,1255,110,115,red blood cell,12650,1.0454545454545454,0.9565217391304348
2442,/images/fe851c88-692d-4199-87e0-d19d9c4eb591.png,20,1253,121,1365,101,112,red blood cell,11312,1.108910891089109,0.9017857142857143
24960,/images/ed0bee2f-05e0-4392-8357-19750cec577c.png,300,1047,393,1138,93,91,red blood cell,8463,0.978494623655914,1.021978021978022
3822,/images/3e764461-22ee-44d3-925d-cd658ff7d154.png,149,1395,261,1532,112,137,red blood cell,15344,1.2232142857142858,0.8175182481751825
11078,/images/98175327-da9e-4e0c-8912-ee68490a4672.png,1025,16,1132,119,107,103,red blood cell,11021,0.9626168224299065,1.0388349514563107
71480,/images/191071ab-6515-428c-9f05-8e4309542b75.png,409,246,517,355,108,109,red blood cell,11772,1.0092592592592593,0.9908256880733946
45612,/images/582e4b8b-404e-4b30-9df3-66f2afb3cdb3.png,274,700,378,814,104,114,red blood cell,11856,1.0961538461538463,0.9122807017543859
41735,/images/32a1ea24-b6b7-4253-ad3e-bdf99c2c9b9d.png,816,736,920,845,104,109,red blood cell,11336,1.0480769230769231,0.9541284403669725
2636,/images/a2ccbf70-e444-49a9-8b7e-9797a05220d8.png,496,1013,631,1136,135,123,red blood cell,16605,0.9111111111111111,1.0975609756097562
42106,/images/46a03374-64c7-49ac-81c9-c3d62542bbf3.png,558,684,658,805,100,121,red blood cell,12100,1.21,0.8264462809917356
32496,/images/d31dd2c0-ae8e-4499-86bb-7cabb6e438b9.png,941,261,1072,382,131,121,red blood cell,15851,0.9236641221374046,1.0826446280991735
65108,/images/5e042380-6ef2-496f-8231-0ca550fbfa71.png,82,356,152,441,70,85,red blood cell,5950,1.2142857142857142,0.8235294117647058
32454,/images/3911fcd2-4e26-4ad9-aaf0-d1c5bf41defc.png,880,354,981,461,101,107,red blood cell,10807,1.0594059405940595,0.9439252336448598
67262,/images/5f491efd-a21c-4a80-aaba-70b8876238ac.png,386,1144,479,1232,93,88,red blood cell,8184,0.946236559139785,1.0568181818181819
5303,/images/06df7bbe-60d4-4f7c-ba4a-5a42ac4be91b.png,468,607,578,731,110,124,red blood cell,13640,1.1272727272727272,0.8870967741935484
53398,/images/766d5547-8dd2-4c8d-b78e-3007f83932e8.png,117,1074,229,1187,112,113,red blood cell,12656,1.0089285714285714,0.9911504424778761
65066,/images/ff3b9d4d-373c-48ef-a75a-d23e2c2ade87.png,1099,26,1200,120,101,94,red blood cell,9494,0.9306930693069307,1.074468085106383
38442,/images/674b0fd3-f247-4b7f-97f7-3e6c57c9ba9e.png,322,1068,421,1166,99,98,red blood cell,9702,0.98989898989899,1.010204081632653
21617,/images/66183740-e1e5-43c9-8539-a87028bb3621.png,829,212,953,357,124,145,red blood cell,17980,1.1693548387096775,0.8551724137931035
46699,/images/da111ca5-520f-4ea8-97ad-ae5fce58ee91.png,736,1212,821,1310,85,98,red blood cell,8330,1.1529411764705881,0.8673469387755102
20266,/images/c66cb6b2-1480-446a-a9d2-b8032a3de0d7.png,415,755,553,877,138,122,red blood cell,16836,0.8840579710144928,1.1311475409836065
45861,/images/939ad732-d7c5-4339-b087-4335b49d6a3c.png,987,996,1111,1111,124,115,red blood cell,14260,0.9274193548387096,1.0782608695652174
12389,/images/3b55c42f-ad59-422f-ba99-4f4f4ca9cb2e.png,860,2,964,101,104,99,red blood cell,10296,0.9519230769230769,1.0505050505050506
58180,/images/2f68686f-1fe8-46e7-ad92-a08e3523ea79.png,412,23,508,128,96,105,red blood cell,10080,1.09375,0.9142857142857143
1412,/images/6d91d1f0-636b-4f5a-a526-7c17fc857190.png,142,800,247,891,105,91,red blood cell,9555,0.8666666666666667,1.1538461538461537
61681,/images/a3c0a876-be12-4ede-8aed-18b32a64401b.png,792,299,886,386,94,87,red blood cell,8178,0.925531914893617,1.0804597701149425
50661,/images/c956e531-6805-4fe1-b61c-8b96a9815a77.png,940,1482,1029,1575,89,93,red blood cell,8277,1.0449438202247192,0.956989247311828
16990,/images/8eeb378e-90f0-47ea-ac1c-2a201eb8d090.png,533,1099,636,1201,103,102,red blood cell,10506,0.9902912621359223,1.0098039215686274
45787,/images/584d62ed-4329-45dd-94ce-e929d8b2bb74.png,892,1044,983,1127,91,83,red blood cell,7553,0.9120879120879121,1.0963855421686748
53023,/images/42e87148-a015-4148-923a-fb83016f64e7.png,551,150,672,261,121,111,red blood cell,13431,0.9173553719008265,1.09009009009009
46794,/images/63055d1b-5221-4c80-8b39-37ac069a1b5c.png,814,104,919,208,105,104,red blood cell,10920,0.9904761904761905,1.0096153846153846
5187,/images/16a51468-9f93-45df-9ae2-5a74c25c5a4b.png,773,580,878,688,105,108,red blood cell,11340,1.0285714285714285,0.9722222222222222
59401,/images/a7c3c52f-3b40-4c92-a212-df9462cf25d8.png,509,1179,630,1286,121,107,red blood cell,12947,0.8842975206611571,1.1308411214953271
51572,/images/d0347b49-8f98-4632-a384-1a4f57ac6374.png,684,402,768,494,84,92,red blood cell,7728,1.0952380952380953,0.9130434782608695
35502,/images/3722d213-f2a9-46d5-aa76-9183b443e455.png,457,1456,576,1562,119,106,red blood cell,12614,0.8907563025210085,1.1226415094339623
26482,/images/cdb086a8-2bf8-4436-b1ef-96cdd801f247.png,659,101,770,211,111,110,red blood cell,12210,0.990990990990991,1.009090909090909
2651,/images/a2ccbf70-e444-49a9-8b7e-9797a05220d8.png,898,1179,1018,1287,120,108,red blood cell,12960,0.9,1.1111111111111112
31000,/images/b59dc3a0-3d54-4e3b-a485-33b3e43966de.png,995,109,1113,205,118,96,red blood cell,11328,0.8135593220338984,1.2291666666666667
39208,/images/2aeb7b85-7df9-4a63-8d37-2eecaaa190e7.png,13,533,113,640,100,107,red blood cell,10700,1.07,0.9345794392523364
21284,/images/fc8df086-39e0-43f8-b0c7-2d23a349539b.png,1066,558,1175,675,109,117,red blood cell,12753,1.073394495412844,0.9316239316239316
52082,/images/de6d3020-9347-473b-9146-8909627790f6.png,97,966,189,1065,92,99,red blood cell,9108,1.076086956521739,0.9292929292929293
51481,/images/baa87bf8-786c-444c-81e8-9fa0a41d8149.png,441,1182,545,1287,104,105,red blood cell,10920,1.0096153846153846,0.9904761904761905
64573,/images/6ba5d0b8-cdc7-4266-9d78-db76faa312e9.png,397,159,487,247,90,88,red blood cell,7920,0.9777777777777777,1.0227272727272727
13091,/images/9691c57a-ccf8-47f9-a8e9-9a324974585b.png,132,883,251,1013,119,130,red blood cell,15470,1.0924369747899159,0.9153846153846154
10077,/images/26799d2b-a289-4eff-9218-0aad77e05e41.png,335,1014,445,1138,110,124,red blood cell,13640,1.1272727272727272,0.8870967741935484
5853,/images/a30da226-b452-408a-a556-bfae4d521464.png,1064,947,1169,1048,105,101,red blood cell,10605,0.9619047619047619,1.0396039603960396
34046,/images/1012abf2-cb05-4337-86c5-513ec4ca904d.png,8,345,115,432,107,87,red blood cell,9309,0.8130841121495327,1.2298850574712643
48637,/images/55836297-fc8e-4e00-9767-0d12b86e4604.png,839,170,945,279,106,109,red blood cell,11554,1.028301886792453,0.9724770642201835
66626,/images/b88fe674-fb9a-41d4-b100-cb1c86440d44.png,999,1316,1107,1427,108,111,red blood cell,11988,1.0277777777777777,0.972972972972973
60911,/images/11b72c7b-5c52-44b7-adb7-21eacc25e441.png,859,1459,940,1544,81,85,red blood cell,6885,1.0493827160493827,0.9529411764705882
15480,/images/79f63258-24ce-4e69-a5cb-8529635a89a9.png,919,649,1027,760,108,111,red blood cell,11988,1.0277777777777777,0.972972972972973
21479,/images/7625dfc4-858a-4c8e-907c-8943d665e9a7.png,228,1309,329,1407,101,98,red blood cell,9898,0.9702970297029703,1.030612244897959
26652,/images/16ec6e1f-5020-40b3-ba26-51c340d03ee7.png,1045,1039,1182,1152,137,113,red blood cell,15481,0.8248175182481752,1.2123893805309736
38686,/images/b5acf759-1115-42f0-a753-656736192528.png,1035,469,1146,599,111,130,red blood cell,14430,1.1711711711711712,0.8538461538461538
79237,/images/eb0173a3-7e5e-4f53-8124-03d9d6317844.png,814,1,915,103,101,102,red blood cell,10302,1.00990099009901,0.9901960784313726
7797,/images/e726dac6-f962-449c-acff-4dd56847b685.png,992,943,1085,1027,93,84,red blood cell,7812,0.9032258064516129,1.1071428571428572
53318,/images/d8f7e159-b7e3-49e4-86e8-aed8c5fbcd97.png,949,914,1070,1020,121,106,red blood cell,12826,0.8760330578512396,1.1415094339622642
3115,/images/14efbfc8-39f6-4599-9994-a8cc95605b9c.png,463,705,578,822,115,117,red blood cell,13455,1.017391304347826,0.9829059829059829
51763,/images/f07174a5-f799-4286-ac43-5b0f5c5777ac.png,561,766,693,876,132,110,red blood cell,14520,0.8333333333333334,1.2
64085,/images/0d3c2521-da55-4df5-bf06-56b3bd4fb2fc.png,311,1217,421,1332,110,115,red blood cell,12650,1.0454545454545454,0.9565217391304348
2166,/images/e94a811d-3145-4313-ba42-2d5ed283179f.png,257,827,353,927,96,100,red blood cell,9600,1.0416666666666667,0.96
32315,/images/1c406ce1-023b-47fc-a2cd-5ea2e255de65.png,313,1385,424,1498,111,113,red blood cell,12543,1.018018018018018,0.9823008849557522
22138,/images/ca677c3c-083f-4d54-9dec-39f79f6a17d8.png,565,990,680,1104,115,114,red blood cell,13110,0.991304347826087,1.0087719298245614
29263,/images/6274fe0d-0d71-40be-b61b-f0bd5b5df1e2.png,704,1003,798,1100,94,97,red blood cell,9118,1.0319148936170213,0.9690721649484536
38514,/images/aa4a023b-55bd-4259-b15d-7086a9b491e0.png,1079,1485,1199,1597,120,112,red blood cell,13440,0.9333333333333333,1.0714285714285714
35708,/images/4063945d-03fc-4ce3-a04c-17435dce8f91.png,697,943,809,1061,112,118,red blood cell,13216,1.0535714285714286,0.9491525423728814
19249,/images/b4d22412-a495-43a9-bec0-73a2322f8dad.png,646,592,740,695,94,103,red blood cell,9682,1.0957446808510638,0.912621359223301
78645,/images/fd1c4c7a-24bc-43f2-b84f-fee182207aee.png,833,916,931,1029,98,113,red blood cell,11074,1.153061224489796,0.8672566371681416
64618,/images/6dfafdf1-f588-4e80-8cf8-0126e1bf7af9.png,693,496,815,613,122,117,red blood cell,14274,0.9590163934426229,1.0427350427350428
19160,/images/bb795ddf-ce72-42d5-9006-124db4d5cf1c.png,791,1411,896,1513,105,102,red blood cell,10710,0.9714285714285714,1.0294117647058822
76738,/images/3317d733-ec0d-45e6-b631-40457392f343.png,0,37,91,144,91,107,red blood cell,9737,1.1758241758241759,0.8504672897196262
58451,/images/5cac6ddf-c8c6-45de-bce0-a1db64b14fb5.png,460,190,583,303,123,113,red blood cell,13899,0.9186991869918699,1.0884955752212389
70183,/images/b338766f-19b9-4874-bcc5-ae22b3c533e6.png,173,1174,269,1257,96,83,red blood cell,7968,0.8645833333333334,1.1566265060240963
60866,/images/11b72c7b-5c52-44b7-adb7-21eacc25e441.png,481,891,572,993,91,102,red blood cell,9282,1.120879120879121,0.8921568627450981
48709,/images/bc832bde-d3ea-4a8e-be90-7a3329dcc314.png,513,1104,625,1211,112,107,red blood cell,11984,0.9553571428571429,1.0467289719626167
61999,/images/bdb5d571-27bc-4a42-ae45-aa5a9af40a81.png,342,1448,444,1545,102,97,red blood cell,9894,0.9509803921568627,1.0515463917525774
31818,/images/63ed5931-d93e-4f9b-a6f3-152713cb560e.png,154,1364,279,1464,125,100,red blood cell,12500,0.8,1.25
51297,/images/216f9d43-6869-4ba1-9106-4f5ea6aac223.png,21,1045,108,1138,87,93,red blood cell,8091,1.0689655172413792,0.9354838709677419
51744,/images/592c941a-aa54-4971-b499-dc47356f80a3.png,1,5,85,85,84,80,red blood cell,6720,0.9523809523809523,1.05
48984,/images/df3d98b9-3dd7-4107-8d4a-ae1b7f247793.png,270,209,405,317,135,108,red blood cell,14580,0.8,1.25
32438,/images/3911fcd2-4e26-4ad9-aaf0-d1c5bf41defc.png,515,881,624,992,109,111,red blood cell,12099,1.018348623853211,0.9819819819819819
42858,/images/a7b6894d-eeea-4ed5-bc0e-785d6c6da8df.png,492,1430,614,1541,122,111,red blood cell,13542,0.9098360655737705,1.0990990990990992
66713,/images/334bf865-e3fb-4200-bd53-d9ff5808ed9f.png,451,821,555,917,104,96,red blood cell,9984,0.9230769230769231,1.0833333333333333
67376,/images/266180ed-77a3-4284-8292-50a49fc47fce.png,203,1379,308,1493,105,114,red blood cell,11970,1.0857142857142856,0.9210526315789473
5144,/images/a777e78c-ad1f-4380-9ab2-b4f9f32b2d78.png,665,286,787,413,122,127,red blood cell,15494,1.040983606557377,0.9606299212598425
42892,/images/a7b6894d-eeea-4ed5-bc0e-785d6c6da8df.png,579,667,693,803,114,136,red blood cell,15504,1.1929824561403508,0.8382352941176471
74505,/images/cbb58718-6319-48db-b84b-78ac9b12ff89.png,871,879,964,989,93,110,red blood cell,10230,1.1827956989247312,0.8454545454545455
77424,/images/c7ec51d5-9f45-4209-8357-39e9a984a733.png,560,783,665,896,105,113,red blood cell,11865,1.0761904761904761,0.9292035398230089
12619,/images/0901f9d1-be4f-4c19-8e83-dd724dded9f5.png,961,31,1081,160,120,129,red blood cell,15480,1.075,0.9302325581395349
55094,/images/3768c577-4e5e-4d70-8c4d-93d8aacd5baa.png,298,1012,418,1121,120,109,red blood cell,13080,0.9083333333333333,1.1009174311926606
46851,/images/63055d1b-5221-4c80-8b39-37ac069a1b5c.png,240,66,345,169,105,103,red blood cell,10815,0.9809523809523809,1.0194174757281553
75265,/images/2afe2750-c963-46f9-a1ad-9260e80679ca.png,435,1334,542,1449,107,115,red blood cell,12305,1.074766355140187,0.9304347826086956
72658,/images/6ab870ba-b24b-49a9-9570-8eafe63aa74e.png,766,1401,878,1522,112,121,red blood cell,13552,1.0803571428571428,0.9256198347107438
66354,/images/fcdf6632-c03f-49a8-9fb3-42e87c99b9d0.png,523,1401,624,1524,101,123,red blood cell,12423,1.2178217821782178,0.8211382113821138
2919,/images/a1c140f9-75d7-42a3-b767-4c01a118892b.png,733,243,865,374,132,131,red blood cell,17292,0.9924242424242424,1.0076335877862594
42267,/images/ca734448-0d52-42fa-b41c-17b2939e58ae.png,281,418,383,525,102,107,red blood cell,10914,1.0490196078431373,0.9532710280373832
30118,/images/81c3c8f0-d5a9-4dda-afd5-e86f6afd9424.png,675,468,782,578,107,110,red blood cell,11770,1.02803738317757,0.9727272727272728
44486,/images/b6573be3-9e04-49c3-9f48-6a145d065363.png,508,1201,613,1304,105,103,red blood cell,10815,0.9809523809523809,1.0194174757281553
39421,/images/55f8c052-8e49-4423-a4c4-365fc6afb6e1.png,756,1270,869,1393,113,123,red blood cell,13899,1.0884955752212389,0.9186991869918699
22673,/images/4ab47131-c2ac-461f-b95c-ac19ce24edbd.png,894,329,995,440,101,111,red blood cell,11211,1.099009900990099,0.9099099099099099
51301,/images/216f9d43-6869-4ba1-9106-4f5ea6aac223.png,112,1032,200,1121,88,89,red blood cell,7832,1.0113636363636365,0.9887640449438202
26265,/images/52767904-4cdc-4821-ba68-8cd0c28f9023.png,760,1017,885,1141,125,124,red blood cell,15500,0.992,1.0080645161290323
49461,/images/f2574be3-81c6-4fc3-8a40-0230d1264f52.png,507,541,597,646,90,105,red blood cell,9450,1.1666666666666667,0.8571428571428571
56471,/images/d75933ed-d26e-4d1f-bda3-96bc0d77fb36.png,153,1074,262,1177,109,103,red blood cell,11227,0.944954128440367,1.058252427184466
23197,/images/3dcd4f1b-ce43-4a34-b1ed-076bb42963b1.png,345,1120,447,1223,102,103,red blood cell,10506,1.0098039215686274,0.9902912621359223
58418,/images/7eae1169-e294-4594-8e03-1366d23ff2d1.png,941,860,1045,944,104,84,red blood cell,8736,0.8076923076923077,1.2380952380952381
50383,/images/3d32a988-449d-4d58-b71f-abbfdc3f2fbc.png,0,220,84,309,84,89,red blood cell,7476,1.0595238095238095,0.9438202247191011
23919,/images/3d8fb5bf-3315-48fb-8ab1-802eafd550bc.png,956,1346,1080,1462,124,116,red blood cell,14384,0.9354838709677419,1.0689655172413792
8939,/images/04628a94-b674-469b-aff6-b476b70df87d.png,980,641,1100,750,120,109,red blood cell,13080,0.9083333333333333,1.1009174311926606
29777,/images/7ef90770-6aeb-45eb-9744-49c5247dde30.png,935,435,1041,546,106,111,red blood cell,11766,1.0471698113207548,0.954954954954955
11401,/images/b5513d5b-46fc-4f44-a616-791087fbd608.png,443,1184,535,1296,92,112,red blood cell,10304,1.2173913043478262,0.8214285714285714
51460,/images/baa87bf8-786c-444c-81e8-9fa0a41d8149.png,273,1463,395,1576,122,113,red blood cell,13786,0.9262295081967213,1.079646017699115
45667,/images/584d62ed-4329-45dd-94ce-e929d8b2bb74.png,1055,371,1162,463,107,92,red blood cell,9844,0.8598130841121495,1.1630434782608696
32893,/images/e40000b4-1b26-42ce-909d-4715e04f0a6e.png,20,115,135,238,115,123,red blood cell,14145,1.0695652173913044,0.9349593495934959
76670,/images/3317d733-ec0d-45e6-b631-40457392f343.png,680,21,786,121,106,100,red blood cell,10600,0.9433962264150944,1.06
35399,/images/002f20ad-2ace-499c-9335-c9080bc3e6b5.png,753,15,867,146,114,131,red blood cell,14934,1.1491228070175439,0.8702290076335878
47075,/images/997eabd9-55bf-4683-83c4-4cee4673a4ef.png,714,834,819,922,105,88,red blood cell,9240,0.8380952380952381,1.1931818181818181
55459,/images/d67655e6-0a80-4a86-b552-1f5e85788377.png,518,157,614,245,96,88,red blood cell,8448,0.9166666666666666,1.0909090909090908
7902,/images/98c25ffe-c329-420a-bc22-b082f565eac9.png,362,1087,484,1227,122,140,red blood cell,17080,1.1475409836065573,0.8714285714285714
28910,/images/686ed568-d5f8-475e-81ad-edab9dd473a0.png,624,1417,716,1497,92,80,red blood cell,7360,0.8695652173913043,1.15
44757,/images/ccb4b13d-ab20-4222-892f-5adf70249aaa.png,121,995,253,1103,132,108,red blood cell,14256,0.8181818181818182,1.2222222222222223
60856,/images/11b72c7b-5c52-44b7-adb7-21eacc25e441.png,609,210,702,304,93,94,red blood cell,8742,1.010752688172043,0.9893617021276596
15794,/images/64113b22-03b1-4ab8-89ab-b2f32154fbbd.png,889,1382,986,1489,97,107,red blood cell,10379,1.1030927835051547,0.9065420560747663
73711,/images/f11d05e4-538a-4024-8711-b08a4ce3c540.png,594,803,701,897,107,94,red blood cell,10058,0.8785046728971962,1.1382978723404256
22597,/images/406e05f0-4444-414c-bb40-f4cb08e75ac9.png,413,289,536,409,123,120,red blood cell,14760,0.975609756097561,1.025
40770,/images/252071ac-e9f2-41d2-abbb-87ef01b8a997.png,987,505,1093,599,106,94,red blood cell,9964,0.8867924528301887,1.127659574468085
51033,/images/7eb95580-693f-41b6-9338-174be1430c23.png,126,1105,213,1188,87,83,red blood cell,7221,0.9540229885057471,1.0481927710843373
64440,/images/34a70114-d3e3-4351-b8db-f6caab17e743.png,702,840,818,952,116,112,red blood cell,12992,0.9655172413793104,1.0357142857142858
49787,/images/5e17f8e6-fd8d-426c-b444-1515d14f04b7.png,651,1235,758,1352,107,117,red blood cell,12519,1.0934579439252337,0.9145299145299145
55934,/images/afd39466-aafa-4d81-9520-483727418723.png,981,988,1055,1079,74,91,red blood cell,6734,1.2297297297297298,0.8131868131868132
2703,/images/a89cace5-c818-4f23-a432-052b3433b81e.png,706,1473,807,1580,101,107,red blood cell,10807,1.0594059405940595,0.9439252336448598
76846,/images/2165fe38-b474-467d-be11-d1d728085efd.png,25,956,139,1058,114,102,red blood cell,11628,0.8947368421052632,1.1176470588235294
8327,/images/65e3d6a6-012c-4b40-9a42-83078eb85e31.png,7,158,96,238,89,80,red blood cell,7120,0.898876404494382,1.1125
75044,/images/073c10c9-5749-44b5-b08b-1be556a960f0.png,888,604,992,705,104,101,red blood cell,10504,0.9711538461538461,1.0297029702970297
58806,/images/434523fd-d4d9-4961-a7c2-d71d6ae68e13.png,123,1010,225,1123,102,113,red blood cell,11526,1.107843137254902,0.9026548672566371
12488,/images/cc94eabb-a3dc-4cfc-9fff-55c76b5b4a71.png,105,1493,192,1591,87,98,red blood cell,8526,1.1264367816091954,0.8877551020408163
26933,/images/71bbdc58-11af-41f2-9a93-3fe9257c5cf3.png,567,437,686,540,119,103,red blood cell,12257,0.865546218487395,1.1553398058252426
64571,/images/6ba5d0b8-cdc7-4266-9d78-db76faa312e9.png,693,512,777,587,84,75,red blood cell,6300,0.8928571428571429,1.12
53069,/images/69b5b3de-ec64-4e5d-bcc2-44f495e06e76.png,618,635,727,759,109,124,red blood cell,13516,1.1376146788990826,0.8790322580645161
29147,/images/cfab01d3-0616-4efb-9290-11f0fd8bf5a3.png,539,133,650,263,111,130,red blood cell,14430,1.1711711711711712,0.8538461538461538
26411,/images/d532e31c-10ce-4313-9a36-bd5e01230254.png,18,75,119,192,101,117,red blood cell,11817,1.1584158415841583,0.8632478632478633
31716,/images/bd432159-5956-457c-bdeb-1b5e702ba513.png,375,938,509,1059,134,121,red blood cell,16214,0.9029850746268657,1.1074380165289257
11111,/images/98175327-da9e-4e0c-8912-ee68490a4672.png,306,1400,421,1500,115,100,red blood cell,11500,0.8695652173913043,1.15
45433,/images/e4eea7ea-8989-46a9-9c98-25a178146b28.png,663,1477,747,1579,84,102,red blood cell,8568,1.2142857142857142,0.8235294117647058
3146,/images/729a38d6-66db-48e5-a00d-7d90d224290f.png,1019,1107,1144,1237,125,130,red blood cell,16250,1.04,0.9615384615384616
32045,/images/b8a4d467-c40c-4ebf-91dd-1c19d0f2a7ae.png,995,1202,1108,1305,113,103,red blood cell,11639,0.911504424778761,1.0970873786407767
6662,/images/95fea6d8-413f-421e-b331-5d51c31df150.png,981,1428,1107,1543,126,115,red blood cell,14490,0.9126984126984127,1.0956521739130434
28319,/images/34e024a5-5698-42d4-972f-fee234b4bd64.png,145,460,278,583,133,123,red blood cell,16359,0.924812030075188,1.08130081300813
50112,/images/e98baeb2-aa58-4cce-8c61-66685dd2b239.png,405,1070,510,1168,105,98,red blood cell,10290,0.9333333333333333,1.0714285714285714
73604,/images/a51d6c18-f9e8-4714-9dbb-38e1577445f2.png,624,1076,710,1173,86,97,red blood cell,8342,1.127906976744186,0.8865979381443299
6921,/images/a9feccda-18f2-405e-9aa1-409fa1f49fe4.png,844,1245,961,1361,117,116,red blood cell,13572,0.9914529914529915,1.0086206896551724
32869,/images/2a6370b0-08f1-4c11-a639-265d4419c9a3.png,957,433,1066,562,109,129,red blood cell,14061,1.18348623853211,0.8449612403100775
42600,/images/184b376b-03cb-4c2d-af51-fc1a62196293.png,792,508,893,625,101,117,red blood cell,11817,1.1584158415841583,0.8632478632478633
6041,/images/72732579-a812-4496-b2dd-ea1556924337.png,442,57,542,161,100,104,red blood cell,10400,1.04,0.9615384615384616
74603,/images/bbedfcbe-9528-4ba9-9d86-4ebba7589ac5.png,288,124,371,222,83,98,red blood cell,8134,1.180722891566265,0.8469387755102041
19482,/images/a85cd1ae-0c94-4387-8305-84ab8d96d137.png,1053,1210,1162,1324,109,114,red blood cell,12426,1.0458715596330275,0.956140350877193
39216,/images/2aeb7b85-7df9-4a63-8d37-2eecaaa190e7.png,229,1461,331,1576,102,115,red blood cell,11730,1.1274509803921569,0.8869565217391304
12843,/images/b10ea12f-cd36-4f2c-994a-67d1665269ab.png,693,767,794,863,101,96,red blood cell,9696,0.9504950495049505,1.0520833333333333
39936,/images/8271d0d8-9985-43eb-94b3-c702adca139f.png,896,65,1005,177,109,112,red blood cell,12208,1.0275229357798166,0.9732142857142857
41604,/images/0fcd1ebe-ee4a-40a0-b787-29cee18bfa1b.png,481,505,563,603,82,98,red blood cell,8036,1.1951219512195121,0.8367346938775511
59547,/images/6bfe6a90-8a69-4171-8e7f-42dc9417c6d9.png,931,1308,1032,1405,101,97,red blood cell,9797,0.9603960396039604,1.041237113402062
62153,/images/a63fa2c7-3ec8-4bb7-bde6-a39e09d2f806.png,13,940,151,1065,138,125,red blood cell,17250,0.9057971014492754,1.104
5373,/images/716273ea-19c4-49af-8604-df587b295eca.png,950,487,1077,607,127,120,red blood cell,15240,0.9448818897637795,1.0583333333333333
43848,/images/c84edeb4-311c-4e82-88f9-ae0505b3ad13.png,911,706,1022,806,111,100,red blood cell,11100,0.9009009009009009,1.11
30430,/images/dedbb10c-43f1-45fb-bb40-3ce2fb874015.png,635,820,759,938,124,118,red blood cell,14632,0.9516129032258065,1.0508474576271187
55790,/images/68f34a9c-f73d-4238-8f55-4b05a8a2154c.png,1088,1477,1189,1572,101,95,red blood cell,9595,0.9405940594059405,1.063157894736842
12421,/images/cc94eabb-a3dc-4cfc-9fff-55c76b5b4a71.png,190,1144,280,1247,90,103,red blood cell,9270,1.1444444444444444,0.8737864077669902
16208,/images/acdc6e12-73d9-44ba-be8c-2a56aaffef4f.png,54,1465,177,1597,123,132,red blood cell,16236,1.0731707317073171,0.9318181818181818
30709,/images/8e0dfc1f-e3eb-4a3f-a1c4-249bdfbfaa27.png,295,237,395,335,100,98,red blood cell,9800,0.98,1.0204081632653061
17397,/images/6f4ffe7b-395f-41ea-ad61-df5e0cbd531c.png,604,424,712,545,108,121,red blood cell,13068,1.1203703703703705,0.8925619834710744
8595,/images/a6aa3b72-2970-4c78-b655-ea8dfe6e018c.png,225,115,345,239,120,124,red blood cell,14880,1.0333333333333334,0.967741935483871
74234,/images/4e43fc22-dc08-4cde-b3ce-ce8a4f377c47.png,851,897,954,1010,103,113,red blood cell,11639,1.0970873786407767,0.911504424778761
29566,/images/42845335-4ab2-4963-806d-0985d1382a31.png,255,848,349,960,94,112,red blood cell,10528,1.1914893617021276,0.8392857142857143
16078,/images/7e25ced3-5caf-47f8-ad0c-42946bd4468b.png,341,653,467,779,126,126,red blood cell,15876,1.0,1.0
32103,/images/9258fe22-6406-4d00-b6f0-3f9492925405.png,159,155,281,273,122,118,red blood cell,14396,0.9672131147540983,1.0338983050847457
51109,/images/4748ba2b-6771-41d9-93a5-af9ccd559261.png,908,1365,1047,1496,139,131,red blood cell,18209,0.9424460431654677,1.0610687022900764
50063,/images/b1145408-feae-4637-b4cf-3e70b99cc62d.png,1095,36,1172,131,77,95,red blood cell,7315,1.2337662337662338,0.8105263157894737
11695,/images/0ed416f9-7c20-4829-9016-559e4009568e.png,222,708,335,823,113,115,red blood cell,12995,1.0176991150442478,0.9826086956521739
65285,/images/24418314-f7a4-49fc-a03e-ec597ca6796e.png,668,141,784,241,116,100,red blood cell,11600,0.8620689655172413,1.16
27921,/images/46f5bd4f-8bea-48d1-a1da-4dea28e3b814.png,306,70,423,182,117,112,red blood cell,13104,0.9572649572649573,1.0446428571428572
43280,/images/36569710-a574-40be-ad42-897a6e74a128.png,269,1295,393,1420,124,125,red blood cell,15500,1.0080645161290323,0.992
9019,/images/ef815e3a-02a6-4cf8-9262-45bc74c50b00.png,806,1145,935,1271,129,126,red blood cell,16254,0.9767441860465116,1.0238095238095237
63891,/images/5e974892-0ebe-4037-8427-ea8616d6d3b8.png,893,1107,1000,1223,107,116,red blood cell,12412,1.0841121495327102,0.9224137931034483
39686,/images/56adbb1e-96a8-40a5-a5a2-243c97ea889b.png,452,968,576,1096,124,128,red blood cell,15872,1.032258064516129,0.96875
56638,/images/4adcaa26-aa1f-47b5-bdf0-18c9f814f576.png,256,600,366,712,110,112,red blood cell,12320,1.018181818181818,0.9821428571428571
65953,/images/25c6cfb1-01d0-4864-87f9-02b7593683c7.png,601,352,709,470,108,118,red blood cell,12744,1.0925925925925926,0.9152542372881356
29051,/images/4c13e22e-dfd1-4fa1-b373-be9d0c272c0f.png,50,753,145,853,95,100,red blood cell,9500,1.0526315789473684,0.95
51269,/images/216f9d43-6869-4ba1-9106-4f5ea6aac223.png,580,946,684,1058,104,112,red blood cell,11648,1.0769230769230769,0.9285714285714286
59540,/images/6bfe6a90-8a69-4171-8e7f-42dc9417c6d9.png,215,805,325,905,110,100,red blood cell,11000,0.9090909090909091,1.1
1346,/images/6d91d1f0-636b-4f5a-a526-7c17fc857190.png,678,296,782,389,104,93,red blood cell,9672,0.8942307692307693,1.118279569892473
17802,/images/1863da5f-c595-4541-a8f4-21fe78678168.png,651,927,758,1033,107,106,red blood cell,11342,0.9906542056074766,1.009433962264151
40802,/images/252071ac-e9f2-41d2-abbb-87ef01b8a997.png,644,1102,741,1198,97,96,red blood cell,9312,0.9896907216494846,1.0104166666666667
79267,/images/05ac7b2a-6a77-4464-926b-8570f7c01693.png,119,701,216,791,97,90,red blood cell,8730,0.9278350515463918,1.0777777777777777
63061,/images/6afd8203-d61a-4e9b-a4cf-dcb53a16b57c.png,298,1175,401,1280,103,105,red blood cell,10815,1.0194174757281553,0.9809523809523809
76029,/images/4c7d2382-a962-4237-a053-955eea3decd8.png,702,950,806,1054,104,104,red blood cell,10816,1.0,1.0
32811,/images/67f5ca94-d84e-490e-bf0d-4ffba7bdbe30.png,871,39,984,151,113,112,red blood cell,12656,0.9911504424778761,1.0089285714285714
49572,/images/bd7937db-fca2-44d0-8538-460110210927.png,90,1003,196,1112,106,109,red blood cell,11554,1.028301886792453,0.9724770642201835
71361,/images/bcb447c9-5d37-414f-a513-d7076b04a532.png,226,1175,334,1288,108,113,red blood cell,12204,1.0462962962962963,0.9557522123893806
58076,/images/a7c91b63-b97c-4f4b-8d34-7ad2b08d7a17.png,497,1142,578,1232,81,90,red blood cell,7290,1.1111111111111112,0.9
26440,/images/2c4d72f1-71a6-4bf1-b5d9-8023c7bbec74.png,1033,917,1145,1045,112,128,red blood cell,14336,1.1428571428571428,0.875
4604,/images/f1de7c7e-e7d3-45ae-a66c-58538bf6cac1.png,63,1366,190,1499,127,133,red blood cell,16891,1.047244094488189,0.9548872180451128
23229,/images/3dcd4f1b-ce43-4a34-b1ed-076bb42963b1.png,9,39,130,163,121,124,red blood cell,15004,1.024793388429752,0.9758064516129032
75386,/images/468c261d-f5d8-423f-883e-48af2bbbc5d1.png,226,966,328,1083,102,117,red blood cell,11934,1.1470588235294117,0.8717948717948718
49331,/images/28c96a4a-4549-4761-99e4-ace4ea7e7ac9.png,568,566,691,692,123,126,red blood cell,15498,1.024390243902439,0.9761904761904762
67291,/images/49c4dbd3-6269-4d4c-9648-a2146c57bab1.png,522,84,625,179,103,95,red blood cell,9785,0.9223300970873787,1.0842105263157895
11067,/images/85a4d82e-cfb7-4983-b272-626c9e8c7583.png,698,239,839,356,141,117,red blood cell,16497,0.8297872340425532,1.205128205128205
76505,/images/34df8890-272d-423a-ae78-ff8d068d3306.png,334,1508,426,1599,92,91,red blood cell,8372,0.9891304347826086,1.010989010989011
35927,/images/f8242b97-b8d5-48b5-b808-0b0f75a5de97.png,409,1430,532,1548,123,118,red blood cell,14514,0.959349593495935,1.0423728813559323
28768,/images/686ed568-d5f8-475e-81ad-edab9dd473a0.png,815,421,922,529,107,108,red blood cell,11556,1.0093457943925233,0.9907407407407407
14700,/images/4e2873dd-651e-4ecc-ac70-7335cf21a469.png,1082,1012,1191,1139,109,127,red blood cell,13843,1.165137614678899,0.8582677165354331
36760,/images/aa2dfa24-2dc3-4279-a232-f84780ace190.png,325,1239,431,1339,106,100,red blood cell,10600,0.9433962264150944,1.06
45156,/images/2596eb32-1323-41e9-8c0f-64819abcfc73.png,731,269,818,366,87,97,red blood cell,8439,1.1149425287356323,0.8969072164948454
68916,/images/bbaa004f-05dc-4cb8-8768-e148085bb0f9.png,282,1171,384,1259,102,88,red blood cell,8976,0.8627450980392157,1.1590909090909092
58008,/images/a7c91b63-b97c-4f4b-8d34-7ad2b08d7a17.png,1010,539,1126,647,116,108,red blood cell,12528,0.9310344827586207,1.0740740740740742
26409,/images/d532e31c-10ce-4313-9a36-bd5e01230254.png,278,1440,389,1546,111,106,red blood cell,11766,0.954954954954955,1.0471698113207548
62038,/images/bdb5d571-27bc-4a42-ae45-aa5a9af40a81.png,623,1492,721,1586,98,94,red blood cell,9212,0.9591836734693877,1.0425531914893618
76355,/images/3dad6483-ac30-4d2b-b045-9f24fe6ff75e.png,643,711,743,808,100,97,red blood cell,9700,0.97,1.0309278350515463
22111,/images/ca677c3c-083f-4d54-9dec-39f79f6a17d8.png,361,1157,468,1254,107,97,red blood cell,10379,0.9065420560747663,1.1030927835051547
6487,/images/640c4a52-3742-4f57-aee3-9e3dc0887622.png,126,1456,226,1554,100,98,red blood cell,9800,0.98,1.0204081632653061
49440,/images/f2574be3-81c6-4fc3-8a40-0230d1264f52.png,210,1057,299,1161,89,104,red blood cell,9256,1.1685393258426966,0.8557692307692307
45287,/images/9e793460-d94c-47ac-b3a7-0d6ad86357da.png,1034,741,1160,856,126,115,red blood cell,14490,0.9126984126984127,1.0956521739130434
23058,/images/0d095f3a-9243-472b-90b4-0ce8309e778c.png,436,201,543,316,107,115,red blood cell,12305,1.074766355140187,0.9304347826086956
10065,/images/26799d2b-a289-4eff-9218-0aad77e05e41.png,908,1334,1015,1452,107,118,red blood cell,12626,1.102803738317757,0.9067796610169492
54570,/images/59dc7da9-35d1-421e-a61b-1e9637bfbfa1.png,644,36,757,152,113,116,red blood cell,13108,1.0265486725663717,0.9741379310344828
7071,/images/8be185e7-2a1a-441c-a5c7-b50a9eb926cb.png,0,221,103,325,103,104,red blood cell,10712,1.0097087378640777,0.9903846153846154
63950,/images/5e974892-0ebe-4037-8427-ea8616d6d3b8.png,2,292,103,407,101,115,red blood cell,11615,1.1386138613861385,0.8782608695652174
76744,/images/3317d733-ec0d-45e6-b631-40457392f343.png,976,213,1076,308,100,95,red blood cell,9500,0.95,1.0526315789473684
75421,/images/468c261d-f5d8-423f-883e-48af2bbbc5d1.png,471,600,561,688,90,88,red blood cell,7920,0.9777777777777777,1.0227272727272727
56535,/images/ac8df764-c8d8-4312-916d-70bfb37574b4.png,679,760,771,864,92,104,red blood cell,9568,1.1304347826086956,0.8846153846153846
43993,/images/de81bf7a-7a56-437f-a068-4d9c3e01134c.png,322,360,419,450,97,90,red blood cell,8730,0.9278350515463918,1.0777777777777777
50039,/images/b1145408-feae-4637-b4cf-3e70b99cc62d.png,110,281,223,398,113,117,red blood cell,13221,1.0353982300884956,0.9658119658119658
30831,/images/93a306b8-594a-4c7f-8b4a-127fb6ad8f1a.png,258,605,375,729,117,124,red blood cell,14508,1.0598290598290598,0.9435483870967742
53711,/images/6f67a66b-56ec-4c36-ae7c-f250d3b86a23.png,521,843,612,934,91,91,red blood cell,8281,1.0,1.0
508,/images/67acd5bc-4658-4c6e-a9b9-cd8ea3a03418.png,167,466,284,590,117,124,red blood cell,14508,1.0598290598290598,0.9435483870967742
769,/images/27fab82c-5bf0-426f-aeb9-47da829b6629.png,150,549,247,650,97,101,red blood cell,9797,1.041237113402062,0.9603960396039604
15929,/images/c7c1b873-0548-4a73-9618-f60912e164df.png,843,459,946,555,103,96,red blood cell,9888,0.9320388349514563,1.0729166666666667
56169,/images/137d540f-d71e-47e8-bd9b-6cd0a6433c33.png,835,845,942,950,107,105,red blood cell,11235,0.9813084112149533,1.019047619047619
65358,/images/24418314-f7a4-49fc-a03e-ec597ca6796e.png,1029,165,1128,263,99,98,red blood cell,9702,0.98989898989899,1.010204081632653
29912,/images/f2a8a483-b254-43aa-817f-7d525adb8911.png,481,264,588,382,107,118,red blood cell,12626,1.102803738317757,0.9067796610169492
79411,/images/dcb21739-3c36-459d-b3cc-1be5871d6fe7.png,948,391,1021,469,73,78,red blood cell,5694,1.0684931506849316,0.9358974358974359
77094,/images/a0e2ef53-d39b-40cf-b8b6-4b148ac339ec.png,414,1431,532,1576,118,145,red blood cell,17110,1.228813559322034,0.8137931034482758
69799,/images/2bd15b6e-fe2d-49f3-b394-940d024d1f91.png,166,1290,267,1402,101,112,red blood cell,11312,1.108910891089109,0.9017857142857143
9368,/images/261562a8-ffd8-4e0e-919b-22e267000b74.png,880,688,976,791,96,103,red blood cell,9888,1.0729166666666667,0.9320388349514563
24910,/images/ed0bee2f-05e0-4392-8357-19750cec577c.png,965,1404,1068,1498,103,94,red blood cell,9682,0.912621359223301,1.0957446808510638
79844,/images/a054a8e2-55f2-4508-97df-207f76b89be2.png,760,49,867,153,107,104,red blood cell,11128,0.9719626168224299,1.0288461538461537
47432,/images/3e753a44-3264-438c-8389-a7822e4a84cc.png,407,942,540,1075,133,133,red blood cell,17689,1.0,1.0
68118,/images/5dec94a3-e3ca-4a58-9702-88e5a83ef612.png,317,991,447,1119,130,128,red blood cell,16640,0.9846153846153847,1.015625
69538,/images/664c570b-4822-413c-9724-11b1d91fac44.png,816,27,891,104,75,77,red blood cell,5775,1.0266666666666666,0.974025974025974
77704,/images/4849866a-73a2-4fcf-a407-2d0a25a09a89.png,492,236,605,351,113,115,red blood cell,12995,1.0176991150442478,0.9826086956521739
8230,/images/65e3d6a6-012c-4b40-9a42-83078eb85e31.png,711,608,819,714,108,106,red blood cell,11448,0.9814814814814815,1.0188679245283019
12837,/images/b10ea12f-cd36-4f2c-994a-67d1665269ab.png,429,891,530,990,101,99,red blood cell,9999,0.9801980198019802,1.02020202020202
25773,/images/1f8edb2a-40bc-4beb-aa6b-884d2473df0f.png,835,98,957,212,122,114,red blood cell,13908,0.9344262295081968,1.0701754385964912
43751,/images/ef83ed4c-2724-4d5f-8abe-1a18d25cea35.png,671,1450,779,1570,108,120,red blood cell,12960,1.1111111111111112,0.9
33560,/images/255d5f0c-87fc-4337-bb51-07c440df4f1b.png,182,44,308,162,126,118,red blood cell,14868,0.9365079365079365,1.0677966101694916
42665,/images/3abbc4d3-1d7e-40c9-9963-33732da7cc50.png,476,764,587,871,111,107,red blood cell,11877,0.963963963963964,1.0373831775700935
64488,/images/6ba5d0b8-cdc7-4266-9d78-db76faa312e9.png,222,825,311,929,89,104,red blood cell,9256,1.1685393258426966,0.8557692307692307
47564,/images/06cd484f-e864-4fee-8819-688b45eed98e.png,8,1301,146,1421,138,120,red blood cell,16560,0.8695652173913043,1.15
53299,/images/d8f7e159-b7e3-49e4-86e8-aed8c5fbcd97.png,60,1008,153,1108,93,100,red blood cell,9300,1.075268817204301,0.93
3622,/images/8bd71314-e38a-4670-bb25-5cd6c9acb595.png,163,979,276,1093,113,114,red blood cell,12882,1.008849557522124,0.9912280701754386
72566,/images/a63ce82f-f3d1-4818-9035-d3d230e5f686.png,726,1074,834,1163,108,89,red blood cell,9612,0.8240740740740741,1.2134831460674158
40366,/images/db249e5a-4142-432c-8288-bacd10d7273d.png,588,649,689,755,101,106,red blood cell,10706,1.0495049504950495,0.9528301886792453
32056,/images/b8a4d467-c40c-4ebf-91dd-1c19d0f2a7ae.png,1049,625,1155,746,106,121,red blood cell,12826,1.1415094339622642,0.8760330578512396
32875,/images/e40000b4-1b26-42ce-909d-4715e04f0a6e.png,499,738,617,867,118,129,red blood cell,15222,1.0932203389830508,0.9147286821705426
29416,/images/b4e5e08d-6427-46f3-aca8-a4df165a151d.png,250,837,377,949,127,112,red blood cell,14224,0.8818897637795275,1.1339285714285714
806,/images/27fab82c-5bf0-426f-aeb9-47da829b6629.png,478,107,576,204,98,97,red blood cell,9506,0.9897959183673469,1.0103092783505154
17036,/images/57e1879e-4294-45e7-9c1b-627e8cca0271.png,618,1001,722,1101,104,100,red blood cell,10400,0.9615384615384616,1.04
50321,/images/3d32a988-449d-4d58-b71f-abbfdc3f2fbc.png,576,437,678,549,102,112,red blood cell,11424,1.0980392156862746,0.9107142857142857
37199,/images/befe6182-266b-4f8a-ac82-3a4154f05f60.png,635,530,759,652,124,122,red blood cell,15128,0.9838709677419355,1.0163934426229508
47409,/images/477e541c-0519-4542-9b13-8ee7922644d3.png,102,1277,208,1395,106,118,red blood cell,12508,1.1132075471698113,0.8983050847457628
43943,/images/d7c7eb2c-2acd-4f86-8a5a-09ab3dd02d16.png,424,480,535,601,111,121,red blood cell,13431,1.09009009009009,0.9173553719008265
31891,/images/f62d4fb6-df7c-446c-94a8-d5aede0b1e0c.png,859,931,975,1029,116,98,red blood cell,11368,0.8448275862068966,1.183673469387755
60814,/images/0ab56f9a-846d-49e2-a617-c6cc477fdfad.png,165,624,277,733,112,109,red blood cell,12208,0.9732142857142857,1.0275229357798166
76383,/images/3dad6483-ac30-4d2b-b045-9f24fe6ff75e.png,885,545,975,647,90,102,red blood cell,9180,1.1333333333333333,0.8823529411764706
78861,/images/4d0a1598-e4dd-45c4-8a90-dd7c780fe1da.png,1021,1335,1129,1448,108,113,red blood cell,12204,1.0462962962962963,0.9557522123893806
43191,/images/fe1ee954-ba71-47b3-954a-d20ab940cd7b.png,504,14,618,118,114,104,red blood cell,11856,0.9122807017543859,1.0961538461538463
35900,/images/33068c1a-48f7-470b-8e49-e2f0888042e9.png,756,1105,867,1214,111,109,red blood cell,12099,0.9819819819819819,1.018348623853211
75249,/images/61dfc937-a428-44b4-94fb-d682bdb8dff0.png,857,338,973,465,116,127,red blood cell,14732,1.0948275862068966,0.9133858267716536
40749,/images/252071ac-e9f2-41d2-abbb-87ef01b8a997.png,437,306,533,405,96,99,red blood cell,9504,1.03125,0.9696969696969697
64132,/images/0d3c2521-da55-4df5-bf06-56b3bd4fb2fc.png,299,1364,377,1449,78,85,red blood cell,6630,1.0897435897435896,0.9176470588235294
44571,/images/419309ef-da3f-4424-93cf-01ff4c52b017.png,1096,1440,1192,1544,96,104,red blood cell,9984,1.0833333333333333,0.9230769230769231
64184,/images/2a91387a-d30f-418d-ac3a-f7cfa6836261.png,543,669,646,776,103,107,red blood cell,11021,1.0388349514563107,0.9626168224299065
64015,/images/03cbfcf2-8da6-462c-b30d-16d63357371f.png,28,1447,127,1549,99,102,red blood cell,10098,1.0303030303030303,0.9705882352941176
41707,/images/67abb826-9b70-4459-8764-da76ecf35bfe.png,536,267,671,408,135,141,red blood cell,19035,1.0444444444444445,0.9574468085106383
20964,/images/d4fef0c5-6597-48b6-97e9-32ed504488e6.png,686,217,809,351,123,134,red blood cell,16482,1.089430894308943,0.917910447761194
29246,/images/6274fe0d-0d71-40be-b61b-f0bd5b5df1e2.png,1077,222,1154,300,77,78,red blood cell,6006,1.0129870129870129,0.9871794871794872
10864,/images/b78b88f0-154a-4b54-8aaf-85d37a42a0f9.png,951,606,1069,733,118,127,red blood cell,14986,1.076271186440678,0.9291338582677166
48534,/images/f3d84be2-8af0-4d62-9f72-23d3dc08cbbe.png,150,423,264,540,114,117,red blood cell,13338,1.0263157894736843,0.9743589743589743
2141,/images/e94a811d-3145-4313-ba42-2d5ed283179f.png,920,627,1012,733,92,106,red blood cell,9752,1.1521739130434783,0.8679245283018868
21663,/images/66183740-e1e5-43c9-8539-a87028bb3621.png,145,457,248,556,103,99,red blood cell,10197,0.9611650485436893,1.0404040404040404
65446,/images/b523daee-317b-461d-bdc1-07b4add4d488.png,1050,993,1131,1088,81,95,red blood cell,7695,1.1728395061728396,0.8526315789473684
12665,/images/5a043d69-f435-46d4-8691-395c1602a76a.png,420,335,519,448,99,113,red blood cell,11187,1.1414141414141414,0.8761061946902655
71101,/images/b666fcc2-d0b2-441e-bc5a-c660345eeb5d.png,682,1410,790,1519,108,109,red blood cell,11772,1.0092592592592593,0.9908256880733946
53118,/images/04a567df-5463-4043-81f1-d726223c19a9.png,121,801,228,906,107,105,red blood cell,11235,0.9813084112149533,1.019047619047619
46026,/images/72088c26-d2dd-4906-b791-b8947fc7fbe4.png,546,369,654,474,108,105,red blood cell,11340,0.9722222222222222,1.0285714285714285
4845,/images/c6ab535c-30e5-4b6b-8273-1ec8d78cdd13.png,921,1207,1022,1321,101,114,red blood cell,11514,1.1287128712871286,0.8859649122807017
36659,/images/21f001d6-f568-4ea4-82da-fab54c77c419.png,1022,1166,1109,1269,87,103,red blood cell,8961,1.1839080459770115,0.8446601941747572
15896,/images/c7c1b873-0548-4a73-9618-f60912e164df.png,645,183,738,286,93,103,red blood cell,9579,1.10752688172043,0.9029126213592233
30975,/images/b59dc3a0-3d54-4e3b-a485-33b3e43966de.png,1051,238,1170,365,119,127,red blood cell,15113,1.0672268907563025,0.937007874015748
25633,/images/770b8ca4-8377-479b-9ad5-5455ec3b44f8.png,844,536,962,662,118,126,red blood cell,14868,1.0677966101694916,0.9365079365079365
49397,/images/f2574be3-81c6-4fc3-8a40-0230d1264f52.png,35,905,148,1029,113,124,red blood cell,14012,1.0973451327433628,0.9112903225806451
46895,/images/9e0e1928-d19a-4100-b093-0b962ac09e05.png,489,1221,590,1322,101,101,red blood cell,10201,1.0,1.0
38341,/images/674b0fd3-f247-4b7f-97f7-3e6c57c9ba9e.png,770,80,875,178,105,98,red blood cell,10290,0.9333333333333333,1.0714285714285714
52619,/images/a6fe423a-5204-4378-bcfa-d6d298a3e9aa.png,486,1277,598,1385,112,108,red blood cell,12096,0.9642857142857143,1.037037037037037
46140,/images/72088c26-d2dd-4906-b791-b8947fc7fbe4.png,194,581,281,670,87,89,red blood cell,7743,1.0229885057471264,0.9775280898876404
4411,/images/21ea4841-8998-4c04-b345-bc99cd8ecee6.png,812,885,906,993,94,108,red blood cell,10152,1.148936170212766,0.8703703703703703
71701,/images/5c99cd97-39f6-4809-9528-9d380cc16b16.png,120,689,214,774,94,85,red blood cell,7990,0.9042553191489362,1.1058823529411765
20997,/images/666601e7-608d-4d19-999f-8fc6ab373a55.png,567,377,687,510,120,133,red blood cell,15960,1.1083333333333334,0.9022556390977443
55155,/images/29d4b75f-d400-4702-a9ac-e5a4ed1a1db1.png,800,138,898,226,98,88,red blood cell,8624,0.8979591836734694,1.1136363636363635
14789,/images/1fdf99d1-a494-4174-bcd7-efbe457ab899.png,1005,462,1102,562,97,100,red blood cell,9700,1.0309278350515463,0.97
16713,/images/d6352a03-ef81-421d-915e-226499555d20.png,633,1321,744,1443,111,122,red blood cell,13542,1.0990990990990992,0.9098360655737705
61581,/images/4a717a39-80f8-4b75-a25e-c46d65d7dcd5.png,442,1363,556,1482,114,119,red blood cell,13566,1.043859649122807,0.957983193277311
52765,/images/9dc6ed5d-6698-48cf-aab3-fd156673729c.png,124,215,220,315,96,100,red blood cell,9600,1.0416666666666667,0.96
46336,/images/fcc2b245-f47f-447f-8527-275b0005677c.png,201,1027,329,1146,128,119,red blood cell,15232,0.9296875,1.0756302521008403
61071,/images/6e86206f-dafe-4c28-bacc-7b83b2d40f0c.png,193,599,300,713,107,114,red blood cell,12198,1.0654205607476634,0.9385964912280702
67181,/images/be6fe358-dee1-4dcf-9b0d-5d8612aba577.png,236,943,319,1027,83,84,red blood cell,6972,1.0120481927710843,0.9880952380952381
48103,/images/05717db9-f1ef-4101-a9f7-7a007e83b1c9.png,565,449,694,562,129,113,red blood cell,14577,0.875968992248062,1.1415929203539823
71150,/images/b666fcc2-d0b2-441e-bc5a-c660345eeb5d.png,248,817,362,954,114,137,red blood cell,15618,1.2017543859649122,0.8321167883211679
66148,/images/191f87a4-6f2d-49e7-bba0-08e3aa78ddaf.png,613,963,703,1053,90,90,red blood cell,8100,1.0,1.0
15073,/images/3a8f468f-f9de-46a8-a7c8-f2be239fa207.png,373,1271,494,1381,121,110,red blood cell,13310,0.9090909090909091,1.1
4515,/images/0f26699f-a776-4424-b092-27da9a1d12e2.png,216,1165,316,1272,100,107,red blood cell,10700,1.07,0.9345794392523364
5353,/images/716273ea-19c4-49af-8604-df587b295eca.png,927,933,1040,1061,113,128,red blood cell,14464,1.1327433628318584,0.8828125
37184,/images/befe6182-266b-4f8a-ac82-3a4154f05f60.png,547,585,668,705,121,120,red blood cell,14520,0.9917355371900827,1.0083333333333333
48151,/images/913099c5-8085-4908-bf4b-1f098bbfcf66.png,671,895,767,1003,96,108,red blood cell,10368,1.125,0.8888888888888888
31497,/images/83ec1cb9-1714-4bf1-81f6-115fde84564d.png,837,1431,953,1548,116,117,red blood cell,13572,1.0086206896551724,0.9914529914529915
36400,/images/4a0a05e1-11ad-4bfc-bfa3-adf3b9bd0b56.png,162,1179,281,1304,119,125,red blood cell,14875,1.050420168067227,0.952
35940,/images/5836500a-221e-40ca-a8be-caaa37f7d300.png,995,773,1090,874,95,101,red blood cell,9595,1.063157894736842,0.9405940594059405
44637,/images/8002cb71-0f25-4fa4-a46f-b49e5aeded0c.png,332,574,454,686,122,112,red blood cell,13664,0.9180327868852459,1.0892857142857142
71647,/images/5c99cd97-39f6-4809-9528-9d380cc16b16.png,857,324,964,442,107,118,red blood cell,12626,1.102803738317757,0.9067796610169492
59868,/images/1519257c-e3e5-4474-908f-8665b3cf1258.png,914,1258,1017,1359,103,101,red blood cell,10403,0.9805825242718447,1.0198019801980198
23792,/images/6b2ff7ca-c5b3-415c-9481-7b14efc6d7ef.png,85,456,206,575,121,119,red blood cell,14399,0.9834710743801653,1.0168067226890756
33380,/images/f632981c-1330-4078-8a12-691beb2dab02.png,826,235,937,353,111,118,red blood cell,13098,1.063063063063063,0.940677966101695
79098,/images/1c90231b-2830-42d9-884e-7301edb16933.png,1062,344,1163,455,101,111,red blood cell,11211,1.099009900990099,0.9099099099099099
17998,/images/eb77e4a9-acb0-4d83-8055-2c5fcaa54b45.png,443,932,539,1028,96,96,red blood cell,9216,1.0,1.0
30738,/images/8e0dfc1f-e3eb-4a3f-a1c4-249bdfbfaa27.png,715,1388,830,1503,115,115,red blood cell,13225,1.0,1.0
22004,/images/c5acd0ad-b0f2-478d-b0ad-5aa733aa7b32.png,67,12,182,137,115,125,red blood cell,14375,1.0869565217391304,0.92
48979,/images/df3d98b9-3dd7-4107-8d4a-ae1b7f247793.png,179,986,291,1093,112,107,red blood cell,11984,0.9553571428571429,1.0467289719626167
58808,/images/434523fd-d4d9-4961-a7c2-d71d6ae68e13.png,992,434,1094,532,102,98,red blood cell,9996,0.9607843137254902,1.0408163265306123
44169,/images/8b494b40-cab5-49d3-893d-c805000fbe88.png,466,1132,588,1246,122,114,red blood cell,13908,0.9344262295081968,1.0701754385964912
37235,/images/71881a39-a30c-40c7-8c4a-9f64c93e79d9.png,405,235,538,360,133,125,red blood cell,16625,0.9398496240601504,1.064
64278,/images/83d4e1fe-da84-4175-a9e2-8efc18782dcf.png,513,280,632,406,119,126,red blood cell,14994,1.0588235294117647,0.9444444444444444
15981,/images/c7c1b873-0548-4a73-9618-f60912e164df.png,700,400,786,489,86,89,red blood cell,7654,1.0348837209302326,0.9662921348314607
73075,/images/f39e2289-fedd-4d12-9e64-ffdafb89247e.png,359,1170,471,1284,112,114,red blood cell,12768,1.0178571428571428,0.9824561403508771
18159,/images/947348fe-4c70-468e-8009-3c14daeca69b.png,342,218,449,335,107,117,red blood cell,12519,1.0934579439252337,0.9145299145299145
25165,/images/90171428-f208-428a-b40e-f57ee3bea457.png,1040,1151,1151,1247,111,96,red blood cell,10656,0.8648648648648649,1.15625
62812,/images/631340cc-cedf-4bca-a3d8-a0731a5482b4.png,86,374,175,459,89,85,red blood cell,7565,0.9550561797752809,1.0470588235294118
8927,/images/04628a94-b674-469b-aff6-b476b70df87d.png,500,119,622,231,122,112,red blood cell,13664,0.9180327868852459,1.0892857142857142
57340,/images/a88a48b6-f85c-45c1-b42f-79716c8463f1.png,579,339,687,430,108,91,red blood cell,9828,0.8425925925925926,1.1868131868131868
59167,/images/4736f545-1f1f-4d77-9241-d69cbf4dae35.png,835,1224,938,1330,103,106,red blood cell,10918,1.029126213592233,0.9716981132075472
43173,/images/c5db0fc0-b96c-496e-90b4-f9fb1b85b28e.png,303,678,395,789,92,111,red blood cell,10212,1.2065217391304348,0.8288288288288288
15970,/images/c7c1b873-0548-4a73-9618-f60912e164df.png,418,1140,523,1239,105,99,red blood cell,10395,0.9428571428571428,1.0606060606060606
15089,/images/3a8f468f-f9de-46a8-a7c8-f2be239fa207.png,722,604,820,711,98,107,red blood cell,10486,1.0918367346938775,0.9158878504672897
8399,/images/ae779806-6d01-4dc6-89df-294c368db6bc.png,623,751,740,857,117,106,red blood cell,12402,0.905982905982906,1.1037735849056605
66267,/images/e8058bed-c362-4e1c-85dc-62f80f32938f.png,920,1447,1017,1554,97,107,red blood cell,10379,1.1030927835051547,0.9065420560747663
54114,/images/d9345456-b76d-46cc-b81e-46d4a0a7b652.png,1009,1152,1106,1252,97,100,red blood cell,9700,1.0309278350515463,0.97
20040,/images/ebfd9f67-138e-49f0-9cef-a0352069eedb.png,791,445,889,539,98,94,red blood cell,9212,0.9591836734693877,1.0425531914893618
79563,/images/161978c3-3a05-47a5-9fee-be7d25693eae.png,413,1119,538,1230,125,111,red blood cell,13875,0.888,1.1261261261261262
41772,/images/32a1ea24-b6b7-4253-ad3e-bdf99c2c9b9d.png,842,450,967,561,125,111,red blood cell,13875,0.888,1.1261261261261262
26693,/images/c1423156-82b3-4dd3-8e74-08eb7ed8e1d6.png,840,1386,967,1499,127,113,red blood cell,14351,0.889763779527559,1.1238938053097345
58710,/images/e4827c85-311a-4df1-89c2-99dad0c3558c.png,339,1259,450,1374,111,115,red blood cell,12765,1.0360360360360361,0.9652173913043478
61026,/images/3d1429ed-4619-41f7-8ff3-d698ad28034c.png,866,290,970,385,104,95,red blood cell,9880,0.9134615384615384,1.0947368421052632
58158,/images/d615b706-8f50-4d96-8de5-6858897528d0.png,1023,153,1123,258,100,105,red blood cell,10500,1.05,0.9523809523809523
2900,/images/a1c140f9-75d7-42a3-b767-4c01a118892b.png,39,314,157,438,118,124,red blood cell,14632,1.0508474576271187,0.9516129032258065
2362,/images/fe851c88-692d-4199-87e0-d19d9c4eb591.png,1099,1283,1189,1374,90,91,red blood cell,8190,1.011111111111111,0.989010989010989
55793,/images/68f34a9c-f73d-4238-8f55-4b05a8a2154c.png,942,987,1028,1067,86,80,red blood cell,6880,0.9302325581395349,1.075
47173,/images/3d1b889e-bb4a-4ee6-b899-974ee7d956a7.png,437,1279,542,1370,105,91,red blood cell,9555,0.8666666666666667,1.1538461538461537
40613,/images/252071ac-e9f2-41d2-abbb-87ef01b8a997.png,454,199,566,300,112,101,red blood cell,11312,0.9017857142857143,1.108910891089109
27240,/images/9f38055f-4fe6-47fd-a6dd-c0743db4eccf.png,85,439,204,535,119,96,red blood cell,11424,0.8067226890756303,1.2395833333333333
40077,/images/6fd30823-3b77-40c9-ba5d-e1eda9660674.png,871,362,985,479,114,117,red blood cell,13338,1.0263157894736843,0.9743589743589743
34495,/images/fa1f9f89-cecb-4972-842c-d14c632f89a9.png,607,927,718,1037,111,110,red blood cell,12210,0.990990990990991,1.009090909090909
33970,/images/701206c5-aaac-4b99-9cc0-4a6854359457.png,652,986,775,1106,123,120,red blood cell,14760,0.975609756097561,1.025
21324,/images/8dace03a-10c4-4d59-bcd9-a2c314c5df33.png,5,852,122,968,117,116,red blood cell,13572,0.9914529914529915,1.0086206896551724
1127,/images/edcb4d77-a4d3-465d-9b59-eb3087766b1c.png,614,282,710,377,96,95,red blood cell,9120,0.9895833333333334,1.0105263157894737
11750,/images/082e1f81-4f49-44ad-b5bb-9dfc155b2ed8.png,595,1142,699,1264,104,122,red blood cell,12688,1.1730769230769231,0.8524590163934426
54933,/images/f1872d08-f8a6-4b21-aa29-f56bbf607883.png,444,862,550,976,106,114,red blood cell,12084,1.0754716981132075,0.9298245614035088
18716,/images/f6f8a69a-3fd2-4684-ac77-3e83ea0fb36d.png,800,158,910,271,110,113,red blood cell,12430,1.0272727272727273,0.9734513274336283
69456,/images/664c570b-4822-413c-9724-11b1d91fac44.png,340,867,451,984,111,117,red blood cell,12987,1.054054054054054,0.9487179487179487
36190,/images/749df49e-5212-49ea-9e88-7d66f258f1df.png,944,1393,1051,1484,107,91,red blood cell,9737,0.8504672897196262,1.1758241758241759
39160,/images/2aeb7b85-7df9-4a63-8d37-2eecaaa190e7.png,975,708,1089,834,114,126,red blood cell,14364,1.105263157894737,0.9047619047619048
71815,/images/093a831a-bf71-4333-bc06-942ae70cb164.png,489,640,587,733,98,93,red blood cell,9114,0.9489795918367347,1.053763440860215
63232,/images/d3283f5b-3b3a-40ea-800b-79960ca851cb.png,296,114,406,234,110,120,red blood cell,13200,1.0909090909090908,0.9166666666666666
55100,/images/3768c577-4e5e-4d70-8c4d-93d8aacd5baa.png,564,632,671,724,107,92,red blood cell,9844,0.8598130841121495,1.1630434782608696
35731,/images/4063945d-03fc-4ce3-a04c-17435dce8f91.png,679,107,792,228,113,121,red blood cell,13673,1.0707964601769913,0.9338842975206612
14692,/images/4e2873dd-651e-4ecc-ac70-7335cf21a469.png,44,384,168,504,124,120,red blood cell,14880,0.967741935483871,1.0333333333333334
74809,/images/91e93160-eb8d-4de0-b6bc-b98ec33d1663.png,651,742,753,844,102,102,red blood cell,10404,1.0,1.0
37677,/images/003a89b0-a095-417a-8dd6-f408339bbc68.png,390,429,502,548,112,119,red blood cell,13328,1.0625,0.9411764705882353
78347,/images/24115f58-a7d6-4022-a95a-86b515a78d3e.png,271,814,369,927,98,113,red blood cell,11074,1.153061224489796,0.8672566371681416
7820,/images/e726dac6-f962-449c-acff-4dd56847b685.png,928,963,1042,1074,114,111,red blood cell,12654,0.9736842105263158,1.027027027027027
5852,/images/a30da226-b452-408a-a556-bfae4d521464.png,159,27,259,133,100,106,red blood cell,10600,1.06,0.9433962264150944
77037,/images/637957ef-df75-4a7b-86d5-9f6e9c042ca2.png,102,1002,206,1111,104,109,red blood cell,11336,1.0480769230769231,0.9541284403669725
17307,/images/3d302619-473d-4c5b-af43-8833ff94233f.png,402,1057,492,1169,90,112,red blood cell,10080,1.2444444444444445,0.8035714285714286
2449,/images/fe851c88-692d-4199-87e0-d19d9c4eb591.png,171,0,274,96,103,96,red blood cell,9888,0.9320388349514563,1.0729166666666667
42765,/images/7c68c343-a7d3-4d26-b330-a5bb97ab8d9c.png,790,1075,895,1177,105,102,red blood cell,10710,0.9714285714285714,1.0294117647058822
68641,/images/31653d0f-c4e6-4e12-8005-518c2de34687.png,85,441,174,521,89,80,red blood cell,7120,0.898876404494382,1.1125
73912,/images/2ae3e6e6-7482-4ab8-ad73-b530b5c2ee3b.png,254,974,346,1059,92,85,red blood cell,7820,0.9239130434782609,1.0823529411764705
22813,/images/72105bb0-8e39-48be-b7f7-5b32f047b99e.png,75,495,186,607,111,112,red blood cell,12432,1.009009009009009,0.9910714285714286
31899,/images/f62d4fb6-df7c-446c-94a8-d5aede0b1e0c.png,336,981,447,1113,111,132,red blood cell,14652,1.1891891891891893,0.8409090909090909
64736,/images/76021d69-8919-4688-95ef-7418eff620cc.png,27,353,110,431,83,78,red blood cell,6474,0.9397590361445783,1.064102564102564
24896,/images/ed0bee2f-05e0-4392-8357-19750cec577c.png,798,558,912,671,114,113,red blood cell,12882,0.9912280701754386,1.008849557522124
150,/images/6b14c855-8561-417c-97a4-63fa552842fd.png,1,162,132,283,131,121,red blood cell,15851,0.9236641221374046,1.0826446280991735
18724,/images/f6f8a69a-3fd2-4684-ac77-3e83ea0fb36d.png,329,1211,427,1298,98,87,red blood cell,8526,0.8877551020408163,1.1264367816091954
34254,/images/259da25f-40f3-4d37-bca9-a9c807af1547.png,919,481,1051,611,132,130,red blood cell,17160,0.9848484848484849,1.0153846153846153
36981,/images/b2e34f5f-904e-4473-9dc7-c6bc1ce12640.png,885,1044,967,1136,82,92,red blood cell,7544,1.1219512195121952,0.8913043478260869
58816,/images/434523fd-d4d9-4961-a7c2-d71d6ae68e13.png,371,164,471,256,100,92,red blood cell,9200,0.92,1.0869565217391304
60595,/images/724e0c34-32cd-41f1-ae37-586038bc67ab.png,723,160,832,275,109,115,red blood cell,12535,1.055045871559633,0.9478260869565217
33438,/images/244ac6fa-8a92-4214-9cf4-ae0811d9ec7e.png,966,950,1090,1068,124,118,red blood cell,14632,0.9516129032258065,1.0508474576271187
58993,/images/597bbff8-6592-41cf-8946-e59b0d1f289a.png,260,958,371,1075,111,117,red blood cell,12987,1.054054054054054,0.9487179487179487
69932,/images/9edba799-e169-46cd-b100-c9f8fc7a8c7d.png,391,160,475,256,84,96,red blood cell,8064,1.1428571428571428,0.875
35174,/images/bfc61c48-685d-470b-86b1-e4c7eb85c4fd.png,608,761,743,888,135,127,red blood cell,17145,0.9407407407407408,1.062992125984252
11788,/images/082e1f81-4f49-44ad-b5bb-9dfc155b2ed8.png,49,169,152,272,103,103,red blood cell,10609,1.0,1.0
16770,/images/4823c1fe-a7f9-4b92-959f-0d9be09cd14b.png,729,1368,840,1472,111,104,red blood cell,11544,0.9369369369369369,1.0673076923076923
11885,/images/2e8d6a43-0110-4bf4-8e70-20567e513b81.png,258,358,350,445,92,87,red blood cell,8004,0.9456521739130435,1.0574712643678161
73353,/images/c890ee00-daa5-4b20-9cd5-930748ecc4e0.png,673,1485,773,1587,100,102,red blood cell,10200,1.02,0.9803921568627451
51561,/images/6afb3717-f197-4668-929a-4fab389ae6e8.png,771,267,870,390,99,123,red blood cell,12177,1.2424242424242424,0.8048780487804879
28270,/images/036404d1-b9fc-497b-bbe1-f4d9c5ac3ce0.png,74,931,192,1051,118,120,red blood cell,14160,1.0169491525423728,0.9833333333333333
54423,/images/22a464ef-c3da-4d56-b37e-e22e95d945e7.png,19,1253,121,1366,102,113,red blood cell,11526,1.107843137254902,0.9026548672566371
1030,/images/63d36d2c-43a9-49ac-9504-028b4968c860.png,372,205,468,312,96,107,red blood cell,10272,1.1145833333333333,0.897196261682243
31611,/images/0d7bf56f-3b5a-40bd-971c-2ca33dd89b2c.png,822,1339,936,1454,114,115,red blood cell,13110,1.0087719298245614,0.991304347826087
39066,/images/8f96ee1f-4ef7-4279-a610-316319bedcf9.png,256,623,390,739,134,116,red blood cell,15544,0.8656716417910447,1.1551724137931034
42669,/images/3abbc4d3-1d7e-40c9-9963-33732da7cc50.png,418,496,516,594,98,98,red blood cell,9604,1.0,1.0
43088,/images/340a1727-0df7-4e6f-9c0e-9c5deddbfca2.png,424,1174,536,1300,112,126,red blood cell,14112,1.125,0.8888888888888888
35504,/images/3722d213-f2a9-46d5-aa76-9183b443e455.png,524,150,662,274,138,124,red blood cell,17112,0.8985507246376812,1.1129032258064515
17035,/images/57e1879e-4294-45e7-9c1b-627e8cca0271.png,12,392,130,509,118,117,red blood cell,13806,0.9915254237288136,1.0085470085470085
32523,/images/d31dd2c0-ae8e-4499-86bb-7cabb6e438b9.png,349,658,454,762,105,104,red blood cell,10920,0.9904761904761905,1.0096153846153846
27012,/images/1f337b61-1b0d-4539-91f9-73d4a0798a4a.png,234,345,322,446,88,101,red blood cell,8888,1.1477272727272727,0.8712871287128713
25364,/images/c52f8cc8-afd7-441c-9f1f-18b6e16d79cf.png,680,45,809,150,129,105,red blood cell,13545,0.813953488372093,1.2285714285714286
26990,/images/1f337b61-1b0d-4539-91f9-73d4a0798a4a.png,296,717,411,831,115,114,red blood cell,13110,0.991304347826087,1.0087719298245614
29431,/images/b4e5e08d-6427-46f3-aca8-a4df165a151d.png,600,145,708,249,108,104,red blood cell,11232,0.9629629629629629,1.0384615384615385
70872,/images/bf002a25-6535-4621-be19-56d468be5413.png,443,1287,550,1386,107,99,red blood cell,10593,0.9252336448598131,1.0808080808080809
44041,/images/8b494b40-cab5-49d3-893d-c805000fbe88.png,68,344,191,462,123,118,red blood cell,14514,0.959349593495935,1.0423728813559323
37530,/images/205306da-0ed8-475a-ace6-f2f81d4be88a.png,85,1006,164,1092,79,86,red blood cell,6794,1.0886075949367089,0.9186046511627907
78703,/images/76a8a5f5-1328-4539-a131-baf877f40cf3.png,777,236,888,350,111,114,red blood cell,12654,1.027027027027027,0.9736842105263158
65238,/images/45ac9409-5537-44ed-90cd-5c8a1ae0e1e0.png,1053,1053,1165,1164,112,111,red blood cell,12432,0.9910714285714286,1.009009009009009
35382,/images/452482bc-24a3-413e-ba03-fad4c9d61f3c.png,734,914,827,1008,93,94,red blood cell,8742,1.010752688172043,0.9893617021276596
62285,/images/e0ff3476-226f-4125-b182-8e524d5503dd.png,755,1149,870,1253,115,104,red blood cell,11960,0.9043478260869565,1.1057692307692308
67806,/images/04de3a31-fc09-40be-9c2c-9830c57f809d.png,766,1183,879,1312,113,129,red blood cell,14577,1.1415929203539823,0.875968992248062
44882,/images/83ec8923-6232-40d7-ba1f-a1b8bf7cb66c.png,735,761,841,874,106,113,red blood cell,11978,1.0660377358490567,0.9380530973451328
69047,/images/b5246b58-6f40-4c9e-8024-f49b0ed6bdbd.png,777,72,892,171,115,99,red blood cell,11385,0.8608695652173913,1.1616161616161615
37192,/images/befe6182-266b-4f8a-ac82-3a4154f05f60.png,1023,400,1138,520,115,120,red blood cell,13800,1.0434782608695652,0.9583333333333334
57172,/images/7c870293-2665-4a6b-a4fa-336959051dfc.png,770,199,880,306,110,107,red blood cell,11770,0.9727272727272728,1.02803738317757
5371,/images/716273ea-19c4-49af-8604-df587b295eca.png,949,1147,1074,1257,125,110,red blood cell,13750,0.88,1.1363636363636365
35794,/images/bb2042c5-35e1-43cc-8171-7de81b764361.png,443,1490,546,1599,103,109,red blood cell,11227,1.058252427184466,0.944954128440367
46667,/images/da111ca5-520f-4ea8-97ad-ae5fce58ee91.png,1006,802,1095,900,89,98,red blood cell,8722,1.101123595505618,0.9081632653061225
22925,/images/ecd68ba2-48af-4866-826a-7cd1c147c055.png,342,1224,460,1345,118,121,red blood cell,14278,1.0254237288135593,0.9752066115702479
29975,/images/deeaa5b3-3895-4aec-a2ce-ed6404862cdf.png,468,1412,585,1531,117,119,red blood cell,13923,1.017094017094017,0.9831932773109243
6965,/images/c776eb78-3323-4571-b39f-7ffc73ae63ce.png,753,54,862,148,109,94,red blood cell,10246,0.8623853211009175,1.1595744680851063
46478,/images/21417261-475a-456f-b03f-57ac85a6e106.png,628,1227,751,1348,123,121,red blood cell,14883,0.983739837398374,1.0165289256198347
12112,/images/984caf56-f400-4a29-be97-a4d6b9d1468d.png,546,1099,673,1238,127,139,red blood cell,17653,1.094488188976378,0.9136690647482014
79764,/images/03b9d6ad-39ca-4097-a98b-77f02b3c00a7.png,1101,621,1183,715,82,94,red blood cell,7708,1.146341463414634,0.8723404255319149
53692,/images/6f67a66b-56ec-4c36-ae7c-f250d3b86a23.png,36,125,153,227,117,102,red blood cell,11934,0.8717948717948718,1.1470588235294117
78119,/images/bb137718-20ba-457d-8ffe-4f9420ecaab6.png,255,125,357,231,102,106,red blood cell,10812,1.0392156862745099,0.9622641509433962
77892,/images/464055b6-3351-4636-a919-8be9840fb850.png,52,1409,179,1518,127,109,red blood cell,13843,0.8582677165354331,1.165137614678899
28928,/images/b12ae3b1-613c-4c0e-9163-3c5cc314abf5.png,580,1127,693,1235,113,108,red blood cell,12204,0.9557522123893806,1.0462962962962963
41949,/images/46a03374-64c7-49ac-81c9-c3d62542bbf3.png,790,30,890,124,100,94,red blood cell,9400,0.94,1.0638297872340425
44351,/images/415409ac-97b3-4cd9-b203-11ef00662352.png,821,1342,951,1462,130,120,red blood cell,15600,0.9230769230769231,1.0833333333333333
77711,/images/4849866a-73a2-4fcf-a407-2d0a25a09a89.png,482,492,590,611,108,119,red blood cell,12852,1.1018518518518519,0.907563025210084
6549,/images/640c4a52-3742-4f57-aee3-9e3dc0887622.png,1075,789,1159,891,84,102,red blood cell,8568,1.2142857142857142,0.8235294117647058
61661,/images/a3c0a876-be12-4ede-8aed-18b32a64401b.png,957,710,1065,823,108,113,red blood cell,12204,1.0462962962962963,0.9557522123893806
6239,/images/effd6334-516f-4d48-9f3c-5272a99780fb.png,1073,1313,1194,1426,121,113,red blood cell,13673,0.9338842975206612,1.0707964601769913
42365,/images/1a27ebe9-93a1-4898-af69-f276057d4012.png,201,237,318,361,117,124,red blood cell,14508,1.0598290598290598,0.9435483870967742
28124,/images/cd2774a0-dab2-4d68-aae9-7568b9f3d2a6.png,795,1220,905,1332,110,112,red blood cell,12320,1.018181818181818,0.9821428571428571
48445,/images/0fa5b35d-6c44-4207-b6f8-d5b355086b5f.png,686,1308,820,1435,134,127,red blood cell,17018,0.9477611940298507,1.0551181102362204
53177,/images/801296d9-3403-426f-859e-5c532858e025.png,697,1119,793,1218,96,99,red blood cell,9504,1.03125,0.9696969696969697
69573,/images/4a49841f-216c-4815-8140-b8762c4f6603.png,456,1194,550,1285,94,91,red blood cell,8554,0.9680851063829787,1.032967032967033
53380,/images/f23ae29e-1bda-4784-b10c-d736757d39b8.png,100,169,186,252,86,83,red blood cell,7138,0.9651162790697675,1.036144578313253
13549,/images/370277f8-436b-4103-8210-b4feb5ab95ea.png,491,1364,596,1454,105,90,red blood cell,9450,0.8571428571428571,1.1666666666666667
4929,/images/755e5bf8-e8e1-492b-a32f-f7d87cccaa40.png,339,1181,466,1289,127,108,red blood cell,13716,0.8503937007874016,1.1759259259259258
18682,/images/c22f7031-9cf8-48ce-b03b-1b12d0db4951.png,229,261,327,347,98,86,red blood cell,8428,0.8775510204081632,1.1395348837209303
23898,/images/c17523c5-90a0-4a6b-9b33-2b4a6cf58d36.png,647,1160,767,1273,120,113,red blood cell,13560,0.9416666666666667,1.0619469026548674
71734,/images/093a831a-bf71-4333-bc06-942ae70cb164.png,988,883,1102,990,114,107,red blood cell,12198,0.9385964912280702,1.0654205607476634
32728,/images/0154dd8e-72f8-4d78-a4dd-93e139577bd1.png,292,55,404,172,112,117,red blood cell,13104,1.0446428571428572,0.9572649572649573
42521,/images/29648565-fe28-4517-ba72-68df0c82c9c5.png,751,1388,849,1489,98,101,red blood cell,9898,1.030612244897959,0.9702970297029703
19922,/images/0ca25c88-457f-4f03-bbc1-98fb6663f1d1.png,181,1186,299,1306,118,120,red blood cell,14160,1.0169491525423728,0.9833333333333333
70963,/images/deaa1931-5f97-45bf-8c00-be6ddeb37b9a.png,18,419,130,540,112,121,red blood cell,13552,1.0803571428571428,0.9256198347107438
8045,/images/694222bb-cddf-469a-9526-f873c6fba58e.png,674,1464,795,1577,121,113,red blood cell,13673,0.9338842975206612,1.0707964601769913
29419,/images/b4e5e08d-6427-46f3-aca8-a4df165a151d.png,1047,227,1148,318,101,91,red blood cell,9191,0.900990099009901,1.10989010989011
75939,/images/034c8d57-04d5-4786-93a4-6ae8fde2c258.png,31,404,146,514,115,110,red blood cell,12650,0.9565217391304348,1.0454545454545454
14691,/images/4e2873dd-651e-4ecc-ac70-7335cf21a469.png,1020,748,1126,852,106,104,red blood cell,11024,0.9811320754716981,1.0192307692307692
958,/images/a8cb75ba-3f2f-40d8-8bc7-c79ebd1b9603.png,716,358,803,462,87,104,red blood cell,9048,1.1954022988505748,0.8365384615384616
31214,/images/1976cd04-d24f-457c-b423-7e4cdb05de9e.png,686,1335,809,1470,123,135,red blood cell,16605,1.0975609756097562,0.9111111111111111
62906,/images/4b346035-b8c0-46ca-8fdb-a01b1421ee4a.png,531,806,643,914,112,108,red blood cell,12096,0.9642857142857143,1.037037037037037
68869,/images/6347dd6a-cfdf-4cb5-bc50-cff5403cfecb.png,987,489,1120,619,133,130,red blood cell,17290,0.9774436090225563,1.023076923076923
40654,/images/252071ac-e9f2-41d2-abbb-87ef01b8a997.png,117,695,218,782,101,87,red blood cell,8787,0.8613861386138614,1.160919540229885
42010,/images/46a03374-64c7-49ac-81c9-c3d62542bbf3.png,81,70,176,171,95,101,red blood cell,9595,1.063157894736842,0.9405940594059405
1050,/images/63d36d2c-43a9-49ac-9504-028b4968c860.png,428,243,534,366,106,123,red blood cell,13038,1.1603773584905661,0.8617886178861789
29985,/images/deeaa5b3-3895-4aec-a2ce-ed6404862cdf.png,278,1072,396,1195,118,123,red blood cell,14514,1.0423728813559323,0.959349593495935
11055,/images/85a4d82e-cfb7-4983-b272-626c9e8c7583.png,1058,1365,1177,1492,119,127,red blood cell,15113,1.0672268907563025,0.937007874015748
52984,/images/e81bf478-27ff-458c-ac30-9e1f8480bc5c.png,578,559,689,649,111,90,red blood cell,9990,0.8108108108108109,1.2333333333333334
17320,/images/3d302619-473d-4c5b-af43-8833ff94233f.png,956,588,1038,678,82,90,red blood cell,7380,1.0975609756097562,0.9111111111111111
64733,/images/76021d69-8919-4688-95ef-7418eff620cc.png,696,711,806,817,110,106,red blood cell,11660,0.9636363636363636,1.0377358490566038
44213,/images/8b494b40-cab5-49d3-893d-c805000fbe88.png,68,1004,178,1093,110,89,red blood cell,9790,0.8090909090909091,1.2359550561797752
34379,/images/1a48cbc1-5423-47e5-8ca5-2ab4f83a05a5.png,915,1163,1045,1291,130,128,red blood cell,16640,0.9846153846153847,1.015625
62681,/images/9e1b0217-0926-4fd1-bb9e-a815c05deb59.png,611,70,709,160,98,90,red blood cell,8820,0.9183673469387755,1.0888888888888888
77269,/images/07a80340-f65e-4f58-9317-94bb6ebd5a28.png,524,1054,614,1152,90,98,red blood cell,8820,1.0888888888888888,0.9183673469387755
46899,/images/9e0e1928-d19a-4100-b093-0b962ac09e05.png,787,437,888,535,101,98,red blood cell,9898,0.9702970297029703,1.030612244897959
13065,/images/555c6ea2-c76c-4e71-af57-855d940c2b37.png,283,1305,404,1414,121,109,red blood cell,13189,0.9008264462809917,1.110091743119266
6837,/images/e36cb882-c6d0-4467-812e-d18c169a9a47.png,175,1185,287,1296,112,111,red blood cell,12432,0.9910714285714286,1.009009009009009
77674,/images/07d15855-eb9b-46a9-b894-7cfe4d097826.png,1079,227,1177,345,98,118,red blood cell,11564,1.2040816326530612,0.8305084745762712
46973,/images/9ebd623d-5534-4dd9-bff8-cdedf322db35.png,642,1186,737,1283,95,97,red blood cell,9215,1.0210526315789474,0.979381443298969
50982,/images/ef8fcfa4-8466-4186-8c69-f5f4904eb489.png,822,8,935,125,113,117,red blood cell,13221,1.0353982300884956,0.9658119658119658
39680,/images/56adbb1e-96a8-40a5-a5a2-243c97ea889b.png,301,1109,419,1229,118,120,red blood cell,14160,1.0169491525423728,0.9833333333333333
32483,/images/3911fcd2-4e26-4ad9-aaf0-d1c5bf41defc.png,686,434,779,542,93,108,red blood cell,10044,1.1612903225806452,0.8611111111111112
556,/images/67acd5bc-4658-4c6e-a9b9-cd8ea3a03418.png,84,312,213,437,129,125,red blood cell,16125,0.9689922480620154,1.032
12307,/images/3b55c42f-ad59-422f-ba99-4f4f4ca9cb2e.png,899,500,997,593,98,93,red blood cell,9114,0.9489795918367347,1.053763440860215
139,/images/6b14c855-8561-417c-97a4-63fa552842fd.png,675,1355,782,1474,107,119,red blood cell,12733,1.1121495327102804,0.8991596638655462
68668,/images/77e76e62-2c71-4b52-9b21-0d1bcde9f9bf.png,555,652,659,757,104,105,red blood cell,10920,1.0096153846153846,0.9904761904761905
33760,/images/441d7843-b20b-4c10-84e3-e6d32621e880.png,696,923,824,1031,128,108,red blood cell,13824,0.84375,1.1851851851851851
47172,/images/3d1b889e-bb4a-4ee6-b899-974ee7d956a7.png,456,1152,561,1268,105,116,red blood cell,12180,1.1047619047619048,0.9051724137931034
30496,/images/5955289d-19e5-45ef-a012-c8ea08ef45e2.png,948,522,1067,649,119,127,red blood cell,15113,1.0672268907563025,0.937007874015748
31749,/images/ab59c9e4-3e50-48b9-874d-060d317410cc.png,165,1398,278,1510,113,112,red blood cell,12656,0.9911504424778761,1.0089285714285714
28761,/images/686ed568-d5f8-475e-81ad-edab9dd473a0.png,976,463,1099,578,123,115,red blood cell,14145,0.9349593495934959,1.0695652173913044
20420,/images/781d4bea-c6a9-4b36-ae10-ba9e328c87fe.png,560,56,675,167,115,111,red blood cell,12765,0.9652173913043478,1.0360360360360361
47903,/images/ab27173b-6e30-4957-bd68-29194328fd39.png,138,104,236,198,98,94,red blood cell,9212,0.9591836734693877,1.0425531914893618
57804,/images/c9ad92d4-b408-4506-916e-def47b2e6ed0.png,130,756,241,861,111,105,red blood cell,11655,0.9459459459459459,1.0571428571428572
7441,/images/37a94c0f-e5d4-46fc-b4f8-994d477995fd.png,55,507,174,620,119,113,red blood cell,13447,0.9495798319327731,1.0530973451327434
26027,/images/612bdd3c-da43-4321-a76b-c73c614928d1.png,871,690,984,808,113,118,red blood cell,13334,1.0442477876106195,0.9576271186440678
33853,/images/b9de8b1a-f96a-4eb5-bc05-84ad43a054f3.png,139,180,265,302,126,122,red blood cell,15372,0.9682539682539683,1.0327868852459017
73303,/images/67a4fb91-6f38-4ca2-8f20-6b2f5f1b29a7.png,320,1001,430,1095,110,94,red blood cell,10340,0.8545454545454545,1.1702127659574468
65764,/images/daea4860-a296-4f6d-acef-996ab0882676.png,845,1034,946,1130,101,96,red blood cell,9696,0.9504950495049505,1.0520833333333333
36484,/images/bd856928-96ee-4fc4-a377-f2fc4e84448b.png,128,462,237,565,109,103,red blood cell,11227,0.944954128440367,1.058252427184466
22991,/images/b687c30d-cf15-445c-b3f6-5aca86584708.png,550,847,649,970,99,123,red blood cell,12177,1.2424242424242424,0.8048780487804879
48180,/images/913099c5-8085-4908-bf4b-1f098bbfcf66.png,334,947,428,1055,94,108,red blood cell,10152,1.148936170212766,0.8703703703703703
40343,/images/eb86033f-4f1c-4e8c-ae84-e8e4c7e08626.png,25,1163,111,1245,86,82,red blood cell,7052,0.9534883720930233,1.048780487804878
72135,/images/64b0e49a-0e48-447d-8872-c1dd255e7a21.png,1097,748,1198,845,101,97,red blood cell,9797,0.9603960396039604,1.041237113402062
22775,/images/8490c623-3d88-4532-baf5-0d266a45b16f.png,947,223,1050,332,103,109,red blood cell,11227,1.058252427184466,0.944954128440367
54419,/images/22a464ef-c3da-4d56-b37e-e22e95d945e7.png,333,974,433,1085,100,111,red blood cell,11100,1.11,0.9009009009009009
15619,/images/84d7545e-c3a8-4b1f-9a39-36aab78c8699.png,182,199,298,316,116,117,red blood cell,13572,1.0086206896551724,0.9914529914529915
75284,/images/9ec1dcec-87c2-4aca-8e6b-0db3cd05509c.png,78,716,166,818,88,102,red blood cell,8976,1.1590909090909092,0.8627450980392157
40916,/images/550cf4ce-b641-44a3-8487-3e16d4049187.png,339,1037,435,1155,96,118,red blood cell,11328,1.2291666666666667,0.8135593220338984
22410,/images/f97c7c87-5e27-45ea-9f93-3285d74091de.png,315,400,416,503,101,103,red blood cell,10403,1.0198019801980198,0.9805825242718447
715,/images/dcc1a193-7b74-44f8-ad8d-813751d8fa6b.png,572,1027,685,1135,113,108,red blood cell,12204,0.9557522123893806,1.0462962962962963
4763,/images/3fa1a4e3-c80d-49da-8f7b-a1abb0424f48.png,424,1298,528,1405,104,107,red blood cell,11128,1.0288461538461537,0.9719626168224299
43078,/images/340a1727-0df7-4e6f-9c0e-9c5deddbfca2.png,575,1270,679,1395,104,125,red blood cell,13000,1.2019230769230769,0.832
46908,/images/9e0e1928-d19a-4100-b093-0b962ac09e05.png,272,90,359,186,87,96,red blood cell,8352,1.103448275862069,0.90625
55806,/images/68f34a9c-f73d-4238-8f55-4b05a8a2154c.png,700,626,779,705,79,79,red blood cell,6241,1.0,1.0
11436,/images/b5513d5b-46fc-4f44-a616-791087fbd608.png,219,1385,347,1511,128,126,red blood cell,16128,0.984375,1.0158730158730158
26701,/images/c1423156-82b3-4dd3-8e74-08eb7ed8e1d6.png,746,738,855,847,109,109,red blood cell,11881,1.0,1.0
47234,/images/58ced55c-bf0d-4204-b6b2-4f8992d92779.png,920,499,1032,601,112,102,red blood cell,11424,0.9107142857142857,1.0980392156862746
72440,/images/a15e0fa8-2620-4f66-896e-175115c9dc3d.png,89,254,200,359,111,105,red blood cell,11655,0.9459459459459459,1.0571428571428572
54628,/images/6473ddb6-ad56-48a2-81e8-c7cb45f06825.png,827,863,932,973,105,110,red blood cell,11550,1.0476190476190477,0.9545454545454546
40708,/images/252071ac-e9f2-41d2-abbb-87ef01b8a997.png,196,923,286,1015,90,92,red blood cell,8280,1.0222222222222221,0.9782608695652174
42867,/images/a7b6894d-eeea-4ed5-bc0e-785d6c6da8df.png,71,864,174,978,103,114,red blood cell,11742,1.1067961165048543,0.9035087719298246
52504,/images/d1144956-5a0c-4bd2-b67d-8498c82d6a12.png,1001,623,1100,720,99,97,red blood cell,9603,0.9797979797979798,1.0206185567010309
66640,/images/b88fe674-fb9a-41d4-b100-cb1c86440d44.png,887,307,974,391,87,84,red blood cell,7308,0.9655172413793104,1.0357142857142858
58853,/images/434523fd-d4d9-4961-a7c2-d71d6ae68e13.png,64,452,153,544,89,92,red blood cell,8188,1.0337078651685394,0.967391304347826
17497,/images/56077789-8580-41b4-89d6-deea227e5c60.png,397,1132,530,1254,133,122,red blood cell,16226,0.9172932330827067,1.0901639344262295
27231,/images/9f38055f-4fe6-47fd-a6dd-c0743db4eccf.png,350,378,454,473,104,95,red blood cell,9880,0.9134615384615384,1.0947368421052632
50342,/images/3d32a988-449d-4d58-b71f-abbfdc3f2fbc.png,217,197,318,295,101,98,red blood cell,9898,0.9702970297029703,1.030612244897959
76352,/images/3dad6483-ac30-4d2b-b045-9f24fe6ff75e.png,581,1448,680,1547,99,99,red blood cell,9801,1.0,1.0
70372,/images/4876c9d0-b386-48fb-84e8-91bf87529161.png,984,583,1075,692,91,109,red blood cell,9919,1.1978021978021978,0.8348623853211009
75705,/images/d12c5f45-6b20-46d6-a66f-c5a4683c25b3.png,972,1362,1078,1475,106,113,red blood cell,11978,1.0660377358490567,0.9380530973451328
19549,/images/2c1eaf87-3fd3-4803-92b8-23bab40bf28c.png,405,438,527,553,122,115,red blood cell,14030,0.9426229508196722,1.0608695652173914
28142,/images/cd2774a0-dab2-4d68-aae9-7568b9f3d2a6.png,632,574,742,691,110,117,red blood cell,12870,1.0636363636363637,0.9401709401709402
39885,/images/af2e63a3-9fde-46aa-a867-81c5c259d1dc.png,845,163,958,285,113,122,red blood cell,13786,1.079646017699115,0.9262295081967213
2220,/images/5bf91ff9-80df-49c0-9c3e-599357d95530.png,397,1227,513,1339,116,112,red blood cell,12992,0.9655172413793104,1.0357142857142858
42726,/images/b8dd6125-5027-47e2-a283-14e199274c80.png,227,748,336,860,109,112,red blood cell,12208,1.0275229357798166,0.9732142857142857
9203,/images/6e7ed596-1b76-4998-8147-a846d53d91c5.png,693,1057,806,1175,113,118,red blood cell,13334,1.0442477876106195,0.9576271186440678
62497,/images/7dfbfeaf-e3b1-4159-8dcd-d7f731280ac8.png,1028,893,1133,993,105,100,red blood cell,10500,0.9523809523809523,1.05
46359,/images/fcc2b245-f47f-447f-8527-275b0005677c.png,74,1203,200,1346,126,143,red blood cell,18018,1.1349206349206349,0.8811188811188811
66448,/images/5f66d20c-fbfe-44ec-a01b-8a09da24807e.png,631,935,739,1043,108,108,red blood cell,11664,1.0,1.0
51121,/images/d64cd75a-df26-44d5-ac25-69061a4e4d57.png,91,870,193,956,102,86,red blood cell,8772,0.8431372549019608,1.186046511627907
78706,/images/76a8a5f5-1328-4539-a131-baf877f40cf3.png,437,1127,552,1236,115,109,red blood cell,12535,0.9478260869565217,1.055045871559633
22659,/images/4ab47131-c2ac-461f-b95c-ac19ce24edbd.png,790,1409,908,1535,118,126,red blood cell,14868,1.0677966101694916,0.9365079365079365
54085,/images/d9345456-b76d-46cc-b81e-46d4a0a7b652.png,746,1351,836,1450,90,99,red blood cell,8910,1.1,0.9090909090909091
45731,/images/584d62ed-4329-45dd-94ce-e929d8b2bb74.png,398,994,500,1076,102,82,red blood cell,8364,0.803921568627451,1.2439024390243902
66104,/images/191f87a4-6f2d-49e7-bba0-08e3aa78ddaf.png,26,118,151,232,125,114,red blood cell,14250,0.912,1.0964912280701755
75373,/images/468c261d-f5d8-423f-883e-48af2bbbc5d1.png,115,901,207,986,92,85,red blood cell,7820,0.9239130434782609,1.0823529411764705
49106,/images/df3d98b9-3dd7-4107-8d4a-ae1b7f247793.png,468,34,549,119,81,85,red blood cell,6885,1.0493827160493827,0.9529411764705882
51684,/images/592c941a-aa54-4971-b499-dc47356f80a3.png,303,4,411,103,108,99,red blood cell,10692,0.9166666666666666,1.0909090909090908
18843,/images/d1b48634-9ad5-46e8-b816-42d1d97c93cd.png,975,88,1082,206,107,118,red blood cell,12626,1.102803738317757,0.9067796610169492
26870,/images/2518f6e4-29cc-4ae4-a914-b215a4c56099.png,713,1061,834,1175,121,114,red blood cell,13794,0.9421487603305785,1.0614035087719298
15372,/images/035f6c4b-0897-46ab-9c3b-5f3b0feff043.png,767,405,866,505,99,100,red blood cell,9900,1.0101010101010102,0.99
24242,/images/bb3ae957-0f6d-4615-bfe5-24fbca50b459.png,743,1123,871,1245,128,122,red blood cell,15616,0.953125,1.0491803278688525
69814,/images/2bd15b6e-fe2d-49f3-b394-940d024d1f91.png,702,457,786,547,84,90,red blood cell,7560,1.0714285714285714,0.9333333333333333
14941,/images/5d1418d3-1559-4725-ad4a-9afb6eaecdfd.png,821,1454,916,1558,95,104,red blood cell,9880,1.0947368421052632,0.9134615384615384
2887,/images/a1c140f9-75d7-42a3-b767-4c01a118892b.png,804,593,925,724,121,131,red blood cell,15851,1.0826446280991735,0.9236641221374046
37675,/images/003a89b0-a095-417a-8dd6-f408339bbc68.png,288,315,410,415,122,100,red blood cell,12200,0.819672131147541,1.22
46505,/images/21417261-475a-456f-b03f-57ac85a6e106.png,728,984,831,1091,103,107,red blood cell,11021,1.0388349514563107,0.9626168224299065
21853,/images/9b3fd401-dab0-440f-8498-eb3cc9ffa970.png,832,464,939,580,107,116,red blood cell,12412,1.0841121495327102,0.9224137931034483
77417,/images/c7ec51d5-9f45-4209-8357-39e9a984a733.png,255,623,355,733,100,110,red blood cell,11000,1.1,0.9090909090909091
60701,/images/45651e76-4bd0-45e5-895b-edec65f51987.png,353,1364,472,1467,119,103,red blood cell,12257,0.865546218487395,1.1553398058252426
13351,/images/a7f1bbb1-6058-4642-bd66-cfb90dce762e.png,345,1184,457,1301,112,117,red blood cell,13104,1.0446428571428572,0.9572649572649573
6258,/images/f4a27dfd-4c52-459f-96b5-ee6b452a3395.png,374,398,496,507,122,109,red blood cell,13298,0.8934426229508197,1.1192660550458715
10364,/images/46a2d369-4bea-4405-ac78-91bbe130b9a7.png,144,149,247,248,103,99,red blood cell,10197,0.9611650485436893,1.0404040404040404
29796,/images/7ef90770-6aeb-45eb-9744-49c5247dde30.png,674,1324,779,1422,105,98,red blood cell,10290,0.9333333333333333,1.0714285714285714
22992,/images/b687c30d-cf15-445c-b3f6-5aca86584708.png,439,284,555,405,116,121,red blood cell,14036,1.043103448275862,0.9586776859504132
21825,/images/9b3fd401-dab0-440f-8498-eb3cc9ffa970.png,96,391,201,501,105,110,red blood cell,11550,1.0476190476190477,0.9545454545454546
57786,/images/5c037ffc-f515-48b3-b231-c110fbd2b8ca.png,990,357,1095,480,105,123,red blood cell,12915,1.1714285714285715,0.8536585365853658
33208,/images/877d5e7f-19b6-40e7-81bd-c92f25e72503.png,803,502,932,632,129,130,red blood cell,16770,1.0077519379844961,0.9923076923076923
60249,/images/abf4cf2a-4532-4772-9f0f-9e123cc1713d.png,209,1084,329,1187,120,103,red blood cell,12360,0.8583333333333333,1.1650485436893203
34001,/images/701206c5-aaac-4b99-9cc0-4a6854359457.png,1083,473,1198,586,115,113,red blood cell,12995,0.9826086956521739,1.0176991150442478
75731,/images/d12c5f45-6b20-46d6-a66f-c5a4683c25b3.png,1061,1307,1166,1423,105,116,red blood cell,12180,1.1047619047619048,0.9051724137931034
70123,/images/c742ee2c-6814-46cd-af56-ae87bb9972f4.png,806,697,898,795,92,98,red blood cell,9016,1.065217391304348,0.9387755102040817
66154,/images/191f87a4-6f2d-49e7-bba0-08e3aa78ddaf.png,30,1421,105,1497,75,76,red blood cell,5700,1.0133333333333334,0.9868421052631579
23524,/images/177f883a-f0f1-4b8e-b598-2ca4bab27381.png,790,1479,898,1583,108,104,red blood cell,11232,0.9629629629629629,1.0384615384615385
26467,/images/2c4d72f1-71a6-4bf1-b5d9-8023c7bbec74.png,1037,1423,1153,1560,116,137,red blood cell,15892,1.1810344827586208,0.8467153284671532
4309,/images/882b91b7-5906-4091-bad4-688d4375eeb5.png,820,1415,914,1519,94,104,red blood cell,9776,1.1063829787234043,0.9038461538461539
38031,/images/e3e9c2de-0a24-4c7e-8a69-3d3093d5bdab.png,574,553,667,664,93,111,red blood cell,10323,1.1935483870967742,0.8378378378378378
71874,/images/61575482-91e1-4db9-83c7-687b7ddbbfc4.png,984,1144,1082,1253,98,109,red blood cell,10682,1.1122448979591837,0.8990825688073395
67250,/images/5f491efd-a21c-4a80-aaba-70b8876238ac.png,646,450,758,564,112,114,red blood cell,12768,1.0178571428571428,0.9824561403508771
59497,/images/6bfe6a90-8a69-4171-8e7f-42dc9417c6d9.png,1013,1342,1132,1453,119,111,red blood cell,13209,0.9327731092436975,1.072072072072072
25480,/images/f6ab936d-924b-4038-aa47-71b07c26b4e2.png,405,1115,520,1233,115,118,red blood cell,13570,1.0260869565217392,0.9745762711864406
16359,/images/69569ecf-cfa1-4ddd-9342-b22c23387fdb.png,906,251,1025,376,119,125,red blood cell,14875,1.050420168067227,0.952
12340,/images/3b55c42f-ad59-422f-ba99-4f4f4ca9cb2e.png,421,896,510,978,89,82,red blood cell,7298,0.9213483146067416,1.0853658536585367
73032,/images/2bd26501-2fbc-4c1a-bef0-4ad57e02b4d0.png,806,105,900,203,94,98,red blood cell,9212,1.0425531914893618,0.9591836734693877
22526,/images/bfe65b11-8aff-46aa-908b-1e989d25fdc4.png,705,105,815,197,110,92,red blood cell,10120,0.8363636363636363,1.1956521739130435
49019,/images/df3d98b9-3dd7-4107-8d4a-ae1b7f247793.png,768,696,878,810,110,114,red blood cell,12540,1.0363636363636364,0.9649122807017544
23542,/images/177f883a-f0f1-4b8e-b598-2ca4bab27381.png,1023,831,1152,950,129,119,red blood cell,15351,0.9224806201550387,1.084033613445378
41258,/images/eed298b3-35f2-4127-88ad-0c4a9062207b.png,173,330,284,452,111,122,red blood cell,13542,1.0990990990990992,0.9098360655737705
38334,/images/674b0fd3-f247-4b7f-97f7-3e6c57c9ba9e.png,215,511,298,602,83,91,red blood cell,7553,1.0963855421686748,0.9120879120879121
45036,/images/13bab3c3-3f79-44d9-a287-0ae6d71eff31.png,724,49,842,187,118,138,red blood cell,16284,1.1694915254237288,0.855072463768116
20230,/images/c66cb6b2-1480-446a-a9d2-b8032a3de0d7.png,315,729,435,836,120,107,red blood cell,12840,0.8916666666666667,1.1214953271028036
1201,/images/5ff7c0c8-d208-4e7d-958d-ca3c2260ff39.png,872,799,1009,932,137,133,red blood cell,18221,0.9708029197080292,1.0300751879699248
16669,/images/bc377041-e098-45c4-9651-2b1ea90d1d7e.png,889,1211,1009,1337,120,126,red blood cell,15120,1.05,0.9523809523809523
22817,/images/72105bb0-8e39-48be-b7f7-5b32f047b99e.png,564,826,687,936,123,110,red blood cell,13530,0.8943089430894309,1.1181818181818182
4084,/images/e02edd82-c424-4dee-98a7-575640655d9b.png,514,830,635,951,121,121,red blood cell,14641,1.0,1.0
9792,/images/3859deaf-6ae1-49a3-9051-898d0f0d7de6.png,459,1270,558,1376,99,106,red blood cell,10494,1.0707070707070707,0.9339622641509434
54283,/images/3b5a8060-dec6-4a83-b7f2-b604e4e69dfc.png,782,740,896,853,114,113,red blood cell,12882,0.9912280701754386,1.008849557522124
69252,/images/f274b784-b995-4a7e-a2c2-6cc31c24c4b4.png,1058,726,1147,817,89,91,red blood cell,8099,1.0224719101123596,0.978021978021978
4948,/images/755e5bf8-e8e1-492b-a32f-f7d87cccaa40.png,678,409,778,520,100,111,red blood cell,11100,1.11,0.9009009009009009
1718,/images/5f783f43-0090-4f8a-bd75-9562f4aa2dd5.png,131,716,246,853,115,137,red blood cell,15755,1.191304347826087,0.8394160583941606
58516,/images/5cac6ddf-c8c6-45de-bce0-a1db64b14fb5.png,756,1123,851,1229,95,106,red blood cell,10070,1.1157894736842104,0.8962264150943396
68200,/images/ff1b23d0-3cef-459b-b81f-39bfcdb6526f.png,916,610,1017,711,101,101,red blood cell,10201,1.0,1.0
65807,/images/daea4860-a296-4f6d-acef-996ab0882676.png,454,365,548,471,94,106,red blood cell,9964,1.127659574468085,0.8867924528301887
50960,/images/ef8fcfa4-8466-4186-8c69-f5f4904eb489.png,797,365,894,467,97,102,red blood cell,9894,1.0515463917525774,0.9509803921568627
57736,/images/5c037ffc-f515-48b3-b231-c110fbd2b8ca.png,156,1315,272,1434,116,119,red blood cell,13804,1.0258620689655173,0.9747899159663865
21542,/images/49efc89d-9cba-44f7-8257-7f911b73f68a.png,307,834,400,929,93,95,red blood cell,8835,1.021505376344086,0.9789473684210527
32953,/images/d1924af6-7512-4ccc-9c6b-adbbaa8db41f.png,63,868,165,980,102,112,red blood cell,11424,1.0980392156862746,0.9107142857142857
79697,/images/03b9d6ad-39ca-4097-a98b-77f02b3c00a7.png,593,669,697,779,104,110,red blood cell,11440,1.0576923076923077,0.9454545454545454
52658,/images/3f390b82-8859-4c27-bbfe-d1b242477f63.png,379,1146,505,1256,126,110,red blood cell,13860,0.873015873015873,1.1454545454545455
61151,/images/80da32ce-8c22-470e-9f35-558c5f7a5df9.png,59,219,139,304,80,85,red blood cell,6800,1.0625,0.9411764705882353
61481,/images/7e837856-3519-4dc0-b357-4cdcfd30b4eb.png,636,747,716,829,80,82,red blood cell,6560,1.025,0.975609756097561
21342,/images/8dace03a-10c4-4d59-bcd9-a2c314c5df33.png,835,280,953,393,118,113,red blood cell,13334,0.9576271186440678,1.0442477876106195
48007,/images/eba73bff-fbe1-436d-9a5f-0a61331a0ea2.png,362,1125,462,1247,100,122,red blood cell,12200,1.22,0.819672131147541
66923,/images/9acf303a-fcba-4e52-be3e-8d061aa5e72a.png,1015,981,1103,1078,88,97,red blood cell,8536,1.1022727272727273,0.9072164948453608
19381,/images/a302a6fa-f635-4ade-b72b-b6f3c2a34ec9.png,421,169,523,289,102,120,red blood cell,12240,1.1764705882352942,0.85
66430,/images/5f66d20c-fbfe-44ec-a01b-8a09da24807e.png,989,982,1100,1076,111,94,red blood cell,10434,0.8468468468468469,1.1808510638297873
52726,/images/9dc6ed5d-6698-48cf-aab3-fd156673729c.png,639,18,738,121,99,103,red blood cell,10197,1.0404040404040404,0.9611650485436893
27339,/images/9f38055f-4fe6-47fd-a6dd-c0743db4eccf.png,530,809,631,891,101,82,red blood cell,8282,0.8118811881188119,1.2317073170731707
33957,/images/701206c5-aaac-4b99-9cc0-4a6854359457.png,509,812,634,934,125,122,red blood cell,15250,0.976,1.0245901639344261
59428,/images/a7c3c52f-3b40-4c92-a212-df9462cf25d8.png,831,1136,926,1236,95,100,red blood cell,9500,1.0526315789473684,0.95
27316,/images/9f38055f-4fe6-47fd-a6dd-c0743db4eccf.png,1092,1369,1187,1467,95,98,red blood cell,9310,1.0315789473684212,0.9693877551020408
25955,/images/e683144c-0465-43a2-86b1-3cf52599d5e0.png,1047,866,1153,975,106,109,red blood cell,11554,1.028301886792453,0.9724770642201835
7588,/images/21cc498b-8cb2-42ed-8f80-bfa27b86ef11.png,366,600,486,715,120,115,red blood cell,13800,0.9583333333333334,1.0434782608695652
5968,/images/97eff653-3908-4e66-931f-eab36bc336c8.png,627,318,748,434,121,116,red blood cell,14036,0.9586776859504132,1.043103448275862
21136,/images/fb05b297-180a-4171-b633-09d5616d7534.png,1067,1471,1192,1590,125,119,red blood cell,14875,0.952,1.050420168067227
68348,/images/0f735cca-051c-4048-a1fa-cb36f389e12f.png,918,725,1048,857,130,132,red blood cell,17160,1.0153846153846153,0.9848484848484849
66121,/images/191f87a4-6f2d-49e7-bba0-08e3aa78ddaf.png,396,1080,480,1183,84,103,red blood cell,8652,1.2261904761904763,0.8155339805825242
965,/images/a8cb75ba-3f2f-40d8-8bc7-c79ebd1b9603.png,617,260,729,392,112,132,red blood cell,14784,1.1785714285714286,0.8484848484848485
720,/images/dcc1a193-7b74-44f8-ad8d-813751d8fa6b.png,160,1251,277,1367,117,116,red blood cell,13572,0.9914529914529915,1.0086206896551724
4142,/images/ac3358f1-ef9a-4ccc-b66c-da5e47e352e0.png,890,846,989,946,99,100,red blood cell,9900,1.0101010101010102,0.99
29918,/images/f2a8a483-b254-43aa-817f-7d525adb8911.png,545,781,665,908,120,127,red blood cell,15240,1.0583333333333333,0.9448818897637795
37181,/images/befe6182-266b-4f8a-ac82-3a4154f05f60.png,469,1188,585,1299,116,111,red blood cell,12876,0.9568965517241379,1.045045045045045
18866,/images/d1b48634-9ad5-46e8-b816-42d1d97c93cd.png,471,1190,582,1291,111,101,red blood cell,11211,0.9099099099099099,1.099009900990099
11361,/images/2f6224be-50d0-4e85-94ef-88315df561b6.png,201,28,293,136,92,108,red blood cell,9936,1.173913043478261,0.8518518518518519
4424,/images/21ea4841-8998-4c04-b345-bc99cd8ecee6.png,160,1184,279,1307,119,123,red blood cell,14637,1.0336134453781514,0.967479674796748
74589,/images/bbedfcbe-9528-4ba9-9d86-4ebba7589ac5.png,1074,465,1166,555,92,90,red blood cell,8280,0.9782608695652174,1.0222222222222221
70085,/images/b8339d7b-85ec-48d0-83e8-c8f831070459.png,378,935,507,1050,129,115,red blood cell,14835,0.8914728682170543,1.1217391304347826
29254,/images/6274fe0d-0d71-40be-b61b-f0bd5b5df1e2.png,197,28,288,107,91,79,red blood cell,7189,0.8681318681318682,1.1518987341772151
26098,/images/71925778-a26e-483e-a07c-f3aaf740122a.png,521,1462,639,1561,118,99,red blood cell,11682,0.8389830508474576,1.1919191919191918
28644,/images/861c3e06-aada-47a0-99ae-94fbc2772cc0.png,312,1154,412,1267,100,113,red blood cell,11300,1.13,0.8849557522123894
27195,/images/bca27923-b270-45df-a0bf-3e1a7d135b2c.png,286,298,392,413,106,115,red blood cell,12190,1.0849056603773586,0.9217391304347826
135,/images/6b14c855-8561-417c-97a4-63fa552842fd.png,724,1027,834,1136,110,109,red blood cell,11990,0.990909090909091,1.0091743119266054
10891,/images/b78b88f0-154a-4b54-8aaf-85d37a42a0f9.png,466,282,588,388,122,106,red blood cell,12932,0.8688524590163934,1.150943396226415
49967,/images/05804cf0-f854-4099-97c2-df287f7c8a8c.png,565,456,691,572,126,116,red blood cell,14616,0.9206349206349206,1.0862068965517242
11746,/images/082e1f81-4f49-44ad-b5bb-9dfc155b2ed8.png,223,150,317,255,94,105,red blood cell,9870,1.1170212765957446,0.8952380952380953
49922,/images/05804cf0-f854-4099-97c2-df287f7c8a8c.png,320,878,439,989,119,111,red blood cell,13209,0.9327731092436975,1.072072072072072
30346,/images/4aad9589-6b32-4522-bcd7-ca04687a02ca.png,125,1218,224,1340,99,122,red blood cell,12078,1.2323232323232323,0.8114754098360656
55580,/images/a27b451d-44a6-4740-861a-9e7e99915563.png,1003,144,1091,221,88,77,red blood cell,6776,0.875,1.1428571428571428
71599,/images/390ad256-e1ed-476a-9f14-2dc34e0da632.png,31,424,140,532,109,108,red blood cell,11772,0.9908256880733946,1.0092592592592593
76214,/images/07a96126-482e-4beb-b42a-0cb59e505372.png,683,806,782,900,99,94,red blood cell,9306,0.9494949494949495,1.053191489361702
56073,/images/ffb7be9a-65df-4f0b-99ae-cfd34e81cd34.png,784,1097,890,1209,106,112,red blood cell,11872,1.0566037735849056,0.9464285714285714
19348,/images/a302a6fa-f635-4ade-b72b-b6f3c2a34ec9.png,548,368,658,472,110,104,red blood cell,11440,0.9454545454545454,1.0576923076923077
66051,/images/c8af0297-ce1f-40ea-bf44-9256dcdae4e9.png,271,1228,387,1335,116,107,red blood cell,12412,0.9224137931034483,1.0841121495327102
71460,/images/191071ab-6515-428c-9f05-8e4309542b75.png,479,1325,586,1433,107,108,red blood cell,11556,1.0093457943925233,0.9907407407407407
18063,/images/0f0c949e-018a-4f3f-ab02-3704f49c7754.png,64,794,159,882,95,88,red blood cell,8360,0.9263157894736842,1.0795454545454546
57640,/images/d32022fa-e492-4b31-a776-9435cfdef6d6.png,114,1036,227,1147,113,111,red blood cell,12543,0.9823008849557522,1.018018018018018
33359,/images/f632981c-1330-4078-8a12-691beb2dab02.png,858,555,968,663,110,108,red blood cell,11880,0.9818181818181818,1.0185185185185186
43168,/images/c5db0fc0-b96c-496e-90b4-f9fb1b85b28e.png,527,480,634,580,107,100,red blood cell,10700,0.9345794392523364,1.07
11994,/images/ca16a5ad-b106-4e84-8a43-178710e854ba.png,794,633,898,736,104,103,red blood cell,10712,0.9903846153846154,1.0097087378640777
57476,/images/00d04a90-80e5-4bce-9511-1b64eabb7a47.png,181,263,290,363,109,100,red blood cell,10900,0.9174311926605505,1.09
13708,/images/0b04ec46-5119-4cda-8c35-c4e5b6f0eed0.png,920,614,1034,745,114,131,red blood cell,14934,1.1491228070175439,0.8702290076335878
36472,/images/cfe6086f-eb0b-4cb0-a430-8cd7de6556e2.png,141,1348,240,1441,99,93,red blood cell,9207,0.9393939393939394,1.064516129032258
72271,/images/ee57e743-a876-4f69-9fe5-bf5d01b44689.png,706,1243,802,1346,96,103,red blood cell,9888,1.0729166666666667,0.9320388349514563
68084,/images/29d40b60-cde1-45b5-b403-692437a77ac1.png,279,418,396,525,117,107,red blood cell,12519,0.9145299145299145,1.0934579439252337
77686,/images/07d15855-eb9b-46a9-b894-7cfe4d097826.png,549,820,639,925,90,105,red blood cell,9450,1.1666666666666667,0.8571428571428571
15328,/images/2d0f600d-f94e-4907-b712-52fb37d9ed52.png,323,719,409,821,86,102,red blood cell,8772,1.186046511627907,0.8431372549019608
74209,/images/4e43fc22-dc08-4cde-b3ce-ce8a4f377c47.png,479,1430,563,1522,84,92,red blood cell,7728,1.0952380952380953,0.9130434782608695
48478,/images/9c4cb048-d64a-4b7f-84ff-ca28a8084fc7.png,10,1173,133,1299,123,126,red blood cell,15498,1.024390243902439,0.9761904761904762
26087,/images/71925778-a26e-483e-a07c-f3aaf740122a.png,977,499,1101,608,124,109,red blood cell,13516,0.8790322580645161,1.1376146788990826
31664,/images/0d7bf56f-3b5a-40bd-971c-2ca33dd89b2c.png,77,1044,160,1125,83,81,red blood cell,6723,0.9759036144578314,1.0246913580246915
40854,/images/bf20d04d-ff8a-4910-91d7-94054c267d1b.png,248,1167,376,1288,128,121,red blood cell,15488,0.9453125,1.0578512396694215
22317,/images/49b03a6e-6b26-4a96-a061-e05647a02138.png,428,1198,541,1311,113,113,red blood cell,12769,1.0,1.0
4593,/images/f1de7c7e-e7d3-45ae-a66c-58538bf6cac1.png,407,138,508,240,101,102,red blood cell,10302,1.00990099009901,0.9901960784313726
57599,/images/8190ec37-9a5e-419f-89ed-fbfb079370db.png,108,591,202,696,94,105,red blood cell,9870,1.1170212765957446,0.8952380952380953
27287,/images/9f38055f-4fe6-47fd-a6dd-c0743db4eccf.png,267,1420,377,1513,110,93,red blood cell,10230,0.8454545454545455,1.1827956989247312
39138,/images/7bde7de1-889b-4218-b0e1-e2c04f6a7986.png,246,32,365,136,119,104,red blood cell,12376,0.8739495798319328,1.1442307692307692
36396,/images/4a0a05e1-11ad-4bfc-bfa3-adf3b9bd0b56.png,450,501,567,609,117,108,red blood cell,12636,0.9230769230769231,1.0833333333333333
74927,/images/dd090806-e4ac-4a78-b2ee-55a30626369c.png,1028,516,1167,652,139,136,red blood cell,18904,0.9784172661870504,1.0220588235294117
52924,/images/abb2f9d6-26fa-4328-983c-959ef6717c05.png,134,180,226,277,92,97,red blood cell,8924,1.0543478260869565,0.9484536082474226
69359,/images/2ac343e4-c889-47c1-8fe2-461b626def76.png,904,1110,1027,1249,123,139,red blood cell,17097,1.1300813008130082,0.8848920863309353
48025,/images/eba73bff-fbe1-436d-9a5f-0a61331a0ea2.png,456,1027,552,1138,96,111,red blood cell,10656,1.15625,0.8648648648648649
9719,/images/53afd70c-08a7-4b9a-b137-7003b2ecbeab.png,612,1031,716,1122,104,91,red blood cell,9464,0.875,1.1428571428571428
16367,/images/69569ecf-cfa1-4ddd-9342-b22c23387fdb.png,976,1235,1112,1366,136,131,red blood cell,17816,0.9632352941176471,1.0381679389312977
42065,/images/46a03374-64c7-49ac-81c9-c3d62542bbf3.png,375,649,476,741,101,92,red blood cell,9292,0.9108910891089109,1.0978260869565217
36701,/images/21f001d6-f568-4ea4-82da-fab54c77c419.png,686,174,800,288,114,114,red blood cell,12996,1.0,1.0
73497,/images/5f2b32bd-fdca-4d6f-b13a-ee9f83626c8d.png,603,733,697,826,94,93,red blood cell,8742,0.9893617021276596,1.010752688172043
27845,/images/948c94ad-395c-41f4-9a68-8a1dcb76888c.png,942,619,1042,721,100,102,red blood cell,10200,1.02,0.9803921568627451
65651,/images/397f37bc-a3a4-4257-9430-c8fc5716f8b1.png,231,937,356,1050,125,113,red blood cell,14125,0.904,1.1061946902654867
42510,/images/29648565-fe28-4517-ba72-68df0c82c9c5.png,334,924,438,1025,104,101,red blood cell,10504,0.9711538461538461,1.0297029702970297
79352,/images/dcb21739-3c36-459d-b3cc-1be5871d6fe7.png,263,712,359,807,96,95,red blood cell,9120,0.9895833333333334,1.0105263157894737
6974,/images/c776eb78-3323-4571-b39f-7ffc73ae63ce.png,514,184,627,297,113,113,red blood cell,12769,1.0,1.0
19652,/images/a3ada657-de00-44db-b1e2-54ba17e39983.png,647,816,761,951,114,135,red blood cell,15390,1.1842105263157894,0.8444444444444444
41794,/images/28bd16ba-2bcf-46af-b889-41b78d2a50c0.png,791,1109,899,1220,108,111,red blood cell,11988,1.0277777777777777,0.972972972972973
30505,/images/5955289d-19e5-45ef-a012-c8ea08ef45e2.png,1037,942,1162,1071,125,129,red blood cell,16125,1.032,0.9689922480620154
77145,/images/dd6f047e-af73-43df-9c46-354534fc20e0.png,1054,1015,1160,1122,106,107,red blood cell,11342,1.009433962264151,0.9906542056074766
62296,/images/e0ff3476-226f-4125-b182-8e524d5503dd.png,399,951,501,1065,102,114,red blood cell,11628,1.1176470588235294,0.8947368421052632
33249,/images/877d5e7f-19b6-40e7-81bd-c92f25e72503.png,1041,184,1183,301,142,117,red blood cell,16614,0.823943661971831,1.2136752136752136
76839,/images/2165fe38-b474-467d-be11-d1d728085efd.png,478,1458,574,1550,96,92,red blood cell,8832,0.9583333333333334,1.0434782608695652
36656,/images/21f001d6-f568-4ea4-82da-fab54c77c419.png,2,471,92,565,90,94,red blood cell,8460,1.0444444444444445,0.9574468085106383
16493,/images/9e5437c6-b0d3-473b-b7c3-8f5afeb90c7a.png,258,1128,377,1239,119,111,red blood cell,13209,0.9327731092436975,1.072072072072072
70884,/images/bf002a25-6535-4621-be19-56d468be5413.png,1038,135,1141,246,103,111,red blood cell,11433,1.0776699029126213,0.9279279279279279
29152,/images/cfab01d3-0616-4efb-9290-11f0fd8bf5a3.png,705,1423,811,1545,106,122,red blood cell,12932,1.150943396226415,0.8688524590163934
50629,/images/c956e531-6805-4fe1-b61c-8b96a9815a77.png,364,870,472,973,108,103,red blood cell,11124,0.9537037037037037,1.0485436893203883
8235,/images/65e3d6a6-012c-4b40-9a42-83078eb85e31.png,576,190,680,288,104,98,red blood cell,10192,0.9423076923076923,1.0612244897959184
44690,/images/8002cb71-0f25-4fa4-a46f-b49e5aeded0c.png,373,1042,490,1140,117,98,red blood cell,11466,0.8376068376068376,1.1938775510204083
38898,/images/d79b4e90-c45d-4f5d-a498-49c3e323c291.png,160,1392,267,1504,107,112,red blood cell,11984,1.0467289719626167,0.9553571428571429
19101,/images/2196389c-45ec-46b5-bc6c-1f4a33df7f7c.png,961,529,1077,657,116,128,red blood cell,14848,1.103448275862069,0.90625
78575,/images/c5084fb8-2b62-464c-8a77-1a07ea653266.png,527,977,625,1069,98,92,red blood cell,9016,0.9387755102040817,1.065217391304348
67579,/images/59542a24-b409-4c95-8608-d9691a741526.png,976,677,1079,786,103,109,red blood cell,11227,1.058252427184466,0.944954128440367
46297,/images/e11515b4-9527-4c23-a0ba-43719bacca0d.png,766,332,892,438,126,106,red blood cell,13356,0.8412698412698413,1.1886792452830188
23007,/images/0d095f3a-9243-472b-90b4-0ce8309e778c.png,668,275,786,376,118,101,red blood cell,11918,0.8559322033898306,1.1683168316831682
10274,/images/f91670db-be74-474c-bd72-68120aed4756.png,819,262,914,353,95,91,red blood cell,8645,0.9578947368421052,1.043956043956044
62031,/images/bdb5d571-27bc-4a42-ae45-aa5a9af40a81.png,666,85,765,181,99,96,red blood cell,9504,0.9696969696969697,1.03125
8963,/images/04628a94-b674-469b-aff6-b476b70df87d.png,1087,595,1200,712,113,117,red blood cell,13221,1.0353982300884956,0.9658119658119658
56984,/images/003d1cdc-0aec-430b-90e0-f4d82135b1ac.png,302,1114,425,1235,123,121,red blood cell,14883,0.983739837398374,1.0165289256198347
74990,/images/b4c52960-bbee-439e-83dc-f89ddaade71b.png,1017,602,1120,703,103,101,red blood cell,10403,0.9805825242718447,1.0198019801980198
10808,/images/2a02cec2-a09b-483a-ad38-14359a763fa4.png,936,548,1038,659,102,111,red blood cell,11322,1.088235294117647,0.918918918918919
12932,/images/b10ea12f-cd36-4f2c-994a-67d1665269ab.png,362,1458,466,1566,104,108,red blood cell,11232,1.0384615384615385,0.9629629629629629
15822,/images/c7c1b873-0548-4a73-9618-f60912e164df.png,694,815,817,917,123,102,red blood cell,12546,0.8292682926829268,1.2058823529411764
21222,/images/0ceb4539-5c4c-487d-9826-452a88b5d537.png,604,880,743,1000,139,120,red blood cell,16680,0.8633093525179856,1.1583333333333334
26976,/images/1f337b61-1b0d-4539-91f9-73d4a0798a4a.png,1035,705,1139,799,104,94,red blood cell,9776,0.9038461538461539,1.1063829787234043
61909,/images/f32b21ae-5ca7-490b-bc40-6db9396d933c.png,769,472,880,576,111,104,red blood cell,11544,0.9369369369369369,1.0673076923076923
38174,/images/33bdb7b5-ad5b-4a73-bbc2-3350f8c2ac0c.png,395,564,509,681,114,117,red blood cell,13338,1.0263157894736843,0.9743589743589743
68065,/images/29d40b60-cde1-45b5-b403-692437a77ac1.png,752,449,872,560,120,111,red blood cell,13320,0.925,1.0810810810810811
12785,/images/b634137b-bc8b-4e88-b0e3-b536ad6e7e18.png,783,866,889,954,106,88,red blood cell,9328,0.8301886792452831,1.2045454545454546
17580,/images/e80bad38-66d0-473e-85dd-92142dba37e6.png,257,1240,383,1370,126,130,red blood cell,16380,1.0317460317460319,0.9692307692307692
13416,/images/370277f8-436b-4103-8210-b4feb5ab95ea.png,572,487,688,590,116,103,red blood cell,11948,0.8879310344827587,1.1262135922330097
23511,/images/177f883a-f0f1-4b8e-b598-2ca4bab27381.png,90,1237,200,1342,110,105,red blood cell,11550,0.9545454545454546,1.0476190476190477
71385,/images/bcb447c9-5d37-414f-a513-d7076b04a532.png,88,392,185,498,97,106,red blood cell,10282,1.092783505154639,0.9150943396226415
3992,/images/f09acb0c-b270-4e91-99f8-410adfa7f34a.png,1025,473,1117,585,92,112,red blood cell,10304,1.2173913043478262,0.8214285714285714
23953,/images/3d8fb5bf-3315-48fb-8ab1-802eafd550bc.png,580,991,693,1088,113,97,red blood cell,10961,0.8584070796460177,1.1649484536082475
46202,/images/d8632217-ec33-4d0a-98e6-427824c58869.png,828,396,940,508,112,112,red blood cell,12544,1.0,1.0
63411,/images/289ef1b7-02d5-42e9-a401-687688181306.png,220,336,322,440,102,104,red blood cell,10608,1.0196078431372548,0.9807692307692307
21744,/images/f68ae8e9-e760-4106-88e0-4bdef2785f06.png,924,157,1040,252,116,95,red blood cell,11020,0.8189655172413793,1.2210526315789474
27135,/images/f232eec3-02c0-43f9-bf32-3e60245397e2.png,390,702,508,829,118,127,red blood cell,14986,1.076271186440678,0.9291338582677166
48382,/images/0fa5b35d-6c44-4207-b6f8-d5b355086b5f.png,614,291,726,397,112,106,red blood cell,11872,0.9464285714285714,1.0566037735849056
54065,/images/d9345456-b76d-46cc-b81e-46d4a0a7b652.png,207,622,304,721,97,99,red blood cell,9603,1.0206185567010309,0.9797979797979798
42815,/images/7029feb3-9ffe-46e4-9883-6a9df84f7b62.png,471,732,566,837,95,105,red blood cell,9975,1.105263157894737,0.9047619047619048
33017,/images/6231d81d-9e84-4a5a-8cb8-47c6a37a0176.png,756,1164,860,1263,104,99,red blood cell,10296,0.9519230769230769,1.0505050505050506
28821,/images/686ed568-d5f8-475e-81ad-edab9dd473a0.png,654,551,781,666,127,115,red blood cell,14605,0.905511811023622,1.1043478260869566
26277,/images/52767904-4cdc-4821-ba68-8cd0c28f9023.png,902,681,1030,822,128,141,red blood cell,18048,1.1015625,0.9078014184397163
8363,/images/9a1cd456-310c-47b6-a1f8-0fbd8e33d1fd.png,775,1020,909,1165,134,145,red blood cell,19430,1.0820895522388059,0.9241379310344827
21936,/images/d57b3894-c912-47e8-b00a-e1a2a7aba644.png,891,1276,1004,1384,113,108,red blood cell,12204,0.9557522123893806,1.0462962962962963
40813,/images/252071ac-e9f2-41d2-abbb-87ef01b8a997.png,187,859,274,939,87,80,red blood cell,6960,0.9195402298850575,1.0875
14054,/images/eaf4b781-b3aa-41ce-8c5e-287979b4e15a.png,596,118,683,220,87,102,red blood cell,8874,1.1724137931034482,0.8529411764705882
62198,/images/a72cd558-b7ac-4bf2-a344-2ce6c73a354e.png,491,1379,582,1487,91,108,red blood cell,9828,1.1868131868131868,0.8425925925925926
32612,/images/ed0d8763-e734-4506-b61b-53fc32a8d8c9.png,219,114,339,245,120,131,red blood cell,15720,1.0916666666666666,0.916030534351145
16956,/images/8eeb378e-90f0-47ea-ac1c-2a201eb8d090.png,555,427,680,558,125,131,red blood cell,16375,1.048,0.9541984732824428
44204,/images/8b494b40-cab5-49d3-893d-c805000fbe88.png,674,672,780,780,106,108,red blood cell,11448,1.0188679245283019,0.9814814814814815
16317,/images/d5009906-bce1-4353-90b4-f4c79362f4cf.png,278,286,385,399,107,113,red blood cell,12091,1.0560747663551402,0.9469026548672567
16813,/images/4823c1fe-a7f9-4b92-959f-0d9be09cd14b.png,149,1345,254,1452,105,107,red blood cell,11235,1.019047619047619,0.9813084112149533
33101,/images/6231d81d-9e84-4a5a-8cb8-47c6a37a0176.png,788,123,885,208,97,85,red blood cell,8245,0.8762886597938144,1.1411764705882352
27496,/images/f5869ba8-6253-426b-93f3-82af59a86144.png,32,1319,138,1441,106,122,red blood cell,12932,1.150943396226415,0.8688524590163934
49426,/images/f2574be3-81c6-4fc3-8a40-0230d1264f52.png,907,709,1031,823,124,114,red blood cell,14136,0.9193548387096774,1.087719298245614
65483,/images/da49db57-0c2f-4213-b322-c88c19fb9296.png,313,632,414,726,101,94,red blood cell,9494,0.9306930693069307,1.074468085106383
54230,/images/3b5a8060-dec6-4a83-b7f2-b604e4e69dfc.png,1074,819,1185,922,111,103,red blood cell,11433,0.9279279279279279,1.0776699029126213
78935,/images/4d0a1598-e4dd-45c4-8a90-dd7c780fe1da.png,847,701,948,802,101,101,red blood cell,10201,1.0,1.0
39168,/images/2aeb7b85-7df9-4a63-8d37-2eecaaa190e7.png,101,566,233,698,132,132,red blood cell,17424,1.0,1.0
7741,/images/187f92b2-71ed-484a-9bd3-599ca0d2636f.png,1016,560,1115,671,99,111,red blood cell,10989,1.121212121212121,0.8918918918918919
52098,/images/de6d3020-9347-473b-9146-8909627790f6.png,1095,1026,1198,1125,103,99,red blood cell,10197,0.9611650485436893,1.0404040404040404
30918,/images/533c47c9-02a6-419b-961b-81797f022f6c.png,457,611,562,713,105,102,red blood cell,10710,0.9714285714285714,1.0294117647058822
793,/images/27fab82c-5bf0-426f-aeb9-47da829b6629.png,1003,456,1127,580,124,124,red blood cell,15376,1.0,1.0
9842,/images/3859deaf-6ae1-49a3-9051-898d0f0d7de6.png,87,807,172,891,85,84,red blood cell,7140,0.9882352941176471,1.0119047619047619
18531,/images/c22f7031-9cf8-48ce-b03b-1b12d0db4951.png,490,1355,618,1465,128,110,red blood cell,14080,0.859375,1.1636363636363636
63373,/images/9f4bc3b4-abb0-4bcb-baa8-ec9f25e2b9c6.png,909,1326,1011,1437,102,111,red blood cell,11322,1.088235294117647,0.918918918918919
19565,/images/883d9731-a04d-4f84-83c9-d3bef954759d.png,879,878,996,1003,117,125,red blood cell,14625,1.0683760683760684,0.936
64344,/images/0a7bfa8a-ee52-4f7a-b9c5-2919ecfa93ef.png,194,130,291,234,97,104,red blood cell,10088,1.0721649484536082,0.9326923076923077
67045,/images/1fe1e118-adb8-4b10-a41e-1e5814e8f067.png,943,574,1035,683,92,109,red blood cell,10028,1.184782608695652,0.8440366972477065
3856,/images/73dd09d3-2bff-4b5e-b996-9da0b8b54a8f.png,555,463,673,580,118,117,red blood cell,13806,0.9915254237288136,1.0085470085470085
38083,/images/907650b5-edae-471d-bc54-a825be3d3fac.png,572,738,696,866,124,128,red blood cell,15872,1.032258064516129,0.96875
36318,/images/81fed4a1-9d48-4938-90c9-c8bf3f5e6b1f.png,26,1085,150,1211,124,126,red blood cell,15624,1.0161290322580645,0.9841269841269841
73346,/images/c890ee00-daa5-4b20-9cd5-930748ecc4e0.png,9,332,121,466,112,134,red blood cell,15008,1.1964285714285714,0.835820895522388
32502,/images/d31dd2c0-ae8e-4499-86bb-7cabb6e438b9.png,844,425,963,545,119,120,red blood cell,14280,1.0084033613445378,0.9916666666666667
48037,/images/1d4f06e1-9c9b-487e-84cd-e7e50cc754da.png,1055,1060,1165,1164,110,104,red blood cell,11440,0.9454545454545454,1.0576923076923077
21860,/images/9b3fd401-dab0-440f-8498-eb3cc9ffa970.png,150,1369,246,1465,96,96,red blood cell,9216,1.0,1.0
71112,/images/b666fcc2-d0b2-441e-bc5a-c660345eeb5d.png,136,48,246,168,110,120,red blood cell,13200,1.0909090909090908,0.9166666666666666
19213,/images/064b84fe-bd21-4c27-b682-0a832272eac4.png,413,743,535,864,122,121,red blood cell,14762,0.9918032786885246,1.0082644628099173
25040,/images/ed0bee2f-05e0-4392-8357-19750cec577c.png,416,1012,507,1108,91,96,red blood cell,8736,1.054945054945055,0.9479166666666666
16897,/images/f5419bc0-4415-41b6-b832-5326cfcc534b.png,602,823,724,931,122,108,red blood cell,13176,0.8852459016393442,1.1296296296296295
18244,/images/947348fe-4c70-468e-8009-3c14daeca69b.png,172,44,276,164,104,120,red blood cell,12480,1.1538461538461537,0.8666666666666667
1943,/images/b95ceeeb-8870-4492-9037-2091ff268c5a.png,980,1368,1098,1484,118,116,red blood cell,13688,0.9830508474576272,1.0172413793103448
25413,/images/5f742392-278d-461c-a848-08def2c28878.png,149,909,287,1037,138,128,red blood cell,17664,0.927536231884058,1.078125
51325,/images/b4f3b2a4-f4b9-48de-ac5d-0e681b77be27.png,256,1294,363,1405,107,111,red blood cell,11877,1.0373831775700935,0.963963963963964
76051,/images/4c7d2382-a962-4237-a053-955eea3decd8.png,978,6,1089,110,111,104,red blood cell,11544,0.9369369369369369,1.0673076923076923
33091,/images/6231d81d-9e84-4a5a-8cb8-47c6a37a0176.png,218,598,315,688,97,90,red blood cell,8730,0.9278350515463918,1.0777777777777777
11532,/images/834a30bb-26bf-4e60-9ea1-3250b926892e.png,1042,215,1158,337,116,122,red blood cell,14152,1.0517241379310345,0.9508196721311475
45811,/images/584d62ed-4329-45dd-94ce-e929d8b2bb74.png,615,9,706,116,91,107,red blood cell,9737,1.1758241758241759,0.8504672897196262
15170,/images/3a8f468f-f9de-46a8-a7c8-f2be239fa207.png,1068,793,1156,876,88,83,red blood cell,7304,0.9431818181818182,1.0602409638554218
12042,/images/b234b6ea-b54d-470c-8461-ba7f4a024796.png,396,1381,527,1510,131,129,red blood cell,16899,0.9847328244274809,1.0155038759689923
50926,/images/ef8fcfa4-8466-4186-8c69-f5f4904eb489.png,434,416,538,544,104,128,red blood cell,13312,1.2307692307692308,0.8125
22682,/images/4ab47131-c2ac-461f-b95c-ac19ce24edbd.png,180,251,272,359,92,108,red blood cell,9936,1.173913043478261,0.8518518518518519
66860,/images/9106a6bb-1352-411f-ac26-0d6fe48c16a8.png,255,1296,362,1409,107,113,red blood cell,12091,1.0560747663551402,0.9469026548672567
46033,/images/72088c26-d2dd-4906-b791-b8947fc7fbe4.png,526,876,632,981,106,105,red blood cell,11130,0.9905660377358491,1.0095238095238095
68783,/images/aa3ad405-828e-4986-8251-20fd981f34d3.png,862,317,977,432,115,115,red blood cell,13225,1.0,1.0
58301,/images/319c9c52-f316-49f3-baad-4444ab19f85b.png,525,857,631,967,106,110,red blood cell,11660,1.0377358490566038,0.9636363636363636
16328,/images/d5009906-bce1-4353-90b4-f4c79362f4cf.png,513,228,621,334,108,106,red blood cell,11448,0.9814814814814815,1.0188679245283019
12473,/images/cc94eabb-a3dc-4cfc-9fff-55c76b5b4a71.png,691,725,791,830,100,105,red blood cell,10500,1.05,0.9523809523809523
54370,/images/19370afd-f897-47d8-bfae-c0d257bbf795.png,23,1244,126,1343,103,99,red blood cell,10197,0.9611650485436893,1.0404040404040404
16917,/images/f5419bc0-4415-41b6-b832-5326cfcc534b.png,719,1069,850,1185,131,116,red blood cell,15196,0.8854961832061069,1.1293103448275863
50665,/images/c956e531-6805-4fe1-b61c-8b96a9815a77.png,0,617,100,723,100,106,red blood cell,10600,1.06,0.9433962264150944
30477,/images/5955289d-19e5-45ef-a012-c8ea08ef45e2.png,552,843,685,980,133,137,red blood cell,18221,1.0300751879699248,0.9708029197080292
35678,/images/4063945d-03fc-4ce3-a04c-17435dce8f91.png,925,482,1035,595,110,113,red blood cell,12430,1.0272727272727273,0.9734513274336283
21985,/images/393df10a-5d64-476b-88f5-14ac56d6ed60.png,37,705,145,811,108,106,red blood cell,11448,0.9814814814814815,1.0188679245283019
10690,/images/20d4f65e-6c63-433a-935c-d568d577967b.png,284,471,377,574,93,103,red blood cell,9579,1.10752688172043,0.9029126213592233
20415,/images/781d4bea-c6a9-4b36-ae10-ba9e328c87fe.png,607,766,729,893,122,127,red blood cell,15494,1.040983606557377,0.9606299212598425
6949,/images/a9feccda-18f2-405e-9aa1-409fa1f49fe4.png,257,1068,364,1164,107,96,red blood cell,10272,0.897196261682243,1.1145833333333333
38269,/images/b834cbf7-ff97-49d9-9561-566c9343735c.png,1075,503,1179,610,104,107,red blood cell,11128,1.0288461538461537,0.9719626168224299
64175,/images/2a91387a-d30f-418d-ac3a-f7cfa6836261.png,427,1280,523,1374,96,94,red blood cell,9024,0.9791666666666666,1.0212765957446808
22196,/images/ca677c3c-083f-4d54-9dec-39f79f6a17d8.png,302,779,406,883,104,104,red blood cell,10816,1.0,1.0
64705,/images/76021d69-8919-4688-95ef-7418eff620cc.png,1037,1414,1128,1501,91,87,red blood cell,7917,0.9560439560439561,1.0459770114942528
31136,/images/1976cd04-d24f-457c-b423-7e4cdb05de9e.png,624,1061,738,1179,114,118,red blood cell,13452,1.0350877192982457,0.9661016949152542
2121,/images/e94a811d-3145-4313-ba42-2d5ed283179f.png,465,1296,580,1398,115,102,red blood cell,11730,0.8869565217391304,1.1274509803921569
33081,/images/6231d81d-9e84-4a5a-8cb8-47c6a37a0176.png,953,1471,1030,1554,77,83,red blood cell,6391,1.077922077922078,0.927710843373494
72777,/images/caeb2d62-1166-43f0-8eac-5b8fc48f02eb.png,1085,601,1177,703,92,102,red blood cell,9384,1.108695652173913,0.9019607843137255
76882,/images/2165fe38-b474-467d-be11-d1d728085efd.png,261,327,370,418,109,91,red blood cell,9919,0.8348623853211009,1.1978021978021978
11619,/images/37e072a6-000d-4773-8d9f-d66b60ace668.png,870,148,968,265,98,117,red blood cell,11466,1.1938775510204083,0.8376068376068376
61237,/images/b3058064-d817-47dd-a8c4-cdb1f62374f8.png,444,340,543,436,99,96,red blood cell,9504,0.9696969696969697,1.03125
51760,/images/f07174a5-f799-4286-ac43-5b0f5c5777ac.png,1009,73,1130,183,121,110,red blood cell,13310,0.9090909090909091,1.1
24087,/images/505355c9-23bf-4f90-8ebc-6a7ef50964d0.png,53,522,170,639,117,117,red blood cell,13689,1.0,1.0
70955,/images/deaa1931-5f97-45bf-8c00-be6ddeb37b9a.png,544,1012,648,1123,104,111,red blood cell,11544,1.0673076923076923,0.9369369369369369
59107,/images/5e2cea49-0823-49d1-83cf-8fd1559cdd93.png,669,650,771,750,102,100,red blood cell,10200,0.9803921568627451,1.02
49643,/images/bd7937db-fca2-44d0-8538-460110210927.png,0,50,114,160,114,110,red blood cell,12540,0.9649122807017544,1.0363636363636364
6504,/images/640c4a52-3742-4f57-aee3-9e3dc0887622.png,683,1234,790,1355,107,121,red blood cell,12947,1.1308411214953271,0.8842975206611571
61584,/images/4a717a39-80f8-4b75-a25e-c46d65d7dcd5.png,394,1352,488,1458,94,106,red blood cell,9964,1.127659574468085,0.8867924528301887
65962,/images/25c6cfb1-01d0-4864-87f9-02b7593683c7.png,11,684,105,785,94,101,red blood cell,9494,1.074468085106383,0.9306930693069307
8232,/images/65e3d6a6-012c-4b40-9a42-83078eb85e31.png,377,886,466,991,89,105,red blood cell,9345,1.1797752808988764,0.8476190476190476
19884,/images/b318889c-3c60-477c-b8f6-d18cb01a59df.png,570,382,663,470,93,88,red blood cell,8184,0.946236559139785,1.0568181818181819
46418,/images/bbecf1a8-a728-4c83-87f8-4dfbac0a1e03.png,755,174,850,270,95,96,red blood cell,9120,1.0105263157894737,0.9895833333333334
47565,/images/06cd484f-e864-4fee-8819-688b45eed98e.png,670,1436,786,1550,116,114,red blood cell,13224,0.9827586206896551,1.0175438596491229
56133,/images/50d9fc90-8642-4bb6-91a7-0069a7e37392.png,77,743,196,850,119,107,red blood cell,12733,0.8991596638655462,1.1121495327102804
36026,/images/5836500a-221e-40ca-a8be-caaa37f7d300.png,1,658,93,754,92,96,red blood cell,8832,1.0434782608695652,0.9583333333333334
8405,/images/ae779806-6d01-4dc6-89df-294c368db6bc.png,584,381,705,502,121,121,red blood cell,14641,1.0,1.0
44423,/images/edd3862f-04e1-49cf-97dd-ca566d17e71a.png,48,195,157,306,109,111,red blood cell,12099,1.018348623853211,0.9819819819819819
24523,/images/109fbb82-bc3c-41ac-984d-e2da86202873.png,973,988,1096,1118,123,130,red blood cell,15990,1.056910569105691,0.9461538461538461
12285,/images/3b55c42f-ad59-422f-ba99-4f4f4ca9cb2e.png,949,574,1061,689,112,115,red blood cell,12880,1.0267857142857142,0.9739130434782609
73905,/images/2ae3e6e6-7482-4ab8-ad73-b530b5c2ee3b.png,510,562,625,668,115,106,red blood cell,12190,0.9217391304347826,1.0849056603773586
12179,/images/87d6343b-70dd-4cdd-939f-d3ac0ca2e700.png,770,600,884,711,114,111,red blood cell,12654,0.9736842105263158,1.027027027027027
42498,/images/29648565-fe28-4517-ba72-68df0c82c9c5.png,417,321,520,424,103,103,red blood cell,10609,1.0,1.0
74953,/images/dd090806-e4ac-4a78-b2ee-55a30626369c.png,74,954,166,1049,92,95,red blood cell,8740,1.0326086956521738,0.968421052631579
16325,/images/d5009906-bce1-4353-90b4-f4c79362f4cf.png,410,317,524,435,114,118,red blood cell,13452,1.0350877192982457,0.9661016949152542
41146,/images/2240b991-48f6-4c59-9b62-5a8b5e541fae.png,56,372,168,480,112,108,red blood cell,12096,0.9642857142857143,1.037037037037037
17784,/images/1863da5f-c595-4541-a8f4-21fe78678168.png,97,694,195,803,98,109,red blood cell,10682,1.1122448979591837,0.8990825688073395
9192,/images/6e7ed596-1b76-4998-8147-a846d53d91c5.png,64,937,194,1055,130,118,red blood cell,15340,0.9076923076923077,1.1016949152542372
8967,/images/04628a94-b674-469b-aff6-b476b70df87d.png,1057,1330,1167,1448,110,118,red blood cell,12980,1.0727272727272728,0.9322033898305084
8886,/images/29539cb0-1c52-46b2-9302-552f8349dc71.png,1096,264,1198,388,102,124,red blood cell,12648,1.2156862745098038,0.8225806451612904
52229,/images/f4c00b8c-d675-4255-8277-ca65bd757f51.png,38,1074,134,1161,96,87,red blood cell,8352,0.90625,1.103448275862069
50825,/images/db0a1123-0b35-48d7-8337-3b1ebd6af0cc.png,446,777,556,887,110,110,red blood cell,12100,1.0,1.0
22211,/images/3d4d7ba7-6c7c-4ddd-b282-31fb5d80edb5.png,61,1080,161,1184,100,104,red blood cell,10400,1.04,0.9615384615384616
13362,/images/a7f1bbb1-6058-4642-bd66-cfb90dce762e.png,1035,616,1135,718,100,102,red blood cell,10200,1.02,0.9803921568627451
52613,/images/0546d843-d778-4aca-b8b5-bfe23d7c87da.png,4,930,85,1028,81,98,red blood cell,7938,1.2098765432098766,0.826530612244898
21109,/images/fb05b297-180a-4171-b633-09d5616d7534.png,674,836,773,947,99,111,red blood cell,10989,1.121212121212121,0.8918918918918919
30261,/images/cecbf663-0751-4e7f-b298-770c88afc2c1.png,1088,182,1183,285,95,103,red blood cell,9785,1.0842105263157895,0.9223300970873787
61650,/images/a3c0a876-be12-4ede-8aed-18b32a64401b.png,169,1198,274,1318,105,120,red blood cell,12600,1.1428571428571428,0.875
2627,/images/a2ccbf70-e444-49a9-8b7e-9797a05220d8.png,854,379,972,498,118,119,red blood cell,14042,1.0084745762711864,0.9915966386554622
26236,/images/7ba9db7e-9d3f-413c-b672-2bba5fb5b415.png,984,913,1120,1035,136,122,red blood cell,16592,0.8970588235294118,1.1147540983606556
25330,/images/c52f8cc8-afd7-441c-9f1f-18b6e16d79cf.png,748,878,867,1010,119,132,red blood cell,15708,1.1092436974789917,0.9015151515151515
71515,/images/191071ab-6515-428c-9f05-8e4309542b75.png,605,452,707,542,102,90,red blood cell,9180,0.8823529411764706,1.1333333333333333
48573,/images/f3d84be2-8af0-4d62-9f72-23d3dc08cbbe.png,411,1261,534,1378,123,117,red blood cell,14391,0.9512195121951219,1.0512820512820513
61832,/images/5f300fd1-7eec-41ac-bbd1-0f4a943c757c.png,729,777,830,899,101,122,red blood cell,12322,1.2079207920792079,0.8278688524590164
48369,/images/6fa2b30f-9b89-46ac-9b79-c0bc105d4271.png,530,409,646,520,116,111,red blood cell,12876,0.9568965517241379,1.045045045045045
10554,/images/9fbf38ab-44b9-4096-a818-603017a4300e.png,37,440,168,565,131,125,red blood cell,16375,0.9541984732824428,1.048
32959,/images/d1924af6-7512-4ccc-9c6b-adbbaa8db41f.png,198,75,317,206,119,131,red blood cell,15589,1.1008403361344539,0.9083969465648855
78260,/images/adff6e1d-ba9d-4c7b-a8fe-1ec458eaeeb8.png,382,860,491,968,109,108,red blood cell,11772,0.9908256880733946,1.0092592592592593
51625,/images/d0347b49-8f98-4632-a384-1a4f57ac6374.png,353,362,464,466,111,104,red blood cell,11544,0.9369369369369369,1.0673076923076923
18824,/images/d1b48634-9ad5-46e8-b816-42d1d97c93cd.png,808,239,923,348,115,109,red blood cell,12535,0.9478260869565217,1.055045871559633
77819,/images/6bc7b53c-5a98-48ef-a9de-59a476707ea4.png,853,598,959,696,106,98,red blood cell,10388,0.9245283018867925,1.0816326530612246
63949,/images/5e974892-0ebe-4037-8427-ea8616d6d3b8.png,140,496,238,592,98,96,red blood cell,9408,0.9795918367346939,1.0208333333333333
75029,/images/9147a21d-0de2-4c04-88da-b788311696ac.png,847,198,962,291,115,93,red blood cell,10695,0.808695652173913,1.2365591397849462
42392,/images/1a27ebe9-93a1-4898-af69-f276057d4012.png,162,392,274,503,112,111,red blood cell,12432,0.9910714285714286,1.009009009009009
20039,/images/ebfd9f67-138e-49f0-9cef-a0352069eedb.png,577,1179,674,1275,97,96,red blood cell,9312,0.9896907216494846,1.0104166666666667
13942,/images/3061aac0-cda3-47d1-8c48-6293e9ffdf36.png,143,1166,253,1289,110,123,red blood cell,13530,1.1181818181818182,0.8943089430894309
8356,/images/65e3d6a6-012c-4b40-9a42-83078eb85e31.png,626,1399,747,1524,121,125,red blood cell,15125,1.0330578512396693,0.968
15518,/images/79f63258-24ce-4e69-a5cb-8529635a89a9.png,513,1110,629,1216,116,106,red blood cell,12296,0.9137931034482759,1.0943396226415094
48740,/images/bc832bde-d3ea-4a8e-be90-7a3329dcc314.png,939,1106,1063,1232,124,126,red blood cell,15624,1.0161290322580645,0.9841269841269841
18305,/images/9ca20b10-e2fd-4bd2-93ef-78298f763ed5.png,450,1250,551,1349,101,99,red blood cell,9999,0.9801980198019802,1.02020202020202
65104,/images/5e042380-6ef2-496f-8231-0ca550fbfa71.png,246,1290,335,1392,89,102,red blood cell,9078,1.146067415730337,0.8725490196078431
15051,/images/3003252a-2d2e-4687-ad30-9c38d68f1394.png,746,1479,835,1576,89,97,red blood cell,8633,1.0898876404494382,0.9175257731958762
70329,/images/90246988-0d6d-4bf8-8a76-94107de4121e.png,152,813,244,910,92,97,red blood cell,8924,1.0543478260869565,0.9484536082474226
49933,/images/05804cf0-f854-4099-97c2-df287f7c8a8c.png,319,1092,412,1198,93,106,red blood cell,9858,1.1397849462365592,0.8773584905660378
76302,/images/1574565f-f45b-4160-947e-25ce1a81aaca.png,844,1076,953,1208,109,132,red blood cell,14388,1.2110091743119267,0.8257575757575758
47813,/images/5a105b89-c592-4d78-b208-7db6c6572752.png,274,460,394,589,120,129,red blood cell,15480,1.075,0.9302325581395349
24830,/images/93f7e207-0d8e-47f8-8258-09a0e03dbdd6.png,659,956,776,1085,117,129,red blood cell,15093,1.1025641025641026,0.9069767441860465
65900,/images/d7581cb0-7a12-471d-a3d8-68dcea362213.png,547,816,668,927,121,111,red blood cell,13431,0.9173553719008265,1.09009009009009
23751,/images/6b2ff7ca-c5b3-415c-9481-7b14efc6d7ef.png,319,181,444,295,125,114,red blood cell,14250,0.912,1.0964912280701755
70818,/images/b62d47f9-2ff5-4902-abdc-b3610acfc7ba.png,191,398,277,501,86,103,red blood cell,8858,1.197674418604651,0.8349514563106796
16733,/images/d6352a03-ef81-421d-915e-226499555d20.png,1016,134,1149,258,133,124,red blood cell,16492,0.9323308270676691,1.0725806451612903
32388,/images/a6526894-e290-482d-ac43-f1df34864817.png,577,310,666,410,89,100,red blood cell,8900,1.1235955056179776,0.89
22352,/images/78c35732-7e31-4153-842e-55ab1cd656f6.png,930,270,1044,375,114,105,red blood cell,11970,0.9210526315789473,1.0857142857142856
51374,/images/b4f3b2a4-f4b9-48de-ac5d-0e681b77be27.png,864,441,965,539,101,98,red blood cell,9898,0.9702970297029703,1.030612244897959
18282,/images/947348fe-4c70-468e-8009-3c14daeca69b.png,14,679,117,793,103,114,red blood cell,11742,1.1067961165048543,0.9035087719298246
77032,/images/637957ef-df75-4a7b-86d5-9f6e9c042ca2.png,935,748,1025,853,90,105,red blood cell,9450,1.1666666666666667,0.8571428571428571
72381,/images/a15e0fa8-2620-4f66-896e-175115c9dc3d.png,559,82,660,193,101,111,red blood cell,11211,1.099009900990099,0.9099099099099099
44948,/images/83ec8923-6232-40d7-ba1f-a1b8bf7cb66c.png,905,779,994,864,89,85,red blood cell,7565,0.9550561797752809,1.0470588235294118
57004,/images/9e82c996-2cfa-418d-9482-8ee23e9d0a5d.png,848,30,954,130,106,100,red blood cell,10600,0.9433962264150944,1.06
43000,/images/6c7095cd-ab6b-4f53-bd94-905d0cc95840.png,144,1470,247,1582,103,112,red blood cell,11536,1.087378640776699,0.9196428571428571
58921,/images/8a7deb24-d2b4-4acf-86c4-3aadd39157fa.png,634,1094,746,1208,112,114,red blood cell,12768,1.0178571428571428,0.9824561403508771
40119,/images/b34e65f6-c32e-42f1-a437-4a037c75a231.png,560,785,658,887,98,102,red blood cell,9996,1.0408163265306123,0.9607843137254902
67900,/images/41ebf9a1-24dc-454e-8bf8-508218f5ee57.png,328,433,432,523,104,90,red blood cell,9360,0.8653846153846154,1.1555555555555554
42475,/images/29648565-fe28-4517-ba72-68df0c82c9c5.png,389,985,509,1100,120,115,red blood cell,13800,0.9583333333333334,1.0434782608695652
59537,/images/6bfe6a90-8a69-4171-8e7f-42dc9417c6d9.png,656,1304,750,1400,94,96,red blood cell,9024,1.0212765957446808,0.9791666666666666
79884,/images/a054a8e2-55f2-4508-97df-207f76b89be2.png,55,889,175,1010,120,121,red blood cell,14520,1.0083333333333333,0.9917355371900827
69929,/images/9edba799-e169-46cd-b100-c9f8fc7a8c7d.png,1029,642,1142,761,113,119,red blood cell,13447,1.0530973451327434,0.9495798319327731
51733,/images/592c941a-aa54-4971-b499-dc47356f80a3.png,555,285,633,374,78,89,red blood cell,6942,1.141025641025641,0.8764044943820225
23856,/images/c17523c5-90a0-4a6b-9b33-2b4a6cf58d36.png,687,649,800,755,113,106,red blood cell,11978,0.9380530973451328,1.0660377358490567
22164,/images/ca677c3c-083f-4d54-9dec-39f79f6a17d8.png,362,285,465,370,103,85,red blood cell,8755,0.8252427184466019,1.2117647058823529
58607,/images/a4d7a7e1-5ae1-486d-b6ee-c9af1476ccad.png,58,584,157,686,99,102,red blood cell,10098,1.0303030303030303,0.9705882352941176
17055,/images/57e1879e-4294-45e7-9c1b-627e8cca0271.png,264,1188,386,1300,122,112,red blood cell,13664,0.9180327868852459,1.0892857142857142
55303,/images/4fb83278-adc5-4424-9f45-b6d0db2955b6.png,732,1094,838,1215,106,121,red blood cell,12826,1.1415094339622642,0.8760330578512396
67578,/images/59542a24-b409-4c95-8608-d9691a741526.png,492,1011,589,1093,97,82,red blood cell,7954,0.845360824742268,1.1829268292682926
33206,/images/877d5e7f-19b6-40e7-81bd-c92f25e72503.png,254,1140,381,1270,127,130,red blood cell,16510,1.0236220472440944,0.9769230769230769
45977,/images/72088c26-d2dd-4906-b791-b8947fc7fbe4.png,1002,1114,1127,1237,125,123,red blood cell,15375,0.984,1.016260162601626
43738,/images/ef83ed4c-2724-4d5f-8abe-1a18d25cea35.png,178,166,308,286,130,120,red blood cell,15600,0.9230769230769231,1.0833333333333333
71719,/images/5c99cd97-39f6-4809-9528-9d380cc16b16.png,202,1,281,73,79,72,red blood cell,5688,0.9113924050632911,1.0972222222222223
62912,/images/4b346035-b8c0-46ca-8fdb-a01b1421ee4a.png,799,59,903,175,104,116,red blood cell,12064,1.1153846153846154,0.896551724137931
28603,/images/861c3e06-aada-47a0-99ae-94fbc2772cc0.png,92,685,204,798,112,113,red blood cell,12656,1.0089285714285714,0.9911504424778761
39907,/images/71cf2467-77d3-4fac-ac6e-1d8767717c34.png,1002,1149,1145,1273,143,124,red blood cell,17732,0.8671328671328671,1.153225806451613
51517,/images/6afb3717-f197-4668-929a-4fab389ae6e8.png,295,1344,398,1447,103,103,red blood cell,10609,1.0,1.0
60625,/images/724e0c34-32cd-41f1-ae37-586038bc67ab.png,269,145,369,249,100,104,red blood cell,10400,1.04,0.9615384615384616
30609,/images/f939782b-f5a2-40a3-9c22-6c6d7e18edc3.png,441,1070,548,1195,107,125,red blood cell,13375,1.1682242990654206,0.856
40442,/images/db249e5a-4142-432c-8288-bacd10d7273d.png,98,905,200,1005,102,100,red blood cell,10200,0.9803921568627451,1.02
66548,/images/b87fb62d-2c36-4f68-aba9-37fcd7d46eef.png,936,770,1050,903,114,133,red blood cell,15162,1.1666666666666667,0.8571428571428571
57859,/images/f4c2b43f-a2e7-4746-8034-0b34aebba8ee.png,919,1483,1025,1588,106,105,red blood cell,11130,0.9905660377358491,1.0095238095238095
68347,/images/0f735cca-051c-4048-a1fa-cb36f389e12f.png,480,484,601,608,121,124,red blood cell,15004,1.024793388429752,0.9758064516129032
28742,/images/151f3af5-5e6e-4bcd-9389-4974fc68813e.png,830,319,935,436,105,117,red blood cell,12285,1.1142857142857143,0.8974358974358975
68054,/images/e2e68cb3-0588-40bb-95b4-356f9cacffc3.png,477,726,602,843,125,117,red blood cell,14625,0.936,1.0683760683760684
21753,/images/f68ae8e9-e760-4106-88e0-4bdef2785f06.png,794,881,900,990,106,109,red blood cell,11554,1.028301886792453,0.9724770642201835
78174,/images/2bed2796-75a9-4d93-bb2d-e3ccbe1a5cbe.png,736,991,849,1105,113,114,red blood cell,12882,1.008849557522124,0.9912280701754386
56647,/images/4adcaa26-aa1f-47b5-bdf0-18c9f814f576.png,391,362,486,462,95,100,red blood cell,9500,1.0526315789473684,0.95
74320,/images/8939e14b-fcdf-48b1-acb9-6514a2fc2fc0.png,654,621,748,706,94,85,red blood cell,7990,0.9042553191489362,1.1058823529411765
66507,/images/b87fb62d-2c36-4f68-aba9-37fcd7d46eef.png,872,445,975,559,103,114,red blood cell,11742,1.1067961165048543,0.9035087719298246
59233,/images/03c8da48-04b9-4520-b674-44a0ecd35688.png,186,187,299,302,113,115,red blood cell,12995,1.0176991150442478,0.9826086956521739
57049,/images/9e82c996-2cfa-418d-9482-8ee23e9d0a5d.png,356,1196,464,1287,108,91,red blood cell,9828,0.8425925925925926,1.1868131868131868
76122,/images/16244280-6c74-47d3-b544-9fd6831a6bf9.png,307,178,404,290,97,112,red blood cell,10864,1.1546391752577319,0.8660714285714286
65659,/images/397f37bc-a3a4-4257-9430-c8fc5716f8b1.png,966,517,1093,635,127,118,red blood cell,14986,0.9291338582677166,1.076271186440678
54827,/images/b6364a57-72a9-43f3-8d02-9f53a992dc95.png,997,874,1080,974,83,100,red blood cell,8300,1.2048192771084338,0.83
51341,/images/b4f3b2a4-f4b9-48de-ac5d-0e681b77be27.png,797,120,921,231,124,111,red blood cell,13764,0.8951612903225806,1.117117117117117
63665,/images/d9c9479e-f1ea-4d6e-861f-843ff9a90d19.png,606,693,696,798,90,105,red blood cell,9450,1.1666666666666667,0.8571428571428571
60208,/images/214f1d15-a081-476e-992d-6c3a77f03d59.png,258,1286,350,1385,92,99,red blood cell,9108,1.076086956521739,0.9292929292929293
73618,/images/a51d6c18-f9e8-4714-9dbb-38e1577445f2.png,133,774,243,884,110,110,red blood cell,12100,1.0,1.0
57941,/images/09bcedaa-e007-4692-a13f-ab02c3f872c4.png,845,451,966,583,121,132,red blood cell,15972,1.0909090909090908,0.9166666666666666
59728,/images/f77d7469-d083-4c2d-a4ea-5a9ff162e3e2.png,800,1067,911,1180,111,113,red blood cell,12543,1.018018018018018,0.9823008849557522
37013,/images/b2e34f5f-904e-4473-9dc7-c6bc1ce12640.png,830,624,939,716,109,92,red blood cell,10028,0.8440366972477065,1.184782608695652
35321,/images/516bf1d5-5d00-4985-926c-3993e9bc3ff5.png,581,666,719,785,138,119,red blood cell,16422,0.8623188405797102,1.1596638655462186
31868,/images/f62d4fb6-df7c-446c-94a8-d5aede0b1e0c.png,35,52,158,176,123,124,red blood cell,15252,1.008130081300813,0.9919354838709677
8331,/images/65e3d6a6-012c-4b40-9a42-83078eb85e31.png,334,0,421,78,87,78,red blood cell,6786,0.896551724137931,1.1153846153846154
29567,/images/42845335-4ab2-4963-806d-0985d1382a31.png,967,120,1094,245,127,125,red blood cell,15875,0.984251968503937,1.016
45984,/images/72088c26-d2dd-4906-b791-b8947fc7fbe4.png,1054,993,1136,1095,82,102,red blood cell,8364,1.2439024390243902,0.803921568627451
258,/images/0dcca702-a4ef-4fb3-a940-9c0c140b21c7.png,370,1151,483,1272,113,121,red blood cell,13673,1.0707964601769913,0.9338842975206612
75197,/images/61dfc937-a428-44b4-94fb-d682bdb8dff0.png,436,293,525,385,89,92,red blood cell,8188,1.0337078651685394,0.967391304347826
44677,/images/8002cb71-0f25-4fa4-a46f-b49e5aeded0c.png,1032,274,1146,386,114,112,red blood cell,12768,0.9824561403508771,1.0178571428571428
39063,/images/8f96ee1f-4ef7-4279-a610-316319bedcf9.png,406,435,526,553,120,118,red blood cell,14160,0.9833333333333333,1.0169491525423728
71438,/images/bcb447c9-5d37-414f-a513-d7076b04a532.png,1102,626,1196,738,94,112,red blood cell,10528,1.1914893617021276,0.8392857142857143
40001,/images/8271d0d8-9985-43eb-94b3-c702adca139f.png,377,434,490,548,113,114,red blood cell,12882,1.008849557522124,0.9912280701754386
10145,/images/09ecf7be-28e2-4531-b9e2-07e01c44097d.png,429,1144,528,1251,99,107,red blood cell,10593,1.0808080808080809,0.9252336448598131
24432,/images/b78ba2c8-ecb3-45b2-9cda-2c8088fa95d1.png,370,2,492,124,122,122,red blood cell,14884,1.0,1.0
28321,/images/34e024a5-5698-42d4-972f-fee234b4bd64.png,485,366,589,480,104,114,red blood cell,11856,1.0961538461538463,0.9122807017543859
21818,/images/9b3fd401-dab0-440f-8498-eb3cc9ffa970.png,687,804,810,926,123,122,red blood cell,15006,0.991869918699187,1.0081967213114753
69275,/images/f274b784-b995-4a7e-a2c2-6cc31c24c4b4.png,623,1385,709,1471,86,86,red blood cell,7396,1.0,1.0
30260,/images/cecbf663-0751-4e7f-b298-770c88afc2c1.png,54,1312,159,1408,105,96,red blood cell,10080,0.9142857142857143,1.09375
72059,/images/64b0e49a-0e48-447d-8872-c1dd255e7a21.png,369,950,482,1059,113,109,red blood cell,12317,0.9646017699115044,1.036697247706422
74549,/images/bbedfcbe-9528-4ba9-9d86-4ebba7589ac5.png,131,320,242,431,111,111,red blood cell,12321,1.0,1.0
78713,/images/76a8a5f5-1328-4539-a131-baf877f40cf3.png,297,826,410,951,113,125,red blood cell,14125,1.1061946902654867,0.904
30214,/images/f81806a8-5883-446c-be78-f0145b12dbdd.png,992,690,1100,808,108,118,red blood cell,12744,1.0925925925925926,0.9152542372881356
7745,/images/187f92b2-71ed-484a-9bd3-599ca0d2636f.png,910,647,997,744,87,97,red blood cell,8439,1.1149425287356323,0.8969072164948454
41767,/images/32a1ea24-b6b7-4253-ad3e-bdf99c2c9b9d.png,708,848,809,952,101,104,red blood cell,10504,1.0297029702970297,0.9711538461538461
6501,/images/640c4a52-3742-4f57-aee3-9e3dc0887622.png,293,122,392,219,99,97,red blood cell,9603,0.9797979797979798,1.0206185567010309
28760,/images/686ed568-d5f8-475e-81ad-edab9dd473a0.png,805,74,900,174,95,100,red blood cell,9500,1.0526315789473684,0.95
15594,/images/169d541c-daed-468e-8b41-0f1abccdf319.png,538,1097,658,1224,120,127,red blood cell,15240,1.0583333333333333,0.9448818897637795
39608,/images/04d21589-b777-43c2-86b5-038cbf8c3a4e.png,317,401,420,496,103,95,red blood cell,9785,0.9223300970873787,1.0842105263157895
23899,/images/c17523c5-90a0-4a6b-9b33-2b4a6cf58d36.png,414,1101,524,1214,110,113,red blood cell,12430,1.0272727272727273,0.9734513274336283
27674,/images/18dbe7c4-89d2-42a6-a969-1e951ab313b1.png,33,828,135,939,102,111,red blood cell,11322,1.088235294117647,0.918918918918919
55807,/images/68f34a9c-f73d-4238-8f55-4b05a8a2154c.png,446,624,542,722,96,98,red blood cell,9408,1.0208333333333333,0.9795918367346939
8897,/images/29539cb0-1c52-46b2-9302-552f8349dc71.png,110,642,229,755,119,113,red blood cell,13447,0.9495798319327731,1.0530973451327434
46547,/images/edd09b2e-2673-4405-8ac0-e476e003e96a.png,743,153,862,267,119,114,red blood cell,13566,0.957983193277311,1.043859649122807
69666,/images/f0713bee-2a71-4ced-b953-4041ea99496a.png,349,648,448,754,99,106,red blood cell,10494,1.0707070707070707,0.9339622641509434
7180,/images/56551792-4aa1-4301-9f8f-8bfebcd20050.png,926,555,1034,676,108,121,red blood cell,13068,1.1203703703703705,0.8925619834710744
71135,/images/b666fcc2-d0b2-441e-bc5a-c660345eeb5d.png,603,808,719,923,116,115,red blood cell,13340,0.9913793103448276,1.008695652173913
23432,/images/8757be1e-b832-407a-8e95-62abae485b24.png,440,968,515,1061,75,93,red blood cell,6975,1.24,0.8064516129032258
47051,/images/997eabd9-55bf-4683-83c4-4cee4673a4ef.png,312,210,432,328,120,118,red blood cell,14160,0.9833333333333333,1.0169491525423728
33506,/images/795d0331-da56-4d45-a58a-54803408ffd9.png,709,294,829,422,120,128,red blood cell,15360,1.0666666666666667,0.9375
4008,/images/a5e05ba8-0c19-41e3-92d5-10e42a03b85e.png,652,231,767,331,115,100,red blood cell,11500,0.8695652173913043,1.15
7250,/images/89f10192-d3dd-4996-a571-4c851dbdc983.png,443,1330,543,1428,100,98,red blood cell,9800,0.98,1.0204081632653061
61252,/images/b3058064-d817-47dd-a8c4-cdb1f62374f8.png,7,645,106,731,99,86,red blood cell,8514,0.8686868686868687,1.1511627906976745
71513,/images/191071ab-6515-428c-9f05-8e4309542b75.png,564,1256,674,1365,110,109,red blood cell,11990,0.990909090909091,1.0091743119266054
35433,/images/002f20ad-2ace-499c-9335-c9080bc3e6b5.png,295,1384,419,1514,124,130,red blood cell,16120,1.0483870967741935,0.9538461538461539
60509,/images/93b47b14-7f78-4b31-8897-d63a81fdab01.png,57,540,153,638,96,98,red blood cell,9408,1.0208333333333333,0.9795918367346939
68880,/images/6347dd6a-cfdf-4cb5-bc50-cff5403cfecb.png,213,1152,331,1270,118,118,red blood cell,13924,1.0,1.0
43430,/images/367663b2-5d09-4020-ab0a-c2200e7a1c8c.png,298,166,420,288,122,122,red blood cell,14884,1.0,1.0
41430,/images/c4494d4f-732f-431a-8a9d-62403f0b74fe.png,275,141,385,250,110,109,red blood cell,11990,0.990909090909091,1.0091743119266054
32345,/images/a6526894-e290-482d-ac43-f1df34864817.png,81,1381,191,1504,110,123,red blood cell,13530,1.1181818181818182,0.8943089430894309
38018,/images/e3e9c2de-0a24-4c7e-8a69-3d3093d5bdab.png,790,17,889,114,99,97,red blood cell,9603,0.9797979797979798,1.0206185567010309
75114,/images/073c10c9-5749-44b5-b08b-1be556a960f0.png,964,807,1060,914,96,107,red blood cell,10272,1.1145833333333333,0.897196261682243
56039,/images/177a3141-fa93-426a-9b52-7da71547ce44.png,241,395,327,497,86,102,red blood cell,8772,1.186046511627907,0.8431372549019608
48515,/images/f3d84be2-8af0-4d62-9f72-23d3dc08cbbe.png,190,917,313,1034,123,117,red blood cell,14391,0.9512195121951219,1.0512820512820513
78049,/images/105af41b-13cc-4ad1-8a1f-8bc4d47cdd94.png,105,149,224,256,119,107,red blood cell,12733,0.8991596638655462,1.1121495327102804
26759,/images/2518f6e4-29cc-4ae4-a914-b215a4c56099.png,826,1247,928,1356,102,109,red blood cell,11118,1.0686274509803921,0.9357798165137615
2516,/images/a23f5539-bfe6-4885-9a0e-dba972475ea9.png,491,144,590,254,99,110,red blood cell,10890,1.1111111111111112,0.9
28075,/images/f1f9df6d-c4cb-4b42-9ca2-8fb47b1b0e91.png,776,1235,894,1331,118,96,red blood cell,11328,0.8135593220338984,1.2291666666666667
4206,/images/ac3358f1-ef9a-4ccc-b66c-da5e47e352e0.png,581,739,699,852,118,113,red blood cell,13334,0.9576271186440678,1.0442477876106195
52515,/images/d1144956-5a0c-4bd2-b67d-8498c82d6a12.png,184,129,287,234,103,105,red blood cell,10815,1.0194174757281553,0.9809523809523809
68615,/images/31653d0f-c4e6-4e12-8005-518c2de34687.png,1093,1168,1196,1269,103,101,red blood cell,10403,0.9805825242718447,1.0198019801980198
53062,/images/69b5b3de-ec64-4e5d-bcc2-44f495e06e76.png,941,710,1049,831,108,121,red blood cell,13068,1.1203703703703705,0.8925619834710744
58331,/images/319c9c52-f316-49f3-baad-4444ab19f85b.png,882,1415,985,1522,103,107,red blood cell,11021,1.0388349514563107,0.9626168224299065
21340,/images/8dace03a-10c4-4d59-bcd9-a2c314c5df33.png,350,1474,456,1576,106,102,red blood cell,10812,0.9622641509433962,1.0392156862745099
41274,/images/2374ae5b-c2df-4db5-afea-c54180aa22e3.png,624,1039,754,1158,130,119,red blood cell,15470,0.9153846153846154,1.0924369747899159
10916,/images/1380f9b4-bf54-4492-90c3-743c7aa8898b.png,813,631,927,739,114,108,red blood cell,12312,0.9473684210526315,1.0555555555555556
5415,/images/75579b27-8191-4044-859b-268be969c42b.png,854,1437,969,1558,115,121,red blood cell,13915,1.0521739130434782,0.9504132231404959
19158,/images/bb795ddf-ce72-42d5-9006-124db4d5cf1c.png,447,1233,557,1336,110,103,red blood cell,11330,0.9363636363636364,1.0679611650485437
46930,/images/9e0e1928-d19a-4100-b093-0b962ac09e05.png,732,1431,820,1515,88,84,red blood cell,7392,0.9545454545454546,1.0476190476190477
4513,/images/0f26699f-a776-4424-b092-27da9a1d12e2.png,353,135,453,235,100,100,red blood cell,10000,1.0,1.0
77603,/images/f20a4fcf-ea8e-4c14-883d-d26a9e08ce25.png,188,1208,282,1298,94,90,red blood cell,8460,0.9574468085106383,1.0444444444444445
96,/images/10be6380-cbbb-4886-8b9e-ff56b1710576.png,1093,689,1187,801,94,112,red blood cell,10528,1.1914893617021276,0.8392857142857143
61149,/images/80da32ce-8c22-470e-9f35-558c5f7a5df9.png,842,892,927,978,85,86,red blood cell,7310,1.011764705882353,0.9883720930232558
13382,/images/a7f1bbb1-6058-4642-bd66-cfb90dce762e.png,261,1055,364,1161,103,106,red blood cell,10918,1.029126213592233,0.9716981132075472
632,/images/e61e6af2-7f8b-47b0-bbe7-acb2ed0299ab.png,617,666,736,785,119,119,red blood cell,14161,1.0,1.0
67910,/images/41ebf9a1-24dc-454e-8bf8-508218f5ee57.png,21,912,114,987,93,75,red blood cell,6975,0.8064516129032258,1.24
22176,/images/ca677c3c-083f-4d54-9dec-39f79f6a17d8.png,791,821,898,931,107,110,red blood cell,11770,1.02803738317757,0.9727272727272728
14047,/images/eaf4b781-b3aa-41ce-8c5e-287979b4e15a.png,30,1303,148,1413,118,110,red blood cell,12980,0.9322033898305084,1.0727272727272728
79304,/images/05ac7b2a-6a77-4464-926b-8570f7c01693.png,475,1406,571,1510,96,104,red blood cell,9984,1.0833333333333333,0.9230769230769231
48112,/images/05717db9-f1ef-4101-a9f7-7a007e83b1c9.png,464,1389,559,1482,95,93,red blood cell,8835,0.9789473684210527,1.021505376344086
79921,/images/0b923ab7-ebff-4079-a4bb-af7da89f374e.png,661,1431,786,1553,125,122,red blood cell,15250,0.976,1.0245901639344261
15431,/images/1b7f47fc-26cd-4273-b848-88a7cbfd9f85.png,277,370,366,472,89,102,red blood cell,9078,1.146067415730337,0.8725490196078431
40938,/images/550cf4ce-b641-44a3-8487-3e16d4049187.png,819,670,918,776,99,106,red blood cell,10494,1.0707070707070707,0.9339622641509434
14835,/images/f8b6a868-60e9-4569-ae69-638a0c39834d.png,713,697,846,809,133,112,red blood cell,14896,0.8421052631578947,1.1875
9369,/images/261562a8-ffd8-4e0e-919b-22e267000b74.png,1068,1508,1168,1598,100,90,red blood cell,9000,0.9,1.1111111111111112
19775,/images/68e69cfb-1a07-48d2-8abe-46b46fe264ed.png,645,543,761,665,116,122,red blood cell,14152,1.0517241379310345,0.9508196721311475
67621,/images/59542a24-b409-4c95-8608-d9691a741526.png,456,497,544,591,88,94,red blood cell,8272,1.0681818181818181,0.9361702127659575
33492,/images/795d0331-da56-4d45-a58a-54803408ffd9.png,44,1062,178,1179,134,117,red blood cell,15678,0.8731343283582089,1.1452991452991452
70782,/images/b62d47f9-2ff5-4902-abdc-b3610acfc7ba.png,143,1393,228,1495,85,102,red blood cell,8670,1.2,0.8333333333333334
67041,/images/1fe1e118-adb8-4b10-a41e-1e5814e8f067.png,279,647,394,772,115,125,red blood cell,14375,1.0869565217391304,0.92
12711,/images/68442532-9cd2-4b42-9d4f-ddf8c13bb38c.png,583,1283,704,1402,121,119,red blood cell,14399,0.9834710743801653,1.0168067226890756
28909,/images/686ed568-d5f8-475e-81ad-edab9dd473a0.png,741,1152,828,1237,87,85,red blood cell,7395,0.9770114942528736,1.0235294117647058
21543,/images/49efc89d-9cba-44f7-8257-7f911b73f68a.png,196,1314,318,1435,122,121,red blood cell,14762,0.9918032786885246,1.0082644628099173
54642,/images/6473ddb6-ad56-48a2-81e8-c7cb45f06825.png,981,938,1073,1039,92,101,red blood cell,9292,1.0978260869565217,0.9108910891089109
54459,/images/22a464ef-c3da-4d56-b37e-e22e95d945e7.png,443,957,536,1051,93,94,red blood cell,8742,1.010752688172043,0.9893617021276596
54748,/images/10891eed-b0f2-4dd0-90cb-da185f6761b2.png,384,88,477,173,93,85,red blood cell,7905,0.9139784946236559,1.0941176470588236
5436,/images/75579b27-8191-4044-859b-268be969c42b.png,879,485,996,615,117,130,red blood cell,15210,1.1111111111111112,0.9
12434,/images/cc94eabb-a3dc-4cfc-9fff-55c76b5b4a71.png,571,163,670,272,99,109,red blood cell,10791,1.101010101010101,0.908256880733945
40675,/images/252071ac-e9f2-41d2-abbb-87ef01b8a997.png,1052,303,1137,392,85,89,red blood cell,7565,1.0470588235294118,0.9550561797752809
58694,/images/a4d7a7e1-5ae1-486d-b6ee-c9af1476ccad.png,256,265,349,360,93,95,red blood cell,8835,1.021505376344086,0.9789473684210527
11833,/images/3cdcb09b-6a8c-43ca-b1d0-c1a289202f65.png,665,694,763,793,98,99,red blood cell,9702,1.010204081632653,0.98989898989899
63306,/images/43bc935a-f655-45e1-a64d-fcb8b78267a6.png,855,1209,962,1315,107,106,red blood cell,11342,0.9906542056074766,1.009433962264151
27862,/images/948c94ad-395c-41f4-9a68-8a1dcb76888c.png,43,1039,140,1141,97,102,red blood cell,9894,1.0515463917525774,0.9509803921568627
68933,/images/bbaa004f-05dc-4cb8-8768-e148085bb0f9.png,491,946,616,1047,125,101,red blood cell,12625,0.808,1.2376237623762376
30675,/images/f939782b-f5a2-40a3-9c22-6c6d7e18edc3.png,692,793,830,909,138,116,red blood cell,16008,0.8405797101449275,1.1896551724137931
56152,/images/50d9fc90-8642-4bb6-91a7-0069a7e37392.png,811,204,907,302,96,98,red blood cell,9408,1.0208333333333333,0.9795918367346939
69855,/images/9edba799-e169-46cd-b100-c9f8fc7a8c7d.png,246,116,353,220,107,104,red blood cell,11128,0.9719626168224299,1.0288461538461537
30348,/images/4aad9589-6b32-4522-bcd7-ca04687a02ca.png,57,753,180,874,123,121,red blood cell,14883,0.983739837398374,1.0165289256198347
8545,/images/a6aa3b72-2970-4c78-b655-ea8dfe6e018c.png,516,783,626,901,110,118,red blood cell,12980,1.0727272727272728,0.9322033898305084
53947,/images/540a5fee-175b-4b92-bf62-1ea9b59c86c6.png,272,475,382,602,110,127,red blood cell,13970,1.1545454545454545,0.8661417322834646
37504,/images/205306da-0ed8-475a-ace6-f2f81d4be88a.png,539,987,658,1107,119,120,red blood cell,14280,1.0084033613445378,0.9916666666666667
56788,/images/0dcbf2c9-f959-4703-a72b-f6a81e66c2ea.png,251,228,340,308,89,80,red blood cell,7120,0.898876404494382,1.1125
6319,/images/c6575e75-c8ce-4766-841f-1137b9e0956c.png,1093,657,1193,763,100,106,red blood cell,10600,1.06,0.9433962264150944
15998,/images/c7c1b873-0548-4a73-9618-f60912e164df.png,809,928,912,1035,103,107,red blood cell,11021,1.0388349514563107,0.9626168224299065
62687,/images/9e1b0217-0926-4fd1-bb9e-a815c05deb59.png,699,832,797,944,98,112,red blood cell,10976,1.1428571428571428,0.875
16431,/images/e474a20b-2769-48f1-a520-4f6ef5a0dbf5.png,324,39,420,151,96,112,red blood cell,10752,1.1666666666666667,0.8571428571428571
1928,/images/02ea7aa8-c142-4a3d-939f-e77689741341.png,216,441,324,571,108,130,red blood cell,14040,1.2037037037037037,0.8307692307692308
25817,/images/14b68d86-ac7f-419d-b4a5-6b0b1d9aaa18.png,761,699,857,816,96,117,red blood cell,11232,1.21875,0.8205128205128205
67305,/images/49c4dbd3-6269-4d4c-9648-a2146c57bab1.png,1,572,99,672,98,100,red blood cell,9800,1.0204081632653061,0.98
24921,/images/ed0bee2f-05e0-4392-8357-19750cec577c.png,75,546,177,653,102,107,red blood cell,10914,1.0490196078431373,0.9532710280373832
21299,/images/8dace03a-10c4-4d59-bcd9-a2c314c5df33.png,535,846,650,948,115,102,red blood cell,11730,0.8869565217391304,1.1274509803921569
58343,/images/50f2f514-6c8e-4c79-b3b3-0be56dd0b78b.png,607,692,706,799,99,107,red blood cell,10593,1.0808080808080809,0.9252336448598131
25940,/images/e683144c-0465-43a2-86b1-3cf52599d5e0.png,642,986,736,1084,94,98,red blood cell,9212,1.0425531914893618,0.9591836734693877
25636,/images/770b8ca4-8377-479b-9ad5-5455ec3b44f8.png,663,1139,777,1241,114,102,red blood cell,11628,0.8947368421052632,1.1176470588235294
47453,/images/f7231477-f2c1-439a-9c8b-204de07686a4.png,479,1089,600,1209,121,120,red blood cell,14520,0.9917355371900827,1.0083333333333333
78904,/images/4d0a1598-e4dd-45c4-8a90-dd7c780fe1da.png,447,11,537,108,90,97,red blood cell,8730,1.0777777777777777,0.9278350515463918
23837,/images/c17523c5-90a0-4a6b-9b33-2b4a6cf58d36.png,477,647,600,762,123,115,red blood cell,14145,0.9349593495934959,1.0695652173913044
35250,/images/a9159b11-ba49-4885-902e-00c8d5095b98.png,535,1287,646,1410,111,123,red blood cell,13653,1.1081081081081081,0.9024390243902439
79033,/images/6144887d-a1c1-46db-91a1-f7ff5bf8c8a5.png,893,785,972,864,79,79,red blood cell,6241,1.0,1.0
1747,/images/5f783f43-0090-4f8a-bd75-9562f4aa2dd5.png,229,1231,331,1330,102,99,red blood cell,10098,0.9705882352941176,1.0303030303030303
328,/images/0dcca702-a4ef-4fb3-a940-9c0c140b21c7.png,644,1052,755,1157,111,105,red blood cell,11655,0.9459459459459459,1.0571428571428572
62139,/images/a63fa2c7-3ec8-4bb7-bde6-a39e09d2f806.png,787,1367,905,1486,118,119,red blood cell,14042,1.0084745762711864,0.9915966386554622
39298,/images/697bdbc0-6e31-4e48-ac74-ba4ab5760d32.png,166,1316,286,1439,120,123,red blood cell,14760,1.025,0.975609756097561
23502,/images/6fb707b1-5c07-479f-8385-5404bf5747b0.png,654,998,784,1120,130,122,red blood cell,15860,0.9384615384615385,1.0655737704918034
48251,/images/71204a6d-814e-44b6-9cee-7b979f478021.png,883,118,997,227,114,109,red blood cell,12426,0.956140350877193,1.0458715596330275
39005,/images/79806898-0214-44bd-ba2c-b570e911be62.png,432,492,545,602,113,110,red blood cell,12430,0.9734513274336283,1.0272727272727273
70516,/images/8cca114a-ed05-4b87-95b7-fae02487f08c.png,869,647,985,750,116,103,red blood cell,11948,0.8879310344827587,1.1262135922330097
43299,/images/36569710-a574-40be-ad42-897a6e74a128.png,871,292,985,418,114,126,red blood cell,14364,1.105263157894737,0.9047619047619048
9783,/images/3859deaf-6ae1-49a3-9051-898d0f0d7de6.png,205,1006,305,1120,100,114,red blood cell,11400,1.14,0.8771929824561403
77152,/images/fe691faa-3bc7-475e-b558-aa8fe7b795bc.png,255,218,359,320,104,102,red blood cell,10608,0.9807692307692307,1.0196078431372548
24305,/images/4d8a4ce8-0f9c-4f21-8844-4cf0e5514bbf.png,1007,754,1107,869,100,115,red blood cell,11500,1.15,0.8695652173913043
59042,/images/597bbff8-6592-41cf-8946-e59b0d1f289a.png,949,6,1047,121,98,115,red blood cell,11270,1.1734693877551021,0.8521739130434782
73778,/images/22cbf509-c9bf-46ec-bfce-f079c6b76c8c.png,97,672,192,761,95,89,red blood cell,8455,0.9368421052631579,1.0674157303370786
39029,/images/79806898-0214-44bd-ba2c-b570e911be62.png,790,43,903,166,113,123,red blood cell,13899,1.0884955752212389,0.9186991869918699
72691,/images/6ab870ba-b24b-49a9-9570-8eafe63aa74e.png,470,1196,578,1310,108,114,red blood cell,12312,1.0555555555555556,0.9473684210526315
181,/images/13099edb-35d9-438f-b093-2cf2ebf9d255.png,42,241,147,362,105,121,red blood cell,12705,1.1523809523809523,0.8677685950413223
54058,/images/d9345456-b76d-46cc-b81e-46d4a0a7b652.png,471,293,596,393,125,100,red blood cell,12500,0.8,1.25
11550,/images/834a30bb-26bf-4e60-9ea1-3250b926892e.png,704,1002,808,1117,104,115,red blood cell,11960,1.1057692307692308,0.9043478260869565
64592,/images/6dfafdf1-f588-4e80-8cf8-0126e1bf7af9.png,38,1324,152,1444,114,120,red blood cell,13680,1.0526315789473684,0.95
35779,/images/bb2042c5-35e1-43cc-8171-7de81b764361.png,494,357,585,457,91,100,red blood cell,9100,1.098901098901099,0.91
49037,/images/df3d98b9-3dd7-4107-8d4a-ae1b7f247793.png,779,172,893,271,114,99,red blood cell,11286,0.868421052631579,1.1515151515151516
73263,/images/67a4fb91-6f38-4ca2-8f20-6b2f5f1b29a7.png,207,832,302,932,95,100,red blood cell,9500,1.0526315789473684,0.95
31722,/images/bd432159-5956-457c-bdeb-1b5e702ba513.png,182,651,268,756,86,105,red blood cell,9030,1.2209302325581395,0.819047619047619
65514,/images/da49db57-0c2f-4213-b322-c88c19fb9296.png,636,1071,739,1182,103,111,red blood cell,11433,1.0776699029126213,0.9279279279279279
37589,/images/205306da-0ed8-475a-ace6-f2f81d4be88a.png,764,126,850,212,86,86,red blood cell,7396,1.0,1.0
54005,/images/5e4f7425-11e6-4f9e-be2d-5a27deb9d1b4.png,511,1104,633,1215,122,111,red blood cell,13542,0.9098360655737705,1.0990990990990992
10070,/images/26799d2b-a289-4eff-9218-0aad77e05e41.png,102,79,226,205,124,126,red blood cell,15624,1.0161290322580645,0.9841269841269841
42681,/images/3abbc4d3-1d7e-40c9-9963-33732da7cc50.png,142,9,247,103,105,94,red blood cell,9870,0.8952380952380953,1.1170212765957446
8580,/images/a6aa3b72-2970-4c78-b655-ea8dfe6e018c.png,709,1322,805,1413,96,91,red blood cell,8736,0.9479166666666666,1.054945054945055
1537,/images/0ac747cd-ff32-49bf-bc1a-3e9b7702ce9c.png,1025,1133,1125,1225,100,92,red blood cell,9200,0.92,1.0869565217391304
79195,/images/eb0173a3-7e5e-4f53-8124-03d9d6317844.png,730,1085,852,1205,122,120,red blood cell,14640,0.9836065573770492,1.0166666666666666
6454,/images/640c4a52-3742-4f57-aee3-9e3dc0887622.png,171,1157,278,1252,107,95,red blood cell,10165,0.8878504672897196,1.1263157894736842
57176,/images/7c870293-2665-4a6b-a4fa-336959051dfc.png,467,217,585,328,118,111,red blood cell,13098,0.940677966101695,1.063063063063063
32910,/images/e40000b4-1b26-42ce-909d-4715e04f0a6e.png,958,111,1072,233,114,122,red blood cell,13908,1.0701754385964912,0.9344262295081968
68922,/images/bbaa004f-05dc-4cb8-8768-e148085bb0f9.png,217,993,314,1081,97,88,red blood cell,8536,0.9072164948453608,1.1022727272727273
18658,/images/c22f7031-9cf8-48ce-b03b-1b12d0db4951.png,516,944,613,1047,97,103,red blood cell,9991,1.0618556701030928,0.941747572815534
6823,/images/e36cb882-c6d0-4467-812e-d18c169a9a47.png,899,407,1017,520,118,113,red blood cell,13334,0.9576271186440678,1.0442477876106195
26873,/images/2518f6e4-29cc-4ae4-a914-b215a4c56099.png,688,649,782,745,94,96,red blood cell,9024,1.0212765957446808,0.9791666666666666
73785,/images/3eba916c-998b-40a7-993c-7ed916c2a04c.png,480,75,590,175,110,100,red blood cell,11000,0.9090909090909091,1.1
12853,/images/b10ea12f-cd36-4f2c-994a-67d1665269ab.png,89,12,193,109,104,97,red blood cell,10088,0.9326923076923077,1.0721649484536082
12154,/images/87d6343b-70dd-4cdd-939f-d3ac0ca2e700.png,441,1024,553,1131,112,107,red blood cell,11984,0.9553571428571429,1.0467289719626167
12894,/images/b10ea12f-cd36-4f2c-994a-67d1665269ab.png,859,107,946,201,87,94,red blood cell,8178,1.0804597701149425,0.925531914893617
56189,/images/137d540f-d71e-47e8-bd9b-6cd0a6433c33.png,150,60,256,184,106,124,red blood cell,13144,1.169811320754717,0.8548387096774194
29013,/images/4c13e22e-dfd1-4fa1-b373-be9d0c272c0f.png,977,524,1081,627,104,103,red blood cell,10712,0.9903846153846154,1.0097087378640777
44055,/images/8b494b40-cab5-49d3-893d-c805000fbe88.png,890,1204,1001,1311,111,107,red blood cell,11877,0.963963963963964,1.0373831775700935
25420,/images/5f742392-278d-461c-a848-08def2c28878.png,414,298,538,415,124,117,red blood cell,14508,0.9435483870967742,1.0598290598290598
14395,/images/f5eb7c5e-bd77-4638-ba9f-58d42f87476b.png,217,1084,340,1198,123,114,red blood cell,14022,0.926829268292683,1.0789473684210527
31900,/images/f62d4fb6-df7c-446c-94a8-d5aede0b1e0c.png,806,1462,919,1584,113,122,red blood cell,13786,1.079646017699115,0.9262295081967213
58324,/images/319c9c52-f316-49f3-baad-4444ab19f85b.png,404,229,510,324,106,95,red blood cell,10070,0.8962264150943396,1.1157894736842104
78752,/images/dc6ac71b-2616-431e-bfd5-4c38139e4ddd.png,1105,769,1196,873,91,104,red blood cell,9464,1.1428571428571428,0.875
74727,/images/c53fd511-31bd-4901-baac-3b44891f6744.png,779,651,896,761,117,110,red blood cell,12870,0.9401709401709402,1.0636363636363637
50371,/images/3d32a988-449d-4d58-b71f-abbfdc3f2fbc.png,718,1492,796,1582,78,90,red blood cell,7020,1.1538461538461537,0.8666666666666667
12132,/images/87d6343b-70dd-4cdd-939f-d3ac0ca2e700.png,732,163,852,292,120,129,red blood cell,15480,1.075,0.9302325581395349
22021,/images/c5acd0ad-b0f2-478d-b0ad-5aa733aa7b32.png,83,205,194,320,111,115,red blood cell,12765,1.0360360360360361,0.9652173913043478
28771,/images/686ed568-d5f8-475e-81ad-edab9dd473a0.png,224,166,328,264,104,98,red blood cell,10192,0.9423076923076923,1.0612244897959184
62059,/images/7f528918-27d4-421f-ab57-0cf9c693e697.png,801,981,914,1102,113,121,red blood cell,13673,1.0707964601769913,0.9338842975206612
73236,/images/85546330-4efd-43e2-87aa-d53a30220bfc.png,1105,381,1189,460,84,79,red blood cell,6636,0.9404761904761905,1.0632911392405062
28377,/images/34e024a5-5698-42d4-972f-fee234b4bd64.png,743,165,839,256,96,91,red blood cell,8736,0.9479166666666666,1.054945054945055
35809,/images/bb2042c5-35e1-43cc-8171-7de81b764361.png,548,350,638,444,90,94,red blood cell,8460,1.0444444444444445,0.9574468085106383
41969,/images/46a03374-64c7-49ac-81c9-c3d62542bbf3.png,696,224,791,322,95,98,red blood cell,9310,1.0315789473684212,0.9693877551020408
72491,/images/22516db4-8687-4051-90c4-2bb1ca3204a5.png,343,149,456,267,113,118,red blood cell,13334,1.0442477876106195,0.9576271186440678
79998,/images/e640ae51-cbf1-4a84-b7cf-d38b17f59c2f.png,534,309,628,395,94,86,red blood cell,8084,0.9148936170212766,1.0930232558139534
28710,/images/151f3af5-5e6e-4bcd-9389-4974fc68813e.png,229,449,317,536,88,87,red blood cell,7656,0.9886363636363636,1.0114942528735633
68191,/images/ff1b23d0-3cef-459b-b81f-39bfcdb6526f.png,159,392,252,488,93,96,red blood cell,8928,1.032258064516129,0.96875
56514,/images/ac8df764-c8d8-4312-916d-70bfb37574b4.png,130,532,230,640,100,108,red blood cell,10800,1.08,0.9259259259259259
61341,/images/e16c0dab-780d-4035-872e-1bb91e49f9d2.png,139,136,239,233,100,97,red blood cell,9700,0.97,1.0309278350515463
23574,/images/79d7a014-21ff-40f1-9ac4-a69839390654.png,1056,1071,1157,1167,101,96,red blood cell,9696,0.9504950495049505,1.0520833333333333
53695,/images/6f67a66b-56ec-4c36-ae7c-f250d3b86a23.png,895,245,999,335,104,90,red blood cell,9360,0.8653846153846154,1.1555555555555554
67646,/images/59542a24-b409-4c95-8608-d9691a741526.png,2,824,75,914,73,90,red blood cell,6570,1.2328767123287672,0.8111111111111111
22253,/images/3d4d7ba7-6c7c-4ddd-b282-31fb5d80edb5.png,751,768,858,878,107,110,red blood cell,11770,1.02803738317757,0.9727272727272728
5888,/images/a30da226-b452-408a-a556-bfae4d521464.png,126,474,226,589,100,115,red blood cell,11500,1.15,0.8695652173913043
58237,/images/319c9c52-f316-49f3-baad-4444ab19f85b.png,285,223,384,330,99,107,red blood cell,10593,1.0808080808080809,0.9252336448598131
19591,/images/883d9731-a04d-4f84-83c9-d3bef954759d.png,904,169,1019,287,115,118,red blood cell,13570,1.0260869565217392,0.9745762711864406
73224,/images/85546330-4efd-43e2-87aa-d53a30220bfc.png,232,372,312,452,80,80,red blood cell,6400,1.0,1.0
12788,/images/b634137b-bc8b-4e88-b0e3-b536ad6e7e18.png,604,463,712,566,108,103,red blood cell,11124,0.9537037037037037,1.0485436893203883
70860,/images/bf002a25-6535-4621-be19-56d468be5413.png,492,354,601,467,109,113,red blood cell,12317,1.036697247706422,0.9646017699115044
37299,/images/2fdbd9bc-bbaf-44c2-b40c-d193709639fa.png,477,1216,598,1324,121,108,red blood cell,13068,0.8925619834710744,1.1203703703703705
46538,/images/dd944a6b-c1d3-4f9f-bbdc-3709707984f7.png,941,334,1058,442,117,108,red blood cell,12636,0.9230769230769231,1.0833333333333333
52730,/images/9dc6ed5d-6698-48cf-aab3-fd156673729c.png,494,1245,600,1345,106,100,red blood cell,10600,0.9433962264150944,1.06
47982,/images/eba73bff-fbe1-436d-9a5f-0a61331a0ea2.png,872,1154,976,1249,104,95,red blood cell,9880,0.9134615384615384,1.0947368421052632
6489,/images/640c4a52-3742-4f57-aee3-9e3dc0887622.png,396,1269,507,1387,111,118,red blood cell,13098,1.063063063063063,0.940677966101695
6895,/images/b21f6c6e-4b45-407a-b4c7-034a115f3ee4.png,860,892,956,984,96,92,red blood cell,8832,0.9583333333333334,1.0434782608695652
65773,/images/daea4860-a296-4f6d-acef-996ab0882676.png,1059,1241,1168,1340,109,99,red blood cell,10791,0.908256880733945,1.101010101010101
72923,/images/a20d0b4b-6e2e-4507-bc22-f321dedc4ed9.png,961,516,1056,606,95,90,red blood cell,8550,0.9473684210526315,1.0555555555555556
22001,/images/393df10a-5d64-476b-88f5-14ac56d6ed60.png,309,1446,423,1558,114,112,red blood cell,12768,0.9824561403508771,1.0178571428571428
70014,/images/3e36698f-8c09-4c8b-8948-737310bf97e5.png,884,1115,990,1246,106,131,red blood cell,13886,1.2358490566037736,0.8091603053435115
42308,/images/ca734448-0d52-42fa-b41c-17b2939e58ae.png,434,1168,548,1277,114,109,red blood cell,12426,0.956140350877193,1.0458715596330275
6951,/images/a9feccda-18f2-405e-9aa1-409fa1f49fe4.png,604,181,709,296,105,115,red blood cell,12075,1.0952380952380953,0.9130434782608695
24277,/images/bb3ae957-0f6d-4615-bfe5-24fbca50b459.png,650,717,767,830,117,113,red blood cell,13221,0.9658119658119658,1.0353982300884956
55810,/images/68f34a9c-f73d-4238-8f55-4b05a8a2154c.png,673,1290,776,1379,103,89,red blood cell,9167,0.8640776699029126,1.1573033707865168
61297,/images/b3058064-d817-47dd-a8c4-cdb1f62374f8.png,581,117,666,207,85,90,red blood cell,7650,1.0588235294117647,0.9444444444444444
59204,/images/4736f545-1f1f-4d77-9241-d69cbf4dae35.png,997,903,1096,1004,99,101,red blood cell,9999,1.02020202020202,0.9801980198019802
61897,/images/f32b21ae-5ca7-490b-bc40-6db9396d933c.png,372,293,471,404,99,111,red blood cell,10989,1.121212121212121,0.8918918918918919
5901,/images/a30da226-b452-408a-a556-bfae4d521464.png,447,829,559,924,112,95,red blood cell,10640,0.8482142857142857,1.1789473684210525
63892,/images/5e974892-0ebe-4037-8427-ea8616d6d3b8.png,555,989,657,1101,102,112,red blood cell,11424,1.0980392156862746,0.9107142857142857
76090,/images/4c7d2382-a962-4237-a053-955eea3decd8.png,809,166,899,258,90,92,red blood cell,8280,1.0222222222222221,0.9782608695652174
40450,/images/db249e5a-4142-432c-8288-bacd10d7273d.png,577,183,676,300,99,117,red blood cell,11583,1.1818181818181819,0.8461538461538461
4181,/images/ac3358f1-ef9a-4ccc-b66c-da5e47e352e0.png,87,1427,197,1531,110,104,red blood cell,11440,0.9454545454545454,1.0576923076923077
75283,/images/9ec1dcec-87c2-4aca-8e6b-0db3cd05509c.png,478,450,575,554,97,104,red blood cell,10088,1.0721649484536082,0.9326923076923077
75502,/images/fa4f8d1a-cb3a-4722-a566-6c7072f30606.png,922,1378,1033,1472,111,94,red blood cell,10434,0.8468468468468469,1.1808510638297873
34658,/images/8d989997-038c-4924-b2d3-d02629a7cdf5.png,273,1238,385,1352,112,114,red blood cell,12768,1.0178571428571428,0.9824561403508771
647,/images/e61e6af2-7f8b-47b0-bbe7-acb2ed0299ab.png,92,1132,223,1243,131,111,red blood cell,14541,0.8473282442748091,1.1801801801801801
20720,/images/79b3a64f-2fb9-46e0-85d4-2bdd59c2075e.png,104,1197,219,1318,115,121,red blood cell,13915,1.0521739130434782,0.9504132231404959
29474,/images/8cc6fe77-5f2f-4670-b4ac-1b49550241a8.png,307,415,417,529,110,114,red blood cell,12540,1.0363636363636364,0.9649122807017544
43219,/images/fe1ee954-ba71-47b3-954a-d20ab940cd7b.png,90,915,198,1037,108,122,red blood cell,13176,1.1296296296296295,0.8852459016393442
57929,/images/09bcedaa-e007-4692-a13f-ab02c3f872c4.png,101,481,231,606,130,125,red blood cell,16250,0.9615384615384616,1.04
5609,/images/75c243e2-610d-4d5a-bc5a-4c53d99d9ae9.png,527,1338,648,1457,121,119,red blood cell,14399,0.9834710743801653,1.0168067226890756
18430,/images/39cc33be-d752-40fe-b7a8-2e69a3517205.png,38,1073,168,1185,130,112,red blood cell,14560,0.8615384615384616,1.1607142857142858
10834,/images/2a02cec2-a09b-483a-ad38-14359a763fa4.png,359,1450,471,1551,112,101,red blood cell,11312,0.9017857142857143,1.108910891089109
55054,/images/1f8f08ea-b5b3-4f68-94d4-3cc071b7dce8.png,514,840,619,954,105,114,red blood cell,11970,1.0857142857142856,0.9210526315789473
48375,/images/6fa2b30f-9b89-46ac-9b79-c0bc105d4271.png,66,830,171,928,105,98,red blood cell,10290,0.9333333333333333,1.0714285714285714
36051,/images/ca9626bc-21a4-46f4-ba94-e7ee7a4cf735.png,844,1350,982,1462,138,112,red blood cell,15456,0.8115942028985508,1.2321428571428572
60806,/images/645cd195-af50-409f-8da9-6e7c7f18ea09.png,47,242,148,345,101,103,red blood cell,10403,1.0198019801980198,0.9805825242718447
23631,/images/79d7a014-21ff-40f1-9ac4-a69839390654.png,1090,705,1193,799,103,94,red blood cell,9682,0.912621359223301,1.0957446808510638
45633,/images/582e4b8b-404e-4b30-9df3-66f2afb3cdb3.png,728,558,827,664,99,106,red blood cell,10494,1.0707070707070707,0.9339622641509434
64018,/images/03cbfcf2-8da6-462c-b30d-16d63357371f.png,671,532,776,640,105,108,red blood cell,11340,1.0285714285714285,0.9722222222222222
27207,/images/bca27923-b270-45df-a0bf-3e1a7d135b2c.png,299,1184,404,1297,105,113,red blood cell,11865,1.0761904761904761,0.9292035398230089
32236,/images/f4722a74-35e7-42bd-8ef6-dfff04b9cd22.png,153,1425,265,1542,112,117,red blood cell,13104,1.0446428571428572,0.9572649572649573
65468,/images/da49db57-0c2f-4213-b322-c88c19fb9296.png,721,1377,820,1488,99,111,red blood cell,10989,1.121212121212121,0.8918918918918919
74468,/images/cbb58718-6319-48db-b84b-78ac9b12ff89.png,141,71,254,174,113,103,red blood cell,11639,0.911504424778761,1.0970873786407767
36827,/images/dfac6c92-8f0f-429a-8caf-9b7732bf78da.png,468,1219,568,1335,100,116,red blood cell,11600,1.16,0.8620689655172413
25770,/images/1f8edb2a-40bc-4beb-aa6b-884d2473df0f.png,16,1430,132,1539,116,109,red blood cell,12644,0.9396551724137931,1.0642201834862386
6397,/images/1ecb0405-a6e9-4485-819e-2fbbf2b718aa.png,856,399,988,517,132,118,red blood cell,15576,0.8939393939393939,1.11864406779661
46536,/images/dd944a6b-c1d3-4f9f-bbdc-3709707984f7.png,815,1387,939,1510,124,123,red blood cell,15252,0.9919354838709677,1.008130081300813
73087,/images/f39e2289-fedd-4d12-9e64-ffdafb89247e.png,557,578,677,676,120,98,red blood cell,11760,0.8166666666666667,1.2244897959183674
26991,/images/1f337b61-1b0d-4539-91f9-73d4a0798a4a.png,503,338,612,449,109,111,red blood cell,12099,1.018348623853211,0.9819819819819819
43335,/images/36569710-a574-40be-ad42-897a6e74a128.png,21,785,128,891,107,106,red blood cell,11342,0.9906542056074766,1.009433962264151
61161,/images/80da32ce-8c22-470e-9f35-558c5f7a5df9.png,106,572,187,671,81,99,red blood cell,8019,1.2222222222222223,0.8181818181818182
3472,/images/ad36bd67-594b-4f63-93e3-886af0bc618e.png,1069,485,1166,595,97,110,red blood cell,10670,1.134020618556701,0.8818181818181818
32190,/images/07346d2e-a6e6-4dc0-95f1-9f7d8d7e3f66.png,694,162,794,267,100,105,red blood cell,10500,1.05,0.9523809523809523
24914,/images/ed0bee2f-05e0-4392-8357-19750cec577c.png,470,214,555,319,85,105,red blood cell,8925,1.2352941176470589,0.8095238095238095
74303,/images/8939e14b-fcdf-48b1-acb9-6514a2fc2fc0.png,712,908,809,1009,97,101,red blood cell,9797,1.041237113402062,0.9603960396039604
63990,/images/5e974892-0ebe-4037-8427-ea8616d6d3b8.png,1004,148,1093,247,89,99,red blood cell,8811,1.1123595505617978,0.898989898989899
42793,/images/7029feb3-9ffe-46e4-9883-6a9df84f7b62.png,488,424,612,541,124,117,red blood cell,14508,0.9435483870967742,1.0598290598290598
67230,/images/5f491efd-a21c-4a80-aaba-70b8876238ac.png,196,369,293,463,97,94,red blood cell,9118,0.9690721649484536,1.0319148936170213
63757,/images/06401963-8b02-46c5-ab2a-3d70bd01623f.png,239,0,344,110,105,110,red blood cell,11550,1.0476190476190477,0.9545454545454546
24816,/images/65054b19-5c6a-4870-99a9-eef994721d3a.png,475,977,595,1108,120,131,red blood cell,15720,1.0916666666666666,0.916030534351145
2223,/images/5bf91ff9-80df-49c0-9c3e-599357d95530.png,60,1090,181,1210,121,120,red blood cell,14520,0.9917355371900827,1.0083333333333333
74780,/images/91e93160-eb8d-4de0-b6bc-b98ec33d1663.png,816,856,914,961,98,105,red blood cell,10290,1.0714285714285714,0.9333333333333333
18975,/images/e9e78ff8-831b-46e9-9785-3eee9acbfcd8.png,956,833,1046,924,90,91,red blood cell,8190,1.011111111111111,0.989010989010989
7001,/images/c776eb78-3323-4571-b39f-7ffc73ae63ce.png,1051,1241,1137,1332,86,91,red blood cell,7826,1.058139534883721,0.945054945054945
34680,/images/8d989997-038c-4924-b2d3-d02629a7cdf5.png,1060,544,1179,655,119,111,red blood cell,13209,0.9327731092436975,1.072072072072072
65054,/images/ff3b9d4d-373c-48ef-a75a-d23e2c2ade87.png,527,1031,628,1140,101,109,red blood cell,11009,1.0792079207920793,0.926605504587156
67898,/images/41ebf9a1-24dc-454e-8bf8-508218f5ee57.png,452,279,555,374,103,95,red blood cell,9785,0.9223300970873787,1.0842105263157895
25170,/images/90171428-f208-428a-b40e-f57ee3bea457.png,883,1119,986,1217,103,98,red blood cell,10094,0.9514563106796117,1.0510204081632653
50185,/images/4cccfcf0-cac9-46f0-870c-0eabfdc781ba.png,479,692,594,804,115,112,red blood cell,12880,0.9739130434782609,1.0267857142857142
52427,/images/a2a20600-f851-4db7-90f9-6f7be027c8b5.png,836,619,920,714,84,95,red blood cell,7980,1.130952380952381,0.8842105263157894
17902,/images/eb77e4a9-acb0-4d83-8055-2c5fcaa54b45.png,18,537,105,629,87,92,red blood cell,8004,1.0574712643678161,0.9456521739130435
38763,/images/b426ef1d-4a59-4f90-b593-50226af60a60.png,11,352,119,472,108,120,red blood cell,12960,1.1111111111111112,0.9
73870,/images/3eba916c-998b-40a7-993c-7ed916c2a04c.png,956,759,1058,846,102,87,red blood cell,8874,0.8529411764705882,1.1724137931034482
63936,/images/5e974892-0ebe-4037-8427-ea8616d6d3b8.png,637,644,737,742,100,98,red blood cell,9800,0.98,1.0204081632653061
46351,/images/fcc2b245-f47f-447f-8527-275b0005677c.png,951,1359,1064,1483,113,124,red blood cell,14012,1.0973451327433628,0.9112903225806451
67434,/images/8e72e20e-e714-4db6-a1da-c05a409257d4.png,531,1102,625,1198,94,96,red blood cell,9024,1.0212765957446808,0.9791666666666666
42497,/images/29648565-fe28-4517-ba72-68df0c82c9c5.png,650,652,749,755,99,103,red blood cell,10197,1.0404040404040404,0.9611650485436893
30019,/images/deeaa5b3-3895-4aec-a2ce-ed6404862cdf.png,717,1250,825,1347,108,97,red blood cell,10476,0.8981481481481481,1.1134020618556701
20340,/images/98976666-9125-47fe-9601-43c41e58dfb4.png,466,468,581,576,115,108,red blood cell,12420,0.9391304347826087,1.0648148148148149
54338,/images/19370afd-f897-47d8-bfae-c0d257bbf795.png,185,807,273,906,88,99,red blood cell,8712,1.125,0.8888888888888888
69519,/images/664c570b-4822-413c-9724-11b1d91fac44.png,766,909,861,990,95,81,red blood cell,7695,0.8526315789473684,1.1728395061728396
72559,/images/01b99da8-b66b-464b-a7ee-1cadab8db18b.png,512,1412,604,1504,92,92,red blood cell,8464,1.0,1.0
49026,/images/df3d98b9-3dd7-4107-8d4a-ae1b7f247793.png,180,460,269,550,89,90,red blood cell,8010,1.0112359550561798,0.9888888888888889
49743,/images/5e17f8e6-fd8d-426c-b444-1515d14f04b7.png,707,1063,810,1172,103,109,red blood cell,11227,1.058252427184466,0.944954128440367
54838,/images/b6364a57-72a9-43f3-8d02-9f53a992dc95.png,310,1204,405,1307,95,103,red blood cell,9785,1.0842105263157895,0.9223300970873787
43990,/images/de81bf7a-7a56-437f-a068-4d9c3e01134c.png,1056,575,1166,691,110,116,red blood cell,12760,1.0545454545454545,0.9482758620689655
18026,/images/0f0c949e-018a-4f3f-ab02-3704f49c7754.png,515,220,624,325,109,105,red blood cell,11445,0.963302752293578,1.0380952380952382
11116,/images/98175327-da9e-4e0c-8912-ee68490a4672.png,421,1395,543,1513,122,118,red blood cell,14396,0.9672131147540983,1.0338983050847457
15641,/images/84d7545e-c3a8-4b1f-9a39-36aab78c8699.png,95,394,214,517,119,123,red blood cell,14637,1.0336134453781514,0.967479674796748
66245,/images/e8058bed-c362-4e1c-85dc-62f80f32938f.png,242,384,353,491,111,107,red blood cell,11877,0.963963963963964,1.0373831775700935
51841,/images/f07174a5-f799-4286-ac43-5b0f5c5777ac.png,289,482,381,591,92,109,red blood cell,10028,1.184782608695652,0.8440366972477065
24601,/images/c03d9b87-e19b-402b-ad86-b30d6e8aeb59.png,883,76,992,177,109,101,red blood cell,11009,0.926605504587156,1.0792079207920793
43591,/images/e0ef520d-7b65-485d-9888-e6859f189f70.png,356,1363,456,1462,100,99,red blood cell,9900,0.99,1.0101010101010102
55957,/images/afd39466-aafa-4d81-9520-483727418723.png,351,546,444,628,93,82,red blood cell,7626,0.8817204301075269,1.1341463414634145
29299,/images/3850f2a5-ab62-49d3-8135-68d60baa676b.png,462,1488,583,1598,121,110,red blood cell,13310,0.9090909090909091,1.1
43499,/images/2d857091-efcd-41c0-ba3f-226de90445c4.png,458,463,547,561,89,98,red blood cell,8722,1.101123595505618,0.9081632653061225
12334,/images/3b55c42f-ad59-422f-ba99-4f4f4ca9cb2e.png,298,1191,407,1296,109,105,red blood cell,11445,0.963302752293578,1.0380952380952382
52784,/images/0a747cb3-c720-4572-a661-ab5670a5c42e.png,759,229,877,345,118,116,red blood cell,13688,0.9830508474576272,1.0172413793103448
35568,/images/a1ff36df-71df-4e6e-a65f-ced9a2b381c3.png,891,879,1010,988,119,109,red blood cell,12971,0.9159663865546218,1.091743119266055
45558,/images/e597f7ce-46c6-4dce-9063-50a2703fdd45.png,629,1199,727,1299,98,100,red blood cell,9800,1.0204081632653061,0.98
40138,/images/b34e65f6-c32e-42f1-a437-4a037c75a231.png,654,456,777,567,123,111,red blood cell,13653,0.9024390243902439,1.1081081081081081
15774,/images/64113b22-03b1-4ab8-89ab-b2f32154fbbd.png,898,843,993,931,95,88,red blood cell,8360,0.9263157894736842,1.0795454545454546
39846,/images/af2e63a3-9fde-46aa-a867-81c5c259d1dc.png,750,384,871,505,121,121,red blood cell,14641,1.0,1.0
39248,/images/f7cced00-9b41-45ec-9fdf-fb9e1a74da90.png,1042,752,1158,877,116,125,red blood cell,14500,1.0775862068965518,0.928
912,/images/dce55b59-c6c3-4693-aa75-6b348c8f52cd.png,128,171,239,279,111,108,red blood cell,11988,0.972972972972973,1.0277777777777777
39917,/images/71cf2467-77d3-4fac-ac6e-1d8767717c34.png,133,665,249,791,116,126,red blood cell,14616,1.0862068965517242,0.9206349206349206
77605,/images/f20a4fcf-ea8e-4c14-883d-d26a9e08ce25.png,595,560,723,669,128,109,red blood cell,13952,0.8515625,1.1743119266055047
39026,/images/79806898-0214-44bd-ba2c-b570e911be62.png,193,712,326,840,133,128,red blood cell,17024,0.9624060150375939,1.0390625
38658,/images/b5acf759-1115-42f0-a753-656736192528.png,862,1319,988,1431,126,112,red blood cell,14112,0.8888888888888888,1.125
63631,/images/d9c9479e-f1ea-4d6e-861f-843ff9a90d19.png,575,29,688,132,113,103,red blood cell,11639,0.911504424778761,1.0970873786407767
67327,/images/49c4dbd3-6269-4d4c-9648-a2146c57bab1.png,701,706,796,806,95,100,red blood cell,9500,1.0526315789473684,0.95
36650,/images/21f001d6-f568-4ea4-82da-fab54c77c419.png,741,612,828,702,87,90,red blood cell,7830,1.0344827586206897,0.9666666666666667
40012,/images/8271d0d8-9985-43eb-94b3-c702adca139f.png,485,334,606,453,121,119,red blood cell,14399,0.9834710743801653,1.0168067226890756
75606,/images/c35ee701-fde2-46b5-b178-1fe3f1ea7da2.png,390,239,491,342,101,103,red blood cell,10403,1.0198019801980198,0.9805825242718447
76268,/images/1574565f-f45b-4160-947e-25ce1a81aaca.png,357,1408,486,1532,129,124,red blood cell,15996,0.9612403100775194,1.0403225806451613
68693,/images/77e76e62-2c71-4b52-9b21-0d1bcde9f9bf.png,615,108,726,218,111,110,red blood cell,12210,0.990990990990991,1.009090909090909
19154,/images/bb795ddf-ce72-42d5-9006-124db4d5cf1c.png,253,1073,353,1174,100,101,red blood cell,10100,1.01,0.9900990099009901
39618,/images/04d21589-b777-43c2-86b5-038cbf8c3a4e.png,153,1135,256,1245,103,110,red blood cell,11330,1.0679611650485437,0.9363636363636364
71587,/images/390ad256-e1ed-476a-9f14-2dc34e0da632.png,238,1125,356,1237,118,112,red blood cell,13216,0.9491525423728814,1.0535714285714286
53430,/images/766d5547-8dd2-4c8d-b78e-3007f83932e8.png,186,802,280,902,94,100,red blood cell,9400,1.0638297872340425,0.94
44916,/images/83ec8923-6232-40d7-ba1f-a1b8bf7cb66c.png,142,668,244,762,102,94,red blood cell,9588,0.9215686274509803,1.0851063829787233
47253,/images/58ced55c-bf0d-4204-b6b2-4f8992d92779.png,1079,1220,1190,1332,111,112,red blood cell,12432,1.009009009009009,0.9910714285714286
44709,/images/867f30da-2568-4480-9968-cece78c61c64.png,818,551,930,658,112,107,red blood cell,11984,0.9553571428571429,1.0467289719626167
15800,/images/64113b22-03b1-4ab8-89ab-b2f32154fbbd.png,793,1372,885,1464,92,92,red blood cell,8464,1.0,1.0
19116,/images/2196389c-45ec-46b5-bc6c-1f4a33df7f7c.png,919,1017,1032,1146,113,129,red blood cell,14577,1.1415929203539823,0.875968992248062
16088,/images/7e25ced3-5caf-47f8-ad0c-42946bd4468b.png,144,190,260,299,116,109,red blood cell,12644,0.9396551724137931,1.0642201834862386
27057,/images/ec301f62-1302-4407-96f9-fcfe45c150ae.png,372,771,489,907,117,136,red blood cell,15912,1.1623931623931625,0.8602941176470589
69536,/images/664c570b-4822-413c-9724-11b1d91fac44.png,50,419,134,494,84,75,red blood cell,6300,0.8928571428571429,1.12
56139,/images/50d9fc90-8642-4bb6-91a7-0069a7e37392.png,295,1232,407,1331,112,99,red blood cell,11088,0.8839285714285714,1.1313131313131313
47711,/images/afbb264e-ff60-443a-83f5-49d09be1b835.png,181,1431,317,1555,136,124,red blood cell,16864,0.9117647058823529,1.096774193548387
52409,/images/a2a20600-f851-4db7-90f9-6f7be027c8b5.png,726,82,835,191,109,109,red blood cell,11881,1.0,1.0
23742,/images/6b2ff7ca-c5b3-415c-9481-7b14efc6d7ef.png,80,1026,193,1140,113,114,red blood cell,12882,1.008849557522124,0.9912280701754386
37890,/images/56a57a8d-c9b9-432a-a3b0-32a09355806c.png,935,1029,1042,1127,107,98,red blood cell,10486,0.9158878504672897,1.0918367346938775
62675,/images/f7a4334a-4332-4de8-b39b-22da907976f2.png,1116,966,1200,1056,84,90,red blood cell,7560,1.0714285714285714,0.9333333333333333
58102,/images/e9916e11-9be6-4dec-9df6-2e7d1a8e1735.png,1059,993,1164,1091,105,98,red blood cell,10290,0.9333333333333333,1.0714285714285714
14189,/images/c186dcd1-af61-455f-9619-1fdd8c881b06.png,672,134,792,258,120,124,red blood cell,14880,1.0333333333333334,0.967741935483871
2510,/images/a23f5539-bfe6-4885-9a0e-dba972475ea9.png,304,491,402,590,98,99,red blood cell,9702,1.010204081632653,0.98989898989899
56630,/images/4adcaa26-aa1f-47b5-bdf0-18c9f814f576.png,202,20,307,122,105,102,red blood cell,10710,0.9714285714285714,1.0294117647058822
24324,/images/4d8a4ce8-0f9c-4f21-8844-4cf0e5514bbf.png,1069,719,1187,814,118,95,red blood cell,11210,0.8050847457627118,1.2421052631578948
9787,/images/3859deaf-6ae1-49a3-9051-898d0f0d7de6.png,464,339,569,440,105,101,red blood cell,10605,0.9619047619047619,1.0396039603960396
49728,/images/5e17f8e6-fd8d-426c-b444-1515d14f04b7.png,575,541,681,636,106,95,red blood cell,10070,0.8962264150943396,1.1157894736842104
1591,/images/7094c11a-1e62-4f98-894e-d17d138a88e9.png,1013,683,1135,810,122,127,red blood cell,15494,1.040983606557377,0.9606299212598425
23759,/images/6b2ff7ca-c5b3-415c-9481-7b14efc6d7ef.png,519,1052,645,1182,126,130,red blood cell,16380,1.0317460317460319,0.9692307692307692
37546,/images/205306da-0ed8-475a-ace6-f2f81d4be88a.png,904,71,999,183,95,112,red blood cell,10640,1.1789473684210525,0.8482142857142857
55392,/images/d67655e6-0a80-4a86-b552-1f5e85788377.png,75,46,179,152,104,106,red blood cell,11024,1.0192307692307692,0.9811320754716981
42353,/images/5c5b7965-1a44-44b8-aa43-660823e61821.png,556,160,661,276,105,116,red blood cell,12180,1.1047619047619048,0.9051724137931034
313,/images/0dcca702-a4ef-4fb3-a940-9c0c140b21c7.png,449,188,560,299,111,111,red blood cell,12321,1.0,1.0
69221,/images/f274b784-b995-4a7e-a2c2-6cc31c24c4b4.png,165,1445,252,1527,87,82,red blood cell,7134,0.9425287356321839,1.0609756097560976
8813,/images/ae17a099-18b5-4a42-a901-850ea056423e.png,183,531,277,631,94,100,red blood cell,9400,1.0638297872340425,0.94
20450,/images/9d819c89-4ea9-4e75-9b03-da87fa6c6f4d.png,232,1322,363,1455,131,133,red blood cell,17423,1.015267175572519,0.9849624060150376
67179,/images/be6fe358-dee1-4dcf-9b0d-5d8612aba577.png,703,544,793,626,90,82,red blood cell,7380,0.9111111111111111,1.0975609756097562
18547,/images/c22f7031-9cf8-48ce-b03b-1b12d0db4951.png,553,1419,664,1522,111,103,red blood cell,11433,0.9279279279279279,1.0776699029126213
41467,/images/c4494d4f-732f-431a-8a9d-62403f0b74fe.png,184,1255,272,1356,88,101,red blood cell,8888,1.1477272727272727,0.8712871287128713
46274,/images/815bf40c-371a-4d34-aa41-c549c8221881.png,752,69,873,172,121,103,red blood cell,12463,0.8512396694214877,1.174757281553398
49527,/images/9f33e0ea-065b-4703-9df9-15829b891860.png,565,1373,689,1508,124,135,red blood cell,16740,1.0887096774193548,0.9185185185185185
10022,/images/26799d2b-a289-4eff-9218-0aad77e05e41.png,624,169,749,292,125,123,red blood cell,15375,0.984,1.016260162601626
202,/images/2559636b-f01a-4414-93da-210c3b12d153.png,524,534,633,660,109,126,red blood cell,13734,1.1559633027522935,0.8650793650793651
39068,/images/8f96ee1f-4ef7-4279-a610-316319bedcf9.png,914,1208,1047,1341,133,133,red blood cell,17689,1.0,1.0
73537,/images/7624ac36-1cf9-42fb-844d-376078309553.png,324,171,426,267,102,96,red blood cell,9792,0.9411764705882353,1.0625
47629,/images/78ac1e98-7062-4e27-8d58-25c392cae889.png,786,975,907,1090,121,115,red blood cell,13915,0.9504132231404959,1.0521739130434782
19052,/images/6e39fb0a-aa41-4b16-b783-7589e97bf289.png,216,386,335,498,119,112,red blood cell,13328,0.9411764705882353,1.0625
44082,/images/8b494b40-cab5-49d3-893d-c805000fbe88.png,391,1228,487,1321,96,93,red blood cell,8928,0.96875,1.032258064516129
44621,/images/6388e241-09a2-4fbe-a712-07d8fe714c51.png,885,78,1005,196,120,118,red blood cell,14160,0.9833333333333333,1.0169491525423728
40259,/images/f05ffdca-dc3a-47bd-a231-2a0d9bd1d50e.png,473,1151,594,1274,121,123,red blood cell,14883,1.0165289256198347,0.983739837398374
38085,/images/907650b5-edae-471d-bc54-a825be3d3fac.png,1039,1198,1170,1334,131,136,red blood cell,17816,1.0381679389312977,0.9632352941176471
6102,/images/c147584d-4c61-412a-bdaf-b02b22c18708.png,832,591,950,697,118,106,red blood cell,12508,0.8983050847457628,1.1132075471698113
25952,/images/e683144c-0465-43a2-86b1-3cf52599d5e0.png,394,866,507,971,113,105,red blood cell,11865,0.9292035398230089,1.0761904761904761
60730,/images/45651e76-4bd0-45e5-895b-edec65f51987.png,100,1354,199,1463,99,109,red blood cell,10791,1.101010101010101,0.908256880733945
43952,/images/d7c7eb2c-2acd-4f86-8a5a-09ab3dd02d16.png,730,1212,822,1313,92,101,red blood cell,9292,1.0978260869565217,0.9108910891089109
73561,/images/7624ac36-1cf9-42fb-844d-376078309553.png,904,490,1013,593,109,103,red blood cell,11227,0.944954128440367,1.058252427184466
45512,/images/94b5a9a1-1c88-4400-aca4-3d56f543fc4a.png,1058,1045,1168,1163,110,118,red blood cell,12980,1.0727272727272728,0.9322033898305084
68725,/images/dcf7a19a-ec3d-44ef-8d7c-33b1e91fb9af.png,694,760,822,903,128,143,red blood cell,18304,1.1171875,0.8951048951048951
20020,/images/ebfd9f67-138e-49f0-9cef-a0352069eedb.png,500,81,595,184,95,103,red blood cell,9785,1.0842105263157895,0.9223300970873787
7085,/images/8be185e7-2a1a-441c-a5c7-b50a9eb926cb.png,583,1418,687,1526,104,108,red blood cell,11232,1.0384615384615385,0.9629629629629629
57802,/images/c9ad92d4-b408-4506-916e-def47b2e6ed0.png,53,1334,149,1423,96,89,red blood cell,8544,0.9270833333333334,1.0786516853932584
74888,/images/81edcae1-65bf-4752-b0e4-494376b71e49.png,326,902,403,977,77,75,red blood cell,5775,0.974025974025974,1.0266666666666666
7698,/images/9f959520-e15e-45c2-bc29-ef3c19154d1c.png,141,74,259,199,118,125,red blood cell,14750,1.0593220338983051,0.944
61485,/images/7e837856-3519-4dc0-b357-4cdcfd30b4eb.png,182,1303,294,1419,112,116,red blood cell,12992,1.0357142857142858,0.9655172413793104
45967,/images/72088c26-d2dd-4906-b791-b8947fc7fbe4.png,314,1089,417,1198,103,109,red blood cell,11227,1.058252427184466,0.944954128440367
52638,/images/a6fe423a-5204-4378-bcfa-d6d298a3e9aa.png,1075,295,1166,408,91,113,red blood cell,10283,1.2417582417582418,0.8053097345132744
43858,/images/679ae89f-4a02-4301-862e-1d844cc66cbf.png,907,742,1028,857,121,115,red blood cell,13915,0.9504132231404959,1.0521739130434782
61475,/images/7e837856-3519-4dc0-b357-4cdcfd30b4eb.png,1032,629,1129,734,97,105,red blood cell,10185,1.0824742268041236,0.9238095238095239
26122,/images/27388ff2-4000-4c9a-a2e3-addc448a5f92.png,220,182,347,301,127,119,red blood cell,15113,0.937007874015748,1.0672268907563025
68715,/images/dcf7a19a-ec3d-44ef-8d7c-33b1e91fb9af.png,611,1331,713,1434,102,103,red blood cell,10506,1.0098039215686274,0.9902912621359223
11154,/images/6303f964-98ef-47c6-bb2d-283aa393f918.png,52,600,150,694,98,94,red blood cell,9212,0.9591836734693877,1.0425531914893618
63173,/images/f0804a5e-e7f5-4cf2-a5df-b65e66502bf1.png,544,598,649,709,105,111,red blood cell,11655,1.0571428571428572,0.9459459459459459
31080,/images/9c48fdf4-621d-4f40-bcd7-6a28cd530de7.png,400,352,505,459,105,107,red blood cell,11235,1.019047619047619,0.9813084112149533
24359,/images/4d8a4ce8-0f9c-4f21-8844-4cf0e5514bbf.png,946,1316,1044,1413,98,97,red blood cell,9506,0.9897959183673469,1.0103092783505154
50613,/images/c956e531-6805-4fe1-b61c-8b96a9815a77.png,857,958,984,1093,127,135,red blood cell,17145,1.062992125984252,0.9407407407407408
70056,/images/b8339d7b-85ec-48d0-83e8-c8f831070459.png,257,1331,368,1440,111,109,red blood cell,12099,0.9819819819819819,1.018348623853211
9513,/images/a18f122f-3a3e-4478-8ac4-91b83e050e65.png,595,1454,707,1574,112,120,red blood cell,13440,1.0714285714285714,0.9333333333333333
33861,/images/b9de8b1a-f96a-4eb5-bc05-84ad43a054f3.png,440,1135,574,1257,134,122,red blood cell,16348,0.9104477611940298,1.098360655737705
2287,/images/fe851c88-692d-4199-87e0-d19d9c4eb591.png,912,1038,1012,1132,100,94,red blood cell,9400,0.94,1.0638297872340425
52819,/images/0a747cb3-c720-4572-a661-ab5670a5c42e.png,194,176,332,314,138,138,red blood cell,19044,1.0,1.0
72821,/images/31435107-c77d-42f8-a619-75cba6a5161b.png,604,590,704,689,100,99,red blood cell,9900,0.99,1.0101010101010102
73482,/images/5f2b32bd-fdca-4d6f-b13a-ee9f83626c8d.png,40,1133,172,1250,132,117,red blood cell,15444,0.8863636363636364,1.1282051282051282
30818,/images/93a306b8-594a-4c7f-8b4a-127fb6ad8f1a.png,1083,1457,1192,1568,109,111,red blood cell,12099,1.018348623853211,0.9819819819819819
79912,/images/0b923ab7-ebff-4079-a4bb-af7da89f374e.png,352,890,457,993,105,103,red blood cell,10815,0.9809523809523809,1.0194174757281553
7159,/images/56551792-4aa1-4301-9f8f-8bfebcd20050.png,679,1429,806,1549,127,120,red blood cell,15240,0.9448818897637795,1.0583333333333333
4602,/images/f1de7c7e-e7d3-45ae-a66c-58538bf6cac1.png,932,1278,1049,1392,117,114,red blood cell,13338,0.9743589743589743,1.0263157894736843
35815,/images/bb2042c5-35e1-43cc-8171-7de81b764361.png,606,360,693,446,87,86,red blood cell,7482,0.9885057471264368,1.0116279069767442
38924,/images/d79b4e90-c45d-4f5d-a498-49c3e323c291.png,81,926,174,1024,93,98,red blood cell,9114,1.053763440860215,0.9489795918367347
68660,/images/31653d0f-c4e6-4e12-8005-518c2de34687.png,993,938,1071,1026,78,88,red blood cell,6864,1.1282051282051282,0.8863636363636364
56256,/images/6b473806-e936-4b19-98cf-a2b94cac35ff.png,92,157,192,256,100,99,red blood cell,9900,0.99,1.0101010101010102
20505,/images/cbde7f7e-2458-4dda-9db2-3d5ccf950ced.png,275,634,381,761,106,127,red blood cell,13462,1.1981132075471699,0.8346456692913385
76221,/images/90a82250-1f68-48c9-9af9-15f18bf8c974.png,1011,1106,1124,1200,113,94,red blood cell,10622,0.831858407079646,1.202127659574468
76181,/images/07a96126-482e-4beb-b42a-0cb59e505372.png,30,1120,131,1219,101,99,red blood cell,9999,0.9801980198019802,1.02020202020202
28230,/images/036404d1-b9fc-497b-bbe1-f4d9c5ac3ce0.png,975,61,1082,169,107,108,red blood cell,11556,1.0093457943925233,0.9907407407407407
25863,/images/461a3ed6-039f-4a70-97cf-c474ecf51ccd.png,472,463,573,575,101,112,red blood cell,11312,1.108910891089109,0.9017857142857143
73902,/images/2ae3e6e6-7482-4ab8-ad73-b530b5c2ee3b.png,698,1377,789,1474,91,97,red blood cell,8827,1.065934065934066,0.9381443298969072
16452,/images/e474a20b-2769-48f1-a520-4f6ef5a0dbf5.png,379,1506,480,1589,101,83,red blood cell,8383,0.8217821782178217,1.216867469879518
25718,/images/412c9fa5-fcf4-402b-b1e4-3271f775058e.png,742,1455,875,1576,133,121,red blood cell,16093,0.9097744360902256,1.0991735537190082
62439,/images/7dfbfeaf-e3b1-4159-8dcd-d7f731280ac8.png,510,814,628,928,118,114,red blood cell,13452,0.9661016949152542,1.0350877192982457
31757,/images/ab59c9e4-3e50-48b9-874d-060d317410cc.png,929,934,1059,1068,130,134,red blood cell,17420,1.0307692307692307,0.9701492537313433
63170,/images/f0804a5e-e7f5-4cf2-a5df-b65e66502bf1.png,149,1436,248,1551,99,115,red blood cell,11385,1.1616161616161615,0.8608695652173913
40668,/images/252071ac-e9f2-41d2-abbb-87ef01b8a997.png,1026,1204,1131,1305,105,101,red blood cell,10605,0.9619047619047619,1.0396039603960396
16333,/images/69569ecf-cfa1-4ddd-9342-b22c23387fdb.png,747,997,869,1118,122,121,red blood cell,14762,0.9918032786885246,1.0082644628099173
56834,/images/0dcbf2c9-f959-4703-a72b-f6a81e66c2ea.png,695,467,796,583,101,116,red blood cell,11716,1.1485148514851484,0.8706896551724138
79529,/images/161978c3-3a05-47a5-9fee-be7d25693eae.png,492,432,586,535,94,103,red blood cell,9682,1.0957446808510638,0.912621359223301
35340,/images/452482bc-24a3-413e-ba03-fad4c9d61f3c.png,469,72,567,173,98,101,red blood cell,9898,1.030612244897959,0.9702970297029703
46199,/images/d8632217-ec33-4d0a-98e6-427824c58869.png,758,366,861,464,103,98,red blood cell,10094,0.9514563106796117,1.0510204081632653
44599,/images/6388e241-09a2-4fbe-a712-07d8fe714c51.png,230,500,342,623,112,123,red blood cell,13776,1.0982142857142858,0.9105691056910569
63314,/images/43bc935a-f655-45e1-a64d-fcb8b78267a6.png,795,1047,887,1149,92,102,red blood cell,9384,1.108695652173913,0.9019607843137255
16847,/images/4823c1fe-a7f9-4b92-959f-0d9be09cd14b.png,7,786,96,892,89,106,red blood cell,9434,1.1910112359550562,0.839622641509434
31238,/images/1976cd04-d24f-457c-b423-7e4cdb05de9e.png,930,729,1044,864,114,135,red blood cell,15390,1.1842105263157894,0.8444444444444444
71454,/images/bcb447c9-5d37-414f-a513-d7076b04a532.png,416,174,526,281,110,107,red blood cell,11770,0.9727272727272728,1.02803738317757
6641,/images/640c4a52-3742-4f57-aee3-9e3dc0887622.png,981,439,1070,523,89,84,red blood cell,7476,0.9438202247191011,1.0595238095238095
23562,/images/177f883a-f0f1-4b8e-b598-2ca4bab27381.png,335,146,444,269,109,123,red blood cell,13407,1.128440366972477,0.8861788617886179
57922,/images/09bcedaa-e007-4692-a13f-ab02c3f872c4.png,885,982,996,1094,111,112,red blood cell,12432,1.009009009009009,0.9910714285714286
36972,/images/b2e34f5f-904e-4473-9dc7-c6bc1ce12640.png,1019,722,1134,825,115,103,red blood cell,11845,0.8956521739130435,1.116504854368932
9885,/images/b4261fa5-876d-48ea-b6da-ec7ca5b48fe2.png,450,520,551,628,101,108,red blood cell,10908,1.0693069306930694,0.9351851851851852
22215,/images/3d4d7ba7-6c7c-4ddd-b282-31fb5d80edb5.png,736,391,845,502,109,111,red blood cell,12099,1.018348623853211,0.9819819819819819
10494,/images/46a2d369-4bea-4405-ac78-91bbe130b9a7.png,66,274,169,386,103,112,red blood cell,11536,1.087378640776699,0.9196428571428571
21482,/images/7625dfc4-858a-4c8e-907c-8943d665e9a7.png,603,1054,708,1157,105,103,red blood cell,10815,0.9809523809523809,1.0194174757281553
51657,/images/592c941a-aa54-4971-b499-dc47356f80a3.png,807,391,907,503,100,112,red blood cell,11200,1.12,0.8928571428571429
79738,/images/03b9d6ad-39ca-4097-a98b-77f02b3c00a7.png,456,1081,561,1181,105,100,red blood cell,10500,0.9523809523809523,1.05
75519,/images/fa4f8d1a-cb3a-4722-a566-6c7072f30606.png,304,293,402,391,98,98,red blood cell,9604,1.0,1.0
41113,/images/2240b991-48f6-4c59-9b62-5a8b5e541fae.png,687,1413,798,1539,111,126,red blood cell,13986,1.135135135135135,0.8809523809523809
4341,/images/84041bf9-dace-4066-9fe0-52170d08f826.png,248,406,340,500,92,94,red blood cell,8648,1.0217391304347827,0.9787234042553191
69862,/images/9edba799-e169-46cd-b100-c9f8fc7a8c7d.png,459,1174,558,1273,99,99,red blood cell,9801,1.0,1.0
47942,/images/ab27173b-6e30-4957-bd68-29194328fd39.png,324,684,428,784,104,100,red blood cell,10400,0.9615384615384616,1.04
21383,/images/5077f87d-a19f-494c-b911-14ccb03bd230.png,779,573,906,690,127,117,red blood cell,14859,0.9212598425196851,1.0854700854700854
40673,/images/252071ac-e9f2-41d2-abbb-87ef01b8a997.png,311,1198,407,1285,96,87,red blood cell,8352,0.90625,1.103448275862069
57359,/images/a88a48b6-f85c-45c1-b42f-79716c8463f1.png,115,659,234,775,119,116,red blood cell,13804,0.9747899159663865,1.0258620689655173
47817,/images/5a105b89-c592-4d78-b208-7db6c6572752.png,409,715,527,832,118,117,red blood cell,13806,0.9915254237288136,1.0085470085470085
19846,/images/b318889c-3c60-477c-b8f6-d18cb01a59df.png,682,143,783,251,101,108,red blood cell,10908,1.0693069306930694,0.9351851851851852
42384,/images/1a27ebe9-93a1-4898-af69-f276057d4012.png,338,1233,446,1359,108,126,red blood cell,13608,1.1666666666666667,0.8571428571428571
25752,/images/1f8edb2a-40bc-4beb-aa6b-884d2473df0f.png,1040,1150,1153,1270,113,120,red blood cell,13560,1.0619469026548674,0.9416666666666667
26977,/images/1f337b61-1b0d-4539-91f9-73d4a0798a4a.png,587,1288,690,1392,103,104,red blood cell,10712,1.0097087378640777,0.9903846153846154
47151,/images/3d1b889e-bb4a-4ee6-b899-974ee7d956a7.png,195,1290,295,1386,100,96,red blood cell,9600,0.96,1.0416666666666667
48641,/images/55836297-fc8e-4e00-9767-0d12b86e4604.png,10,618,97,709,87,91,red blood cell,7917,1.0459770114942528,0.9560439560439561
11850,/images/3cdcb09b-6a8c-43ca-b1d0-c1a289202f65.png,34,258,140,373,106,115,red blood cell,12190,1.0849056603773586,0.9217391304347826
23354,/images/a7688988-2bcc-4458-83d3-5e482da5f87b.png,895,1109,995,1210,100,101,red blood cell,10100,1.01,0.9900990099009901
59966,/images/f0fe292d-85ae-4c3a-a676-037dde2594e6.png,630,1243,745,1362,115,119,red blood cell,13685,1.0347826086956522,0.9663865546218487
59293,/images/03c8da48-04b9-4520-b674-44a0ecd35688.png,1100,1150,1186,1241,86,91,red blood cell,7826,1.058139534883721,0.945054945054945
44642,/images/8002cb71-0f25-4fa4-a46f-b49e5aeded0c.png,719,314,835,426,116,112,red blood cell,12992,0.9655172413793104,1.0357142857142858
49031,/images/df3d98b9-3dd7-4107-8d4a-ae1b7f247793.png,481,187,583,293,102,106,red blood cell,10812,1.0392156862745099,0.9622641509433962
13265,/images/030f3421-ed3f-4bf1-8f27-4d02590bffbc.png,516,975,617,1088,101,113,red blood cell,11413,1.118811881188119,0.8938053097345132
58804,/images/434523fd-d4d9-4961-a7c2-d71d6ae68e13.png,254,20,364,129,110,109,red blood cell,11990,0.990909090909091,1.0091743119266054
61891,/images/f32b21ae-5ca7-490b-bc40-6db9396d933c.png,307,1423,424,1533,117,110,red blood cell,12870,0.9401709401709402,1.0636363636363637
64979,/images/dec61ae1-5037-4c3a-8952-15371becca7d.png,437,1174,544,1276,107,102,red blood cell,10914,0.9532710280373832,1.0490196078431373
71760,/images/093a831a-bf71-4333-bc06-942ae70cb164.png,1044,337,1140,420,96,83,red blood cell,7968,0.8645833333333334,1.1566265060240963
39537,/images/5a631871-2fc7-4a68-9c39-f3b9a0bf4a04.png,706,447,814,546,108,99,red blood cell,10692,0.9166666666666666,1.0909090909090908
56625,/images/4adcaa26-aa1f-47b5-bdf0-18c9f814f576.png,714,1222,852,1342,138,120,red blood cell,16560,0.8695652173913043,1.15
41638,/images/0fcd1ebe-ee4a-40a0-b787-29cee18bfa1b.png,384,331,462,414,78,83,red blood cell,6474,1.064102564102564,0.9397590361445783
70401,/images/4876c9d0-b386-48fb-84e8-91bf87529161.png,224,1323,322,1411,98,88,red blood cell,8624,0.8979591836734694,1.1136363636363635
61635,/images/a3c0a876-be12-4ede-8aed-18b32a64401b.png,479,1097,575,1190,96,93,red blood cell,8928,0.96875,1.032258064516129
9747,/images/3859deaf-6ae1-49a3-9051-898d0f0d7de6.png,876,1201,978,1304,102,103,red blood cell,10506,1.0098039215686274,0.9902912621359223
66878,/images/9acf303a-fcba-4e52-be3e-8d061aa5e72a.png,225,1000,325,1097,100,97,red blood cell,9700,0.97,1.0309278350515463
3980,/images/f09acb0c-b270-4e91-99f8-410adfa7f34a.png,878,1139,968,1237,90,98,red blood cell,8820,1.0888888888888888,0.9183673469387755
14854,/images/3090a362-1f3d-49e9-a76e-ce76ff9c2276.png,783,644,892,751,109,107,red blood cell,11663,0.981651376146789,1.0186915887850467
79865,/images/a054a8e2-55f2-4508-97df-207f76b89be2.png,503,897,619,1023,116,126,red blood cell,14616,1.0862068965517242,0.9206349206349206
63869,/images/5e974892-0ebe-4037-8427-ea8616d6d3b8.png,45,1123,146,1236,101,113,red blood cell,11413,1.118811881188119,0.8938053097345132
16287,/images/d5009906-bce1-4353-90b4-f4c79362f4cf.png,776,1032,889,1157,113,125,red blood cell,14125,1.1061946902654867,0.904
9887,/images/b4261fa5-876d-48ea-b6da-ec7ca5b48fe2.png,465,373,576,485,111,112,red blood cell,12432,1.009009009009009,0.9910714285714286
64634,/images/6dfafdf1-f588-4e80-8cf8-0126e1bf7af9.png,695,48,797,152,102,104,red blood cell,10608,1.0196078431372548,0.9807692307692307
66092,/images/191f87a4-6f2d-49e7-bba0-08e3aa78ddaf.png,524,1005,640,1120,116,115,red blood cell,13340,0.9913793103448276,1.008695652173913
73697,/images/f11d05e4-538a-4024-8711-b08a4ce3c540.png,353,401,463,507,110,106,red blood cell,11660,0.9636363636363636,1.0377358490566038
29522,/images/8cc6fe77-5f2f-4670-b4ac-1b49550241a8.png,79,1099,189,1209,110,110,red blood cell,12100,1.0,1.0
8830,/images/91827f1a-9b04-4ef0-972c-12e90e60c516.png,609,656,735,785,126,129,red blood cell,16254,1.0238095238095237,0.9767441860465116
14152,/images/eaf4b781-b3aa-41ce-8c5e-287979b4e15a.png,1012,89,1100,172,88,83,red blood cell,7304,0.9431818181818182,1.0602409638554218
7979,/images/933e7e07-fc3d-42eb-be0c-6b1623ee60fa.png,295,1257,422,1371,127,114,red blood cell,14478,0.8976377952755905,1.1140350877192982
70938,/images/deaa1931-5f97-45bf-8c00-be6ddeb37b9a.png,254,1425,351,1528,97,103,red blood cell,9991,1.0618556701030928,0.941747572815534
11950,/images/f8a8b148-60e4-4a5c-ae19-941b19ec0846.png,600,686,708,798,108,112,red blood cell,12096,1.037037037037037,0.9642857142857143
62281,/images/e0ff3476-226f-4125-b182-8e524d5503dd.png,1047,836,1168,944,121,108,red blood cell,13068,0.8925619834710744,1.1203703703703705
28798,/images/686ed568-d5f8-475e-81ad-edab9dd473a0.png,234,1060,331,1155,97,95,red blood cell,9215,0.979381443298969,1.0210526315789474
39004,/images/79806898-0214-44bd-ba2c-b570e911be62.png,653,344,777,467,124,123,red blood cell,15252,0.9919354838709677,1.008130081300813
59817,/images/acb16781-11ad-4327-874a-5c9c35dcb085.png,664,409,762,517,98,108,red blood cell,10584,1.1020408163265305,0.9074074074074074
6994,/images/c776eb78-3323-4571-b39f-7ffc73ae63ce.png,1040,514,1135,602,95,88,red blood cell,8360,0.9263157894736842,1.0795454545454546
76522,/images/38c69905-8a4f-451a-8d0a-b855dc88dd16.png,877,60,986,172,109,112,red blood cell,12208,1.0275229357798166,0.9732142857142857
11188,/images/6303f964-98ef-47c6-bb2d-283aa393f918.png,240,398,343,489,103,91,red blood cell,9373,0.883495145631068,1.1318681318681318
48096,/images/05717db9-f1ef-4101-a9f7-7a007e83b1c9.png,314,1391,440,1524,126,133,red blood cell,16758,1.0555555555555556,0.9473684210526315
178,/images/13099edb-35d9-438f-b093-2cf2ebf9d255.png,997,127,1119,248,122,121,red blood cell,14762,0.9918032786885246,1.0082644628099173
68993,/images/b5246b58-6f40-4c9e-8024-f49b0ed6bdbd.png,667,1204,794,1311,127,107,red blood cell,13589,0.84251968503937,1.1869158878504673
49981,/images/05804cf0-f854-4099-97c2-df287f7c8a8c.png,263,234,384,361,121,127,red blood cell,15367,1.0495867768595042,0.952755905511811
51500,/images/baa87bf8-786c-444c-81e8-9fa0a41d8149.png,799,691,895,779,96,88,red blood cell,8448,0.9166666666666666,1.0909090909090908
10931,/images/1380f9b4-bf54-4492-90c3-743c7aa8898b.png,255,1397,352,1508,97,111,red blood cell,10767,1.1443298969072164,0.8738738738738738
52456,/images/a2a20600-f851-4db7-90f9-6f7be027c8b5.png,186,814,263,891,77,77,red blood cell,5929,1.0,1.0
56347,/images/4372709c-f356-4906-be17-415384d916e8.png,281,1095,397,1195,116,100,red blood cell,11600,0.8620689655172413,1.16
62039,/images/bdb5d571-27bc-4a42-ae45-aa5a9af40a81.png,9,282,106,377,97,95,red blood cell,9215,0.979381443298969,1.0210526315789474
5871,/images/a30da226-b452-408a-a556-bfae4d521464.png,1019,674,1127,777,108,103,red blood cell,11124,0.9537037037037037,1.0485436893203883
59254,/images/03c8da48-04b9-4520-b674-44a0ecd35688.png,14,71,113,173,99,102,red blood cell,10098,1.0303030303030303,0.9705882352941176
29096,/images/4c13e22e-dfd1-4fa1-b373-be9d0c272c0f.png,160,18,265,116,105,98,red blood cell,10290,0.9333333333333333,1.0714285714285714
16105,/images/66557580-fd38-4d4b-80d8-88611ecc78c6.png,271,921,393,1061,122,140,red blood cell,17080,1.1475409836065573,0.8714285714285714
66724,/images/334bf865-e3fb-4200-bd53-d9ff5808ed9f.png,661,1261,768,1364,107,103,red blood cell,11021,0.9626168224299065,1.0388349514563107
53331,/images/d8f7e159-b7e3-49e4-86e8-aed8c5fbcd97.png,1095,242,1186,334,91,92,red blood cell,8372,1.010989010989011,0.9891304347826086
17277,/images/3d302619-473d-4c5b-af43-8833ff94233f.png,685,397,785,517,100,120,red blood cell,12000,1.2,0.8333333333333334
10618,/images/20d4f65e-6c63-433a-935c-d568d577967b.png,624,850,731,954,107,104,red blood cell,11128,0.9719626168224299,1.0288461538461537
24760,/images/530761d4-1931-44cd-b220-d60db0e228f9.png,969,805,1097,925,128,120,red blood cell,15360,0.9375,1.0666666666666667
66114,/images/191f87a4-6f2d-49e7-bba0-08e3aa78ddaf.png,851,700,960,808,109,108,red blood cell,11772,0.9908256880733946,1.0092592592592593
6765,/images/672e4ecf-a56b-462e-b83b-76f4efaa6634.png,810,746,940,872,130,126,red blood cell,16380,0.9692307692307692,1.0317460317460319
74410,/images/06a3effb-996c-4767-afd2-6aa3b697cb4e.png,956,265,1048,361,92,96,red blood cell,8832,1.0434782608695652,0.9583333333333334
27253,/images/9f38055f-4fe6-47fd-a6dd-c0743db4eccf.png,873,1321,976,1435,103,114,red blood cell,11742,1.1067961165048543,0.9035087719298246
36807,/images/dfac6c92-8f0f-429a-8caf-9b7732bf78da.png,707,960,802,1073,95,113,red blood cell,10735,1.1894736842105262,0.8407079646017699
25349,/images/c52f8cc8-afd7-441c-9f1f-18b6e16d79cf.png,184,16,300,140,116,124,red blood cell,14384,1.0689655172413792,0.9354838709677419
46246,/images/815bf40c-371a-4d34-aa41-c549c8221881.png,524,461,641,570,117,109,red blood cell,12753,0.9316239316239316,1.073394495412844
60011,/images/49288109-80e9-4ec8-96d1-26a0166b8883.png,496,1262,587,1351,91,89,red blood cell,8099,0.978021978021978,1.0224719101123596
16861,/images/4823c1fe-a7f9-4b92-959f-0d9be09cd14b.png,852,1129,940,1212,88,83,red blood cell,7304,0.9431818181818182,1.0602409638554218
1356,/images/6d91d1f0-636b-4f5a-a526-7c17fc857190.png,306,619,393,699,87,80,red blood cell,6960,0.9195402298850575,1.0875
67001,/images/3b4440f7-a69b-4042-a9d0-d6958abcdf4e.png,1034,828,1165,943,131,115,red blood cell,15065,0.8778625954198473,1.1391304347826088
32984,/images/d1924af6-7512-4ccc-9c6b-adbbaa8db41f.png,464,244,580,355,116,111,red blood cell,12876,0.9568965517241379,1.045045045045045
78858,/images/4d0a1598-e4dd-45c4-8a90-dd7c780fe1da.png,401,1186,520,1301,119,115,red blood cell,13685,0.9663865546218487,1.0347826086956522
69918,/images/9edba799-e169-46cd-b100-c9f8fc7a8c7d.png,782,39,879,138,97,99,red blood cell,9603,1.0206185567010309,0.9797979797979798
71944,/images/61575482-91e1-4db9-83c7-687b7ddbbfc4.png,60,413,149,503,89,90,red blood cell,8010,1.0112359550561798,0.9888888888888889
34321,/images/0d2aba33-6920-4001-bd54-59fe0bf9f50e.png,334,1345,434,1457,100,112,red blood cell,11200,1.12,0.8928571428571429
72706,/images/6ab870ba-b24b-49a9-9570-8eafe63aa74e.png,327,1439,418,1540,91,101,red blood cell,9191,1.10989010989011,0.900990099009901
5066,/images/b7f1a1eb-c150-4456-9c47-e7db8a5cb77a.png,23,435,152,566,129,131,red blood cell,16899,1.0155038759689923,0.9847328244274809
27755,/images/e3c1442a-717f-41dd-bf97-81e1233ac9fa.png,1081,706,1173,814,92,108,red blood cell,9936,1.173913043478261,0.8518518518518519
46843,/images/63055d1b-5221-4c80-8b39-37ac069a1b5c.png,414,949,536,1071,122,122,red blood cell,14884,1.0,1.0
67256,/images/5f491efd-a21c-4a80-aaba-70b8876238ac.png,428,308,523,385,95,77,red blood cell,7315,0.8105263157894737,1.2337662337662338
52751,/images/9dc6ed5d-6698-48cf-aab3-fd156673729c.png,444,1205,547,1303,103,98,red blood cell,10094,0.9514563106796117,1.0510204081632653
69730,/images/f0713bee-2a71-4ced-b953-4041ea99496a.png,1095,662,1191,757,96,95,red blood cell,9120,0.9895833333333334,1.0105263157894737
4420,/images/21ea4841-8998-4c04-b345-bc99cd8ecee6.png,818,748,912,860,94,112,red blood cell,10528,1.1914893617021276,0.8392857142857143
50682,/images/6b4c79f5-b194-4586-be9f-e339c5af4188.png,253,834,366,958,113,124,red blood cell,14012,1.0973451327433628,0.9112903225806451
57146,/images/7d041c38-11f2-4186-8a24-29d7d0f5c3cf.png,172,918,243,1000,71,82,red blood cell,5822,1.1549295774647887,0.8658536585365854
35150,/images/a6ba808f-ec60-42a5-ad91-7b32412ab708.png,725,684,834,777,109,93,red blood cell,10137,0.8532110091743119,1.1720430107526882
68008,/images/bcaefb02-682a-41b9-acc7-e6cc010f5b30.png,505,1213,598,1303,93,90,red blood cell,8370,0.967741935483871,1.0333333333333334
16348,/images/69569ecf-cfa1-4ddd-9342-b22c23387fdb.png,1029,204,1146,328,117,124,red blood cell,14508,1.0598290598290598,0.9435483870967742
3494,/images/ad36bd67-594b-4f63-93e3-886af0bc618e.png,76,1034,206,1152,130,118,red blood cell,15340,0.9076923076923077,1.1016949152542372
79826,/images/fc15659f-6264-4dd5-ab17-43d89fb297b9.png,549,1015,646,1127,97,112,red blood cell,10864,1.1546391752577319,0.8660714285714286
70429,/images/8cca114a-ed05-4b87-95b7-fae02487f08c.png,715,1403,828,1514,113,111,red blood cell,12543,0.9823008849557522,1.018018018018018
43270,/images/36569710-a574-40be-ad42-897a6e74a128.png,657,836,760,940,103,104,red blood cell,10712,1.0097087378640777,0.9903846153846154
23831,/images/c17523c5-90a0-4a6b-9b33-2b4a6cf58d36.png,288,268,399,379,111,111,red blood cell,12321,1.0,1.0
23026,/images/0d095f3a-9243-472b-90b4-0ce8309e778c.png,969,1196,1072,1306,103,110,red blood cell,11330,1.0679611650485437,0.9363636363636364
51048,/images/7eb95580-693f-41b6-9338-174be1430c23.png,1,370,112,468,111,98,red blood cell,10878,0.8828828828828829,1.1326530612244898
47430,/images/3e753a44-3264-438c-8389-a7822e4a84cc.png,382,836,498,952,116,116,red blood cell,13456,1.0,1.0
51158,/images/d64cd75a-df26-44d5-ac25-69061a4e4d57.png,11,1143,123,1268,112,125,red blood cell,14000,1.1160714285714286,0.896
55410,/images/d67655e6-0a80-4a86-b552-1f5e85788377.png,399,485,499,574,100,89,red blood cell,8900,0.89,1.1235955056179776
62387,/images/9af1ee02-87fd-42bc-963e-fa9ac3eb45bb.png,186,1322,297,1441,111,119,red blood cell,13209,1.072072072072072,0.9327731092436975
62883,/images/4b346035-b8c0-46ca-8fdb-a01b1421ee4a.png,101,755,206,855,105,100,red blood cell,10500,0.9523809523809523,1.05
24768,/images/530761d4-1931-44cd-b220-d60db0e228f9.png,885,1410,1008,1513,123,103,red blood cell,12669,0.8373983739837398,1.1941747572815533
40122,/images/b34e65f6-c32e-42f1-a437-4a037c75a231.png,957,26,1058,129,101,103,red blood cell,10403,1.0198019801980198,0.9805825242718447
6883,/images/b21f6c6e-4b45-407a-b4c7-034a115f3ee4.png,486,289,603,406,117,117,red blood cell,13689,1.0,1.0
75791,/images/f48bf825-13c4-42fc-8dd8-10cc4ae6b202.png,652,10,761,120,109,110,red blood cell,11990,1.0091743119266054,0.990909090909091
39600,/images/04d21589-b777-43c2-86b5-038cbf8c3a4e.png,369,684,501,813,132,129,red blood cell,17028,0.9772727272727273,1.0232558139534884
39025,/images/79806898-0214-44bd-ba2c-b570e911be62.png,596,87,723,216,127,129,red blood cell,16383,1.015748031496063,0.9844961240310077
38759,/images/b426ef1d-4a59-4f90-b593-50226af60a60.png,367,766,485,888,118,122,red blood cell,14396,1.0338983050847457,0.9672131147540983
5967,/images/97eff653-3908-4e66-931f-eab36bc336c8.png,271,317,394,435,123,118,red blood cell,14514,0.959349593495935,1.0423728813559323
55417,/images/d67655e6-0a80-4a86-b552-1f5e85788377.png,808,360,908,454,100,94,red blood cell,9400,0.94,1.0638297872340425
248,/images/0dcca702-a4ef-4fb3-a940-9c0c140b21c7.png,315,1006,439,1128,124,122,red blood cell,15128,0.9838709677419355,1.0163934426229508
5851,/images/a30da226-b452-408a-a556-bfae4d521464.png,1004,540,1126,664,122,124,red blood cell,15128,1.0163934426229508,0.9838709677419355
2127,/images/e94a811d-3145-4313-ba42-2d5ed283179f.png,228,1272,348,1377,120,105,red blood cell,12600,0.875,1.1428571428571428
9837,/images/3859deaf-6ae1-49a3-9051-898d0f0d7de6.png,264,321,363,407,99,86,red blood cell,8514,0.8686868686868687,1.1511627906976745
880,/images/dce55b59-c6c3-4693-aa75-6b348c8f52cd.png,598,1473,696,1570,98,97,red blood cell,9506,0.9897959183673469,1.0103092783505154
995,/images/a8cb75ba-3f2f-40d8-8bc7-c79ebd1b9603.png,574,883,687,1002,113,119,red blood cell,13447,1.0530973451327434,0.9495798319327731
24325,/images/4d8a4ce8-0f9c-4f21-8844-4cf0e5514bbf.png,132,882,231,998,99,116,red blood cell,11484,1.1717171717171717,0.853448275862069
24484,/images/109fbb82-bc3c-41ac-984d-e2da86202873.png,1051,846,1177,984,126,138,red blood cell,17388,1.0952380952380953,0.9130434782608695
58169,/images/d615b706-8f50-4d96-8de5-6858897528d0.png,717,1317,843,1420,126,103,red blood cell,12978,0.8174603174603174,1.2233009708737863
21356,/images/5077f87d-a19f-494c-b911-14ccb03bd230.png,727,259,849,377,122,118,red blood cell,14396,0.9672131147540983,1.0338983050847457
11567,/images/b4dc3088-3fe2-4688-be24-70664a64e022.png,332,778,451,903,119,125,red blood cell,14875,1.050420168067227,0.952
25896,/images/4811fdf2-d7e8-475e-a840-45dda5282bf3.png,619,588,726,721,107,133,red blood cell,14231,1.2429906542056075,0.8045112781954887
49208,/images/a9daf82a-a46d-4296-bd72-2c374ed0a193.png,849,1199,959,1315,110,116,red blood cell,12760,1.0545454545454545,0.9482758620689655
8618,/images/a6aa3b72-2970-4c78-b655-ea8dfe6e018c.png,11,800,101,885,90,85,red blood cell,7650,0.9444444444444444,1.0588235294117647
64907,/images/dec61ae1-5037-4c3a-8952-15371becca7d.png,110,925,207,1020,97,95,red blood cell,9215,0.979381443298969,1.0210526315789474
30457,/images/5955289d-19e5-45ef-a012-c8ea08ef45e2.png,222,1021,342,1149,120,128,red blood cell,15360,1.0666666666666667,0.9375
28796,/images/686ed568-d5f8-475e-81ad-edab9dd473a0.png,1041,100,1147,202,106,102,red blood cell,10812,0.9622641509433962,1.0392156862745099
72734,/images/caeb2d62-1166-43f0-8eac-5b8fc48f02eb.png,707,819,808,929,101,110,red blood cell,11110,1.0891089108910892,0.9181818181818182
28599,/images/dbdfad64-110c-421f-a1c7-f68fd9e82d67.png,1081,1399,1196,1508,115,109,red blood cell,12535,0.9478260869565217,1.055045871559633
25601,/images/770b8ca4-8377-479b-9ad5-5455ec3b44f8.png,354,895,457,1004,103,109,red blood cell,11227,1.058252427184466,0.944954128440367
38899,/images/d79b4e90-c45d-4f5d-a498-49c3e323c291.png,103,1307,199,1409,96,102,red blood cell,9792,1.0625,0.9411764705882353
67580,/images/59542a24-b409-4c95-8608-d9691a741526.png,118,298,221,402,103,104,red blood cell,10712,1.0097087378640777,0.9903846153846154
45372,/images/e4eea7ea-8989-46a9-9c98-25a178146b28.png,830,204,931,330,101,126,red blood cell,12726,1.2475247524752475,0.8015873015873016
42467,/images/29648565-fe28-4517-ba72-68df0c82c9c5.png,1058,768,1173,873,115,105,red blood cell,12075,0.9130434782608695,1.0952380952380953
70495,/images/8cca114a-ed05-4b87-95b7-fae02487f08c.png,283,1221,403,1318,120,97,red blood cell,11640,0.8083333333333333,1.2371134020618557
79700,/images/03b9d6ad-39ca-4097-a98b-77f02b3c00a7.png,411,937,517,1047,106,110,red blood cell,11660,1.0377358490566038,0.9636363636363636
38376,/images/674b0fd3-f247-4b7f-97f7-3e6c57c9ba9e.png,593,541,690,619,97,78,red blood cell,7566,0.8041237113402062,1.2435897435897436
76150,/images/16244280-6c74-47d3-b544-9fd6831a6bf9.png,845,988,927,1075,82,87,red blood cell,7134,1.0609756097560976,0.9425287356321839
71339,/images/bcb447c9-5d37-414f-a513-d7076b04a532.png,505,68,619,190,114,122,red blood cell,13908,1.0701754385964912,0.9344262295081968
65745,/images/daea4860-a296-4f6d-acef-996ab0882676.png,666,299,770,415,104,116,red blood cell,12064,1.1153846153846154,0.896551724137931
58626,/images/a4d7a7e1-5ae1-486d-b6ee-c9af1476ccad.png,873,696,961,804,88,108,red blood cell,9504,1.2272727272727273,0.8148148148148148
31311,/images/31c749e8-18d1-4105-b7e6-8319cceddae0.png,663,337,780,448,117,111,red blood cell,12987,0.9487179487179487,1.054054054054054
54044,/images/d9345456-b76d-46cc-b81e-46d4a0a7b652.png,875,546,988,657,113,111,red blood cell,12543,0.9823008849557522,1.018018018018018
51586,/images/d0347b49-8f98-4632-a384-1a4f57ac6374.png,579,366,685,463,106,97,red blood cell,10282,0.9150943396226415,1.092783505154639
67375,/images/266180ed-77a3-4284-8292-50a49fc47fce.png,336,1467,442,1570,106,103,red blood cell,10918,0.9716981132075472,1.029126213592233
32575,/images/3f26fbbc-deb1-494f-b71c-c7cb3d4819fb.png,983,948,1112,1081,129,133,red blood cell,17157,1.0310077519379846,0.9699248120300752
61760,/images/985627c9-7b85-40de-a106-eb9cc47b47cb.png,377,1032,487,1143,110,111,red blood cell,12210,1.009090909090909,0.990990990990991
2108,/images/e94a811d-3145-4313-ba42-2d5ed283179f.png,288,39,389,146,101,107,red blood cell,10807,1.0594059405940595,0.9439252336448598
2207,/images/5bf91ff9-80df-49c0-9c3e-599357d95530.png,1071,507,1190,624,119,117,red blood cell,13923,0.9831932773109243,1.017094017094017
21122,/images/fb05b297-180a-4171-b633-09d5616d7534.png,644,1127,761,1254,117,127,red blood cell,14859,1.0854700854700854,0.9212598425196851
31313,/images/31c749e8-18d1-4105-b7e6-8319cceddae0.png,1031,903,1132,1014,101,111,red blood cell,11211,1.099009900990099,0.9099099099099099
14408,/images/3b13e20f-ec0d-44ec-b2f4-eaebfa09150e.png,477,1310,584,1425,107,115,red blood cell,12305,1.074766355140187,0.9304347826086956
49520,/images/9f33e0ea-065b-4703-9df9-15829b891860.png,743,828,873,950,130,122,red blood cell,15860,0.9384615384615385,1.0655737704918034
39177,/images/2aeb7b85-7df9-4a63-8d37-2eecaaa190e7.png,196,516,317,626,121,110,red blood cell,13310,0.9090909090909091,1.1
36367,/images/4a0a05e1-11ad-4bfc-bfa3-adf3b9bd0b56.png,882,1219,980,1326,98,107,red blood cell,10486,1.0918367346938775,0.9158878504672897
53865,/images/540a5fee-175b-4b92-bf62-1ea9b59c86c6.png,41,737,155,847,114,110,red blood cell,12540,0.9649122807017544,1.0363636363636364
16361,/images/69569ecf-cfa1-4ddd-9342-b22c23387fdb.png,103,875,221,1013,118,138,red blood cell,16284,1.1694915254237288,0.855072463768116
66098,/images/191f87a4-6f2d-49e7-bba0-08e3aa78ddaf.png,663,1352,780,1464,117,112,red blood cell,13104,0.9572649572649573,1.0446428571428572
60744,/images/645cd195-af50-409f-8da9-6e7c7f18ea09.png,205,931,315,1049,110,118,red blood cell,12980,1.0727272727272728,0.9322033898305084
9202,/images/6e7ed596-1b76-4998-8147-a846d53d91c5.png,806,1212,922,1331,116,119,red blood cell,13804,1.0258620689655173,0.9747899159663865
65866,/images/d7581cb0-7a12-471d-a3d8-68dcea362213.png,687,1108,781,1198,94,90,red blood cell,8460,0.9574468085106383,1.0444444444444445
24138,/images/505355c9-23bf-4f90-8ebc-6a7ef50964d0.png,1099,389,1197,480,98,91,red blood cell,8918,0.9285714285714286,1.0769230769230769
47718,/images/afbb264e-ff60-443a-83f5-49d09be1b835.png,993,592,1097,696,104,104,red blood cell,10816,1.0,1.0
43322,/images/36569710-a574-40be-ad42-897a6e74a128.png,48,481,172,606,124,125,red blood cell,15500,1.0080645161290323,0.992
35058,/images/67582df6-bf13-4c83-a531-1214692b70de.png,435,1272,544,1389,109,117,red blood cell,12753,1.073394495412844,0.9316239316239316
10496,/images/46a2d369-4bea-4405-ac78-91bbe130b9a7.png,137,1180,212,1264,75,84,red blood cell,6300,1.12,0.8928571428571429
59065,/images/5e2cea49-0823-49d1-83cf-8fd1559cdd93.png,813,1045,913,1148,100,103,red blood cell,10300,1.03,0.970873786407767
25242,/images/90171428-f208-428a-b40e-f57ee3bea457.png,417,115,531,229,114,114,red blood cell,12996,1.0,1.0
24295,/images/4d8a4ce8-0f9c-4f21-8844-4cf0e5514bbf.png,1002,647,1092,733,90,86,red blood cell,7740,0.9555555555555556,1.0465116279069768
2089,/images/f3bd0fcc-647d-4ca0-8c43-a16bd6ea3878.png,167,378,263,488,96,110,red blood cell,10560,1.1458333333333333,0.8727272727272727
74604,/images/bbedfcbe-9528-4ba9-9d86-4ebba7589ac5.png,557,868,653,951,96,83,red blood cell,7968,0.8645833333333334,1.1566265060240963
42213,/images/ca734448-0d52-42fa-b41c-17b2939e58ae.png,1038,604,1159,722,121,118,red blood cell,14278,0.9752066115702479,1.0254237288135593
48449,/images/e13f2327-fbf4-4d84-a8c1-09cb1e449c8c.png,714,78,832,207,118,129,red blood cell,15222,1.0932203389830508,0.9147286821705426
24887,/images/ed0bee2f-05e0-4392-8357-19750cec577c.png,657,802,752,897,95,95,red blood cell,9025,1.0,1.0
71096,/images/2dbf6f69-e020-4948-9e49-4b33edb7cebd.png,136,93,238,189,102,96,red blood cell,9792,0.9411764705882353,1.0625
60639,/images/724e0c34-32cd-41f1-ae37-586038bc67ab.png,759,258,849,360,90,102,red blood cell,9180,1.1333333333333333,0.8823529411764706
48678,/images/03359d4d-69cb-4146-8286-ca7399366f97.png,747,246,843,354,96,108,red blood cell,10368,1.125,0.8888888888888888
27585,/images/715761a2-745e-4743-9849-956a034ad3c4.png,1097,891,1193,985,96,94,red blood cell,9024,0.9791666666666666,1.0212765957446808
23392,/images/a7688988-2bcc-4458-83d3-5e482da5f87b.png,7,7,125,113,118,106,red blood cell,12508,0.8983050847457628,1.1132075471698113
68931,/images/bbaa004f-05dc-4cb8-8768-e148085bb0f9.png,874,724,963,826,89,102,red blood cell,9078,1.146067415730337,0.8725490196078431
71409,/images/bcb447c9-5d37-414f-a513-d7076b04a532.png,732,1179,820,1273,88,94,red blood cell,8272,1.0681818181818181,0.9361702127659575
72869,/images/31435107-c77d-42f8-a619-75cba6a5161b.png,877,723,964,821,87,98,red blood cell,8526,1.1264367816091954,0.8877551020408163
10321,/images/f91670db-be74-474c-bd72-68120aed4756.png,505,360,605,464,100,104,red blood cell,10400,1.04,0.9615384615384616
30010,/images/deeaa5b3-3895-4aec-a2ce-ed6404862cdf.png,1058,1062,1185,1198,127,136,red blood cell,17272,1.0708661417322836,0.9338235294117647
71542,/images/191071ab-6515-428c-9f05-8e4309542b75.png,1120,1357,1196,1443,76,86,red blood cell,6536,1.131578947368421,0.8837209302325582
77552,/images/2d2e81f3-e329-4765-9ba1-2c95f12dc9f3.png,995,680,1093,788,98,108,red blood cell,10584,1.1020408163265305,0.9074074074074074
67243,/images/5f491efd-a21c-4a80-aaba-70b8876238ac.png,538,383,628,480,90,97,red blood cell,8730,1.0777777777777777,0.9278350515463918
65843,/images/daea4860-a296-4f6d-acef-996ab0882676.png,197,1392,284,1486,87,94,red blood cell,8178,1.0804597701149425,0.925531914893617
47295,/images/1dd3e6dd-343f-4cc9-b0ed-e4d27fb36f0a.png,935,1373,1044,1487,109,114,red blood cell,12426,1.0458715596330275,0.956140350877193
48949,/images/5dec0204-af81-44ef-a942-8a173669c123.png,284,1,370,81,86,80,red blood cell,6880,0.9302325581395349,1.075
16793,/images/4823c1fe-a7f9-4b92-959f-0d9be09cd14b.png,22,291,121,397,99,106,red blood cell,10494,1.0707070707070707,0.9339622641509434
857,/images/c7a2d648-47cb-4b39-afa4-1b7fcfe51934.png,1031,1416,1153,1549,122,133,red blood cell,16226,1.0901639344262295,0.9172932330827067
13773,/images/1b369bcf-ced4-4ae2-9196-2664bd2b1738.png,526,1476,645,1592,119,116,red blood cell,13804,0.9747899159663865,1.0258620689655173
32171,/images/25cfca07-2101-484f-b312-a927395f2651.png,471,247,580,371,109,124,red blood cell,13516,1.1376146788990826,0.8790322580645161
55313,/images/4fb83278-adc5-4424-9f45-b6d0db2955b6.png,591,578,704,679,113,101,red blood cell,11413,0.8938053097345132,1.118811881188119
8597,/images/a6aa3b72-2970-4c78-b655-ea8dfe6e018c.png,967,1375,1081,1494,114,119,red blood cell,13566,1.043859649122807,0.957983193277311
36337,/images/4a0a05e1-11ad-4bfc-bfa3-adf3b9bd0b56.png,666,680,772,790,106,110,red blood cell,11660,1.0377358490566038,0.9636363636363636
59837,/images/acb16781-11ad-4327-874a-5c9c35dcb085.png,391,184,509,297,118,113,red blood cell,13334,0.9576271186440678,1.0442477876106195
55047,/images/1f8f08ea-b5b3-4f68-94d4-3cc071b7dce8.png,837,384,932,475,95,91,red blood cell,8645,0.9578947368421052,1.043956043956044
26555,/images/4935818a-7e7a-4f44-a3b6-b361d1abfe16.png,5,352,110,465,105,113,red blood cell,11865,1.0761904761904761,0.9292035398230089
79052,/images/036e008f-07a1-4e92-899d-1822dc390ccb.png,706,84,808,185,102,101,red blood cell,10302,0.9901960784313726,1.00990099009901
18113,/images/947348fe-4c70-468e-8009-3c14daeca69b.png,770,964,859,1063,89,99,red blood cell,8811,1.1123595505617978,0.898989898989899
38239,/images/b834cbf7-ff97-49d9-9561-566c9343735c.png,686,1150,803,1279,117,129,red blood cell,15093,1.1025641025641026,0.9069767441860465
26595,/images/5893e081-04f2-4e33-9851-bed5f0e4d333.png,275,451,388,553,113,102,red blood cell,11526,0.9026548672566371,1.107843137254902
28391,/images/a6d85204-24b8-4b23-a8b1-c3e8b93f9f22.png,656,1267,771,1384,115,117,red blood cell,13455,1.017391304347826,0.9829059829059829
69545,/images/664c570b-4822-413c-9724-11b1d91fac44.png,219,1505,307,1600,88,95,red blood cell,8360,1.0795454545454546,0.9263157894736842
56575,/images/a824b499-3736-4581-bbdc-be1b3b4cf756.png,723,848,818,951,95,103,red blood cell,9785,1.0842105263157895,0.9223300970873787
35373,/images/452482bc-24a3-413e-ba03-fad4c9d61f3c.png,254,990,368,1095,114,105,red blood cell,11970,0.9210526315789473,1.0857142857142856
78058,/images/105af41b-13cc-4ad1-8a1f-8bc4d47cdd94.png,397,541,506,638,109,97,red blood cell,10573,0.8899082568807339,1.1237113402061856
44335,/images/415409ac-97b3-4cd9-b203-11ef00662352.png,494,38,596,134,102,96,red blood cell,9792,0.9411764705882353,1.0625
72261,/images/ee57e743-a876-4f69-9fe5-bf5d01b44689.png,170,399,283,509,113,110,red blood cell,12430,0.9734513274336283,1.0272727272727273
2855,/images/521a26aa-0a31-4c07-b4d0-fac08eb08344.png,942,226,1079,360,137,134,red blood cell,18358,0.9781021897810219,1.0223880597014925
32981,/images/d1924af6-7512-4ccc-9c6b-adbbaa8db41f.png,130,892,233,1001,103,109,red blood cell,11227,1.058252427184466,0.944954128440367
76276,/images/1574565f-f45b-4160-947e-25ce1a81aaca.png,377,523,489,633,112,110,red blood cell,12320,0.9821428571428571,1.018181818181818
60198,/images/214f1d15-a081-476e-992d-6c3a77f03d59.png,1050,885,1147,991,97,106,red blood cell,10282,1.092783505154639,0.9150943396226415
51146,/images/d64cd75a-df26-44d5-ac25-69061a4e4d57.png,584,242,692,353,108,111,red blood cell,11988,1.0277777777777777,0.972972972972973
9652,/images/d997337e-e4a8-4ef0-b8ba-975e6c43b62c.png,191,1450,305,1576,114,126,red blood cell,14364,1.105263157894737,0.9047619047619048
40597,/images/29861cf9-9a1e-4733-8309-4bd10706b4a3.png,685,771,820,905,135,134,red blood cell,18090,0.9925925925925926,1.007462686567164
30656,/images/f939782b-f5a2-40a3-9c22-6c6d7e18edc3.png,15,1424,101,1526,86,102,red blood cell,8772,1.186046511627907,0.8431372549019608
37683,/images/003a89b0-a095-417a-8dd6-f408339bbc68.png,871,115,983,219,112,104,red blood cell,11648,0.9285714285714286,1.0769230769230769
30190,/images/a1669b59-fe09-4fe6-ba9f-06bec6725502.png,979,150,1097,258,118,108,red blood cell,12744,0.9152542372881356,1.0925925925925926
75609,/images/c35ee701-fde2-46b5-b178-1fe3f1ea7da2.png,166,364,277,491,111,127,red blood cell,14097,1.1441441441441442,0.8740157480314961
68401,/images/040112be-3c8d-49aa-93f1-522f94a592ff.png,871,668,955,757,84,89,red blood cell,7476,1.0595238095238095,0.9438202247191011
22251,/images/3d4d7ba7-6c7c-4ddd-b282-31fb5d80edb5.png,1,54,102,148,101,94,red blood cell,9494,0.9306930693069307,1.074468085106383
26414,/images/d532e31c-10ce-4313-9a36-bd5e01230254.png,815,915,923,1022,108,107,red blood cell,11556,0.9907407407407407,1.0093457943925233
17357,/images/04018590-4e66-4cb9-ad2d-83570f1b29ae.png,766,228,889,345,123,117,red blood cell,14391,0.9512195121951219,1.0512820512820513
41013,/images/8e078333-8fa0-45be-a46e-fa05708cb365.png,177,600,281,720,104,120,red blood cell,12480,1.1538461538461537,0.8666666666666667
35675,/images/4063945d-03fc-4ce3-a04c-17435dce8f91.png,963,1033,1082,1155,119,122,red blood cell,14518,1.0252100840336134,0.9754098360655737
51423,/images/b4f3b2a4-f4b9-48de-ac5d-0e681b77be27.png,1052,190,1150,284,98,94,red blood cell,9212,0.9591836734693877,1.0425531914893618
77695,/images/07d15855-eb9b-46a9-b894-7cfe4d097826.png,835,177,945,291,110,114,red blood cell,12540,1.0363636363636364,0.9649122807017544
2744,/images/a89cace5-c818-4f23-a432-052b3433b81e.png,1103,1365,1192,1474,89,109,red blood cell,9701,1.2247191011235956,0.8165137614678899
60576,/images/58065a0c-d4c5-40fd-bcdc-037f61788482.png,979,296,1084,397,105,101,red blood cell,10605,0.9619047619047619,1.0396039603960396
56246,/images/b600b38d-225b-46a5-b6f8-b607430f6a10.png,694,377,809,484,115,107,red blood cell,12305,0.9304347826086956,1.074766355140187
46395,/images/bbecf1a8-a728-4c83-87f8-4dfbac0a1e03.png,445,1042,570,1165,125,123,red blood cell,15375,0.984,1.016260162601626
61532,/images/7e837856-3519-4dc0-b357-4cdcfd30b4eb.png,453,378,521,460,68,82,red blood cell,5576,1.2058823529411764,0.8292682926829268
51838,/images/f07174a5-f799-4286-ac43-5b0f5c5777ac.png,129,583,213,669,84,86,red blood cell,7224,1.0238095238095237,0.9767441860465116
48332,/images/6fa2b30f-9b89-46ac-9b79-c0bc105d4271.png,86,972,216,1096,130,124,red blood cell,16120,0.9538461538461539,1.0483870967741935
52723,/images/9dc6ed5d-6698-48cf-aab3-fd156673729c.png,983,951,1080,1055,97,104,red blood cell,10088,1.0721649484536082,0.9326923076923077
70676,/images/7521ec48-57b5-48a8-a5d6-8280ad5da19c.png,865,523,965,610,100,87,red blood cell,8700,0.87,1.1494252873563218
38444,/images/674b0fd3-f247-4b7f-97f7-3e6c57c9ba9e.png,418,969,517,1077,99,108,red blood cell,10692,1.0909090909090908,0.9166666666666666
67499,/images/75660b56-51c2-45a9-9c15-e18d12a3af8c.png,773,53,881,157,108,104,red blood cell,11232,0.9629629629629629,1.0384615384615385
34975,/images/2b369d75-9c55-43e0-b352-d981aea544e3.png,816,1191,936,1300,120,109,red blood cell,13080,0.9083333333333333,1.1009174311926606
4318,/images/882b91b7-5906-4091-bad4-688d4375eeb5.png,928,73,1029,178,101,105,red blood cell,10605,1.0396039603960396,0.9619047619047619
3883,/images/73dd09d3-2bff-4b5e-b996-9da0b8b54a8f.png,825,92,945,204,120,112,red blood cell,13440,0.9333333333333333,1.0714285714285714
79436,/images/dcb21739-3c36-459d-b3cc-1be5871d6fe7.png,806,1176,888,1258,82,82,red blood cell,6724,1.0,1.0
4598,/images/f1de7c7e-e7d3-45ae-a66c-58538bf6cac1.png,281,67,399,184,118,117,red blood cell,13806,0.9915254237288136,1.0085470085470085
76483,/images/34df8890-272d-423a-ae78-ff8d068d3306.png,467,114,556,195,89,81,red blood cell,7209,0.9101123595505618,1.0987654320987654
42801,/images/7029feb3-9ffe-46e4-9883-6a9df84f7b62.png,172,641,277,744,105,103,red blood cell,10815,0.9809523809523809,1.0194174757281553
498,/images/f65a1633-9935-4984-a285-a60d30aa1707.png,270,377,396,500,126,123,red blood cell,15498,0.9761904761904762,1.024390243902439
5557,/images/eb6e8684-b84e-483d-b835-f59286d2516b.png,348,1340,457,1456,109,116,red blood cell,12644,1.0642201834862386,0.9396551724137931
39062,/images/8f96ee1f-4ef7-4279-a610-316319bedcf9.png,779,353,894,464,115,111,red blood cell,12765,0.9652173913043478,1.0360360360360361
9454,/images/e3a4b3e7-9500-4b6c-a402-b6d3f45e714b.png,623,1402,735,1515,112,113,red blood cell,12656,1.0089285714285714,0.9911504424778761
5594,/images/75c243e2-610d-4d5a-bc5a-4c53d99d9ae9.png,183,1139,300,1262,117,123,red blood cell,14391,1.0512820512820513,0.9512195121951219
56577,/images/a824b499-3736-4581-bbdc-be1b3b4cf756.png,117,769,238,888,121,119,red blood cell,14399,0.9834710743801653,1.0168067226890756
77242,/images/07a80340-f65e-4f58-9317-94bb6ebd5a28.png,1083,1193,1185,1302,102,109,red blood cell,11118,1.0686274509803921,0.9357798165137615
13237,/images/711f6b3f-cd63-46d1-834a-bc8e9aa9b43e.png,1013,1284,1115,1372,102,88,red blood cell,8976,0.8627450980392157,1.1590909090909092
11936,/images/f8a8b148-60e4-4a5c-ae19-941b19ec0846.png,929,275,1049,392,120,117,red blood cell,14040,0.975,1.0256410256410255
2360,/images/fe851c88-692d-4199-87e0-d19d9c4eb591.png,132,20,224,128,92,108,red blood cell,9936,1.173913043478261,0.8518518518518519
68905,/images/6347dd6a-cfdf-4cb5-bc50-cff5403cfecb.png,810,1332,933,1450,123,118,red blood cell,14514,0.959349593495935,1.0423728813559323
39328,/images/17ef5841-bd19-4610-ba47-7d321231847b.png,682,367,813,485,131,118,red blood cell,15458,0.9007633587786259,1.1101694915254237
68028,/images/bcaefb02-682a-41b9-acc7-e6cc010f5b30.png,921,320,1011,421,90,101,red blood cell,9090,1.1222222222222222,0.8910891089108911
63864,/images/5e974892-0ebe-4037-8427-ea8616d6d3b8.png,779,897,873,985,94,88,red blood cell,8272,0.9361702127659575,1.0681818181818181
50948,/images/ef8fcfa4-8466-4186-8c69-f5f4904eb489.png,717,500,820,593,103,93,red blood cell,9579,0.9029126213592233,1.10752688172043
73079,/images/f39e2289-fedd-4d12-9e64-ffdafb89247e.png,596,1267,714,1372,118,105,red blood cell,12390,0.8898305084745762,1.1238095238095238
49007,/images/df3d98b9-3dd7-4107-8d4a-ae1b7f247793.png,487,1404,597,1499,110,95,red blood cell,10450,0.8636363636363636,1.1578947368421053
24440,/images/b78ba2c8-ecb3-45b2-9cda-2c8088fa95d1.png,386,329,516,447,130,118,red blood cell,15340,0.9076923076923077,1.1016949152542372
33409,/images/f632981c-1330-4078-8a12-691beb2dab02.png,997,809,1100,926,103,117,red blood cell,12051,1.1359223300970873,0.8803418803418803
50082,/images/e98baeb2-aa58-4cce-8c61-66685dd2b239.png,177,934,296,1044,119,110,red blood cell,13090,0.9243697478991597,1.0818181818181818
37324,/images/4d88e2d2-5aad-410c-9bbc-702ee9496995.png,605,595,713,705,108,110,red blood cell,11880,1.0185185185185186,0.9818181818181818
39461,/images/5a631871-2fc7-4a68-9c39-f3b9a0bf4a04.png,300,840,406,944,106,104,red blood cell,11024,0.9811320754716981,1.0192307692307692
13371,/images/a7f1bbb1-6058-4642-bd66-cfb90dce762e.png,457,946,578,1056,121,110,red blood cell,13310,0.9090909090909091,1.1
15849,/images/c7c1b873-0548-4a73-9618-f60912e164df.png,873,757,974,864,101,107,red blood cell,10807,1.0594059405940595,0.9439252336448598
19166,/images/bb795ddf-ce72-42d5-9006-124db4d5cf1c.png,487,1022,593,1143,106,121,red blood cell,12826,1.1415094339622642,0.8760330578512396
29679,/images/b85fc640-de49-4f7e-afc0-978ff020f2e2.png,880,139,985,256,105,117,red blood cell,12285,1.1142857142857143,0.8974358974358975
57373,/images/a88a48b6-f85c-45c1-b42f-79716c8463f1.png,564,810,677,917,113,107,red blood cell,12091,0.9469026548672567,1.0560747663551402
42282,/images/ca734448-0d52-42fa-b41c-17b2939e58ae.png,314,1402,421,1511,107,109,red blood cell,11663,1.0186915887850467,0.981651376146789
38783,/images/b426ef1d-4a59-4f90-b593-50226af60a60.png,583,664,691,753,108,89,red blood cell,9612,0.8240740740740741,1.2134831460674158
11518,/images/834a30bb-26bf-4e60-9ea1-3250b926892e.png,379,27,487,144,108,117,red blood cell,12636,1.0833333333333333,0.9230769230769231
25371,/images/fbb1b44c-d75a-4550-a6c0-0eb62b96bfce.png,556,369,679,501,123,132,red blood cell,16236,1.0731707317073171,0.9318181818181818
10277,/images/f91670db-be74-474c-bd72-68120aed4756.png,552,241,661,335,109,94,red blood cell,10246,0.8623853211009175,1.1595744680851063
11437,/images/b5513d5b-46fc-4f44-a616-791087fbd608.png,864,1169,992,1290,128,121,red blood cell,15488,0.9453125,1.0578512396694215
25226,/images/90171428-f208-428a-b40e-f57ee3bea457.png,67,432,165,524,98,92,red blood cell,9016,0.9387755102040817,1.065217391304348
14788,/images/1fdf99d1-a494-4174-bcd7-efbe457ab899.png,695,896,798,995,103,99,red blood cell,10197,0.9611650485436893,1.0404040404040404
74407,/images/06a3effb-996c-4767-afd2-6aa3b697cb4e.png,106,605,190,693,84,88,red blood cell,7392,1.0476190476190477,0.9545454545454546
3460,/images/ad36bd67-594b-4f63-93e3-886af0bc618e.png,453,311,555,430,102,119,red blood cell,12138,1.1666666666666667,0.8571428571428571
5081,/images/b7f1a1eb-c150-4456-9c47-e7db8a5cb77a.png,761,242,871,363,110,121,red blood cell,13310,1.1,0.9090909090909091
319,/images/0dcca702-a4ef-4fb3-a940-9c0c140b21c7.png,458,665,550,755,92,90,red blood cell,8280,0.9782608695652174,1.0222222222222221
41438,/images/c4494d4f-732f-431a-8a9d-62403f0b74fe.png,352,611,450,706,98,95,red blood cell,9310,0.9693877551020408,1.0315789473684212
22513,/images/bfe65b11-8aff-46aa-908b-1e989d25fdc4.png,796,619,919,726,123,107,red blood cell,13161,0.8699186991869918,1.1495327102803738
41762,/images/32a1ea24-b6b7-4253-ad3e-bdf99c2c9b9d.png,420,474,555,596,135,122,red blood cell,16470,0.9037037037037037,1.1065573770491803
62859,/images/4b346035-b8c0-46ca-8fdb-a01b1421ee4a.png,200,936,314,1049,114,113,red blood cell,12882,0.9912280701754386,1.008849557522124
21881,/images/30ad83f1-a9b3-4a07-aea6-6c06b71e9ace.png,594,670,701,774,107,104,red blood cell,11128,0.9719626168224299,1.0288461538461537
77039,/images/637957ef-df75-4a7b-86d5-9f6e9c042ca2.png,911,224,1016,328,105,104,red blood cell,10920,0.9904761904761905,1.0096153846153846
33822,/images/cb08956d-dd6a-4e13-817b-40a0a93068f1.png,133,952,231,1065,98,113,red blood cell,11074,1.153061224489796,0.8672566371681416
71248,/images/86495bbf-687b-429c-b9d3-6c2681ade7e2.png,688,1075,770,1174,82,99,red blood cell,8118,1.2073170731707317,0.8282828282828283
2897,/images/a1c140f9-75d7-42a3-b767-4c01a118892b.png,900,1371,1024,1493,124,122,red blood cell,15128,0.9838709677419355,1.0163934426229508
23344,/images/a7688988-2bcc-4458-83d3-5e482da5f87b.png,542,81,636,177,94,96,red blood cell,9024,1.0212765957446808,0.9791666666666666
73693,/images/f11d05e4-538a-4024-8711-b08a4ce3c540.png,247,1038,349,1150,102,112,red blood cell,11424,1.0980392156862746,0.9107142857142857
74846,/images/81edcae1-65bf-4752-b0e4-494376b71e49.png,1059,753,1161,869,102,116,red blood cell,11832,1.1372549019607843,0.8793103448275862
57366,/images/a88a48b6-f85c-45c1-b42f-79716c8463f1.png,477,452,566,540,89,88,red blood cell,7832,0.9887640449438202,1.0113636363636365
47331,/images/1dd3e6dd-343f-4cc9-b0ed-e4d27fb36f0a.png,402,4,515,112,113,108,red blood cell,12204,0.9557522123893806,1.0462962962962963
79554,/images/161978c3-3a05-47a5-9fee-be7d25693eae.png,936,1085,1044,1199,108,114,red blood cell,12312,1.0555555555555556,0.9473684210526315
4147,/images/ac3358f1-ef9a-4ccc-b66c-da5e47e352e0.png,281,495,398,600,117,105,red blood cell,12285,0.8974358974358975,1.1142857142857143
33986,/images/701206c5-aaac-4b99-9cc0-4a6854359457.png,348,1286,469,1399,121,113,red blood cell,13673,0.9338842975206612,1.0707964601769913
56899,/images/f28e6d66-af71-40c1-b30c-da71d7230a3f.png,993,445,1093,548,100,103,red blood cell,10300,1.03,0.970873786407767
66632,/images/b88fe674-fb9a-41d4-b100-cb1c86440d44.png,803,655,909,750,106,95,red blood cell,10070,0.8962264150943396,1.1157894736842104
9027,/images/ef815e3a-02a6-4cf8-9262-45bc74c50b00.png,595,360,726,488,131,128,red blood cell,16768,0.9770992366412213,1.0234375
79010,/images/6144887d-a1c1-46db-91a1-f7ff5bf8c8a5.png,97,542,205,677,108,135,red blood cell,14580,1.25,0.8
65875,/images/d7581cb0-7a12-471d-a3d8-68dcea362213.png,214,832,324,948,110,116,red blood cell,12760,1.0545454545454545,0.9482758620689655
16559,/images/69565501-6e77-4f40-bd80-caa3dda34d8b.png,836,1172,954,1302,118,130,red blood cell,15340,1.1016949152542372,0.9076923076923077
23937,/images/3d8fb5bf-3315-48fb-8ab1-802eafd550bc.png,808,1382,918,1474,110,92,red blood cell,10120,0.8363636363636363,1.1956521739130435
79946,/images/e640ae51-cbf1-4a84-b7cf-d38b17f59c2f.png,585,879,683,968,98,89,red blood cell,8722,0.9081632653061225,1.101123595505618
51985,/images/4f62b14e-c6f4-4155-8f50-881558f83fae.png,561,371,636,456,75,85,red blood cell,6375,1.1333333333333333,0.8823529411764706
56322,/images/4372709c-f356-4906-be17-415384d916e8.png,850,544,953,656,103,112,red blood cell,11536,1.087378640776699,0.9196428571428571
25142,/images/9e74feb8-017d-4d53-8896-9ebda4327dd1.png,31,773,158,877,127,104,red blood cell,13208,0.8188976377952756,1.2211538461538463
23412,/images/8757be1e-b832-407a-8e95-62abae485b24.png,565,1038,672,1156,107,118,red blood cell,12626,1.102803738317757,0.9067796610169492
39023,/images/79806898-0214-44bd-ba2c-b570e911be62.png,637,760,751,873,114,113,red blood cell,12882,0.9912280701754386,1.008849557522124
36534,/images/bd856928-96ee-4fc4-a377-f2fc4e84448b.png,311,453,415,546,104,93,red blood cell,9672,0.8942307692307693,1.118279569892473
33702,/images/441d7843-b20b-4c10-84e3-e6d32621e880.png,569,644,684,745,115,101,red blood cell,11615,0.8782608695652174,1.1386138613861385
23923,/images/3d8fb5bf-3315-48fb-8ab1-802eafd550bc.png,629,748,738,857,109,109,red blood cell,11881,1.0,1.0
31106,/images/9c48fdf4-621d-4f40-bcd7-6a28cd530de7.png,426,1292,531,1386,105,94,red blood cell,9870,0.8952380952380953,1.1170212765957446
51974,/images/4f62b14e-c6f4-4155-8f50-881558f83fae.png,11,1101,99,1178,88,77,red blood cell,6776,0.875,1.1428571428571428
46290,/images/e11515b4-9527-4c23-a0ba-43719bacca0d.png,814,35,921,146,107,111,red blood cell,11877,1.0373831775700935,0.963963963963964
54645,/images/6473ddb6-ad56-48a2-81e8-c7cb45f06825.png,849,741,948,846,99,105,red blood cell,10395,1.0606060606060606,0.9428571428571428
20146,/images/df49578a-60d4-4a3b-9ee0-79d9d59bc72a.png,33,281,169,409,136,128,red blood cell,17408,0.9411764705882353,1.0625
58647,/images/a4d7a7e1-5ae1-486d-b6ee-c9af1476ccad.png,139,1253,226,1356,87,103,red blood cell,8961,1.1839080459770115,0.8446601941747572
37402,/images/08f5a524-0554-49c2-83a8-ae9a6d51e8fd.png,328,1108,429,1218,101,110,red blood cell,11110,1.0891089108910892,0.9181818181818182
24996,/images/ed0bee2f-05e0-4392-8357-19750cec577c.png,62,647,167,743,105,96,red blood cell,10080,0.9142857142857143,1.09375
59170,/images/4736f545-1f1f-4d77-9241-d69cbf4dae35.png,893,603,979,693,86,90,red blood cell,7740,1.0465116279069768,0.9555555555555556
36702,/images/21f001d6-f568-4ea4-82da-fab54c77c419.png,553,155,660,260,107,105,red blood cell,11235,0.9813084112149533,1.019047619047619
61622,/images/a3c0a876-be12-4ede-8aed-18b32a64401b.png,375,783,476,887,101,104,red blood cell,10504,1.0297029702970297,0.9711538461538461
32843,/images/2a6370b0-08f1-4c11-a639-265d4419c9a3.png,1026,16,1137,141,111,125,red blood cell,13875,1.1261261261261262,0.888
8063,/images/694222bb-cddf-469a-9526-f873c6fba58e.png,356,914,468,1017,112,103,red blood cell,11536,0.9196428571428571,1.087378640776699
8201,/images/6bb4892c-27a9-4642-aba1-4b73f38f757c.png,418,339,533,452,115,113,red blood cell,12995,0.9826086956521739,1.0176991150442478
37328,/images/4d88e2d2-5aad-410c-9bbc-702ee9496995.png,433,28,545,120,112,92,red blood cell,10304,0.8214285714285714,1.2173913043478262
57444,/images/00d04a90-80e5-4bce-9511-1b64eabb7a47.png,604,642,698,729,94,87,red blood cell,8178,0.925531914893617,1.0804597701149425
56573,/images/a824b499-3736-4581-bbdc-be1b3b4cf756.png,307,1008,412,1121,105,113,red blood cell,11865,1.0761904761904761,0.9292035398230089
76806,/images/2165fe38-b474-467d-be11-d1d728085efd.png,46,613,164,722,118,109,red blood cell,12862,0.923728813559322,1.0825688073394495
20796,/images/c2ec116f-f091-422c-926c-70b548a8f6ef.png,198,226,297,333,99,107,red blood cell,10593,1.0808080808080809,0.9252336448598131
24291,/images/4d8a4ce8-0f9c-4f21-8844-4cf0e5514bbf.png,773,674,875,775,102,101,red blood cell,10302,0.9901960784313726,1.00990099009901
72423,/images/a15e0fa8-2620-4f66-896e-175115c9dc3d.png,635,1355,718,1450,83,95,red blood cell,7885,1.144578313253012,0.8736842105263158
57067,/images/9e82c996-2cfa-418d-9482-8ee23e9d0a5d.png,488,1499,578,1599,90,100,red blood cell,9000,1.1111111111111112,0.9
31921,/images/9eb66577-7857-43dc-a879-8f2c9d7f780f.png,917,1243,1014,1333,97,90,red blood cell,8730,0.9278350515463918,1.0777777777777777
69769,/images/2bd15b6e-fe2d-49f3-b394-940d024d1f91.png,931,1348,1026,1450,95,102,red blood cell,9690,1.0736842105263158,0.9313725490196079
59075,/images/5e2cea49-0823-49d1-83cf-8fd1559cdd93.png,41,294,147,394,106,100,red blood cell,10600,0.9433962264150944,1.06
56422,/images/d75933ed-d26e-4d1f-bda3-96bc0d77fb36.png,389,532,499,638,110,106,red blood cell,11660,0.9636363636363636,1.0377358490566038
71521,/images/191071ab-6515-428c-9f05-8e4309542b75.png,252,1455,342,1546,90,91,red blood cell,8190,1.011111111111111,0.989010989010989
29165,/images/6274fe0d-0d71-40be-b61b-f0bd5b5df1e2.png,703,919,800,1021,97,102,red blood cell,9894,1.0515463917525774,0.9509803921568627
18105,/images/947348fe-4c70-468e-8009-3c14daeca69b.png,644,1218,746,1321,102,103,red blood cell,10506,1.0098039215686274,0.9902912621359223
32904,/images/e40000b4-1b26-42ce-909d-4715e04f0a6e.png,965,1092,1080,1200,115,108,red blood cell,12420,0.9391304347826087,1.0648148148148149
69714,/images/f0713bee-2a71-4ced-b953-4041ea99496a.png,390,1325,473,1409,83,84,red blood cell,6972,1.0120481927710843,0.9880952380952381
54840,/images/b6364a57-72a9-43f3-8d02-9f53a992dc95.png,951,1280,1047,1379,96,99,red blood cell,9504,1.03125,0.9696969696969697
75326,/images/9ec1dcec-87c2-4aca-8e6b-0db3cd05509c.png,648,1467,758,1571,110,104,red blood cell,11440,0.9454545454545454,1.0576923076923077
6843,/images/e36cb882-c6d0-4467-812e-d18c169a9a47.png,398,496,494,595,96,99,red blood cell,9504,1.03125,0.9696969696969697
57775,/images/5c037ffc-f515-48b3-b231-c110fbd2b8ca.png,500,571,617,692,117,121,red blood cell,14157,1.0341880341880343,0.9669421487603306
77255,/images/07a80340-f65e-4f58-9317-94bb6ebd5a28.png,451,298,545,401,94,103,red blood cell,9682,1.0957446808510638,0.912621359223301
71746,/images/093a831a-bf71-4333-bc06-942ae70cb164.png,567,407,674,512,107,105,red blood cell,11235,0.9813084112149533,1.019047619047619
7613,/images/21cc498b-8cb2-42ed-8f80-bfa27b86ef11.png,898,34,1007,142,109,108,red blood cell,11772,0.9908256880733946,1.0092592592592593
35513,/images/3e33ee12-ef02-4287-8318-7ad3b284a617.png,137,512,237,607,100,95,red blood cell,9500,0.95,1.0526315789473684
22141,/images/ca677c3c-083f-4d54-9dec-39f79f6a17d8.png,776,1191,871,1286,95,95,red blood cell,9025,1.0,1.0
78072,/images/105af41b-13cc-4ad1-8a1f-8bc4d47cdd94.png,1033,1122,1145,1231,112,109,red blood cell,12208,0.9732142857142857,1.0275229357798166
46990,/images/9ebd623d-5534-4dd9-bff8-cdedf322db35.png,349,1135,447,1240,98,105,red blood cell,10290,1.0714285714285714,0.9333333333333333
41383,/images/a065c50b-341d-4803-b4b0-0fe8f04fdbb5.png,283,168,392,281,109,113,red blood cell,12317,1.036697247706422,0.9646017699115044
3697,/images/dacf7e3f-1d8c-42a0-8539-3abe3971c956.png,29,443,148,554,119,111,red blood cell,13209,0.9327731092436975,1.072072072072072
77859,/images/6bc7b53c-5a98-48ef-a9de-59a476707ea4.png,567,1055,676,1167,109,112,red blood cell,12208,1.0275229357798166,0.9732142857142857
72920,/images/a20d0b4b-6e2e-4507-bc22-f321dedc4ed9.png,654,703,756,791,102,88,red blood cell,8976,0.8627450980392157,1.1590909090909092
67590,/images/59542a24-b409-4c95-8608-d9691a741526.png,1031,547,1124,654,93,107,red blood cell,9951,1.1505376344086022,0.8691588785046729
44432,/images/edd3862f-04e1-49cf-97dd-ca566d17e71a.png,832,167,943,292,111,125,red blood cell,13875,1.1261261261261262,0.888
16230,/images/acdc6e12-73d9-44ba-be8c-2a56aaffef4f.png,788,180,920,311,132,131,red blood cell,17292,0.9924242424242424,1.0076335877862594
42086,/images/46a03374-64c7-49ac-81c9-c3d62542bbf3.png,1109,759,1193,844,84,85,red blood cell,7140,1.0119047619047619,0.9882352941176471
36872,/images/3de03fa2-3ad3-43fc-8435-b2a80bdd7550.png,9,1365,123,1477,114,112,red blood cell,12768,0.9824561403508771,1.0178571428571428
59956,/images/f0fe292d-85ae-4c3a-a676-037dde2594e6.png,1003,442,1130,564,127,122,red blood cell,15494,0.9606299212598425,1.040983606557377
60268,/images/7abc0d26-dd66-4ef4-8c4e-4a661e589a7f.png,32,104,156,235,124,131,red blood cell,16244,1.0564516129032258,0.9465648854961832
31217,/images/1976cd04-d24f-457c-b423-7e4cdb05de9e.png,764,1289,896,1454,132,165,red blood cell,21780,1.25,0.8
48753,/images/fed6ba05-36a5-45dc-a4e1-9baa7de2c622.png,1041,1191,1142,1289,101,98,red blood cell,9898,0.9702970297029703,1.030612244897959
78795,/images/9174f910-3859-4839-8e30-2c3b25269322.png,296,142,400,251,104,109,red blood cell,11336,1.0480769230769231,0.9541284403669725
26057,/images/71925778-a26e-483e-a07c-f3aaf740122a.png,66,1133,169,1219,103,86,red blood cell,8858,0.8349514563106796,1.197674418604651
58537,/images/7fd2d254-b062-4f3d-8970-687e73c5a00a.png,906,1087,1015,1196,109,109,red blood cell,11881,1.0,1.0
20130,/images/81a2748d-51c9-4439-995d-f747871d6544.png,515,636,630,779,115,143,red blood cell,16445,1.2434782608695651,0.8041958041958042
25821,/images/14b68d86-ac7f-419d-b4a5-6b0b1d9aaa18.png,33,255,140,376,107,121,red blood cell,12947,1.1308411214953271,0.8842975206611571
47996,/images/eba73bff-fbe1-436d-9a5f-0a61331a0ea2.png,814,436,917,555,103,119,red blood cell,12257,1.1553398058252426,0.865546218487395
34593,/images/a0eedcb9-b85c-4612-b945-7e8227f53c35.png,645,342,741,430,96,88,red blood cell,8448,0.9166666666666666,1.0909090909090908
26358,/images/ef1419e0-3a3a-458a-b3b2-7efddac50404.png,413,485,541,616,128,131,red blood cell,16768,1.0234375,0.9770992366412213
69255,/images/f274b784-b995-4a7e-a2c2-6cc31c24c4b4.png,826,834,914,921,88,87,red blood cell,7656,0.9886363636363636,1.0114942528735633
77060,/images/637957ef-df75-4a7b-86d5-9f6e9c042ca2.png,454,1489,564,1596,110,107,red blood cell,11770,0.9727272727272728,1.02803738317757
19054,/images/6e39fb0a-aa41-4b16-b783-7589e97bf289.png,178,527,288,649,110,122,red blood cell,13420,1.1090909090909091,0.9016393442622951
551,/images/67acd5bc-4658-4c6e-a9b9-cd8ea3a03418.png,862,1355,983,1469,121,114,red blood cell,13794,0.9421487603305785,1.0614035087719298
51331,/images/b4f3b2a4-f4b9-48de-ac5d-0e681b77be27.png,250,253,355,357,105,104,red blood cell,10920,0.9904761904761905,1.0096153846153846
27418,/images/9f38055f-4fe6-47fd-a6dd-c0743db4eccf.png,0,1129,103,1230,103,101,red blood cell,10403,0.9805825242718447,1.0198019801980198
44498,/images/b6573be3-9e04-49c3-9f48-6a145d065363.png,586,1109,690,1209,104,100,red blood cell,10400,0.9615384615384616,1.04
10281,/images/f91670db-be74-474c-bd72-68120aed4756.png,135,1155,237,1258,102,103,red blood cell,10506,1.0098039215686274,0.9902912621359223
47193,/images/58ced55c-bf0d-4204-b6b2-4f8992d92779.png,1035,463,1144,572,109,109,red blood cell,11881,1.0,1.0
72003,/images/6ad3efc9-4392-4cee-98a5-186564a96373.png,639,216,762,338,123,122,red blood cell,15006,0.991869918699187,1.0081967213114753
20708,/images/79b3a64f-2fb9-46e0-85d4-2bdd59c2075e.png,145,559,252,671,107,112,red blood cell,11984,1.0467289719626167,0.9553571428571429
31316,/images/31c749e8-18d1-4105-b7e6-8319cceddae0.png,431,181,535,285,104,104,red blood cell,10816,1.0,1.0
13801,/images/1b369bcf-ced4-4ae2-9196-2664bd2b1738.png,121,41,240,171,119,130,red blood cell,15470,1.0924369747899159,0.9153846153846154
62877,/images/4b346035-b8c0-46ca-8fdb-a01b1421ee4a.png,1051,536,1159,662,108,126,red blood cell,13608,1.1666666666666667,0.8571428571428571
31239,/images/1976cd04-d24f-457c-b423-7e4cdb05de9e.png,620,105,729,220,109,115,red blood cell,12535,1.055045871559633,0.9478260869565217
76934,/images/25ddc1ca-d368-4fff-b1ad-1dbf1e7c97aa.png,142,599,248,729,106,130,red blood cell,13780,1.2264150943396226,0.8153846153846154
69447,/images/fde0fd54-49cc-42e1-90c6-6b612cd062d8.png,841,949,922,1027,81,78,red blood cell,6318,0.9629629629629629,1.0384615384615385
48133,/images/913099c5-8085-4908-bf4b-1f098bbfcf66.png,726,395,848,512,122,117,red blood cell,14274,0.9590163934426229,1.0427350427350428
56688,/images/89b3d781-2f81-4d23-bed4-84da064df7f3.png,568,161,678,277,110,116,red blood cell,12760,1.0545454545454545,0.9482758620689655
48370,/images/6fa2b30f-9b89-46ac-9b79-c0bc105d4271.png,501,607,601,710,100,103,red blood cell,10300,1.03,0.970873786407767
45970,/images/72088c26-d2dd-4906-b791-b8947fc7fbe4.png,739,656,835,749,96,93,red blood cell,8928,0.96875,1.032258064516129
1065,/images/edcb4d77-a4d3-465d-9b59-eb3087766b1c.png,524,678,649,801,125,123,red blood cell,15375,0.984,1.016260162601626
26486,/images/cdb086a8-2bf8-4436-b1ef-96cdd801f247.png,233,785,356,896,123,111,red blood cell,13653,0.9024390243902439,1.1081081081081081
56767,/images/0dcbf2c9-f959-4703-a72b-f6a81e66c2ea.png,835,920,945,1031,110,111,red blood cell,12210,1.009090909090909,0.990990990990991
22751,/images/8490c623-3d88-4532-baf5-0d266a45b16f.png,62,338,171,435,109,97,red blood cell,10573,0.8899082568807339,1.1237113402061856
16521,/images/1315c2a4-0794-4dfa-a709-e2451723d2b6.png,440,136,581,265,141,129,red blood cell,18189,0.9148936170212766,1.0930232558139534
64455,/images/34a70114-d3e3-4351-b8db-f6caab17e743.png,264,545,353,643,89,98,red blood cell,8722,1.101123595505618,0.9081632653061225
7387,/images/89f10192-d3dd-4996-a571-4c851dbdc983.png,80,432,160,530,80,98,red blood cell,7840,1.225,0.8163265306122449
28282,/images/ffd59802-46c6-4b58-80fe-e534e39781a7.png,530,1228,628,1319,98,91,red blood cell,8918,0.9285714285714286,1.0769230769230769
56696,/images/89b3d781-2f81-4d23-bed4-84da064df7f3.png,818,1013,935,1120,117,107,red blood cell,12519,0.9145299145299145,1.0934579439252337
1414,/images/6d91d1f0-636b-4f5a-a526-7c17fc857190.png,240,610,343,697,103,87,red blood cell,8961,0.8446601941747572,1.1839080459770115
24365,/images/4d8a4ce8-0f9c-4f21-8844-4cf0e5514bbf.png,946,1116,1060,1216,114,100,red blood cell,11400,0.8771929824561403,1.14
67820,/images/04de3a31-fc09-40be-9c2c-9830c57f809d.png,131,823,235,943,104,120,red blood cell,12480,1.1538461538461537,0.8666666666666667
29309,/images/3850f2a5-ab62-49d3-8135-68d60baa676b.png,506,1229,627,1331,121,102,red blood cell,12342,0.8429752066115702,1.1862745098039216
6478,/images/640c4a52-3742-4f57-aee3-9e3dc0887622.png,540,1048,657,1165,117,117,red blood cell,13689,1.0,1.0
59658,/images/a2754679-68b0-40f4-be01-bafad5ac1261.png,1095,1223,1180,1308,85,85,red blood cell,7225,1.0,1.0
22105,/images/ac4d6507-d710-497b-ad7c-e0dd75c1d06d.png,564,1116,677,1235,113,119,red blood cell,13447,1.0530973451327434,0.9495798319327731
78065,/images/105af41b-13cc-4ad1-8a1f-8bc4d47cdd94.png,193,1043,303,1150,110,107,red blood cell,11770,0.9727272727272728,1.02803738317757
2156,/images/e94a811d-3145-4313-ba42-2d5ed283179f.png,13,307,109,411,96,104,red blood cell,9984,1.0833333333333333,0.9230769230769231
79264,/images/05ac7b2a-6a77-4464-926b-8570f7c01693.png,122,174,232,287,110,113,red blood cell,12430,1.0272727272727273,0.9734513274336283
24228,/images/bb3ae957-0f6d-4615-bfe5-24fbca50b459.png,1081,858,1199,969,118,111,red blood cell,13098,0.940677966101695,1.063063063063063
50290,/images/3d32a988-449d-4d58-b71f-abbfdc3f2fbc.png,424,207,537,315,113,108,red blood cell,12204,0.9557522123893806,1.0462962962962963
17390,/images/6f4ffe7b-395f-41ea-ad61-df5e0cbd531c.png,498,1417,604,1517,106,100,red blood cell,10600,0.9433962264150944,1.06
50655,/images/c956e531-6805-4fe1-b61c-8b96a9815a77.png,291,1183,390,1287,99,104,red blood cell,10296,1.0505050505050506,0.9519230769230769
11320,/images/2f6224be-50d0-4e85-94ef-88315df561b6.png,382,88,482,195,100,107,red blood cell,10700,1.07,0.9345794392523364
49887,/images/5e17f8e6-fd8d-426c-b444-1515d14f04b7.png,199,1179,295,1285,96,106,red blood cell,10176,1.1041666666666667,0.9056603773584906
70797,/images/b62d47f9-2ff5-4902-abdc-b3610acfc7ba.png,773,56,888,166,115,110,red blood cell,12650,0.9565217391304348,1.0454545454545454
27820,/images/db3f4098-02e4-45a3-a7af-5dda37ac1526.png,857,141,938,238,81,97,red blood cell,7857,1.1975308641975309,0.8350515463917526
75200,/images/61dfc937-a428-44b4-94fb-d682bdb8dff0.png,476,942,576,1050,100,108,red blood cell,10800,1.08,0.9259259259259259
36392,/images/4a0a05e1-11ad-4bfc-bfa3-adf3b9bd0b56.png,144,986,245,1084,101,98,red blood cell,9898,0.9702970297029703,1.030612244897959
25380,/images/fbb1b44c-d75a-4550-a6c0-0eb62b96bfce.png,1078,699,1188,819,110,120,red blood cell,13200,1.0909090909090908,0.9166666666666666
23906,/images/3d8fb5bf-3315-48fb-8ab1-802eafd550bc.png,987,509,1114,622,127,113,red blood cell,14351,0.889763779527559,1.1238938053097345
70012,/images/3e36698f-8c09-4c8b-8948-737310bf97e5.png,438,1260,551,1375,113,115,red blood cell,12995,1.0176991150442478,0.9826086956521739
31540,/images/3130f950-8345-4315-9711-92f7af3f5c14.png,182,1061,282,1173,100,112,red blood cell,11200,1.12,0.8928571428571429
37567,/images/205306da-0ed8-475a-ace6-f2f81d4be88a.png,455,324,548,412,93,88,red blood cell,8184,0.946236559139785,1.0568181818181819
78877,/images/4d0a1598-e4dd-45c4-8a90-dd7c780fe1da.png,359,1260,471,1381,112,121,red blood cell,13552,1.0803571428571428,0.9256198347107438
16938,/images/8eeb378e-90f0-47ea-ac1c-2a201eb8d090.png,236,1375,344,1496,108,121,red blood cell,13068,1.1203703703703705,0.8925619834710744
70434,/images/8cca114a-ed05-4b87-95b7-fae02487f08c.png,347,181,468,299,121,118,red blood cell,14278,0.9752066115702479,1.0254237288135593
2682,/images/a89cace5-c818-4f23-a432-052b3433b81e.png,917,687,1021,803,104,116,red blood cell,12064,1.1153846153846154,0.896551724137931
53798,/images/76b24246-8571-4e7b-8815-b185414a2c51.png,688,122,780,202,92,80,red blood cell,7360,0.8695652173913043,1.15
10810,/images/2a02cec2-a09b-483a-ad38-14359a763fa4.png,636,299,742,421,106,122,red blood cell,12932,1.150943396226415,0.8688524590163934
18089,/images/947348fe-4c70-468e-8009-3c14daeca69b.png,223,1232,341,1366,118,134,red blood cell,15812,1.1355932203389831,0.8805970149253731
71148,/images/b666fcc2-d0b2-441e-bc5a-c660345eeb5d.png,770,512,873,628,103,116,red blood cell,11948,1.1262135922330097,0.8879310344827587
42391,/images/1a27ebe9-93a1-4898-af69-f276057d4012.png,102,1127,216,1239,114,112,red blood cell,12768,0.9824561403508771,1.0178571428571428
76021,/images/4c7d2382-a962-4237-a053-955eea3decd8.png,909,640,1004,730,95,90,red blood cell,8550,0.9473684210526315,1.0555555555555556
23014,/images/0d095f3a-9243-472b-90b4-0ce8309e778c.png,510,467,637,582,127,115,red blood cell,14605,0.905511811023622,1.1043478260869566
36582,/images/21f001d6-f568-4ea4-82da-fab54c77c419.png,763,336,857,427,94,91,red blood cell,8554,0.9680851063829787,1.032967032967033
56512,/images/7dcc84ce-e8b4-46c8-9506-7c8ebda5da2f.png,786,311,866,411,80,100,red blood cell,8000,1.25,0.8
1343,/images/6d91d1f0-636b-4f5a-a526-7c17fc857190.png,818,304,930,425,112,121,red blood cell,13552,1.0803571428571428,0.9256198347107438
22149,/images/ca677c3c-083f-4d54-9dec-39f79f6a17d8.png,607,1379,690,1465,83,86,red blood cell,7138,1.036144578313253,0.9651162790697675
10074,/images/26799d2b-a289-4eff-9218-0aad77e05e41.png,72,601,181,716,109,115,red blood cell,12535,1.055045871559633,0.9478260869565217
65756,/images/daea4860-a296-4f6d-acef-996ab0882676.png,159,143,266,250,107,107,red blood cell,11449,1.0,1.0
32418,/images/3911fcd2-4e26-4ad9-aaf0-d1c5bf41defc.png,825,94,938,205,113,111,red blood cell,12543,0.9823008849557522,1.018018018018018
36788,/images/aa2dfa24-2dc3-4279-a232-f84780ace190.png,946,1016,1046,1114,100,98,red blood cell,9800,0.98,1.0204081632653061
39617,/images/04d21589-b777-43c2-86b5-038cbf8c3a4e.png,971,879,1078,1001,107,122,red blood cell,13054,1.1401869158878504,0.8770491803278688
62450,/images/7dfbfeaf-e3b1-4159-8dcd-d7f731280ac8.png,201,361,299,460,98,99,red blood cell,9702,1.010204081632653,0.98989898989899
52535,/images/d1144956-5a0c-4bd2-b67d-8498c82d6a12.png,634,416,720,504,86,88,red blood cell,7568,1.0232558139534884,0.9772727272727273
57162,/images/7c870293-2665-4a6b-a4fa-336959051dfc.png,732,1463,834,1567,102,104,red blood cell,10608,1.0196078431372548,0.9807692307692307
35247,/images/a9159b11-ba49-4885-902e-00c8d5095b98.png,618,942,748,1067,130,125,red blood cell,16250,0.9615384615384616,1.04
51024,/images/cc275c45-7511-4070-84af-10b8ffebda53.png,410,650,530,764,120,114,red blood cell,13680,0.95,1.0526315789473684
8521,/images/dfc026a9-079f-4f45-8666-e0ccba5bb437.png,595,969,703,1083,108,114,red blood cell,12312,1.0555555555555556,0.9473684210526315
71948,/images/61575482-91e1-4db9-83c7-687b7ddbbfc4.png,81,952,154,1033,73,81,red blood cell,5913,1.1095890410958904,0.9012345679012346
1483,/images/0ac747cd-ff32-49bf-bc1a-3e9b7702ce9c.png,770,581,872,681,102,100,red blood cell,10200,0.9803921568627451,1.02
10815,/images/2a02cec2-a09b-483a-ad38-14359a763fa4.png,568,706,682,825,114,119,red blood cell,13566,1.043859649122807,0.957983193277311
38767,/images/b426ef1d-4a59-4f90-b593-50226af60a60.png,1010,1167,1114,1287,104,120,red blood cell,12480,1.1538461538461537,0.8666666666666667
23782,/images/6b2ff7ca-c5b3-415c-9481-7b14efc6d7ef.png,437,762,544,881,107,119,red blood cell,12733,1.1121495327102804,0.8991596638655462
12498,/images/8e4bdd0d-1c72-4836-ae3e-05e2e50e4983.png,9,1410,117,1516,108,106,red blood cell,11448,0.9814814814814815,1.0188679245283019
16522,/images/1315c2a4-0794-4dfa-a709-e2451723d2b6.png,806,279,951,416,145,137,red blood cell,19865,0.9448275862068966,1.0583941605839415
785,/images/27fab82c-5bf0-426f-aeb9-47da829b6629.png,589,418,696,535,107,117,red blood cell,12519,1.0934579439252337,0.9145299145299145
29300,/images/3850f2a5-ab62-49d3-8135-68d60baa676b.png,0,1129,121,1231,121,102,red blood cell,12342,0.8429752066115702,1.1862745098039216
76584,/images/4184a235-d209-4151-86e9-6c77e7938dab.png,843,1012,960,1127,117,115,red blood cell,13455,0.9829059829059829,1.017391304347826
73364,/images/c890ee00-daa5-4b20-9cd5-930748ecc4e0.png,117,1182,219,1273,102,91,red blood cell,9282,0.8921568627450981,1.120879120879121
19149,/images/bb795ddf-ce72-42d5-9006-124db4d5cf1c.png,322,225,443,344,121,119,red blood cell,14399,0.9834710743801653,1.0168067226890756
5133,/images/a777e78c-ad1f-4380-9ab2-b4f9f32b2d78.png,691,728,812,846,121,118,red blood cell,14278,0.9752066115702479,1.0254237288135593
42377,/images/1a27ebe9-93a1-4898-af69-f276057d4012.png,206,931,310,1052,104,121,red blood cell,12584,1.1634615384615385,0.859504132231405
46674,/images/da111ca5-520f-4ea8-97ad-ae5fce58ee91.png,871,987,958,1081,87,94,red blood cell,8178,1.0804597701149425,0.925531914893617
22892,/images/be779f52-0bfa-4c01-a16f-b7f0bc92ed7c.png,1072,128,1196,249,124,121,red blood cell,15004,0.9758064516129032,1.024793388429752
8020,/images/694222bb-cddf-469a-9526-f873c6fba58e.png,1045,34,1151,137,106,103,red blood cell,10918,0.9716981132075472,1.029126213592233
19053,/images/6e39fb0a-aa41-4b16-b783-7589e97bf289.png,241,273,355,392,114,119,red blood cell,13566,1.043859649122807,0.957983193277311
66854,/images/9106a6bb-1352-411f-ac26-0d6fe48c16a8.png,151,1051,262,1168,111,117,red blood cell,12987,1.054054054054054,0.9487179487179487
2072,/images/f3bd0fcc-647d-4ca0-8c43-a16bd6ea3878.png,587,840,685,956,98,116,red blood cell,11368,1.183673469387755,0.8448275862068966
27417,/images/9f38055f-4fe6-47fd-a6dd-c0743db4eccf.png,2,176,96,292,94,116,red blood cell,10904,1.2340425531914894,0.8103448275862069
79806,/images/fc15659f-6264-4dd5-ab17-43d89fb297b9.png,223,301,338,413,115,112,red blood cell,12880,0.9739130434782609,1.0267857142857142
62969,/images/f234a2de-f3c8-4521-a306-8cfdf52dd597.png,725,192,814,290,89,98,red blood cell,8722,1.101123595505618,0.9081632653061225
15399,/images/1b7f47fc-26cd-4273-b848-88a7cbfd9f85.png,689,266,820,385,131,119,red blood cell,15589,0.9083969465648855,1.1008403361344539
69692,/images/f0713bee-2a71-4ced-b953-4041ea99496a.png,1034,592,1156,712,122,120,red blood cell,14640,0.9836065573770492,1.0166666666666666
41543,/images/0fcd1ebe-ee4a-40a0-b787-29cee18bfa1b.png,27,85,135,186,108,101,red blood cell,10908,0.9351851851851852,1.0693069306930694
3178,/images/c3215597-a032-46be-9058-d6de1e5191d7.png,502,1070,625,1196,123,126,red blood cell,15498,1.024390243902439,0.9761904761904762
41456,/images/c4494d4f-732f-431a-8a9d-62403f0b74fe.png,183,395,278,486,95,91,red blood cell,8645,0.9578947368421052,1.043956043956044
36670,/images/21f001d6-f568-4ea4-82da-fab54c77c419.png,46,1340,142,1422,96,82,red blood cell,7872,0.8541666666666666,1.170731707317073
45218,/images/b7a0d235-2217-43b4-aeff-cde4ccaf6789.png,194,1080,327,1202,133,122,red blood cell,16226,0.9172932330827067,1.0901639344262295
70713,/images/8ab5c462-045e-4b59-b53a-9b2bc3ed2487.png,1090,1007,1187,1101,97,94,red blood cell,9118,0.9690721649484536,1.0319148936170213
2073,/images/f3bd0fcc-647d-4ca0-8c43-a16bd6ea3878.png,1071,483,1182,607,111,124,red blood cell,13764,1.117117117117117,0.8951612903225806
17481,/images/56077789-8580-41b4-89d6-deea227e5c60.png,284,481,408,593,124,112,red blood cell,13888,0.9032258064516129,1.1071428571428572
66707,/images/b88fe674-fb9a-41d4-b100-cb1c86440d44.png,335,245,434,331,99,86,red blood cell,8514,0.8686868686868687,1.1511627906976745
2503,/images/a23f5539-bfe6-4885-9a0e-dba972475ea9.png,689,1003,778,1086,89,83,red blood cell,7387,0.9325842696629213,1.072289156626506
21716,/images/81af1442-d835-46bf-b80b-a898dba3da1b.png,448,357,567,464,119,107,red blood cell,12733,0.8991596638655462,1.1121495327102804
36944,/images/b2e34f5f-904e-4473-9dc7-c6bc1ce12640.png,215,786,311,880,96,94,red blood cell,9024,0.9791666666666666,1.0212765957446808
44503,/images/b6573be3-9e04-49c3-9f48-6a145d065363.png,66,203,183,324,117,121,red blood cell,14157,1.0341880341880343,0.9669421487603306
34303,/images/0d2aba33-6920-4001-bd54-59fe0bf9f50e.png,11,288,143,403,132,115,red blood cell,15180,0.8712121212121212,1.1478260869565218
42251,/images/ca734448-0d52-42fa-b41c-17b2939e58ae.png,273,530,383,648,110,118,red blood cell,12980,1.0727272727272728,0.9322033898305084
42283,/images/ca734448-0d52-42fa-b41c-17b2939e58ae.png,0,1419,114,1525,114,106,red blood cell,12084,0.9298245614035088,1.0754716981132075
24389,/images/4d8a4ce8-0f9c-4f21-8844-4cf0e5514bbf.png,123,1003,219,1086,96,83,red blood cell,7968,0.8645833333333334,1.1566265060240963
43119,/images/c5db0fc0-b96c-496e-90b4-f9fb1b85b28e.png,613,854,727,952,114,98,red blood cell,11172,0.8596491228070176,1.163265306122449
51489,/images/baa87bf8-786c-444c-81e8-9fa0a41d8149.png,633,610,735,707,102,97,red blood cell,9894,0.9509803921568627,1.0515463917525774
8196,/images/6bb4892c-27a9-4642-aba1-4b73f38f757c.png,492,1170,590,1284,98,114,red blood cell,11172,1.163265306122449,0.8596491228070176
40576,/images/29861cf9-9a1e-4733-8309-4bd10706b4a3.png,599,1199,716,1321,117,122,red blood cell,14274,1.0427350427350428,0.9590163934426229
6875,/images/b21f6c6e-4b45-407a-b4c7-034a115f3ee4.png,581,302,709,420,128,118,red blood cell,15104,0.921875,1.0847457627118644
57488,/images/00d04a90-80e5-4bce-9511-1b64eabb7a47.png,366,364,464,467,98,103,red blood cell,10094,1.0510204081632653,0.9514563106796117
2020,/images/bfefa21c-11e1-4dab-ac5d-8ff6f046d65f.png,134,491,259,617,125,126,red blood cell,15750,1.008,0.9920634920634921
64157,/images/0d3c2521-da55-4df5-bf06-56b3bd4fb2fc.png,136,303,226,383,90,80,red blood cell,7200,0.8888888888888888,1.125
44326,/images/b197093e-2928-46a4-8e35-fa5ea7ea6dac.png,425,1333,553,1477,128,144,red blood cell,18432,1.125,0.8888888888888888
56732,/images/b3606d0e-6fe5-478a-bb4b-64d7c4889d86.png,69,838,187,955,118,117,red blood cell,13806,0.9915254237288136,1.0085470085470085
67145,/images/be6fe358-dee1-4dcf-9b0d-5d8612aba577.png,629,1422,748,1524,119,102,red blood cell,12138,0.8571428571428571,1.1666666666666667
30134,/images/81c3c8f0-d5a9-4dda-afd5-e86f6afd9424.png,374,1052,466,1147,92,95,red blood cell,8740,1.0326086956521738,0.968421052631579
10694,/images/20d4f65e-6c63-433a-935c-d568d577967b.png,505,1260,592,1349,87,89,red blood cell,7743,1.0229885057471264,0.9775280898876404
9352,/images/261562a8-ffd8-4e0e-919b-22e267000b74.png,677,1028,782,1138,105,110,red blood cell,11550,1.0476190476190477,0.9545454545454546
64584,/images/6dfafdf1-f588-4e80-8cf8-0126e1bf7af9.png,271,724,393,843,122,119,red blood cell,14518,0.9754098360655737,1.0252100840336134
73323,/images/67a4fb91-6f38-4ca2-8f20-6b2f5f1b29a7.png,628,215,721,297,93,82,red blood cell,7626,0.8817204301075269,1.1341463414634145
73625,/images/a51d6c18-f9e8-4714-9dbb-38e1577445f2.png,157,598,244,705,87,107,red blood cell,9309,1.2298850574712643,0.8130841121495327
30803,/images/93a306b8-594a-4c7f-8b4a-127fb6ad8f1a.png,914,770,1032,888,118,118,red blood cell,13924,1.0,1.0
62779,/images/631340cc-cedf-4bca-a3d8-a0731a5482b4.png,316,753,411,859,95,106,red blood cell,10070,1.1157894736842104,0.8962264150943396
65413,/images/b523daee-317b-461d-bdc1-07b4add4d488.png,115,1443,232,1566,117,123,red blood cell,14391,1.0512820512820513,0.9512195121951219
53065,/images/69b5b3de-ec64-4e5d-bcc2-44f495e06e76.png,536,1251,637,1354,101,103,red blood cell,10403,1.0198019801980198,0.9805825242718447
50329,/images/3d32a988-449d-4d58-b71f-abbfdc3f2fbc.png,1002,1043,1109,1145,107,102,red blood cell,10914,0.9532710280373832,1.0490196078431373
36891,/images/b2e34f5f-904e-4473-9dc7-c6bc1ce12640.png,595,752,688,844,93,92,red blood cell,8556,0.989247311827957,1.0108695652173914
73013,/images/2bd26501-2fbc-4c1a-bef0-4ad57e02b4d0.png,964,573,1061,692,97,119,red blood cell,11543,1.2268041237113403,0.8151260504201681
74887,/images/81edcae1-65bf-4752-b0e4-494376b71e49.png,277,1068,373,1156,96,88,red blood cell,8448,0.9166666666666666,1.0909090909090908
40325,/images/eb86033f-4f1c-4e8c-ae84-e8e4c7e08626.png,981,1253,1076,1351,95,98,red blood cell,9310,1.0315789473684212,0.9693877551020408
32901,/images/e40000b4-1b26-42ce-909d-4715e04f0a6e.png,873,1315,980,1418,107,103,red blood cell,11021,0.9626168224299065,1.0388349514563107
53986,/images/540a5fee-175b-4b92-bf62-1ea9b59c86c6.png,1106,963,1200,1072,94,109,red blood cell,10246,1.1595744680851063,0.8623853211009175
30997,/images/b59dc3a0-3d54-4e3b-a485-33b3e43966de.png,108,1445,234,1549,126,104,red blood cell,13104,0.8253968253968254,1.2115384615384615
29581,/images/42845335-4ab2-4963-806d-0985d1382a31.png,232,715,351,844,119,129,red blood cell,15351,1.084033613445378,0.9224806201550387
40322,/images/eb86033f-4f1c-4e8c-ae84-e8e4c7e08626.png,956,1418,1054,1523,98,105,red blood cell,10290,1.0714285714285714,0.9333333333333333
22305,/images/49b03a6e-6b26-4a96-a061-e05647a02138.png,874,808,1008,929,134,121,red blood cell,16214,0.9029850746268657,1.1074380165289257
65537,/images/01b38a56-13eb-447b-89ee-fc21cb40dcc1.png,254,1244,357,1368,103,124,red blood cell,12772,1.203883495145631,0.8306451612903226
25609,/images/770b8ca4-8377-479b-9ad5-5455ec3b44f8.png,819,339,927,460,108,121,red blood cell,13068,1.1203703703703705,0.8925619834710744
71070,/images/2dbf6f69-e020-4948-9e49-4b33edb7cebd.png,639,648,744,760,105,112,red blood cell,11760,1.0666666666666667,0.9375
62061,/images/7f528918-27d4-421f-ab57-0cf9c693e697.png,1036,1138,1140,1251,104,113,red blood cell,11752,1.0865384615384615,0.9203539823008849
8896,/images/29539cb0-1c52-46b2-9302-552f8349dc71.png,345,131,468,247,123,116,red blood cell,14268,0.943089430894309,1.0603448275862069
59445,/images/a7c3c52f-3b40-4c92-a212-df9462cf25d8.png,117,109,219,217,102,108,red blood cell,11016,1.0588235294117647,0.9444444444444444
21648,/images/66183740-e1e5-43c9-8539-a87028bb3621.png,347,1229,452,1341,105,112,red blood cell,11760,1.0666666666666667,0.9375
61107,/images/80da32ce-8c22-470e-9f35-558c5f7a5df9.png,517,1362,614,1461,97,99,red blood cell,9603,1.0206185567010309,0.9797979797979798
35692,/images/4063945d-03fc-4ce3-a04c-17435dce8f91.png,550,1316,642,1408,92,92,red blood cell,8464,1.0,1.0
78074,/images/105af41b-13cc-4ad1-8a1f-8bc4d47cdd94.png,324,781,417,875,93,94,red blood cell,8742,1.010752688172043,0.9893617021276596
8871,/images/29539cb0-1c52-46b2-9302-552f8349dc71.png,1077,73,1177,180,100,107,red blood cell,10700,1.07,0.9345794392523364
50236,/images/3d32a988-449d-4d58-b71f-abbfdc3f2fbc.png,309,476,404,569,95,93,red blood cell,8835,0.9789473684210527,1.021505376344086
10772,/images/fac4b0e2-6b52-4c0e-b762-4fa65d552856.png,869,581,955,687,86,106,red blood cell,9116,1.2325581395348837,0.8113207547169812
21741,/images/f68ae8e9-e760-4106-88e0-4bdef2785f06.png,948,1279,1052,1373,104,94,red blood cell,9776,0.9038461538461539,1.1063829787234043
2038,/images/bfefa21c-11e1-4dab-ac5d-8ff6f046d65f.png,283,337,400,474,117,137,red blood cell,16029,1.170940170940171,0.8540145985401459
78495,/images/c94827ce-d619-4705-a68a-df63a2c95ffa.png,862,16,968,132,106,116,red blood cell,12296,1.0943396226415094,0.9137931034482759
76220,/images/90a82250-1f68-48c9-9af9-15f18bf8c974.png,167,333,305,459,138,126,red blood cell,17388,0.9130434782608695,1.0952380952380953
21941,/images/d57b3894-c912-47e8-b00a-e1a2a7aba644.png,381,1318,498,1437,117,119,red blood cell,13923,1.017094017094017,0.9831932773109243
45854,/images/7db1373d-5bbf-47e6-ab40-30cba7678745.png,550,1110,677,1226,127,116,red blood cell,14732,0.9133858267716536,1.0948275862068966
10192,/images/e3ea07d7-884a-412e-874a-40fd6b856736.png,552,1193,672,1314,120,121,red blood cell,14520,1.0083333333333333,0.9917355371900827
15520,/images/79f63258-24ce-4e69-a5cb-8529635a89a9.png,820,1144,921,1249,101,105,red blood cell,10605,1.0396039603960396,0.9619047619047619
58288,/images/319c9c52-f316-49f3-baad-4444ab19f85b.png,599,979,679,1054,80,75,red blood cell,6000,0.9375,1.0666666666666667
70210,/images/a5c3b3f8-7ceb-4573-a400-a76b9479af46.png,670,817,767,910,97,93,red blood cell,9021,0.9587628865979382,1.043010752688172
30834,/images/93a306b8-594a-4c7f-8b4a-127fb6ad8f1a.png,996,512,1102,619,106,107,red blood cell,11342,1.009433962264151,0.9906542056074766
78973,/images/6144887d-a1c1-46db-91a1-f7ff5bf8c8a5.png,604,1146,688,1239,84,93,red blood cell,7812,1.1071428571428572,0.9032258064516129
76385,/images/3dad6483-ac30-4d2b-b045-9f24fe6ff75e.png,998,919,1111,1034,113,115,red blood cell,12995,1.0176991150442478,0.9826086956521739
57399,/images/a88a48b6-f85c-45c1-b42f-79716c8463f1.png,773,191,857,284,84,93,red blood cell,7812,1.1071428571428572,0.9032258064516129
60245,/images/abf4cf2a-4532-4772-9f0f-9e123cc1713d.png,592,923,711,1045,119,122,red blood cell,14518,1.0252100840336134,0.9754098360655737
46449,/images/bbecf1a8-a728-4c83-87f8-4dfbac0a1e03.png,345,1080,456,1189,111,109,red blood cell,12099,0.9819819819819819,1.018348623853211
37998,/images/e3e9c2de-0a24-4c7e-8a69-3d3093d5bdab.png,446,1359,548,1476,102,117,red blood cell,11934,1.1470588235294117,0.8717948717948718
46686,/images/da111ca5-520f-4ea8-97ad-ae5fce58ee91.png,912,265,1030,373,118,108,red blood cell,12744,0.9152542372881356,1.0925925925925926
9084,/images/21c2a8aa-407c-4569-8212-96fcafa84138.png,0,219,128,344,128,125,red blood cell,16000,0.9765625,1.024
52704,/images/9dc6ed5d-6698-48cf-aab3-fd156673729c.png,27,162,136,265,109,103,red blood cell,11227,0.944954128440367,1.058252427184466
34580,/images/a0eedcb9-b85c-4612-b945-7e8227f53c35.png,629,898,723,988,94,90,red blood cell,8460,0.9574468085106383,1.0444444444444445
22819,/images/72105bb0-8e39-48be-b7f7-5b32f047b99e.png,352,134,463,253,111,119,red blood cell,13209,1.072072072072072,0.9327731092436975
50622,/images/c956e531-6805-4fe1-b61c-8b96a9815a77.png,747,1337,861,1462,114,125,red blood cell,14250,1.0964912280701755,0.912
12743,/images/b634137b-bc8b-4e88-b0e3-b536ad6e7e18.png,793,552,898,655,105,103,red blood cell,10815,0.9809523809523809,1.0194174757281553
9694,/images/53afd70c-08a7-4b9a-b137-7003b2ecbeab.png,603,905,720,1030,117,125,red blood cell,14625,1.0683760683760684,0.936
57609,/images/d32022fa-e492-4b31-a776-9435cfdef6d6.png,522,1399,646,1513,124,114,red blood cell,14136,0.9193548387096774,1.087719298245614
65561,/images/01b38a56-13eb-447b-89ee-fc21cb40dcc1.png,303,591,419,702,116,111,red blood cell,12876,0.9568965517241379,1.045045045045045
17779,/images/1863da5f-c595-4541-a8f4-21fe78678168.png,821,505,925,614,104,109,red blood cell,11336,1.0480769230769231,0.9541284403669725
43085,/images/340a1727-0df7-4e6f-9c0e-9c5deddbfca2.png,700,487,809,610,109,123,red blood cell,13407,1.128440366972477,0.8861788617886179
52963,/images/e81bf478-27ff-458c-ac30-9e1f8480bc5c.png,884,798,1004,923,120,125,red blood cell,15000,1.0416666666666667,0.96
77347,/images/3ff98212-7c2a-46cd-afb7-34a2479bed07.png,488,165,592,267,104,102,red blood cell,10608,0.9807692307692307,1.0196078431372548
8600,/images/a6aa3b72-2970-4c78-b655-ea8dfe6e018c.png,1024,456,1114,549,90,93,red blood cell,8370,1.0333333333333334,0.967741935483871
11208,/images/6303f964-98ef-47c6-bb2d-283aa393f918.png,329,425,432,530,103,105,red blood cell,10815,1.0194174757281553,0.9809523809523809
70368,/images/4876c9d0-b386-48fb-84e8-91bf87529161.png,763,365,881,469,118,104,red blood cell,12272,0.8813559322033898,1.1346153846153846
71466,/images/191071ab-6515-428c-9f05-8e4309542b75.png,170,444,284,556,114,112,red blood cell,12768,0.9824561403508771,1.0178571428571428
64273,/images/83d4e1fe-da84-4175-a9e2-8efc18782dcf.png,166,524,278,649,112,125,red blood cell,14000,1.1160714285714286,0.896
6038,/images/72732579-a812-4496-b2dd-ea1556924337.png,88,873,186,965,98,92,red blood cell,9016,0.9387755102040817,1.065217391304348
39291,/images/697bdbc0-6e31-4e48-ac74-ba4ab5760d32.png,99,45,212,168,113,123,red blood cell,13899,1.0884955752212389,0.9186991869918699
63257,/images/d3283f5b-3b3a-40ea-800b-79960ca851cb.png,1017,1038,1144,1166,127,128,red blood cell,16256,1.0078740157480315,0.9921875
50174,/images/4cccfcf0-cac9-46f0-870c-0eabfdc781ba.png,256,1430,377,1557,121,127,red blood cell,15367,1.0495867768595042,0.952755905511811
63078,/images/6afd8203-d61a-4e9b-a4cf-dcb53a16b57c.png,872,1256,982,1350,110,94,red blood cell,10340,0.8545454545454545,1.1702127659574468
44196,/images/8b494b40-cab5-49d3-893d-c805000fbe88.png,896,336,1013,437,117,101,red blood cell,11817,0.8632478632478633,1.1584158415841583
10098,/images/d1617cf7-eb56-42ee-85af-66c4748753c0.png,213,649,332,769,119,120,red blood cell,14280,1.0084033613445378,0.9916666666666667
77579,/images/f20a4fcf-ea8e-4c14-883d-d26a9e08ce25.png,284,283,394,382,110,99,red blood cell,10890,0.9,1.1111111111111112
31706,/images/bd432159-5956-457c-bdeb-1b5e702ba513.png,66,630,192,745,126,115,red blood cell,14490,0.9126984126984127,1.0956521739130434
9858,/images/3859deaf-6ae1-49a3-9051-898d0f0d7de6.png,12,1481,96,1577,84,96,red blood cell,8064,1.1428571428571428,0.875
40569,/images/29861cf9-9a1e-4733-8309-4bd10706b4a3.png,1,1178,132,1318,131,140,red blood cell,18340,1.0687022900763359,0.9357142857142857
20656,/images/d09eed76-e09b-4d90-b8f0-5a801beae41c.png,951,547,1073,649,122,102,red blood cell,12444,0.8360655737704918,1.196078431372549
64496,/images/6ba5d0b8-cdc7-4266-9d78-db76faa312e9.png,1042,978,1153,1080,111,102,red blood cell,11322,0.918918918918919,1.088235294117647
55546,/images/a27b451d-44a6-4740-861a-9e7e99915563.png,758,850,855,945,97,95,red blood cell,9215,0.979381443298969,1.0210526315789474
38491,/images/aa4a023b-55bd-4259-b15d-7086a9b491e0.png,872,1200,985,1325,113,125,red blood cell,14125,1.1061946902654867,0.904
14544,/images/458cb2e9-5a7f-437c-ac5d-a56f98a3efdf.png,443,363,554,465,111,102,red blood cell,11322,0.918918918918919,1.088235294117647
35881,/images/33068c1a-48f7-470b-8e49-e2f0888042e9.png,313,680,436,815,123,135,red blood cell,16605,1.0975609756097562,0.9111111111111111
77111,/images/a0e2ef53-d39b-40cf-b8b6-4b148ac339ec.png,1090,858,1200,977,110,119,red blood cell,13090,1.0818181818181818,0.9243697478991597
61090,/images/80da32ce-8c22-470e-9f35-558c5f7a5df9.png,122,1330,240,1441,118,111,red blood cell,13098,0.940677966101695,1.063063063063063
54752,/images/10891eed-b0f2-4dd0-90cb-da185f6761b2.png,453,695,556,785,103,90,red blood cell,9270,0.8737864077669902,1.1444444444444444
9980,/images/b9ccf7ca-953f-4832-9575-5e70b2a8c224.png,90,50,216,169,126,119,red blood cell,14994,0.9444444444444444,1.0588235294117647
71575,/images/b9c6db13-ca3a-4937-8ecf-e537047ed858.png,202,160,321,270,119,110,red blood cell,13090,0.9243697478991597,1.0818181818181818
44331,/images/b197093e-2928-46a4-8e35-fa5ea7ea6dac.png,267,349,396,482,129,133,red blood cell,17157,1.0310077519379846,0.9699248120300752
10092,/images/d1617cf7-eb56-42ee-85af-66c4748753c0.png,875,815,985,927,110,112,red blood cell,12320,1.018181818181818,0.9821428571428571
15789,/images/64113b22-03b1-4ab8-89ab-b2f32154fbbd.png,858,1480,952,1576,94,96,red blood cell,9024,1.0212765957446808,0.9791666666666666
37833,/images/56a57a8d-c9b9-432a-a3b0-32a09355806c.png,133,1427,239,1528,106,101,red blood cell,10706,0.9528301886792453,1.0495049504950495
1098,/images/edcb4d77-a4d3-465d-9b59-eb3087766b1c.png,822,829,942,949,120,120,red blood cell,14400,1.0,1.0
35425,/images/002f20ad-2ace-499c-9335-c9080bc3e6b5.png,1060,397,1189,536,129,139,red blood cell,17931,1.0775193798449612,0.9280575539568345
77467,/images/a11ed7d0-12f6-468f-abad-5cba7d968123.png,852,1174,967,1288,115,114,red blood cell,13110,0.991304347826087,1.0087719298245614
62960,/images/f234a2de-f3c8-4521-a306-8cfdf52dd597.png,985,1470,1094,1576,109,106,red blood cell,11554,0.9724770642201835,1.028301886792453
58404,/images/7eae1169-e294-4594-8e03-1366d23ff2d1.png,437,753,538,858,101,105,red blood cell,10605,1.0396039603960396,0.9619047619047619
32947,/images/d1924af6-7512-4ccc-9c6b-adbbaa8db41f.png,248,1098,375,1231,127,133,red blood cell,16891,1.047244094488189,0.9548872180451128
63559,/images/de0321fa-6f7d-4dd1-b96b-186701c3b1d9.png,1001,1191,1127,1304,126,113,red blood cell,14238,0.8968253968253969,1.1150442477876106
22847,/images/95d5e689-c1d1-4ae8-a659-cc20c62a99f0.png,713,985,812,1099,99,114,red blood cell,11286,1.1515151515151516,0.868421052631579
18098,/images/947348fe-4c70-468e-8009-3c14daeca69b.png,773,380,868,489,95,109,red blood cell,10355,1.1473684210526316,0.8715596330275229
45939,/images/0d098413-6911-4535-b70a-3c3effd8cf49.png,944,459,1054,576,110,117,red blood cell,12870,1.0636363636363637,0.9401709401709402
80031,/images/38d1b930-dd97-4248-9160-e9389a1a8dd7.png,29,809,129,909,100,100,red blood cell,10000,1.0,1.0
37661,/images/205306da-0ed8-475a-ace6-f2f81d4be88a.png,928,530,1029,631,101,101,red blood cell,10201,1.0,1.0
42317,/images/5c5b7965-1a44-44b8-aa43-660823e61821.png,628,253,736,369,108,116,red blood cell,12528,1.0740740740740742,0.9310344827586207
67128,/images/4272cbd7-5b0a-4bf7-b690-dee1c128f07b.png,738,1,831,103,93,102,red blood cell,9486,1.096774193548387,0.9117647058823529
40979,/images/bbe65c18-8a56-4dfe-875c-94e124a84125.png,798,190,912,289,114,99,red blood cell,11286,0.868421052631579,1.1515151515151516
11819,/images/3cdcb09b-6a8c-43ca-b1d0-c1a289202f65.png,413,622,519,733,106,111,red blood cell,11766,1.0471698113207548,0.954954954954955
49060,/images/df3d98b9-3dd7-4107-8d4a-ae1b7f247793.png,136,690,224,789,88,99,red blood cell,8712,1.125,0.8888888888888888
67827,/images/04de3a31-fc09-40be-9c2c-9830c57f809d.png,675,75,766,170,91,95,red blood cell,8645,1.043956043956044,0.9578947368421052
2552,/images/a23f5539-bfe6-4885-9a0e-dba972475ea9.png,332,610,425,714,93,104,red blood cell,9672,1.118279569892473,0.8942307692307693
78776,/images/9174f910-3859-4839-8e30-2c3b25269322.png,533,323,654,440,121,117,red blood cell,14157,0.9669421487603306,1.0341880341880343
47153,/images/3d1b889e-bb4a-4ee6-b899-974ee7d956a7.png,501,870,594,964,93,94,red blood cell,8742,1.010752688172043,0.9893617021276596
48622,/images/55836297-fc8e-4e00-9767-0d12b86e4604.png,221,721,327,841,106,120,red blood cell,12720,1.1320754716981132,0.8833333333333333
55404,/images/d67655e6-0a80-4a86-b552-1f5e85788377.png,505,277,609,371,104,94,red blood cell,9776,0.9038461538461539,1.1063829787234043
2590,/images/a23f5539-bfe6-4885-9a0e-dba972475ea9.png,443,1479,540,1561,97,82,red blood cell,7954,0.845360824742268,1.1829268292682926
72054,/images/64b0e49a-0e48-447d-8872-c1dd255e7a21.png,104,795,212,909,108,114,red blood cell,12312,1.0555555555555556,0.9473684210526315
41583,/images/0fcd1ebe-ee4a-40a0-b787-29cee18bfa1b.png,457,1241,560,1346,103,105,red blood cell,10815,1.0194174757281553,0.9809523809523809
1126,/images/edcb4d77-a4d3-465d-9b59-eb3087766b1c.png,670,327,762,432,92,105,red blood cell,9660,1.141304347826087,0.8761904761904762
58606,/images/a4d7a7e1-5ae1-486d-b6ee-c9af1476ccad.png,951,375,1057,478,106,103,red blood cell,10918,0.9716981132075472,1.029126213592233
48633,/images/55836297-fc8e-4e00-9767-0d12b86e4604.png,460,84,550,182,90,98,red blood cell,8820,1.0888888888888888,0.9183673469387755
44376,/images/415409ac-97b3-4cd9-b203-11ef00662352.png,49,199,176,306,127,107,red blood cell,13589,0.84251968503937,1.1869158878504673
13132,/images/711f6b3f-cd63-46d1-834a-bc8e9aa9b43e.png,392,1251,505,1362,113,111,red blood cell,12543,0.9823008849557522,1.018018018018018
39386,/images/fbcb2ef0-3c97-4d7a-8b96-0147c73f3941.png,16,811,114,907,98,96,red blood cell,9408,0.9795918367346939,1.0208333333333333
23852,/images/c17523c5-90a0-4a6b-9b33-2b4a6cf58d36.png,764,411,862,527,98,116,red blood cell,11368,1.183673469387755,0.8448275862068966
24826,/images/65054b19-5c6a-4870-99a9-eef994721d3a.png,1015,1250,1152,1377,137,127,red blood cell,17399,0.927007299270073,1.078740157480315
78691,/images/76a8a5f5-1328-4539-a131-baf877f40cf3.png,104,1229,204,1326,100,97,red blood cell,9700,0.97,1.0309278350515463
56526,/images/ac8df764-c8d8-4312-916d-70bfb37574b4.png,624,890,740,1003,116,113,red blood cell,13108,0.9741379310344828,1.0265486725663717
3145,/images/729a38d6-66db-48e5-a00d-7d90d224290f.png,403,364,522,493,119,129,red blood cell,15351,1.084033613445378,0.9224806201550387
14438,/images/3b13e20f-ec0d-44ec-b2f4-eaebfa09150e.png,258,466,376,584,118,118,red blood cell,13924,1.0,1.0
51868,/images/d67398c5-8b0e-463f-a04e-8583c820786c.png,270,1328,370,1432,100,104,red blood cell,10400,1.04,0.9615384615384616
20006,/images/8e69098c-fae0-47a3-8833-c2bfdfb1a416.png,800,432,906,520,106,88,red blood cell,9328,0.8301886792452831,1.2045454545454546
46420,/images/bbecf1a8-a728-4c83-87f8-4dfbac0a1e03.png,590,231,698,342,108,111,red blood cell,11988,1.0277777777777777,0.972972972972973
5262,/images/729733ff-a349-4a96-b636-ccabe7d7e167.png,645,1396,745,1506,100,110,red blood cell,11000,1.1,0.9090909090909091
66827,/images/9106a6bb-1352-411f-ac26-0d6fe48c16a8.png,992,531,1110,638,118,107,red blood cell,12626,0.9067796610169492,1.102803738317757
56353,/images/4372709c-f356-4906-be17-415384d916e8.png,597,5,686,112,89,107,red blood cell,9523,1.202247191011236,0.8317757009345794
28468,/images/c3042130-a6e2-458f-9fde-bb012f68f5f2.png,549,607,668,724,119,117,red blood cell,13923,0.9831932773109243,1.017094017094017
55180,/images/9c5f48c0-0544-4c0c-92b4-59b7d7b7814c.png,589,840,694,951,105,111,red blood cell,11655,1.0571428571428572,0.9459459459459459
33457,/images/9bd40bc6-4949-42d3-b38f-d60422932f65.png,177,1432,321,1553,144,121,red blood cell,17424,0.8402777777777778,1.1900826446280992
11449,/images/dca685a8-a609-45d8-93d7-da1e4165b9bd.png,30,68,164,209,134,141,red blood cell,18894,1.0522388059701493,0.950354609929078
7511,/images/071901eb-4c3f-404b-a747-3d0b9d0a5158.png,152,539,255,625,103,86,red blood cell,8858,0.8349514563106796,1.197674418604651
57168,/images/7c870293-2665-4a6b-a4fa-336959051dfc.png,107,1440,226,1545,119,105,red blood cell,12495,0.8823529411764706,1.1333333333333333
7507,/images/071901eb-4c3f-404b-a747-3d0b9d0a5158.png,981,1252,1098,1366,117,114,red blood cell,13338,0.9743589743589743,1.0263157894736843
58035,/images/a7c91b63-b97c-4f4b-8d34-7ad2b08d7a17.png,463,585,566,682,103,97,red blood cell,9991,0.941747572815534,1.0618556701030928
46295,/images/e11515b4-9527-4c23-a0ba-43719bacca0d.png,228,186,358,313,130,127,red blood cell,16510,0.9769230769230769,1.0236220472440944
58651,/images/a4d7a7e1-5ae1-486d-b6ee-c9af1476ccad.png,637,625,725,709,88,84,red blood cell,7392,0.9545454545454546,1.0476190476190477
44686,/images/8002cb71-0f25-4fa4-a46f-b49e5aeded0c.png,551,265,665,394,114,129,red blood cell,14706,1.131578947368421,0.8837209302325582
45708,/images/584d62ed-4329-45dd-94ce-e929d8b2bb74.png,960,1002,1068,1110,108,108,red blood cell,11664,1.0,1.0
70186,/images/b338766f-19b9-4874-bcc5-ae22b3c533e6.png,212,408,310,510,98,102,red blood cell,9996,1.0408163265306123,0.9607843137254902
19337,/images/b4d22412-a495-43a9-bec0-73a2322f8dad.png,1031,1476,1138,1579,107,103,red blood cell,11021,0.9626168224299065,1.0388349514563107
75616,/images/c35ee701-fde2-46b5-b178-1fe3f1ea7da2.png,429,1159,535,1258,106,99,red blood cell,10494,0.9339622641509434,1.0707070707070707
24172,/images/1d4cdf2e-79a0-41e9-aabe-e437a190dfc4.png,693,993,805,1110,112,117,red blood cell,13104,1.0446428571428572,0.9572649572649573
45516,/images/94b5a9a1-1c88-4400-aca4-3d56f543fc4a.png,575,686,702,794,127,108,red blood cell,13716,0.8503937007874016,1.1759259259259258
6704,/images/95fea6d8-413f-421e-b331-5d51c31df150.png,571,1428,673,1518,102,90,red blood cell,9180,0.8823529411764706,1.1333333333333333
9287,/images/261562a8-ffd8-4e0e-919b-22e267000b74.png,1074,805,1180,900,106,95,red blood cell,10070,0.8962264150943396,1.1157894736842104
27746,/images/e3c1442a-717f-41dd-bf97-81e1233ac9fa.png,869,1333,984,1437,115,104,red blood cell,11960,0.9043478260869565,1.1057692307692308
45364,/images/e4eea7ea-8989-46a9-9c98-25a178146b28.png,65,311,178,416,113,105,red blood cell,11865,0.9292035398230089,1.0761904761904761
24467,/images/b78ba2c8-ecb3-45b2-9cda-2c8088fa95d1.png,202,793,325,906,123,113,red blood cell,13899,0.9186991869918699,1.0884955752212389
9899,/images/b4261fa5-876d-48ea-b6da-ec7ca5b48fe2.png,422,1291,536,1418,114,127,red blood cell,14478,1.1140350877192982,0.8976377952755905
59551,/images/6bfe6a90-8a69-4171-8e7f-42dc9417c6d9.png,768,120,848,218,80,98,red blood cell,7840,1.225,0.8163265306122449
29469,/images/8cc6fe77-5f2f-4670-b4ac-1b49550241a8.png,994,383,1108,499,114,116,red blood cell,13224,1.0175438596491229,0.9827586206896551
52079,/images/de6d3020-9347-473b-9146-8909627790f6.png,122,1436,216,1532,94,96,red blood cell,9024,1.0212765957446808,0.9791666666666666
44656,/images/8002cb71-0f25-4fa4-a46f-b49e5aeded0c.png,273,646,395,773,122,127,red blood cell,15494,1.040983606557377,0.9606299212598425
9151,/images/d3ed519e-2152-4e30-838d-a3ea23be512f.png,459,1133,578,1237,119,104,red blood cell,12376,0.8739495798319328,1.1442307692307692
70750,/images/8ab5c462-045e-4b59-b53a-9b2bc3ed2487.png,198,153,301,239,103,86,red blood cell,8858,0.8349514563106796,1.197674418604651
79061,/images/036e008f-07a1-4e92-899d-1822dc390ccb.png,873,728,984,853,111,125,red blood cell,13875,1.1261261261261262,0.888
18174,/images/947348fe-4c70-468e-8009-3c14daeca69b.png,76,1420,197,1541,121,121,red blood cell,14641,1.0,1.0
12678,/images/5a043d69-f435-46d4-8691-395c1602a76a.png,376,1209,506,1325,130,116,red blood cell,15080,0.8923076923076924,1.1206896551724137
58723,/images/e4827c85-311a-4df1-89c2-99dad0c3558c.png,629,201,747,316,118,115,red blood cell,13570,0.9745762711864406,1.0260869565217392
34147,/images/de5d19b7-e670-4ac7-843b-7ce7bcebdf45.png,582,1388,700,1489,118,101,red blood cell,11918,0.8559322033898306,1.1683168316831682
123,/images/10be6380-cbbb-4886-8b9e-ff56b1710576.png,1077,870,1191,985,114,115,red blood cell,13110,1.0087719298245614,0.991304347826087
79561,/images/161978c3-3a05-47a5-9fee-be7d25693eae.png,13,544,108,626,95,82,red blood cell,7790,0.8631578947368421,1.1585365853658536
72989,/images/2bd26501-2fbc-4c1a-bef0-4ad57e02b4d0.png,406,327,526,458,120,131,red blood cell,15720,1.0916666666666666,0.916030534351145
69146,/images/de2b8835-552c-4f01-98b7-67bc4910062e.png,528,648,619,740,91,92,red blood cell,8372,1.010989010989011,0.9891304347826086
46861,/images/63055d1b-5221-4c80-8b39-37ac069a1b5c.png,804,233,910,348,106,115,red blood cell,12190,1.0849056603773586,0.9217391304347826
76851,/images/2165fe38-b474-467d-be11-d1d728085efd.png,392,393,502,498,110,105,red blood cell,11550,0.9545454545454546,1.0476190476190477
8111,/images/694222bb-cddf-469a-9526-f873c6fba58e.png,160,158,256,247,96,89,red blood cell,8544,0.9270833333333334,1.0786516853932584
25717,/images/412c9fa5-fcf4-402b-b1e4-3271f775058e.png,968,505,1093,616,125,111,red blood cell,13875,0.888,1.1261261261261262
17772,/images/b5143aae-6e98-4dc6-b546-980cb472de67.png,1001,1116,1097,1234,96,118,red blood cell,11328,1.2291666666666667,0.8135593220338984
12512,/images/8e4bdd0d-1c72-4836-ae3e-05e2e50e4983.png,36,1252,136,1353,100,101,red blood cell,10100,1.01,0.9900990099009901
54392,/images/22a464ef-c3da-4d56-b37e-e22e95d945e7.png,652,1163,770,1279,118,116,red blood cell,13688,0.9830508474576272,1.0172413793103448
3832,/images/3e764461-22ee-44d3-925d-cd658ff7d154.png,749,896,851,1012,102,116,red blood cell,11832,1.1372549019607843,0.8793103448275862
23261,/images/3dcd4f1b-ce43-4a34-b1ed-076bb42963b1.png,1061,1343,1157,1448,96,105,red blood cell,10080,1.09375,0.9142857142857143
52259,/images/4903d9c7-de88-426a-b42d-a7e797e5ebcd.png,542,933,626,1029,84,96,red blood cell,8064,1.1428571428571428,0.875
79885,/images/a054a8e2-55f2-4508-97df-207f76b89be2.png,107,784,247,901,140,117,red blood cell,16380,0.8357142857142857,1.1965811965811965
3450,/images/ad36bd67-594b-4f63-93e3-886af0bc618e.png,176,511,287,615,111,104,red blood cell,11544,0.9369369369369369,1.0673076923076923
7232,/images/89f10192-d3dd-4996-a571-4c851dbdc983.png,1070,1138,1166,1229,96,91,red blood cell,8736,0.9479166666666666,1.054945054945055
76991,/images/51e86aa9-caa0-4297-94e8-34a57d7f7e36.png,295,532,403,635,108,103,red blood cell,11124,0.9537037037037037,1.0485436893203883
13332,/images/a7f1bbb1-6058-4642-bd66-cfb90dce762e.png,319,971,428,1072,109,101,red blood cell,11009,0.926605504587156,1.0792079207920793
29445,/images/8cc6fe77-5f2f-4670-b4ac-1b49550241a8.png,340,1096,447,1203,107,107,red blood cell,11449,1.0,1.0
24038,/images/5107dcb7-164f-4e10-bbff-822b39b76efc.png,1040,1435,1158,1558,118,123,red blood cell,14514,1.0423728813559323,0.959349593495935
57773,/images/5c037ffc-f515-48b3-b231-c110fbd2b8ca.png,924,619,1022,725,98,106,red blood cell,10388,1.0816326530612246,0.9245283018867925
20621,/images/0f2a6cda-afec-437b-8803-8d3176b072c1.png,40,224,148,332,108,108,red blood cell,11664,1.0,1.0
35028,/images/67582df6-bf13-4c83-a531-1214692b70de.png,848,1083,959,1202,111,119,red blood cell,13209,1.072072072072072,0.9327731092436975
11173,/images/6303f964-98ef-47c6-bb2d-283aa393f918.png,745,658,848,756,103,98,red blood cell,10094,0.9514563106796117,1.0510204081632653
20871,/images/c2ec116f-f091-422c-926c-70b548a8f6ef.png,890,1130,996,1253,106,123,red blood cell,13038,1.1603773584905661,0.8617886178861789
43999,/images/de81bf7a-7a56-437f-a068-4d9c3e01134c.png,699,864,817,972,118,108,red blood cell,12744,0.9152542372881356,1.0925925925925926
44663,/images/8002cb71-0f25-4fa4-a46f-b49e5aeded0c.png,948,515,1063,626,115,111,red blood cell,12765,0.9652173913043478,1.0360360360360361
74490,/images/cbb58718-6319-48db-b84b-78ac9b12ff89.png,193,708,305,821,112,113,red blood cell,12656,1.0089285714285714,0.9911504424778761
10367,/images/46a2d369-4bea-4405-ac78-91bbe130b9a7.png,969,288,1055,388,86,100,red blood cell,8600,1.1627906976744187,0.86
41053,/images/e871f52c-77a6-4813-80d4-95bd97985f1a.png,633,78,747,190,114,112,red blood cell,12768,0.9824561403508771,1.0178571428571428
52768,/images/9dc6ed5d-6698-48cf-aab3-fd156673729c.png,313,942,402,1051,89,109,red blood cell,9701,1.2247191011235956,0.8165137614678899
40704,/images/252071ac-e9f2-41d2-abbb-87ef01b8a997.png,741,801,855,912,114,111,red blood cell,12654,0.9736842105263158,1.027027027027027
10600,/images/20d4f65e-6c63-433a-935c-d568d577967b.png,919,800,1018,896,99,96,red blood cell,9504,0.9696969696969697,1.03125
16404,/images/e474a20b-2769-48f1-a520-4f6ef5a0dbf5.png,135,1030,242,1141,107,111,red blood cell,11877,1.0373831775700935,0.963963963963964
77910,/images/464055b6-3351-4636-a919-8be9840fb850.png,1047,798,1138,890,91,92,red blood cell,8372,1.010989010989011,0.9891304347826086
68396,/images/040112be-3c8d-49aa-93f1-522f94a592ff.png,398,354,480,452,82,98,red blood cell,8036,1.1951219512195121,0.8367346938775511
10377,/images/46a2d369-4bea-4405-ac78-91bbe130b9a7.png,490,70,613,184,123,114,red blood cell,14022,0.926829268292683,1.0789473684210527
58831,/images/434523fd-d4d9-4961-a7c2-d71d6ae68e13.png,388,461,474,565,86,104,red blood cell,8944,1.2093023255813953,0.8269230769230769
62124,/images/a63fa2c7-3ec8-4bb7-bde6-a39e09d2f806.png,92,658,196,764,104,106,red blood cell,11024,1.0192307692307692,0.9811320754716981
1749,/images/5f783f43-0090-4f8a-bd75-9562f4aa2dd5.png,749,243,855,332,106,89,red blood cell,9434,0.839622641509434,1.1910112359550562
976,/images/a8cb75ba-3f2f-40d8-8bc7-c79ebd1b9603.png,451,112,572,227,121,115,red blood cell,13915,0.9504132231404959,1.0521739130434782
20152,/images/df49578a-60d4-4a3b-9ee0-79d9d59bc72a.png,109,712,234,848,125,136,red blood cell,17000,1.088,0.9191176470588235
29020,/images/4c13e22e-dfd1-4fa1-b373-be9d0c272c0f.png,848,1167,935,1264,87,97,red blood cell,8439,1.1149425287356323,0.8969072164948454
22875,/images/be779f52-0bfa-4c01-a16f-b7f0bc92ed7c.png,144,269,261,381,117,112,red blood cell,13104,0.9572649572649573,1.0446428571428572
4373,/images/84041bf9-dace-4066-9fe0-52170d08f826.png,299,646,392,749,93,103,red blood cell,9579,1.10752688172043,0.9029126213592233
48966,/images/5dec0204-af81-44ef-a942-8a173669c123.png,661,1290,761,1412,100,122,red blood cell,12200,1.22,0.819672131147541
38595,/images/f8b14fc4-dd6b-4ad0-a96d-c62845f48681.png,538,713,671,850,133,137,red blood cell,18221,1.0300751879699248,0.9708029197080292
79205,/images/eb0173a3-7e5e-4f53-8124-03d9d6317844.png,918,1308,1037,1420,119,112,red blood cell,13328,0.9411764705882353,1.0625
74296,/images/8939e14b-fcdf-48b1-acb9-6514a2fc2fc0.png,794,1303,880,1401,86,98,red blood cell,8428,1.1395348837209303,0.8775510204081632
2898,/images/a1c140f9-75d7-42a3-b767-4c01a118892b.png,101,1013,227,1133,126,120,red blood cell,15120,0.9523809523809523,1.05
51796,/images/f07174a5-f799-4286-ac43-5b0f5c5777ac.png,178,381,280,471,102,90,red blood cell,9180,0.8823529411764706,1.1333333333333333
1641,/images/7094c11a-1e62-4f98-894e-d17d138a88e9.png,1087,556,1181,661,94,105,red blood cell,9870,1.1170212765957446,0.8952380952380953
29071,/images/4c13e22e-dfd1-4fa1-b373-be9d0c272c0f.png,926,303,1036,402,110,99,red blood cell,10890,0.9,1.1111111111111112
30049,/images/81c3c8f0-d5a9-4dda-afd5-e86f6afd9424.png,486,1462,585,1573,99,111,red blood cell,10989,1.121212121212121,0.8918918918918919
3620,/images/8bd71314-e38a-4670-bb25-5cd6c9acb595.png,958,478,1058,578,100,100,red blood cell,10000,1.0,1.0
2694,/images/a89cace5-c818-4f23-a432-052b3433b81e.png,303,1070,424,1188,121,118,red blood cell,14278,0.9752066115702479,1.0254237288135593
59611,/images/faead1c7-bb2c-4adf-bfce-9ff36cd2cf6a.png,613,372,728,512,115,140,red blood cell,16100,1.2173913043478262,0.8214285714285714
36689,/images/21f001d6-f568-4ea4-82da-fab54c77c419.png,436,1257,537,1358,101,101,red blood cell,10201,1.0,1.0
48634,/images/55836297-fc8e-4e00-9767-0d12b86e4604.png,72,390,174,493,102,103,red blood cell,10506,1.0098039215686274,0.9902912621359223
42286,/images/ca734448-0d52-42fa-b41c-17b2939e58ae.png,501,973,610,1073,109,100,red blood cell,10900,0.9174311926605505,1.09
55513,/images/43072c64-4c08-47cd-ae8a-b74d31f80008.png,711,1297,822,1397,111,100,red blood cell,11100,0.9009009009009009,1.11
14016,/images/eaf4b781-b3aa-41ce-8c5e-287979b4e15a.png,642,1329,736,1432,94,103,red blood cell,9682,1.0957446808510638,0.912621359223301
64057,/images/03cbfcf2-8da6-462c-b30d-16d63357371f.png,127,211,243,321,116,110,red blood cell,12760,0.9482758620689655,1.0545454545454545
32126,/images/9258fe22-6406-4d00-b6f0-3f9492925405.png,821,470,963,600,142,130,red blood cell,18460,0.9154929577464789,1.0923076923076922
76732,/images/3317d733-ec0d-45e6-b631-40457392f343.png,245,654,334,761,89,107,red blood cell,9523,1.202247191011236,0.8317757009345794
6919,/images/a9feccda-18f2-405e-9aa1-409fa1f49fe4.png,576,374,685,463,109,89,red blood cell,9701,0.8165137614678899,1.2247191011235956
23655,/images/79d7a014-21ff-40f1-9ac4-a69839390654.png,857,461,956,572,99,111,red blood cell,10989,1.121212121212121,0.8918918918918919
63747,/images/06401963-8b02-46c5-ab2a-3d70bd01623f.png,308,1334,406,1428,98,94,red blood cell,9212,0.9591836734693877,1.0425531914893618
69557,/images/4a49841f-216c-4815-8140-b8762c4f6603.png,323,392,428,502,105,110,red blood cell,11550,1.0476190476190477,0.9545454545454546
69865,/images/9edba799-e169-46cd-b100-c9f8fc7a8c7d.png,97,1355,212,1470,115,115,red blood cell,13225,1.0,1.0
40641,/images/252071ac-e9f2-41d2-abbb-87ef01b8a997.png,199,198,303,302,104,104,red blood cell,10816,1.0,1.0
3323,/images/b901c906-91be-48c4-88ec-2c527544a258.png,541,1418,664,1535,123,117,red blood cell,14391,0.9512195121951219,1.0512820512820513
16259,/images/acdc6e12-73d9-44ba-be8c-2a56aaffef4f.png,269,427,398,548,129,121,red blood cell,15609,0.937984496124031,1.0661157024793388
65350,/images/24418314-f7a4-49fc-a03e-ec597ca6796e.png,142,1000,260,1121,118,121,red blood cell,14278,1.0254237288135593,0.9752066115702479
15507,/images/79f63258-24ce-4e69-a5cb-8529635a89a9.png,770,1051,876,1159,106,108,red blood cell,11448,1.0188679245283019,0.9814814814814815
44484,/images/b6573be3-9e04-49c3-9f48-6a145d065363.png,694,1093,786,1192,92,99,red blood cell,9108,1.076086956521739,0.9292929292929293
55052,/images/1f8f08ea-b5b3-4f68-94d4-3cc071b7dce8.png,928,626,1031,722,103,96,red blood cell,9888,0.9320388349514563,1.0729166666666667
30771,/images/8e0dfc1f-e3eb-4a3f-a1c4-249bdfbfaa27.png,761,1312,877,1432,116,120,red blood cell,13920,1.0344827586206897,0.9666666666666667
73285,/images/67a4fb91-6f38-4ca2-8f20-6b2f5f1b29a7.png,132,748,232,855,100,107,red blood cell,10700,1.07,0.9345794392523364
58578,/images/7fd2d254-b062-4f3d-8970-687e73c5a00a.png,17,1229,131,1350,114,121,red blood cell,13794,1.0614035087719298,0.9421487603305785
30692,/images/f939782b-f5a2-40a3-9c22-6c6d7e18edc3.png,483,422,569,526,86,104,red blood cell,8944,1.2093023255813953,0.8269230769230769
30986,/images/b59dc3a0-3d54-4e3b-a485-33b3e43966de.png,139,1340,256,1452,117,112,red blood cell,13104,0.9572649572649573,1.0446428571428572
77623,/images/f20a4fcf-ea8e-4c14-883d-d26a9e08ce25.png,56,1493,161,1600,105,107,red blood cell,11235,1.019047619047619,0.9813084112149533
52753,/images/9dc6ed5d-6698-48cf-aab3-fd156673729c.png,246,1363,371,1484,125,121,red blood cell,15125,0.968,1.0330578512396693
13269,/images/030f3421-ed3f-4bf1-8f27-4d02590bffbc.png,700,479,809,586,109,107,red blood cell,11663,0.981651376146789,1.0186915887850467
74224,/images/4e43fc22-dc08-4cde-b3ce-ce8a4f377c47.png,48,931,128,1010,80,79,red blood cell,6320,0.9875,1.0126582278481013
15937,/images/c7c1b873-0548-4a73-9618-f60912e164df.png,487,617,571,704,84,87,red blood cell,7308,1.0357142857142858,0.9655172413793104
53457,/images/766d5547-8dd2-4c8d-b78e-3007f83932e8.png,358,367,446,440,88,73,red blood cell,6424,0.8295454545454546,1.2054794520547945
12889,/images/b10ea12f-cd36-4f2c-994a-67d1665269ab.png,130,442,221,535,91,93,red blood cell,8463,1.021978021978022,0.978494623655914
37084,/images/d6942996-5664-4370-ad87-2bdcbd49ac16.png,919,819,1018,926,99,107,red blood cell,10593,1.0808080808080809,0.9252336448598131
19868,/images/b318889c-3c60-477c-b8f6-d18cb01a59df.png,482,519,570,600,88,81,red blood cell,7128,0.9204545454545454,1.0864197530864197
50662,/images/c956e531-6805-4fe1-b61c-8b96a9815a77.png,131,17,222,92,91,75,red blood cell,6825,0.8241758241758241,1.2133333333333334
9598,/images/239f17eb-a2e2-47e9-82e3-fa0d9a70fb9f.png,903,879,1039,995,136,116,red blood cell,15776,0.8529411764705882,1.1724137931034482
72722,/images/6ab870ba-b24b-49a9-9570-8eafe63aa74e.png,791,594,871,667,80,73,red blood cell,5840,0.9125,1.095890410958904
43932,/images/d7c7eb2c-2acd-4f86-8a5a-09ab3dd02d16.png,548,543,647,634,99,91,red blood cell,9009,0.9191919191919192,1.0879120879120878
56637,/images/4adcaa26-aa1f-47b5-bdf0-18c9f814f576.png,891,750,997,857,106,107,red blood cell,11342,1.009433962264151,0.9906542056074766
52843,/images/58f7e1da-3478-48f4-958c-e9b1cb8696aa.png,85,1441,193,1549,108,108,red blood cell,11664,1.0,1.0
53741,/images/76b24246-8571-4e7b-8815-b185414a2c51.png,214,775,314,870,100,95,red blood cell,9500,0.95,1.0526315789473684
17204,/images/471f75c6-bd5d-4c20-bcc1-258e836f4d69.png,246,998,350,1101,104,103,red blood cell,10712,0.9903846153846154,1.0097087378640777
15300,/images/2d0f600d-f94e-4907-b712-52fb37d9ed52.png,241,48,351,151,110,103,red blood cell,11330,0.9363636363636364,1.0679611650485437
46210,/images/d8632217-ec33-4d0a-98e6-427824c58869.png,326,535,435,640,109,105,red blood cell,11445,0.963302752293578,1.0380952380952382
40271,/images/f05ffdca-dc3a-47bd-a231-2a0d9bd1d50e.png,87,799,214,920,127,121,red blood cell,15367,0.952755905511811,1.0495867768595042
6274,/images/f4a27dfd-4c52-459f-96b5-ee6b452a3395.png,0,91,140,221,140,130,red blood cell,18200,0.9285714285714286,1.0769230769230769
39926,/images/8271d0d8-9985-43eb-94b3-c702adca139f.png,840,302,964,411,124,109,red blood cell,13516,0.8790322580645161,1.1376146788990826
23847,/images/c17523c5-90a0-4a6b-9b33-2b4a6cf58d36.png,513,16,639,121,126,105,red blood cell,13230,0.8333333333333334,1.2
78011,/images/c691c8ef-d3c7-47b6-a941-f6a1089f21a9.png,360,1098,450,1196,90,98,red blood cell,8820,1.0888888888888888,0.9183673469387755
72039,/images/6ad3efc9-4392-4cee-98a5-186564a96373.png,426,611,524,714,98,103,red blood cell,10094,1.0510204081632653,0.9514563106796117
47635,/images/78ac1e98-7062-4e27-8d58-25c392cae889.png,59,980,174,1115,115,135,red blood cell,15525,1.173913043478261,0.8518518518518519
61192,/images/0da07970-3146-479c-8a07-f61ed32814a9.png,110,1211,221,1330,111,119,red blood cell,13209,1.072072072072072,0.9327731092436975
3854,/images/73dd09d3-2bff-4b5e-b996-9da0b8b54a8f.png,781,1251,904,1387,123,136,red blood cell,16728,1.1056910569105691,0.9044117647058824
3836,/images/3e764461-22ee-44d3-925d-cd658ff7d154.png,372,1497,485,1591,113,94,red blood cell,10622,0.831858407079646,1.202127659574468
67604,/images/59542a24-b409-4c95-8608-d9691a741526.png,47,342,129,432,82,90,red blood cell,7380,1.0975609756097562,0.9111111111111111
72250,/images/7d4d0646-26b5-46fa-ab25-452d986e887b.png,93,1490,175,1572,82,82,red blood cell,6724,1.0,1.0
25618,/images/770b8ca4-8377-479b-9ad5-5455ec3b44f8.png,679,866,800,974,121,108,red blood cell,13068,0.8925619834710744,1.1203703703703705
14596,/images/c649e1cb-4029-4433-b231-d67d68f7391a.png,963,637,1082,771,119,134,red blood cell,15946,1.1260504201680672,0.8880597014925373
22003,/images/c5acd0ad-b0f2-478d-b0ad-5aa733aa7b32.png,273,418,384,545,111,127,red blood cell,14097,1.1441441441441442,0.8740157480314961
44009,/images/de81bf7a-7a56-437f-a068-4d9c3e01134c.png,473,297,586,393,113,96,red blood cell,10848,0.8495575221238938,1.1770833333333333
3342,/images/b1100ae1-0ac8-4fc2-b0ff-8819f7fbe724.png,759,1188,864,1317,105,129,red blood cell,13545,1.2285714285714286,0.813953488372093
16957,/images/8eeb378e-90f0-47ea-ac1c-2a201eb8d090.png,721,1218,820,1320,99,102,red blood cell,10098,1.0303030303030303,0.9705882352941176
67329,/images/49c4dbd3-6269-4d4c-9648-a2146c57bab1.png,210,1348,310,1452,100,104,red blood cell,10400,1.04,0.9615384615384616
23356,/images/a7688988-2bcc-4458-83d3-5e482da5f87b.png,561,999,670,1097,109,98,red blood cell,10682,0.8990825688073395,1.1122448979591837
63634,/images/d9c9479e-f1ea-4d6e-861f-843ff9a90d19.png,855,834,952,926,97,92,red blood cell,8924,0.9484536082474226,1.0543478260869565
38099,/images/907650b5-edae-471d-bc54-a825be3d3fac.png,718,1219,843,1335,125,116,red blood cell,14500,0.928,1.0775862068965518
23932,/images/3d8fb5bf-3315-48fb-8ab1-802eafd550bc.png,264,723,362,826,98,103,red blood cell,10094,1.0510204081632653,0.9514563106796117
40081,/images/6fd30823-3b77-40c9-ba5d-e1eda9660674.png,1081,287,1196,415,115,128,red blood cell,14720,1.1130434782608696,0.8984375
29928,/images/f2a8a483-b254-43aa-817f-7d525adb8911.png,1082,865,1190,985,108,120,red blood cell,12960,1.1111111111111112,0.9
74489,/images/cbb58718-6319-48db-b84b-78ac9b12ff89.png,724,779,833,880,109,101,red blood cell,11009,0.926605504587156,1.0792079207920793
54052,/images/d9345456-b76d-46cc-b81e-46d4a0a7b652.png,557,61,672,182,115,121,red blood cell,13915,1.0521739130434782,0.9504132231404959
62851,/images/4b346035-b8c0-46ca-8fdb-a01b1421ee4a.png,1033,664,1149,767,116,103,red blood cell,11948,0.8879310344827587,1.1262135922330097
78772,/images/9174f910-3859-4839-8e30-2c3b25269322.png,228,173,330,300,102,127,red blood cell,12954,1.2450980392156863,0.8031496062992126
43732,/images/ef83ed4c-2724-4d5f-8abe-1a18d25cea35.png,884,1312,1011,1419,127,107,red blood cell,13589,0.84251968503937,1.1869158878504673
71381,/images/bcb447c9-5d37-414f-a513-d7076b04a532.png,619,697,720,808,101,111,red blood cell,11211,1.099009900990099,0.9099099099099099
71866,/images/61575482-91e1-4db9-83c7-687b7ddbbfc4.png,1065,205,1176,315,111,110,red blood cell,12210,0.990990990990991,1.009090909090909
12321,/images/3b55c42f-ad59-422f-ba99-4f4f4ca9cb2e.png,229,1254,320,1351,91,97,red blood cell,8827,1.065934065934066,0.9381443298969072
10167,/images/09ecf7be-28e2-4531-b9e2-07e01c44097d.png,1002,1070,1105,1172,103,102,red blood cell,10506,0.9902912621359223,1.0098039215686274
18300,/images/9ca20b10-e2fd-4bd2-93ef-78298f763ed5.png,399,360,508,495,109,135,red blood cell,14715,1.238532110091743,0.8074074074074075
36591,/images/21f001d6-f568-4ea4-82da-fab54c77c419.png,765,1245,867,1336,102,91,red blood cell,9282,0.8921568627450981,1.120879120879121
74706,/images/5ccca8ee-abea-458a-a891-bedd31c3ddc3.png,939,1322,1059,1448,120,126,red blood cell,15120,1.05,0.9523809523809523
77595,/images/f20a4fcf-ea8e-4c14-883d-d26a9e08ce25.png,903,1270,1021,1377,118,107,red blood cell,12626,0.9067796610169492,1.102803738317757
8362,/images/9a1cd456-310c-47b6-a1f8-0fbd8e33d1fd.png,362,1234,494,1347,132,113,red blood cell,14916,0.8560606060606061,1.168141592920354
47465,/images/f7231477-f2c1-439a-9c8b-204de07686a4.png,1017,1225,1137,1372,120,147,red blood cell,17640,1.225,0.8163265306122449
64389,/images/0a7bfa8a-ee52-4f7a-b9c5-2919ecfa93ef.png,391,710,480,804,89,94,red blood cell,8366,1.0561797752808988,0.9468085106382979
11234,/images/6303f964-98ef-47c6-bb2d-283aa393f918.png,460,418,556,507,96,89,red blood cell,8544,0.9270833333333334,1.0786516853932584
69470,/images/664c570b-4822-413c-9724-11b1d91fac44.png,128,1432,242,1538,114,106,red blood cell,12084,0.9298245614035088,1.0754716981132075
25141,/images/9e74feb8-017d-4d53-8896-9ebda4327dd1.png,150,1262,241,1347,91,85,red blood cell,7735,0.9340659340659341,1.0705882352941176
32898,/images/e40000b4-1b26-42ce-909d-4715e04f0a6e.png,666,723,785,848,119,125,red blood cell,14875,1.050420168067227,0.952
74351,/images/06a3effb-996c-4767-afd2-6aa3b697cb4e.png,755,988,850,1087,95,99,red blood cell,9405,1.0421052631578946,0.9595959595959596
37748,/images/fe0c5e48-f65e-488c-9c3c-1ea7c7835c0c.png,868,1175,989,1287,121,112,red blood cell,13552,0.9256198347107438,1.0803571428571428
45132,/images/56fbae44-4677-47f8-9c3a-22dac043c115.png,534,1325,622,1416,88,91,red blood cell,8008,1.0340909090909092,0.967032967032967
30109,/images/81c3c8f0-d5a9-4dda-afd5-e86f6afd9424.png,310,1239,413,1352,103,113,red blood cell,11639,1.0970873786407767,0.911504424778761
8191,/images/6bb4892c-27a9-4642-aba1-4b73f38f757c.png,876,319,963,420,87,101,red blood cell,8787,1.160919540229885,0.8613861386138614
16794,/images/4823c1fe-a7f9-4b92-959f-0d9be09cd14b.png,880,725,956,819,76,94,red blood cell,7144,1.236842105263158,0.8085106382978723
37985,/images/e3e9c2de-0a24-4c7e-8a69-3d3093d5bdab.png,338,594,436,685,98,91,red blood cell,8918,0.9285714285714286,1.0769230769230769
22079,/images/ac4d6507-d710-497b-ad7c-e0dd75c1d06d.png,638,543,761,665,123,122,red blood cell,15006,0.991869918699187,1.0081967213114753
1089,/images/edcb4d77-a4d3-465d-9b59-eb3087766b1c.png,477,538,616,671,139,133,red blood cell,18487,0.9568345323741008,1.0451127819548873
13096,/images/711f6b3f-cd63-46d1-834a-bc8e9aa9b43e.png,224,126,336,239,112,113,red blood cell,12656,1.0089285714285714,0.9911504424778761
61031,/images/3d1429ed-4619-41f7-8ff3-d698ad28034c.png,770,628,872,722,102,94,red blood cell,9588,0.9215686274509803,1.0851063829787233
33351,/images/f632981c-1330-4078-8a12-691beb2dab02.png,794,115,895,215,101,100,red blood cell,10100,0.9900990099009901,1.01
1291,/images/6d91d1f0-636b-4f5a-a526-7c17fc857190.png,731,975,838,1079,107,104,red blood cell,11128,0.9719626168224299,1.0288461538461537
52702,/images/9dc6ed5d-6698-48cf-aab3-fd156673729c.png,132,390,239,499,107,109,red blood cell,11663,1.0186915887850467,0.981651376146789
10215,/images/e3ea07d7-884a-412e-874a-40fd6b856736.png,5,658,101,768,96,110,red blood cell,10560,1.1458333333333333,0.8727272727272727
34515,/images/fa1f9f89-cecb-4972-842c-d14c632f89a9.png,418,995,523,1085,105,90,red blood cell,9450,0.8571428571428571,1.1666666666666667
2556,/images/a23f5539-bfe6-4885-9a0e-dba972475ea9.png,514,324,606,427,92,103,red blood cell,9476,1.1195652173913044,0.8932038834951457
13918,/images/de00f9a5-aa8b-4679-8ec6-85528a942d6f.png,118,849,229,948,111,99,red blood cell,10989,0.8918918918918919,1.121212121212121
76337,/images/3dad6483-ac30-4d2b-b045-9f24fe6ff75e.png,231,1415,314,1508,83,93,red blood cell,7719,1.1204819277108433,0.8924731182795699
56920,/images/a93c35ba-1690-4358-8837-669bcd850bb7.png,639,515,744,614,105,99,red blood cell,10395,0.9428571428571428,1.0606060606060606
77685,/images/07d15855-eb9b-46a9-b894-7cfe4d097826.png,693,1092,779,1181,86,89,red blood cell,7654,1.0348837209302326,0.9662921348314607
8509,/images/dfc026a9-079f-4f45-8666-e0ccba5bb437.png,942,277,1056,407,114,130,red blood cell,14820,1.1403508771929824,0.8769230769230769
79573,/images/161978c3-3a05-47a5-9fee-be7d25693eae.png,579,710,700,809,121,99,red blood cell,11979,0.8181818181818182,1.2222222222222223
75031,/images/9147a21d-0de2-4c04-88da-b788311696ac.png,764,658,882,766,118,108,red blood cell,12744,0.9152542372881356,1.0925925925925926
51987,/images/4f62b14e-c6f4-4155-8f50-881558f83fae.png,311,885,394,966,83,81,red blood cell,6723,0.9759036144578314,1.0246913580246915
60857,/images/11b72c7b-5c52-44b7-adb7-21eacc25e441.png,887,238,984,335,97,97,red blood cell,9409,1.0,1.0
50351,/images/3d32a988-449d-4d58-b71f-abbfdc3f2fbc.png,823,80,905,165,82,85,red blood cell,6970,1.0365853658536586,0.9647058823529412
71091,/images/2dbf6f69-e020-4948-9e49-4b33edb7cebd.png,129,1371,224,1484,95,113,red blood cell,10735,1.1894736842105262,0.8407079646017699
4302,/images/882b91b7-5906-4091-bad4-688d4375eeb5.png,855,763,941,856,86,93,red blood cell,7998,1.0813953488372092,0.9247311827956989
5919,/images/a30da226-b452-408a-a556-bfae4d521464.png,399,184,503,304,104,120,red blood cell,12480,1.1538461538461537,0.8666666666666667
57048,/images/9e82c996-2cfa-418d-9482-8ee23e9d0a5d.png,906,1076,1016,1187,110,111,red blood cell,12210,1.009090909090909,0.990990990990991
28815,/images/686ed568-d5f8-475e-81ad-edab9dd473a0.png,741,321,853,429,112,108,red blood cell,12096,0.9642857142857143,1.037037037037037
56445,/images/d75933ed-d26e-4d1f-bda3-96bc0d77fb36.png,272,1091,373,1187,101,96,red blood cell,9696,0.9504950495049505,1.0520833333333333
24549,/images/c03d9b87-e19b-402b-ad86-b30d6e8aeb59.png,592,994,701,1100,109,106,red blood cell,11554,0.9724770642201835,1.028301886792453
9744,/images/3859deaf-6ae1-49a3-9051-898d0f0d7de6.png,585,1340,683,1431,98,91,red blood cell,8918,0.9285714285714286,1.0769230769230769
29549,/images/8cc6fe77-5f2f-4670-b4ac-1b49550241a8.png,428,113,537,204,109,91,red blood cell,9919,0.8348623853211009,1.1978021978021978
3434,/images/fd1302e2-3cd2-4a1a-9c13-00f810a9c41b.png,1083,1030,1171,1128,88,98,red blood cell,8624,1.1136363636363635,0.8979591836734694
62088,/images/7f528918-27d4-421f-ab57-0cf9c693e697.png,1048,1245,1166,1348,118,103,red blood cell,12154,0.8728813559322034,1.145631067961165
46134,/images/72088c26-d2dd-4906-b791-b8947fc7fbe4.png,505,1106,599,1204,94,98,red blood cell,9212,1.0425531914893618,0.9591836734693877
69643,/images/4a49841f-216c-4815-8140-b8762c4f6603.png,1027,675,1115,766,88,91,red blood cell,8008,1.0340909090909092,0.967032967032967
63794,/images/6013bff0-dc4b-4bde-9409-0f6139c3495c.png,382,820,480,920,98,100,red blood cell,9800,1.0204081632653061,0.98
43230,/images/fe1ee954-ba71-47b3-954a-d20ab940cd7b.png,629,869,746,994,117,125,red blood cell,14625,1.0683760683760684,0.936
58890,/images/8a7deb24-d2b4-4acf-86c4-3aadd39157fa.png,476,817,574,911,98,94,red blood cell,9212,0.9591836734693877,1.0425531914893618
44537,/images/419309ef-da3f-4424-93cf-01ff4c52b017.png,63,894,169,1016,106,122,red blood cell,12932,1.150943396226415,0.8688524590163934
2262,/images/fe851c88-692d-4199-87e0-d19d9c4eb591.png,128,1212,215,1318,87,106,red blood cell,9222,1.2183908045977012,0.8207547169811321
65552,/images/01b38a56-13eb-447b-89ee-fc21cb40dcc1.png,307,1442,415,1556,108,114,red blood cell,12312,1.0555555555555556,0.9473684210526315
42979,/images/ff37dd9b-2e3c-444d-9d29-6db186cfa2fb.png,607,792,727,938,120,146,red blood cell,17520,1.2166666666666666,0.821917808219178
43514,/images/2d857091-efcd-41c0-ba3f-226de90445c4.png,528,1132,663,1251,135,119,red blood cell,16065,0.8814814814814815,1.134453781512605
46354,/images/fcc2b245-f47f-447f-8527-275b0005677c.png,976,888,1095,990,119,102,red blood cell,12138,0.8571428571428571,1.1666666666666667
24476,/images/b78ba2c8-ecb3-45b2-9cda-2c8088fa95d1.png,394,628,545,772,151,144,red blood cell,21744,0.9536423841059603,1.0486111111111112
54162,/images/c415532c-4cce-4580-9fcd-623c172a1abd.png,204,1277,314,1387,110,110,red blood cell,12100,1.0,1.0
23024,/images/0d095f3a-9243-472b-90b4-0ce8309e778c.png,444,1287,556,1399,112,112,red blood cell,12544,1.0,1.0
68987,/images/b5246b58-6f40-4c9e-8024-f49b0ed6bdbd.png,669,52,770,158,101,106,red blood cell,10706,1.0495049504950495,0.9528301886792453
737,/images/dcc1a193-7b74-44f8-ad8d-813751d8fa6b.png,1051,521,1172,652,121,131,red blood cell,15851,1.0826446280991735,0.9236641221374046
74281,/images/8939e14b-fcdf-48b1-acb9-6514a2fc2fc0.png,8,695,109,795,101,100,red blood cell,10100,0.9900990099009901,1.01
56853,/images/a588091c-5e4c-4e61-914d-e96f3ee3e505.png,658,861,766,958,108,97,red blood cell,10476,0.8981481481481481,1.1134020618556701
48468,/images/e13f2327-fbf4-4d84-a8c1-09cb1e449c8c.png,569,95,697,213,128,118,red blood cell,15104,0.921875,1.0847457627118644
48606,/images/55836297-fc8e-4e00-9767-0d12b86e4604.png,1087,257,1195,375,108,118,red blood cell,12744,1.0925925925925926,0.9152542372881356
34033,/images/1012abf2-cb05-4337-86c5-513ec4ca904d.png,863,196,956,286,93,90,red blood cell,8370,0.967741935483871,1.0333333333333334
67193,/images/be6fe358-dee1-4dcf-9b0d-5d8612aba577.png,854,1190,952,1287,98,97,red blood cell,9506,0.9897959183673469,1.0103092783505154
18033,/images/0f0c949e-018a-4f3f-ab02-3704f49c7754.png,1022,821,1141,951,119,130,red blood cell,15470,1.0924369747899159,0.9153846153846154
17597,/images/e80bad38-66d0-473e-85dd-92142dba37e6.png,32,1268,142,1392,110,124,red blood cell,13640,1.1272727272727272,0.8870967741935484
73164,/images/f39e2289-fedd-4d12-9e64-ffdafb89247e.png,873,892,960,987,87,95,red blood cell,8265,1.0919540229885059,0.9157894736842105
74065,/images/fe436c09-b680-4f4c-8faf-aa10a55a335b.png,798,22,895,118,97,96,red blood cell,9312,0.9896907216494846,1.0104166666666667
23373,/images/a7688988-2bcc-4458-83d3-5e482da5f87b.png,215,159,334,269,119,110,red blood cell,13090,0.9243697478991597,1.0818181818181818
71116,/images/b666fcc2-d0b2-441e-bc5a-c660345eeb5d.png,407,112,511,217,104,105,red blood cell,10920,1.0096153846153846,0.9904761904761905
161,/images/13099edb-35d9-438f-b093-2cf2ebf9d255.png,267,1125,386,1248,119,123,red blood cell,14637,1.0336134453781514,0.967479674796748
34883,/images/a4fbb9f2-9b75-4fdc-877d-2feaafac25b3.png,741,1177,850,1278,109,101,red blood cell,11009,0.926605504587156,1.0792079207920793
16870,/images/4823c1fe-a7f9-4b92-959f-0d9be09cd14b.png,633,724,729,809,96,85,red blood cell,8160,0.8854166666666666,1.1294117647058823
27191,/images/f232eec3-02c0-43f9-bf32-3e60245397e2.png,479,817,619,950,140,133,red blood cell,18620,0.95,1.0526315789473684
68257,/images/a6391703-0820-4913-a7cd-e843ff0d84ba.png,596,1028,705,1125,109,97,red blood cell,10573,0.8899082568807339,1.1237113402061856
74569,/images/bbedfcbe-9528-4ba9-9d86-4ebba7589ac5.png,678,72,772,176,94,104,red blood cell,9776,1.1063829787234043,0.9038461538461539
59511,/images/6bfe6a90-8a69-4171-8e7f-42dc9417c6d9.png,883,131,983,222,100,91,red blood cell,9100,0.91,1.098901098901099
27476,/images/f5869ba8-6253-426b-93f3-82af59a86144.png,599,298,705,411,106,113,red blood cell,11978,1.0660377358490567,0.9380530973451328
35952,/images/5836500a-221e-40ca-a8be-caaa37f7d300.png,549,419,664,532,115,113,red blood cell,12995,0.9826086956521739,1.0176991150442478
3493,/images/ad36bd67-594b-4f63-93e3-886af0bc618e.png,910,1468,1006,1579,96,111,red blood cell,10656,1.15625,0.8648648648648649
24450,/images/b78ba2c8-ecb3-45b2-9cda-2c8088fa95d1.png,844,97,959,233,115,136,red blood cell,15640,1.182608695652174,0.8455882352941176
17179,/images/471f75c6-bd5d-4c20-bcc1-258e836f4d69.png,381,1172,484,1278,103,106,red blood cell,10918,1.029126213592233,0.9716981132075472
34099,/images/de5d19b7-e670-4ac7-843b-7ce7bcebdf45.png,792,118,909,227,117,109,red blood cell,12753,0.9316239316239316,1.073394495412844
23481,/images/6fb707b1-5c07-479f-8385-5404bf5747b0.png,1,965,123,1089,122,124,red blood cell,15128,1.0163934426229508,0.9838709677419355
41272,/images/2374ae5b-c2df-4db5-afea-c54180aa22e3.png,314,1152,444,1276,130,124,red blood cell,16120,0.9538461538461539,1.0483870967741935
11354,/images/2f6224be-50d0-4e85-94ef-88315df561b6.png,42,822,134,908,92,86,red blood cell,7912,0.9347826086956522,1.069767441860465
4731,/images/3fa1a4e3-c80d-49da-8f7b-a1abb0424f48.png,825,1313,928,1408,103,95,red blood cell,9785,0.9223300970873787,1.0842105263157895
33459,/images/9bd40bc6-4949-42d3-b38f-d60422932f65.png,778,629,884,757,106,128,red blood cell,13568,1.2075471698113207,0.828125
14157,/images/c8fd1336-dd0a-4f97-abbf-be2c18b91e02.png,932,473,1015,575,83,102,red blood cell,8466,1.2289156626506024,0.8137254901960784
59626,/images/a2754679-68b0-40f4-be01-bafad5ac1261.png,64,478,182,596,118,118,red blood cell,13924,1.0,1.0
22691,/images/4ab47131-c2ac-461f-b95c-ac19ce24edbd.png,82,642,184,750,102,108,red blood cell,11016,1.0588235294117647,0.9444444444444444
27856,/images/948c94ad-395c-41f4-9a68-8a1dcb76888c.png,680,852,781,945,101,93,red blood cell,9393,0.9207920792079208,1.086021505376344
40650,/images/252071ac-e9f2-41d2-abbb-87ef01b8a997.png,766,608,867,708,101,100,red blood cell,10100,0.9900990099009901,1.01
21278,/images/fc8df086-39e0-43f8-b0c7-2d23a349539b.png,941,611,1058,728,117,117,red blood cell,13689,1.0,1.0
36389,/images/4a0a05e1-11ad-4bfc-bfa3-adf3b9bd0b56.png,125,826,226,944,101,118,red blood cell,11918,1.1683168316831682,0.8559322033898306
77817,/images/6bc7b53c-5a98-48ef-a9de-59a476707ea4.png,345,1493,443,1593,98,100,red blood cell,9800,1.0204081632653061,0.98
14252,/images/6382976c-ee87-4916-b798-4ef1373b2df0.png,727,663,827,760,100,97,red blood cell,9700,0.97,1.0309278350515463
59964,/images/f0fe292d-85ae-4c3a-a676-037dde2594e6.png,376,247,504,358,128,111,red blood cell,14208,0.8671875,1.1531531531531531
43312,/images/36569710-a574-40be-ad42-897a6e74a128.png,591,362,691,468,100,106,red blood cell,10600,1.06,0.9433962264150944
17438,/images/56077789-8580-41b4-89d6-deea227e5c60.png,989,471,1103,587,114,116,red blood cell,13224,1.0175438596491229,0.9827586206896551
44620,/images/6388e241-09a2-4fbe-a712-07d8fe714c51.png,277,435,396,566,119,131,red blood cell,15589,1.1008403361344539,0.9083969465648855
76227,/images/90a82250-1f68-48c9-9af9-15f18bf8c974.png,267,1373,386,1486,119,113,red blood cell,13447,0.9495798319327731,1.0530973451327434
10015,/images/b9ccf7ca-953f-4832-9575-5e70b2a8c224.png,58,785,154,886,96,101,red blood cell,9696,1.0520833333333333,0.9504950495049505
14772,/images/1fdf99d1-a494-4174-bcd7-efbe457ab899.png,48,1396,148,1491,100,95,red blood cell,9500,0.95,1.0526315789473684
43063,/images/340a1727-0df7-4e6f-9c0e-9c5deddbfca2.png,1028,544,1132,648,104,104,red blood cell,10816,1.0,1.0
53436,/images/766d5547-8dd2-4c8d-b78e-3007f83932e8.png,908,142,1025,242,117,100,red blood cell,11700,0.8547008547008547,1.17
10563,/images/9fbf38ab-44b9-4096-a818-603017a4300e.png,998,449,1141,584,143,135,red blood cell,19305,0.9440559440559441,1.0592592592592593
71240,/images/86495bbf-687b-429c-b9d3-6c2681ade7e2.png,457,1301,585,1437,128,136,red blood cell,17408,1.0625,0.9411764705882353
2144,/images/e94a811d-3145-4313-ba42-2d5ed283179f.png,267,696,375,793,108,97,red blood cell,10476,0.8981481481481481,1.1134020618556701
51437,/images/b4f3b2a4-f4b9-48de-ac5d-0e681b77be27.png,82,1344,181,1444,99,100,red blood cell,9900,1.0101010101010102,0.99
49842,/images/5e17f8e6-fd8d-426c-b444-1515d14f04b7.png,160,1159,263,1268,103,109,red blood cell,11227,1.058252427184466,0.944954128440367
798,/images/27fab82c-5bf0-426f-aeb9-47da829b6629.png,150,24,247,120,97,96,red blood cell,9312,0.9896907216494846,1.0104166666666667
44023,/images/de81bf7a-7a56-437f-a068-4d9c3e01134c.png,61,1243,178,1337,117,94,red blood cell,10998,0.8034188034188035,1.2446808510638299
43974,/images/d7c7eb2c-2acd-4f86-8a5a-09ab3dd02d16.png,223,424,314,511,91,87,red blood cell,7917,0.9560439560439561,1.0459770114942528
15777,/images/64113b22-03b1-4ab8-89ab-b2f32154fbbd.png,500,269,607,380,107,111,red blood cell,11877,1.0373831775700935,0.963963963963964
66521,/images/b87fb62d-2c36-4f68-aba9-37fcd7d46eef.png,552,1429,666,1552,114,123,red blood cell,14022,1.0789473684210527,0.926829268292683
52192,/images/f4c00b8c-d675-4255-8277-ca65bd757f51.png,573,680,681,788,108,108,red blood cell,11664,1.0,1.0
43247,/images/fe1ee954-ba71-47b3-954a-d20ab940cd7b.png,794,1437,917,1554,123,117,red blood cell,14391,0.9512195121951219,1.0512820512820513
5821,/images/143f5959-5b6d-4f95-bcee-9e110450fc22.png,843,274,962,395,119,121,red blood cell,14399,1.0168067226890756,0.9834710743801653
69923,/images/9edba799-e169-46cd-b100-c9f8fc7a8c7d.png,363,1368,484,1490,121,122,red blood cell,14762,1.0082644628099173,0.9918032786885246
35343,/images/452482bc-24a3-413e-ba03-fad4c9d61f3c.png,1046,203,1138,300,92,97,red blood cell,8924,1.0543478260869565,0.9484536082474226
63639,/images/d9c9479e-f1ea-4d6e-861f-843ff9a90d19.png,806,599,911,699,105,100,red blood cell,10500,0.9523809523809523,1.05
31761,/images/ab59c9e4-3e50-48b9-874d-060d317410cc.png,469,800,588,920,119,120,red blood cell,14280,1.0084033613445378,0.9916666666666667
23543,/images/177f883a-f0f1-4b8e-b598-2ca4bab27381.png,1006,696,1125,813,119,117,red blood cell,13923,0.9831932773109243,1.017094017094017
78111,/images/bb137718-20ba-457d-8ffe-4f9420ecaab6.png,47,296,140,392,93,96,red blood cell,8928,1.032258064516129,0.96875
15233,/images/dd7142e4-2d86-4170-a41f-e825743e8907.png,438,469,542,582,104,113,red blood cell,11752,1.0865384615384615,0.9203539823008849
79335,/images/dcb21739-3c36-459d-b3cc-1be5871d6fe7.png,966,1319,1078,1431,112,112,red blood cell,12544,1.0,1.0
50118,/images/e98baeb2-aa58-4cce-8c61-66685dd2b239.png,1,855,97,972,96,117,red blood cell,11232,1.21875,0.8205128205128205
54791,/images/b6364a57-72a9-43f3-8d02-9f53a992dc95.png,933,1343,1039,1442,106,99,red blood cell,10494,0.9339622641509434,1.0707070707070707
27565,/images/715761a2-745e-4743-9849-956a034ad3c4.png,1026,560,1126,655,100,95,red blood cell,9500,0.95,1.0526315789473684
8721,/images/92e4fd7b-79ef-49c2-a52b-9ef13dd720ef.png,359,299,470,417,111,118,red blood cell,13098,1.063063063063063,0.940677966101695
69684,/images/f0713bee-2a71-4ced-b953-4041ea99496a.png,711,671,813,772,102,101,red blood cell,10302,0.9901960784313726,1.00990099009901
29533,/images/8cc6fe77-5f2f-4670-b4ac-1b49550241a8.png,755,836,855,934,100,98,red blood cell,9800,0.98,1.0204081632653061
15515,/images/79f63258-24ce-4e69-a5cb-8529635a89a9.png,24,786,144,902,120,116,red blood cell,13920,0.9666666666666667,1.0344827586206897
11390,/images/2f6224be-50d0-4e85-94ef-88315df561b6.png,295,883,396,988,101,105,red blood cell,10605,1.0396039603960396,0.9619047619047619
58341,/images/50f2f514-6c8e-4c79-b3b3-0be56dd0b78b.png,773,140,895,257,122,117,red blood cell,14274,0.9590163934426229,1.0427350427350428
61328,/images/e16c0dab-780d-4035-872e-1bb91e49f9d2.png,810,874,913,980,103,106,red blood cell,10918,1.029126213592233,0.9716981132075472
40784,/images/252071ac-e9f2-41d2-abbb-87ef01b8a997.png,421,612,526,715,105,103,red blood cell,10815,0.9809523809523809,1.0194174757281553
53591,/images/7c1cd7c7-7452-4428-a98e-dd7675c8ddea.png,272,304,356,406,84,102,red blood cell,8568,1.2142857142857142,0.8235294117647058
75517,/images/fa4f8d1a-cb3a-4722-a566-6c7072f30606.png,33,879,137,997,104,118,red blood cell,12272,1.1346153846153846,0.8813559322033898
34005,/images/701206c5-aaac-4b99-9cc0-4a6854359457.png,1068,1018,1184,1128,116,110,red blood cell,12760,0.9482758620689655,1.0545454545454545
71991,/images/6ad3efc9-4392-4cee-98a5-186564a96373.png,997,650,1116,767,119,117,red blood cell,13923,0.9831932773109243,1.017094017094017
54293,/images/3b5a8060-dec6-4a83-b7f2-b604e4e69dfc.png,36,649,149,757,113,108,red blood cell,12204,0.9557522123893806,1.0462962962962963
78250,/images/adff6e1d-ba9d-4c7b-a8fe-1ec458eaeeb8.png,444,804,545,912,101,108,red blood cell,10908,1.0693069306930694,0.9351851851851852
21570,/images/49efc89d-9cba-44f7-8257-7f911b73f68a.png,77,1318,176,1417,99,99,red blood cell,9801,1.0,1.0
27334,/images/9f38055f-4fe6-47fd-a6dd-c0743db4eccf.png,306,807,391,905,85,98,red blood cell,8330,1.1529411764705881,0.8673469387755102
79755,/images/03b9d6ad-39ca-4097-a98b-77f02b3c00a7.png,617,949,700,1036,83,87,red blood cell,7221,1.0481927710843373,0.9540229885057471
52026,/images/6c3f81d7-5670-46bd-9eaa-9b426413abb7.png,1047,151,1161,255,114,104,red blood cell,11856,0.9122807017543859,1.0961538461538463
5126,/images/a777e78c-ad1f-4380-9ab2-b4f9f32b2d78.png,826,934,950,1052,124,118,red blood cell,14632,0.9516129032258065,1.0508474576271187
45217,/images/b7a0d235-2217-43b4-aeff-cde4ccaf6789.png,993,1116,1110,1234,117,118,red blood cell,13806,1.0085470085470085,0.9915254237288136
16461,/images/e474a20b-2769-48f1-a520-4f6ef5a0dbf5.png,716,1127,811,1220,95,93,red blood cell,8835,0.9789473684210527,1.021505376344086
50583,/images/e98ea067-82b5-4a0d-87bf-b4bbdc10ddab.png,185,330,300,463,115,133,red blood cell,15295,1.1565217391304348,0.8646616541353384
30245,/images/f81806a8-5883-446c-be78-f0145b12dbdd.png,593,443,700,562,107,119,red blood cell,12733,1.1121495327102804,0.8991596638655462
13110,/images/711f6b3f-cd63-46d1-834a-bc8e9aa9b43e.png,218,268,337,379,119,111,red blood cell,13209,0.9327731092436975,1.072072072072072
65502,/images/da49db57-0c2f-4213-b322-c88c19fb9296.png,55,621,153,732,98,111,red blood cell,10878,1.1326530612244898,0.8828828828828829
19106,/images/2196389c-45ec-46b5-bc6c-1f4a33df7f7c.png,488,1354,607,1490,119,136,red blood cell,16184,1.1428571428571428,0.875
67543,/images/45902b63-be9a-49ae-9ede-3a8015671bc4.png,682,487,777,595,95,108,red blood cell,10260,1.1368421052631579,0.8796296296296297
41112,/images/2240b991-48f6-4c59-9b62-5a8b5e541fae.png,476,1484,582,1590,106,106,red blood cell,11236,1.0,1.0
27775,/images/e3c1442a-717f-41dd-bf97-81e1233ac9fa.png,94,12,192,101,98,89,red blood cell,8722,0.9081632653061225,1.101123595505618
24188,/images/194aec70-41a5-4ac3-b22f-0b6eda91f730.png,763,20,889,135,126,115,red blood cell,14490,0.9126984126984127,1.0956521739130434
58620,/images/a4d7a7e1-5ae1-486d-b6ee-c9af1476ccad.png,343,28,440,135,97,107,red blood cell,10379,1.1030927835051547,0.9065420560747663
53879,/images/540a5fee-175b-4b92-bf62-1ea9b59c86c6.png,794,951,894,1034,100,83,red blood cell,8300,0.83,1.2048192771084338
77828,/images/6bc7b53c-5a98-48ef-a9de-59a476707ea4.png,339,1376,435,1471,96,95,red blood cell,9120,0.9895833333333334,1.0105263157894737
35616,/images/45f18ac0-f097-4b20-a99d-8837cf488822.png,699,613,806,744,107,131,red blood cell,14017,1.2242990654205608,0.816793893129771
1839,/images/5f783f43-0090-4f8a-bd75-9562f4aa2dd5.png,729,1412,816,1520,87,108,red blood cell,9396,1.2413793103448276,0.8055555555555556
39131,/images/7bde7de1-889b-4218-b0e1-e2c04f6a7986.png,968,616,1077,729,109,113,red blood cell,12317,1.036697247706422,0.9646017699115044
57893,/images/f4c2b43f-a2e7-4746-8034-0b34aebba8ee.png,446,536,555,646,109,110,red blood cell,11990,1.0091743119266054,0.990909090909091
51198,/images/ad8731b7-0dae-4983-9dc6-dec31767d761.png,474,1275,584,1391,110,116,red blood cell,12760,1.0545454545454545,0.9482758620689655
5106,/images/a777e78c-ad1f-4380-9ab2-b4f9f32b2d78.png,254,1487,355,1581,101,94,red blood cell,9494,0.9306930693069307,1.074468085106383
2472,/images/a23f5539-bfe6-4885-9a0e-dba972475ea9.png,402,196,496,305,94,109,red blood cell,10246,1.1595744680851063,0.8623853211009175
34844,/images/4fc9a597-aaa8-43b0-ad1c-2eabbe442e84.png,981,718,1072,816,91,98,red blood cell,8918,1.0769230769230769,0.9285714285714286
45929,/images/0d098413-6911-4535-b70a-3c3effd8cf49.png,1045,712,1161,830,116,118,red blood cell,13688,1.0172413793103448,0.9830508474576272
51652,/images/592c941a-aa54-4971-b499-dc47356f80a3.png,175,1201,283,1306,108,105,red blood cell,11340,0.9722222222222222,1.0285714285714285
26182,/images/04de27ff-0d36-4da3-a829-e93851d76981.png,957,342,1057,464,100,122,red blood cell,12200,1.22,0.819672131147541
62089,/images/7f528918-27d4-421f-ab57-0cf9c693e697.png,634,0,763,112,129,112,red blood cell,14448,0.8682170542635659,1.1517857142857142
2078,/images/f3bd0fcc-647d-4ca0-8c43-a16bd6ea3878.png,585,1436,699,1551,114,115,red blood cell,13110,1.0087719298245614,0.991304347826087
76676,/images/3317d733-ec0d-45e6-b631-40457392f343.png,395,491,506,599,111,108,red blood cell,11988,0.972972972972973,1.0277777777777777
46775,/images/02fb5e19-6f94-4787-bb78-e550a29a3cbd.png,231,1478,356,1592,125,114,red blood cell,14250,0.912,1.0964912280701755
8466,/images/e234ce8b-4ec4-4d93-9068-d7854d77ddf4.png,1030,807,1148,918,118,111,red blood cell,13098,0.940677966101695,1.063063063063063
66536,/images/b87fb62d-2c36-4f68-aba9-37fcd7d46eef.png,1079,477,1173,571,94,94,red blood cell,8836,1.0,1.0
11344,/images/2f6224be-50d0-4e85-94ef-88315df561b6.png,472,7,578,116,106,109,red blood cell,11554,1.028301886792453,0.9724770642201835
20530,/images/cbde7f7e-2458-4dda-9db2-3d5ccf950ced.png,423,1181,546,1302,123,121,red blood cell,14883,0.983739837398374,1.0165289256198347
14483,/images/3b13e20f-ec0d-44ec-b2f4-eaebfa09150e.png,247,392,367,508,120,116,red blood cell,13920,0.9666666666666667,1.0344827586206897
4813,/images/3fa1a4e3-c80d-49da-8f7b-a1abb0424f48.png,672,1206,774,1301,102,95,red blood cell,9690,0.9313725490196079,1.0736842105263158
37282,/images/2fdbd9bc-bbaf-44c2-b40c-d193709639fa.png,883,750,988,864,105,114,red blood cell,11970,1.0857142857142856,0.9210526315789473
41619,/images/0fcd1ebe-ee4a-40a0-b787-29cee18bfa1b.png,558,0,653,114,95,114,red blood cell,10830,1.2,0.8333333333333334
17623,/images/70a95e58-ba60-4c1f-adcd-49c198dc2ba0.png,714,264,809,366,95,102,red blood cell,9690,1.0736842105263158,0.9313725490196079
65597,/images/01b38a56-13eb-447b-89ee-fc21cb40dcc1.png,1018,1487,1111,1585,93,98,red blood cell,9114,1.053763440860215,0.9489795918367347
26560,/images/4935818a-7e7a-4f44-a3b6-b361d1abfe16.png,411,930,532,1049,121,119,red blood cell,14399,0.9834710743801653,1.0168067226890756
52107,/images/de6d3020-9347-473b-9146-8909627790f6.png,530,1093,625,1189,95,96,red blood cell,9120,1.0105263157894737,0.9895833333333334
3702,/images/dacf7e3f-1d8c-42a0-8539-3abe3971c956.png,233,152,323,244,90,92,red blood cell,8280,1.0222222222222221,0.9782608695652174
29140,/images/cfab01d3-0616-4efb-9290-11f0fd8bf5a3.png,400,82,499,193,99,111,red blood cell,10989,1.121212121212121,0.8918918918918919
18674,/images/c22f7031-9cf8-48ce-b03b-1b12d0db4951.png,516,340,608,444,92,104,red blood cell,9568,1.1304347826086956,0.8846153846153846
26324,/images/580210c2-a8ed-4720-b71c-a77945968abc.png,582,1188,691,1290,109,102,red blood cell,11118,0.9357798165137615,1.0686274509803921
64048,/images/03cbfcf2-8da6-462c-b30d-16d63357371f.png,1035,1143,1127,1257,92,114,red blood cell,10488,1.2391304347826086,0.8070175438596491
22761,/images/8490c623-3d88-4532-baf5-0d266a45b16f.png,216,183,327,291,111,108,red blood cell,11988,0.972972972972973,1.0277777777777777
42751,/images/a6f8a029-44ee-4fe3-b807-38d137347729.png,1038,507,1147,632,109,125,red blood cell,13625,1.146788990825688,0.872
60154,/images/214f1d15-a081-476e-992d-6c3a77f03d59.png,544,488,650,604,106,116,red blood cell,12296,1.0943396226415094,0.9137931034482759
46492,/images/21417261-475a-456f-b03f-57ac85a6e106.png,1000,868,1116,989,116,121,red blood cell,14036,1.043103448275862,0.9586776859504132
61687,/images/a3c0a876-be12-4ede-8aed-18b32a64401b.png,9,1498,91,1591,82,93,red blood cell,7626,1.1341463414634145,0.8817204301075269
63887,/images/5e974892-0ebe-4037-8427-ea8616d6d3b8.png,555,1278,664,1370,109,92,red blood cell,10028,0.8440366972477065,1.184782608695652
37130,/images/d6942996-5664-4370-ad87-2bdcbd49ac16.png,218,8,323,111,105,103,red blood cell,10815,0.9809523809523809,1.0194174757281553
64399,/images/0a7bfa8a-ee52-4f7a-b9c5-2919ecfa93ef.png,533,1036,622,1110,89,74,red blood cell,6586,0.8314606741573034,1.2027027027027026
25869,/images/461a3ed6-039f-4a70-97cf-c474ecf51ccd.png,51,1207,167,1312,116,105,red blood cell,12180,0.9051724137931034,1.1047619047619048
21006,/images/666601e7-608d-4d19-999f-8fc6ab373a55.png,999,617,1118,745,119,128,red blood cell,15232,1.0756302521008403,0.9296875
38421,/images/674b0fd3-f247-4b7f-97f7-3e6c57c9ba9e.png,983,210,1068,304,85,94,red blood cell,7990,1.1058823529411765,0.9042553191489362
23135,/images/c94a5851-b846-4fde-8c89-05bec3a8ac53.png,869,201,1002,328,133,127,red blood cell,16891,0.9548872180451128,1.047244094488189
46962,/images/9e0e1928-d19a-4100-b093-0b962ac09e05.png,513,1168,605,1264,92,96,red blood cell,8832,1.0434782608695652,0.9583333333333334
13676,/images/1e86933d-6a5a-4a3c-a0f2-ca22afd767b3.png,948,131,1050,250,102,119,red blood cell,12138,1.1666666666666667,0.8571428571428571
74945,/images/dd090806-e4ac-4a78-b2ee-55a30626369c.png,712,1345,823,1459,111,114,red blood cell,12654,1.027027027027027,0.9736842105263158
77407,/images/c7ec51d5-9f45-4209-8357-39e9a984a733.png,376,554,477,656,101,102,red blood cell,10302,1.00990099009901,0.9901960784313726
29174,/images/6274fe0d-0d71-40be-b61b-f0bd5b5df1e2.png,927,219,1032,314,105,95,red blood cell,9975,0.9047619047619048,1.105263157894737
22605,/images/406e05f0-4444-414c-bb40-f4cb08e75ac9.png,805,723,937,831,132,108,red blood cell,14256,0.8181818181818182,1.2222222222222223
76712,/images/3317d733-ec0d-45e6-b631-40457392f343.png,294,116,384,219,90,103,red blood cell,9270,1.1444444444444444,0.8737864077669902
1150,/images/4411fea2-d785-4eeb-80c6-c739ab6114c4.png,522,998,644,1100,122,102,red blood cell,12444,0.8360655737704918,1.196078431372549
12956,/images/b10ea12f-cd36-4f2c-994a-67d1665269ab.png,361,741,466,836,105,95,red blood cell,9975,0.9047619047619048,1.105263157894737
33446,/images/244ac6fa-8a92-4214-9cf4-ae0811d9ec7e.png,37,864,149,973,112,109,red blood cell,12208,0.9732142857142857,1.0275229357798166
29428,/images/b4e5e08d-6427-46f3-aca8-a4df165a151d.png,937,576,1035,667,98,91,red blood cell,8918,0.9285714285714286,1.0769230769230769
74130,/images/9fe8bdc8-847d-434e-93e5-ae14ff3b45e1.png,923,257,1013,352,90,95,red blood cell,8550,1.0555555555555556,0.9473684210526315
16207,/images/acdc6e12-73d9-44ba-be8c-2a56aaffef4f.png,627,1234,738,1340,111,106,red blood cell,11766,0.954954954954955,1.0471698113207548
60974,/images/5397d8e2-bb09-42e7-9861-65ffad0fe94e.png,927,1404,1022,1503,95,99,red blood cell,9405,1.0421052631578946,0.9595959595959596
62499,/images/7dfbfeaf-e3b1-4159-8dcd-d7f731280ac8.png,245,968,329,1071,84,103,red blood cell,8652,1.2261904761904763,0.8155339805825242
35884,/images/33068c1a-48f7-470b-8e49-e2f0888042e9.png,514,1224,621,1340,107,116,red blood cell,12412,1.0841121495327102,0.9224137931034483
78056,/images/105af41b-13cc-4ad1-8a1f-8bc4d47cdd94.png,368,1123,487,1238,119,115,red blood cell,13685,0.9663865546218487,1.0347826086956522
18579,/images/c22f7031-9cf8-48ce-b03b-1b12d0db4951.png,99,1204,203,1308,104,104,red blood cell,10816,1.0,1.0
19068,/images/6e39fb0a-aa41-4b16-b783-7589e97bf289.png,514,104,627,220,113,116,red blood cell,13108,1.0265486725663717,0.9741379310344828
33868,/images/1a332b2c-9d49-4ff2-810c-5633d2314527.png,630,806,742,919,112,113,red blood cell,12656,1.0089285714285714,0.9911504424778761
36320,/images/81fed4a1-9d48-4938-90c9-c8bf3f5e6b1f.png,585,533,716,662,131,129,red blood cell,16899,0.9847328244274809,1.0155038759689923
13135,/images/711f6b3f-cd63-46d1-834a-bc8e9aa9b43e.png,1004,243,1088,334,84,91,red blood cell,7644,1.0833333333333333,0.9230769230769231
11935,/images/f8a8b148-60e4-4a5c-ae19-941b19ec0846.png,333,80,442,175,109,95,red blood cell,10355,0.8715596330275229,1.1473684210526316
23871,/images/c17523c5-90a0-4a6b-9b33-2b4a6cf58d36.png,450,812,560,924,110,112,red blood cell,12320,1.018181818181818,0.9821428571428571
73567,/images/7624ac36-1cf9-42fb-844d-376078309553.png,561,552,673,655,112,103,red blood cell,11536,0.9196428571428571,1.087378640776699
29035,/images/4c13e22e-dfd1-4fa1-b373-be9d0c272c0f.png,981,1442,1086,1546,105,104,red blood cell,10920,0.9904761904761905,1.0096153846153846
24412,/images/4d8a4ce8-0f9c-4f21-8844-4cf0e5514bbf.png,487,1348,597,1438,110,90,red blood cell,9900,0.8181818181818182,1.2222222222222223
5333,/images/06df7bbe-60d4-4f7c-ba4a-5a42ac4be91b.png,616,95,727,231,111,136,red blood cell,15096,1.2252252252252251,0.8161764705882353
40469,/images/db249e5a-4142-432c-8288-bacd10d7273d.png,208,285,304,387,96,102,red blood cell,9792,1.0625,0.9411764705882353
5308,/images/06df7bbe-60d4-4f7c-ba4a-5a42ac4be91b.png,990,188,1123,302,133,114,red blood cell,15162,0.8571428571428571,1.1666666666666667
62438,/images/7dfbfeaf-e3b1-4159-8dcd-d7f731280ac8.png,945,767,1053,875,108,108,red blood cell,11664,1.0,1.0
4585,/images/98efca97-37d2-4459-aca6-375ecc0c4539.png,468,1114,600,1238,132,124,red blood cell,16368,0.9393939393939394,1.064516129032258
28073,/images/f1f9df6d-c4cb-4b42-9ca2-8fb47b1b0e91.png,250,599,372,716,122,117,red blood cell,14274,0.9590163934426229,1.0427350427350428
55010,/images/7beee655-6156-43b8-b185-dbae0eaf7f45.png,539,904,657,1026,118,122,red blood cell,14396,1.0338983050847457,0.9672131147540983
49631,/images/bd7937db-fca2-44d0-8538-460110210927.png,752,320,868,425,116,105,red blood cell,12180,0.9051724137931034,1.1047619047619048
61974,/images/c66a3e52-0f3f-4c81-bab9-0303499549f7.png,444,77,554,182,110,105,red blood cell,11550,0.9545454545454546,1.0476190476190477
28713,/images/151f3af5-5e6e-4bcd-9389-4974fc68813e.png,813,792,925,911,112,119,red blood cell,13328,1.0625,0.9411764705882353
13453,/images/370277f8-436b-4103-8210-b4feb5ab95ea.png,116,916,221,1004,105,88,red blood cell,9240,0.8380952380952381,1.1931818181818181
21593,/images/49efc89d-9cba-44f7-8257-7f911b73f68a.png,978,1457,1070,1551,92,94,red blood cell,8648,1.0217391304347827,0.9787234042553191
12404,/images/3b55c42f-ad59-422f-ba99-4f4f4ca9cb2e.png,578,1001,670,1097,92,96,red blood cell,8832,1.0434782608695652,0.9583333333333334
31286,/images/db7c5ec1-fefe-4e9d-83c1-da8fb982f1e2.png,368,51,480,158,112,107,red blood cell,11984,0.9553571428571429,1.0467289719626167
64620,/images/6dfafdf1-f588-4e80-8cf8-0126e1bf7af9.png,76,368,162,455,86,87,red blood cell,7482,1.0116279069767442,0.9885057471264368
64199,/images/2a91387a-d30f-418d-ac3a-f7cfa6836261.png,327,514,424,615,97,101,red blood cell,9797,1.041237113402062,0.9603960396039604
29452,/images/8cc6fe77-5f2f-4670-b4ac-1b49550241a8.png,558,1001,661,1100,103,99,red blood cell,10197,0.9611650485436893,1.0404040404040404
70529,/images/8cca114a-ed05-4b87-95b7-fae02487f08c.png,156,260,249,359,93,99,red blood cell,9207,1.064516129032258,0.9393939393939394
702,/images/e61e6af2-7f8b-47b0-bbe7-acb2ed0299ab.png,152,975,274,1093,122,118,red blood cell,14396,0.9672131147540983,1.0338983050847457
61394,/images/e16c0dab-780d-4035-872e-1bb91e49f9d2.png,228,1031,325,1129,97,98,red blood cell,9506,1.0103092783505154,0.9897959183673469
37629,/images/205306da-0ed8-475a-ace6-f2f81d4be88a.png,708,862,814,974,106,112,red blood cell,11872,1.0566037735849056,0.9464285714285714
43163,/images/c5db0fc0-b96c-496e-90b4-f9fb1b85b28e.png,1007,975,1109,1071,102,96,red blood cell,9792,0.9411764705882353,1.0625
5207,/images/16a51468-9f93-45df-9ae2-5a74c25c5a4b.png,508,450,617,571,109,121,red blood cell,13189,1.110091743119266,0.9008264462809917
34010,/images/701206c5-aaac-4b99-9cc0-4a6854359457.png,159,1231,265,1329,106,98,red blood cell,10388,0.9245283018867925,1.0816326530612246
69214,/images/f274b784-b995-4a7e-a2c2-6cc31c24c4b4.png,776,1311,867,1403,91,92,red blood cell,8372,1.010989010989011,0.9891304347826086
5194,/images/16a51468-9f93-45df-9ae2-5a74c25c5a4b.png,674,242,792,363,118,121,red blood cell,14278,1.0254237288135593,0.9752066115702479
74670,/images/5ccca8ee-abea-458a-a891-bedd31c3ddc3.png,553,338,651,434,98,96,red blood cell,9408,0.9795918367346939,1.0208333333333333
71752,/images/093a831a-bf71-4333-bc06-942ae70cb164.png,918,1416,1019,1513,101,97,red blood cell,9797,0.9603960396039604,1.041237113402062
31962,/images/9eb66577-7857-43dc-a879-8f2c9d7f780f.png,523,1394,618,1499,95,105,red blood cell,9975,1.105263157894737,0.9047619047619048
20408,/images/781d4bea-c6a9-4b36-ae10-ba9e328c87fe.png,696,1164,824,1294,128,130,red blood cell,16640,1.015625,0.9846153846153847
72172,/images/005e60b6-77b8-458c-b57c-bfe0c7e7df78.png,466,482,570,601,104,119,red blood cell,12376,1.1442307692307692,0.8739495798319328
29965,/images/deeaa5b3-3895-4aec-a2ce-ed6404862cdf.png,874,1482,958,1583,84,101,red blood cell,8484,1.2023809523809523,0.8316831683168316
63676,/images/d9c9479e-f1ea-4d6e-861f-843ff9a90d19.png,205,305,287,381,82,76,red blood cell,6232,0.926829268292683,1.0789473684210527
52915,/images/abb2f9d6-26fa-4328-983c-959ef6717c05.png,421,410,515,506,94,96,red blood cell,9024,1.0212765957446808,0.9791666666666666
10851,/images/2a02cec2-a09b-483a-ad38-14359a763fa4.png,973,269,1076,370,103,101,red blood cell,10403,0.9805825242718447,1.0198019801980198
11894,/images/2e8d6a43-0110-4bf4-8e70-20567e513b81.png,752,773,852,873,100,100,red blood cell,10000,1.0,1.0
30077,/images/81c3c8f0-d5a9-4dda-afd5-e86f6afd9424.png,817,1001,933,1102,116,101,red blood cell,11716,0.8706896551724138,1.1485148514851484
41511,/images/2f3ebec8-ef64-420d-9aa0-c2fcadc27d74.png,323,1084,446,1202,123,118,red blood cell,14514,0.959349593495935,1.0423728813559323
17530,/images/e80bad38-66d0-473e-85dd-92142dba37e6.png,699,465,824,582,125,117,red blood cell,14625,0.936,1.0683760683760684
65002,/images/ff3b9d4d-373c-48ef-a75a-d23e2c2ade87.png,874,976,965,1075,91,99,red blood cell,9009,1.0879120879120878,0.9191919191919192
5983,/images/97eff653-3908-4e66-931f-eab36bc336c8.png,693,186,813,311,120,125,red blood cell,15000,1.0416666666666667,0.96
42839,/images/7029feb3-9ffe-46e4-9883-6a9df84f7b62.png,84,18,186,118,102,100,red blood cell,10200,0.9803921568627451,1.02
12363,/images/3b55c42f-ad59-422f-ba99-4f4f4ca9cb2e.png,126,551,229,652,103,101,red blood cell,10403,0.9805825242718447,1.0198019801980198
57447,/images/00d04a90-80e5-4bce-9511-1b64eabb7a47.png,73,116,173,228,100,112,red blood cell,11200,1.12,0.8928571428571429
32839,/images/2a6370b0-08f1-4c11-a639-265d4419c9a3.png,397,811,508,929,111,118,red blood cell,13098,1.063063063063063,0.940677966101695
39141,/images/7bde7de1-889b-4218-b0e1-e2c04f6a7986.png,369,220,476,346,107,126,red blood cell,13482,1.1775700934579438,0.8492063492063492
71505,/images/191071ab-6515-428c-9f05-8e4309542b75.png,1028,1375,1110,1454,82,79,red blood cell,6478,0.9634146341463414,1.0379746835443038
64387,/images/0a7bfa8a-ee52-4f7a-b9c5-2919ecfa93ef.png,645,260,757,353,112,93,red blood cell,10416,0.8303571428571429,1.2043010752688172
62155,/images/a63fa2c7-3ec8-4bb7-bde6-a39e09d2f806.png,143,1187,236,1302,93,115,red blood cell,10695,1.2365591397849462,0.808695652173913
74812,/images/91e93160-eb8d-4de0-b6bc-b98ec33d1663.png,726,113,822,216,96,103,red blood cell,9888,1.0729166666666667,0.9320388349514563
43175,/images/c5db0fc0-b96c-496e-90b4-f9fb1b85b28e.png,218,1393,312,1510,94,117,red blood cell,10998,1.2446808510638299,0.8034188034188035
73720,/images/f11d05e4-538a-4024-8711-b08a4ce3c540.png,548,650,641,743,93,93,red blood cell,8649,1.0,1.0
70697,/images/8ab5c462-045e-4b59-b53a-9b2bc3ed2487.png,810,789,914,905,104,116,red blood cell,12064,1.1153846153846154,0.896551724137931
57926,/images/09bcedaa-e007-4692-a13f-ab02c3f872c4.png,178,759,289,871,111,112,red blood cell,12432,1.009009009009009,0.9910714285714286
67264,/images/5f491efd-a21c-4a80-aaba-70b8876238ac.png,955,92,1041,175,86,83,red blood cell,7138,0.9651162790697675,1.036144578313253
53451,/images/766d5547-8dd2-4c8d-b78e-3007f83932e8.png,181,1404,283,1486,102,82,red blood cell,8364,0.803921568627451,1.2439024390243902
36661,/images/21f001d6-f568-4ea4-82da-fab54c77c419.png,983,613,1086,704,103,91,red blood cell,9373,0.883495145631068,1.1318681318681318
13916,/images/de00f9a5-aa8b-4679-8ec6-85528a942d6f.png,871,1005,996,1122,125,117,red blood cell,14625,0.936,1.0683760683760684
42093,/images/46a03374-64c7-49ac-81c9-c3d62542bbf3.png,596,1058,683,1141,87,83,red blood cell,7221,0.9540229885057471,1.0481927710843373
28408,/images/a6d85204-24b8-4b23-a8b1-c3e8b93f9f22.png,644,765,759,881,115,116,red blood cell,13340,1.008695652173913,0.9913793103448276
67182,/images/be6fe358-dee1-4dcf-9b0d-5d8612aba577.png,649,1079,730,1170,81,91,red blood cell,7371,1.123456790123457,0.8901098901098901
44490,/images/b6573be3-9e04-49c3-9f48-6a145d065363.png,994,1110,1104,1223,110,113,red blood cell,12430,1.0272727272727273,0.9734513274336283
32531,/images/318de807-7232-4ab1-843e-a901547c0125.png,282,648,402,751,120,103,red blood cell,12360,0.8583333333333333,1.1650485436893203
60950,/images/5397d8e2-bb09-42e7-9861-65ffad0fe94e.png,67,1381,191,1511,124,130,red blood cell,16120,1.0483870967741935,0.9538461538461539
32642,/images/ed0d8763-e734-4506-b61b-53fc32a8d8c9.png,831,863,951,977,120,114,red blood cell,13680,0.95,1.0526315789473684
54848,/images/b6364a57-72a9-43f3-8d02-9f53a992dc95.png,203,903,303,996,100,93,red blood cell,9300,0.93,1.075268817204301
76709,/images/3317d733-ec0d-45e6-b631-40457392f343.png,298,972,396,1083,98,111,red blood cell,10878,1.1326530612244898,0.8828828828828829
51353,/images/b4f3b2a4-f4b9-48de-ac5d-0e681b77be27.png,191,184,308,297,117,113,red blood cell,13221,0.9658119658119658,1.0353982300884956
69997,/images/3e36698f-8c09-4c8b-8948-737310bf97e5.png,70,1044,181,1159,111,115,red blood cell,12765,1.0360360360360361,0.9652173913043478
77597,/images/f20a4fcf-ea8e-4c14-883d-d26a9e08ce25.png,863,568,975,686,112,118,red blood cell,13216,1.0535714285714286,0.9491525423728814
46672,/images/da111ca5-520f-4ea8-97ad-ae5fce58ee91.png,713,552,830,649,117,97,red blood cell,11349,0.8290598290598291,1.2061855670103092
27824,/images/db3f4098-02e4-45a3-a7af-5dda37ac1526.png,727,18,821,112,94,94,red blood cell,8836,1.0,1.0
30330,/images/cecbf663-0751-4e7f-b298-770c88afc2c1.png,150,1484,272,1599,122,115,red blood cell,14030,0.9426229508196722,1.0608695652173914
6419,/images/1ecb0405-a6e9-4485-819e-2fbbf2b718aa.png,520,541,636,649,116,108,red blood cell,12528,0.9310344827586207,1.0740740740740742
68403,/images/040112be-3c8d-49aa-93f1-522f94a592ff.png,414,815,522,920,108,105,red blood cell,11340,0.9722222222222222,1.0285714285714285
64576,/images/6ba5d0b8-cdc7-4266-9d78-db76faa312e9.png,682,680,764,780,82,100,red blood cell,8200,1.2195121951219512,0.82
23363,/images/a7688988-2bcc-4458-83d3-5e482da5f87b.png,743,1398,842,1490,99,92,red blood cell,9108,0.9292929292929293,1.076086956521739
73334,/images/c890ee00-daa5-4b20-9cd5-930748ecc4e0.png,500,629,588,728,88,99,red blood cell,8712,1.125,0.8888888888888888
54263,/images/3b5a8060-dec6-4a83-b7f2-b604e4e69dfc.png,402,1156,501,1252,99,96,red blood cell,9504,0.9696969696969697,1.03125
718,/images/dcc1a193-7b74-44f8-ad8d-813751d8fa6b.png,119,48,232,167,113,119,red blood cell,13447,1.0530973451327434,0.9495798319327731
18912,/images/e9e78ff8-831b-46e9-9785-3eee9acbfcd8.png,560,694,664,791,104,97,red blood cell,10088,0.9326923076923077,1.0721649484536082
63338,/images/9f4bc3b4-abb0-4bcb-baa8-ec9f25e2b9c6.png,46,520,173,642,127,122,red blood cell,15494,0.9606299212598425,1.040983606557377
66613,/images/087f2c9c-188d-43cc-a94c-0eb8f10ac092.png,529,968,617,1065,88,97,red blood cell,8536,1.1022727272727273,0.9072164948453608
11671,/images/0ed416f9-7c20-4829-9016-559e4009568e.png,200,1467,325,1571,125,104,red blood cell,13000,0.832,1.2019230769230769
72210,/images/7d4d0646-26b5-46fa-ab25-452d986e887b.png,304,945,398,1050,94,105,red blood cell,9870,1.1170212765957446,0.8952380952380953
41022,/images/8e078333-8fa0-45be-a46e-fa05708cb365.png,235,834,362,969,127,135,red blood cell,17145,1.062992125984252,0.9407407407407408
78255,/images/adff6e1d-ba9d-4c7b-a8fe-1ec458eaeeb8.png,354,209,473,316,119,107,red blood cell,12733,0.8991596638655462,1.1121495327102804
22822,/images/72105bb0-8e39-48be-b7f7-5b32f047b99e.png,641,611,754,726,113,115,red blood cell,12995,1.0176991150442478,0.9826086956521739
74718,/images/5ccca8ee-abea-458a-a891-bedd31c3ddc3.png,930,1294,1020,1383,90,89,red blood cell,8010,0.9888888888888889,1.0112359550561798
33076,/images/6231d81d-9e84-4a5a-8cb8-47c6a37a0176.png,980,1390,1070,1476,90,86,red blood cell,7740,0.9555555555555556,1.0465116279069768
68165,/images/5dec94a3-e3ca-4a58-9702-88e5a83ef612.png,120,546,207,630,87,84,red blood cell,7308,0.9655172413793104,1.0357142857142858
9386,/images/e3a4b3e7-9500-4b6c-a402-b6d3f45e714b.png,902,2,1012,108,110,106,red blood cell,11660,0.9636363636363636,1.0377358490566038
58064,/images/a7c91b63-b97c-4f4b-8d34-7ad2b08d7a17.png,803,1158,900,1260,97,102,red blood cell,9894,1.0515463917525774,0.9509803921568627
6920,/images/a9feccda-18f2-405e-9aa1-409fa1f49fe4.png,606,1268,703,1363,97,95,red blood cell,9215,0.979381443298969,1.0210526315789474
46273,/images/815bf40c-371a-4d34-aa41-c549c8221881.png,578,104,687,216,109,112,red blood cell,12208,1.0275229357798166,0.9732142857142857
14247,/images/6382976c-ee87-4916-b798-4ef1373b2df0.png,442,1471,545,1586,103,115,red blood cell,11845,1.116504854368932,0.8956521739130435
66919,/images/9acf303a-fcba-4e52-be3e-8d061aa5e72a.png,495,1186,578,1277,83,91,red blood cell,7553,1.0963855421686748,0.9120879120879121
79347,/images/dcb21739-3c36-459d-b3cc-1be5871d6fe7.png,743,1084,844,1186,101,102,red blood cell,10302,1.00990099009901,0.9901960784313726
1811,/images/5f783f43-0090-4f8a-bd75-9562f4aa2dd5.png,437,210,524,299,87,89,red blood cell,7743,1.0229885057471264,0.9775280898876404
30964,/images/533c47c9-02a6-419b-961b-81797f022f6c.png,342,1181,444,1285,102,104,red blood cell,10608,1.0196078431372548,0.9807692307692307
57984,/images/7942691b-6376-4c75-ae8a-ddf65454dcb2.png,42,568,136,667,94,99,red blood cell,9306,1.053191489361702,0.9494949494949495
16037,/images/7e25ced3-5caf-47f8-ad0c-42946bd4468b.png,827,1075,948,1189,121,114,red blood cell,13794,0.9421487603305785,1.0614035087719298
41409,/images/65e8b0cd-05d1-4c8d-8efd-24bf71df3167.png,679,1094,788,1217,109,123,red blood cell,13407,1.128440366972477,0.8861788617886179
36240,/images/b2103776-9b32-4160-b4f0-0692deda19dc.png,935,466,1038,589,103,123,red blood cell,12669,1.1941747572815533,0.8373983739837398
48544,/images/f3d84be2-8af0-4d62-9f72-23d3dc08cbbe.png,192,1,304,99,112,98,red blood cell,10976,0.875,1.1428571428571428
290,/images/0dcca702-a4ef-4fb3-a940-9c0c140b21c7.png,565,589,668,694,103,105,red blood cell,10815,1.0194174757281553,0.9809523809523809
23469,/images/8757be1e-b832-407a-8e95-62abae485b24.png,538,700,620,786,82,86,red blood cell,7052,1.048780487804878,0.9534883720930233
70720,/images/8ab5c462-045e-4b59-b53a-9b2bc3ed2487.png,598,611,687,711,89,100,red blood cell,8900,1.1235955056179776,0.89
22115,/images/ca677c3c-083f-4d54-9dec-39f79f6a17d8.png,694,648,807,762,113,114,red blood cell,12882,1.008849557522124,0.9912280701754386
8343,/images/65e3d6a6-012c-4b40-9a42-83078eb85e31.png,748,768,836,860,88,92,red blood cell,8096,1.0454545454545454,0.9565217391304348
5723,/images/d3dcdf92-9328-4796-adf4-918646877ba1.png,442,784,559,888,117,104,red blood cell,12168,0.8888888888888888,1.125
5084,/images/b7f1a1eb-c150-4456-9c47-e7db8a5cb77a.png,1015,419,1129,546,114,127,red blood cell,14478,1.1140350877192982,0.8976377952755905
47599,/images/06cd484f-e864-4fee-8819-688b45eed98e.png,462,564,581,683,119,119,red blood cell,14161,1.0,1.0
11854,/images/3cdcb09b-6a8c-43ca-b1d0-c1a289202f65.png,770,744,875,835,105,91,red blood cell,9555,0.8666666666666667,1.1538461538461537
10336,/images/affa429c-0315-4c18-a002-13bb3ecab259.png,92,693,190,808,98,115,red blood cell,11270,1.1734693877551021,0.8521739130434782
43420,/images/367663b2-5d09-4020-ab0a-c2200e7a1c8c.png,588,744,694,846,106,102,red blood cell,10812,0.9622641509433962,1.0392156862745099
43991,/images/de81bf7a-7a56-437f-a068-4d9c3e01134c.png,179,29,287,130,108,101,red blood cell,10908,0.9351851851851852,1.0693069306930694
11391,/images/2f6224be-50d0-4e85-94ef-88315df561b6.png,64,518,173,629,109,111,red blood cell,12099,1.018348623853211,0.9819819819819819
16914,/images/f5419bc0-4415-41b6-b832-5326cfcc534b.png,407,938,518,1066,111,128,red blood cell,14208,1.1531531531531531,0.8671875
55604,/images/c32b8bb8-c89d-4ae9-9c77-5b9356ca35a1.png,535,835,648,935,113,100,red blood cell,11300,0.8849557522123894,1.13
21795,/images/f68ae8e9-e760-4106-88e0-4bdef2785f06.png,24,32,137,130,113,98,red blood cell,11074,0.8672566371681416,1.153061224489796
13977,/images/31af9c31-7868-44a6-8eb4-82ce118af425.png,169,262,268,380,99,118,red blood cell,11682,1.1919191919191918,0.8389830508474576
80077,/images/99e979d4-ee97-4d7f-9da6-00bead40db4d.png,696,790,804,895,108,105,red blood cell,11340,0.9722222222222222,1.0285714285714285
56467,/images/d75933ed-d26e-4d1f-bda3-96bc0d77fb36.png,113,134,220,242,107,108,red blood cell,11556,1.0093457943925233,0.9907407407407407
46512,/images/dd944a6b-c1d3-4f9f-bbdc-3709707984f7.png,791,910,922,1039,131,129,red blood cell,16899,0.9847328244274809,1.0155038759689923
13630,/images/d47cd049-d78b-4ba3-a7d4-399be4dd1dde.png,343,769,469,902,126,133,red blood cell,16758,1.0555555555555556,0.9473684210526315
27922,/images/46f5bd4f-8bea-48d1-a1da-4dea28e3b814.png,188,1419,317,1541,129,122,red blood cell,15738,0.9457364341085271,1.0573770491803278
45859,/images/7db1373d-5bbf-47e6-ab40-30cba7678745.png,851,516,965,649,114,133,red blood cell,15162,1.1666666666666667,0.8571428571428571
63582,/images/de0321fa-6f7d-4dd1-b96b-186701c3b1d9.png,1052,886,1142,987,90,101,red blood cell,9090,1.1222222222222222,0.8910891089108911
38835,/images/d0d3ae45-b434-4869-a518-427320ebe62d.png,772,1451,889,1585,117,134,red blood cell,15678,1.1452991452991452,0.8731343283582089
13876,/images/7d65d296-0f7b-41cc-9073-a547e24326c8.png,907,1222,1018,1336,111,114,red blood cell,12654,1.027027027027027,0.9736842105263158
16499,/images/1315c2a4-0794-4dfa-a709-e2451723d2b6.png,140,84,258,206,118,122,red blood cell,14396,1.0338983050847457,0.9672131147540983
1917,/images/02ea7aa8-c142-4a3d-939f-e77689741341.png,940,45,1065,162,125,117,red blood cell,14625,0.936,1.0683760683760684
64126,/images/0d3c2521-da55-4df5-bf06-56b3bd4fb2fc.png,794,742,898,847,104,105,red blood cell,10920,1.0096153846153846,0.9904761904761905
54253,/images/3b5a8060-dec6-4a83-b7f2-b604e4e69dfc.png,141,565,242,688,101,123,red blood cell,12423,1.2178217821782178,0.8211382113821138
40500,/images/e3ade58d-086c-47fa-9120-76beacb45395.png,490,970,620,1106,130,136,red blood cell,17680,1.0461538461538462,0.9558823529411765
55306,/images/4fb83278-adc5-4424-9f45-b6d0db2955b6.png,736,468,846,575,110,107,red blood cell,11770,0.9727272727272728,1.02803738317757
37962,/images/56a57a8d-c9b9-432a-a3b0-32a09355806c.png,556,327,656,423,100,96,red blood cell,9600,0.96,1.0416666666666667
32806,/images/67f5ca94-d84e-490e-bf0d-4ffba7bdbe30.png,540,1313,653,1417,113,104,red blood cell,11752,0.9203539823008849,1.0865384615384615
18503,/images/9b410534-3b70-4a88-9f93-205cf4e55a05.png,437,408,530,519,93,111,red blood cell,10323,1.1935483870967742,0.8378378378378378
37918,/images/56a57a8d-c9b9-432a-a3b0-32a09355806c.png,160,667,260,754,100,87,red blood cell,8700,0.87,1.1494252873563218
3535,/images/25132962-ff5d-4737-995f-c54d8490539b.png,36,35,139,139,103,104,red blood cell,10712,1.0097087378640777,0.9903846153846154
6940,/images/a9feccda-18f2-405e-9aa1-409fa1f49fe4.png,471,12,578,111,107,99,red blood cell,10593,0.9252336448598131,1.0808080808080809
69429,/images/fde0fd54-49cc-42e1-90c6-6b612cd062d8.png,503,835,592,939,89,104,red blood cell,9256,1.1685393258426966,0.8557692307692307
26093,/images/71925778-a26e-483e-a07c-f3aaf740122a.png,107,814,208,916,101,102,red blood cell,10302,1.00990099009901,0.9901960784313726
6783,/images/672e4ecf-a56b-462e-b83b-76f4efaa6634.png,1099,1346,1194,1462,95,116,red blood cell,11020,1.2210526315789474,0.8189655172413793
25007,/images/ed0bee2f-05e0-4392-8357-19750cec577c.png,748,7,844,101,96,94,red blood cell,9024,0.9791666666666666,1.0212765957446808
42008,/images/46a03374-64c7-49ac-81c9-c3d62542bbf3.png,784,164,880,260,96,96,red blood cell,9216,1.0,1.0
79219,/images/eb0173a3-7e5e-4f53-8124-03d9d6317844.png,967,70,1096,196,129,126,red blood cell,16254,0.9767441860465116,1.0238095238095237
43239,/images/fe1ee954-ba71-47b3-954a-d20ab940cd7b.png,952,950,1071,1075,119,125,red blood cell,14875,1.050420168067227,0.952
11655,/images/0ed416f9-7c20-4829-9016-559e4009568e.png,890,602,1003,724,113,122,red blood cell,13786,1.079646017699115,0.9262295081967213
63150,/images/d82c657e-5678-41da-9a6e-3ad29430b759.png,762,1071,861,1180,99,109,red blood cell,10791,1.101010101010101,0.908256880733945
29681,/images/b85fc640-de49-4f7e-afc0-978ff020f2e2.png,575,168,688,286,113,118,red blood cell,13334,1.0442477876106195,0.9576271186440678
29228,/images/6274fe0d-0d71-40be-b61b-f0bd5b5df1e2.png,702,1031,786,1116,84,85,red blood cell,7140,1.0119047619047619,0.9882352941176471
59687,/images/a2754679-68b0-40f4-be01-bafad5ac1261.png,135,340,258,458,123,118,red blood cell,14514,0.959349593495935,1.0423728813559323
59729,/images/f77d7469-d083-4c2d-a4ea-5a9ff162e3e2.png,61,1072,177,1167,116,95,red blood cell,11020,0.8189655172413793,1.2210526315789474
11877,/images/3cdcb09b-6a8c-43ca-b1d0-c1a289202f65.png,781,646,877,731,96,85,red blood cell,8160,0.8854166666666666,1.1294117647058823
50938,/images/ef8fcfa4-8466-4186-8c69-f5f4904eb489.png,513,488,608,587,95,99,red blood cell,9405,1.0421052631578946,0.9595959595959596
38671,/images/b5acf759-1115-42f0-a753-656736192528.png,458,7,566,100,108,93,red blood cell,10044,0.8611111111111112,1.1612903225806452
10582,/images/20d4f65e-6c63-433a-935c-d568d577967b.png,25,1169,142,1266,117,97,red blood cell,11349,0.8290598290598291,1.2061855670103092
8471,/images/e234ce8b-4ec4-4d93-9068-d7854d77ddf4.png,264,624,381,740,117,116,red blood cell,13572,0.9914529914529915,1.0086206896551724
79953,/images/e640ae51-cbf1-4a84-b7cf-d38b17f59c2f.png,465,646,558,744,93,98,red blood cell,9114,1.053763440860215,0.9489795918367347
45549,/images/e597f7ce-46c6-4dce-9063-50a2703fdd45.png,332,150,425,249,93,99,red blood cell,9207,1.064516129032258,0.9393939393939394
78421,/images/fe00fa09-d3c8-485b-9d0f-3cce556c9edd.png,81,579,190,668,109,89,red blood cell,9701,0.8165137614678899,1.2247191011235956
7957,/images/933e7e07-fc3d-42eb-be0c-6b1623ee60fa.png,91,1140,212,1264,121,124,red blood cell,15004,1.024793388429752,0.9758064516129032
18967,/images/e9e78ff8-831b-46e9-9785-3eee9acbfcd8.png,511,1011,597,1093,86,82,red blood cell,7052,0.9534883720930233,1.048780487804878
65563,/images/01b38a56-13eb-447b-89ee-fc21cb40dcc1.png,1048,1217,1165,1334,117,117,red blood cell,13689,1.0,1.0
73834,/images/3eba916c-998b-40a7-993c-7ed916c2a04c.png,262,1235,358,1346,96,111,red blood cell,10656,1.15625,0.8648648648648649
8914,/images/04628a94-b674-469b-aff6-b476b70df87d.png,260,1199,382,1323,122,124,red blood cell,15128,1.0163934426229508,0.9838709677419355
42003,/images/46a03374-64c7-49ac-81c9-c3d62542bbf3.png,448,722,546,818,98,96,red blood cell,9408,0.9795918367346939,1.0208333333333333
8146,/images/694222bb-cddf-469a-9526-f873c6fba58e.png,402,556,485,635,83,79,red blood cell,6557,0.9518072289156626,1.0506329113924051
39172,/images/2aeb7b85-7df9-4a63-8d37-2eecaaa190e7.png,662,1132,769,1253,107,121,red blood cell,12947,1.1308411214953271,0.8842975206611571
56544,/images/ac8df764-c8d8-4312-916d-70bfb37574b4.png,349,1336,474,1446,125,110,red blood cell,13750,0.88,1.1363636363636365
67720,/images/2b128a1a-95ed-408b-b9f8-8795cc814d80.png,659,1503,748,1585,89,82,red blood cell,7298,0.9213483146067416,1.0853658536585367
26349,/images/ef1419e0-3a3a-458a-b3b2-7efddac50404.png,160,1360,279,1481,119,121,red blood cell,14399,1.0168067226890756,0.9834710743801653
320,/images/0dcca702-a4ef-4fb3-a940-9c0c140b21c7.png,227,575,329,680,102,105,red blood cell,10710,1.0294117647058822,0.9714285714285714
8912,/images/04628a94-b674-469b-aff6-b476b70df87d.png,351,503,466,623,115,120,red blood cell,13800,1.0434782608695652,0.9583333333333334
42903,/images/7d4c2160-317f-48d1-a60a-788ec300b3e8.png,838,915,947,1009,109,94,red blood cell,10246,0.8623853211009175,1.1595744680851063
56120,/images/50d9fc90-8642-4bb6-91a7-0069a7e37392.png,551,961,659,1082,108,121,red blood cell,13068,1.1203703703703705,0.8925619834710744
44910,/images/83ec8923-6232-40d7-ba1f-a1b8bf7cb66c.png,353,1493,442,1580,89,87,red blood cell,7743,0.9775280898876404,1.0229885057471264
76121,/images/16244280-6c74-47d3-b544-9fd6831a6bf9.png,689,1347,786,1445,97,98,red blood cell,9506,1.0103092783505154,0.9897959183673469
4694,/images/b91b1641-ee06-44d8-94cc-24cdb583cc37.png,575,704,716,828,141,124,red blood cell,17484,0.8794326241134752,1.1370967741935485
79480,/images/a2fc0093-8645-43c7-bdee-ec8ca9484815.png,330,701,422,800,92,99,red blood cell,9108,1.076086956521739,0.9292929292929293
39459,/images/5a631871-2fc7-4a68-9c39-f3b9a0bf4a04.png,329,389,432,494,103,105,red blood cell,10815,1.0194174757281553,0.9809523809523809
33611,/images/00c8364b-8c85-4502-bcfe-64736fe76815.png,166,600,281,709,115,109,red blood cell,12535,0.9478260869565217,1.055045871559633
23154,/images/c94a5851-b846-4fde-8c89-05bec3a8ac53.png,1071,1036,1194,1158,123,122,red blood cell,15006,0.991869918699187,1.0081967213114753
75647,/images/50d7c6c9-3230-48fe-947c-7dcfd0aad710.png,1087,693,1187,797,100,104,red blood cell,10400,1.04,0.9615384615384616
14689,/images/4e2873dd-651e-4ecc-ac70-7335cf21a469.png,14,728,118,857,104,129,red blood cell,13416,1.2403846153846154,0.8062015503875969
17074,/images/883b726a-f61c-4382-9f1b-2fff302beba6.png,95,655,228,791,133,136,red blood cell,18088,1.0225563909774436,0.9779411764705882
18725,/images/f6f8a69a-3fd2-4684-ac77-3e83ea0fb36d.png,940,873,1066,990,126,117,red blood cell,14742,0.9285714285714286,1.0769230769230769
74301,/images/8939e14b-fcdf-48b1-acb9-6514a2fc2fc0.png,261,1443,352,1544,91,101,red blood cell,9191,1.10989010989011,0.900990099009901
68839,/images/aa3ad405-828e-4986-8251-20fd981f34d3.png,463,1320,567,1433,104,113,red blood cell,11752,1.0865384615384615,0.9203539823008849
77534,/images/2d2e81f3-e329-4765-9ba1-2c95f12dc9f3.png,489,288,584,386,95,98,red blood cell,9310,1.0315789473684212,0.9693877551020408
11163,/images/6303f964-98ef-47c6-bb2d-283aa393f918.png,953,393,1053,509,100,116,red blood cell,11600,1.16,0.8620689655172413
65173,/images/5e042380-6ef2-496f-8231-0ca550fbfa71.png,657,32,743,113,86,81,red blood cell,6966,0.9418604651162791,1.0617283950617284
46662,/images/da111ca5-520f-4ea8-97ad-ae5fce58ee91.png,1052,1117,1155,1223,103,106,red blood cell,10918,1.029126213592233,0.9716981132075472
56128,/images/50d9fc90-8642-4bb6-91a7-0069a7e37392.png,1009,701,1107,803,98,102,red blood cell,9996,1.0408163265306123,0.9607843137254902
4814,/images/3fa1a4e3-c80d-49da-8f7b-a1abb0424f48.png,349,1356,439,1442,90,86,red blood cell,7740,0.9555555555555556,1.0465116279069768
57126,/images/7d041c38-11f2-4186-8a24-29d7d0f5c3cf.png,244,527,342,621,98,94,red blood cell,9212,0.9591836734693877,1.0425531914893618
10874,/images/b78b88f0-154a-4b54-8aaf-85d37a42a0f9.png,599,597,708,715,109,118,red blood cell,12862,1.0825688073394495,0.923728813559322
63955,/images/5e974892-0ebe-4037-8427-ea8616d6d3b8.png,68,827,153,930,85,103,red blood cell,8755,1.2117647058823529,0.8252427184466019
53969,/images/540a5fee-175b-4b92-bf62-1ea9b59c86c6.png,219,2,306,92,87,90,red blood cell,7830,1.0344827586206897,0.9666666666666667
39213,/images/2aeb7b85-7df9-4a63-8d37-2eecaaa190e7.png,364,640,471,768,107,128,red blood cell,13696,1.1962616822429906,0.8359375
25570,/images/f6ab936d-924b-4038-aa47-71b07c26b4e2.png,559,1131,668,1246,109,115,red blood cell,12535,1.055045871559633,0.9478260869565217
25193,/images/90171428-f208-428a-b40e-f57ee3bea457.png,774,770,875,890,101,120,red blood cell,12120,1.188118811881188,0.8416666666666667
52624,/images/a6fe423a-5204-4378-bcfa-d6d298a3e9aa.png,800,667,926,780,126,113,red blood cell,14238,0.8968253968253969,1.1150442477876106
78340,/images/24115f58-a7d6-4022-a95a-86b515a78d3e.png,28,854,150,955,122,101,red blood cell,12322,0.8278688524590164,1.2079207920792079
45328,/images/e4eea7ea-8989-46a9-9c98-25a178146b28.png,920,1255,1047,1372,127,117,red blood cell,14859,0.9212598425196851,1.0854700854700854
64931,/images/dec61ae1-5037-4c3a-8952-15371becca7d.png,293,1067,388,1159,95,92,red blood cell,8740,0.968421052631579,1.0326086956521738
51206,/images/ad8731b7-0dae-4983-9dc6-dec31767d761.png,898,134,1011,244,113,110,red blood cell,12430,0.9734513274336283,1.0272727272727273
29427,/images/b4e5e08d-6427-46f3-aca8-a4df165a151d.png,449,1350,556,1449,107,99,red blood cell,10593,0.9252336448598131,1.0808080808080809
20117,/images/81a2748d-51c9-4439-995d-f747871d6544.png,911,612,1030,748,119,136,red blood cell,16184,1.1428571428571428,0.875
47452,/images/f7231477-f2c1-439a-9c8b-204de07686a4.png,1030,1097,1129,1209,99,112,red blood cell,11088,1.1313131313131313,0.8839285714285714
2501,/images/a23f5539-bfe6-4885-9a0e-dba972475ea9.png,339,1110,447,1215,108,105,red blood cell,11340,0.9722222222222222,1.0285714285714285
50834,/images/db0a1123-0b35-48d7-8337-3b1ebd6af0cc.png,482,2,608,105,126,103,red blood cell,12978,0.8174603174603174,1.2233009708737863
31816,/images/63ed5931-d93e-4f9b-a6f3-152713cb560e.png,576,728,680,831,104,103,red blood cell,10712,0.9903846153846154,1.0097087378640777
14293,/images/95bea542-6cd0-41c5-82c5-509af8c3b505.png,109,1454,221,1576,112,122,red blood cell,13664,1.0892857142857142,0.9180327868852459
46113,/images/72088c26-d2dd-4906-b791-b8947fc7fbe4.png,896,9,1001,117,105,108,red blood cell,11340,1.0285714285714285,0.9722222222222222
57294,/images/aaade430-4c49-4038-97b7-f8cdd937db57.png,419,107,519,209,100,102,red blood cell,10200,1.02,0.9803921568627451
4066,/images/e02edd82-c424-4dee-98a7-575640655d9b.png,438,699,554,795,116,96,red blood cell,11136,0.8275862068965517,1.2083333333333333
39743,/images/56adbb1e-96a8-40a5-a5a2-243c97ea889b.png,121,0,232,108,111,108,red blood cell,11988,0.972972972972973,1.0277777777777777
4931,/images/755e5bf8-e8e1-492b-a32f-f7d87cccaa40.png,49,1316,160,1439,111,123,red blood cell,13653,1.1081081081081081,0.9024390243902439
74337,/images/8939e14b-fcdf-48b1-acb9-6514a2fc2fc0.png,654,1385,729,1475,75,90,red blood cell,6750,1.2,0.8333333333333334
49123,/images/df3d98b9-3dd7-4107-8d4a-ae1b7f247793.png,626,1495,711,1598,85,103,red blood cell,8755,1.2117647058823529,0.8252427184466019
42191,/images/b618e87e-6059-496f-b0f6-e158f676a1fb.png,966,484,1073,584,107,100,red blood cell,10700,0.9345794392523364,1.07
53437,/images/766d5547-8dd2-4c8d-b78e-3007f83932e8.png,857,62,945,143,88,81,red blood cell,7128,0.9204545454545454,1.0864197530864197
54045,/images/d9345456-b76d-46cc-b81e-46d4a0a7b652.png,184,74,284,183,100,109,red blood cell,10900,1.09,0.9174311926605505
22680,/images/4ab47131-c2ac-461f-b95c-ac19ce24edbd.png,1072,827,1186,947,114,120,red blood cell,13680,1.0526315789473684,0.95
35039,/images/67582df6-bf13-4c83-a531-1214692b70de.png,771,1246,900,1378,129,132,red blood cell,17028,1.0232558139534884,0.9772727272727273
65047,/images/ff3b9d4d-373c-48ef-a75a-d23e2c2ade87.png,728,1387,828,1475,100,88,red blood cell,8800,0.88,1.1363636363636365
23695,/images/79d7a014-21ff-40f1-9ac4-a69839390654.png,908,55,990,142,82,87,red blood cell,7134,1.0609756097560976,0.9425287356321839
71432,/images/bcb447c9-5d37-414f-a513-d7076b04a532.png,224,827,325,921,101,94,red blood cell,9494,0.9306930693069307,1.074468085106383
25565,/images/f6ab936d-924b-4038-aa47-71b07c26b4e2.png,692,80,813,208,121,128,red blood cell,15488,1.0578512396694215,0.9453125
39107,/images/7bde7de1-889b-4218-b0e1-e2c04f6a7986.png,500,148,610,280,110,132,red blood cell,14520,1.2,0.8333333333333334
76192,/images/07a96126-482e-4beb-b42a-0cb59e505372.png,599,1435,719,1541,120,106,red blood cell,12720,0.8833333333333333,1.1320754716981132
18643,/images/c22f7031-9cf8-48ce-b03b-1b12d0db4951.png,178,964,265,1067,87,103,red blood cell,8961,1.1839080459770115,0.8446601941747572
70205,/images/b338766f-19b9-4874-bcc5-ae22b3c533e6.png,822,1390,922,1480,100,90,red blood cell,9000,0.9,1.1111111111111112
30501,/images/5955289d-19e5-45ef-a012-c8ea08ef45e2.png,243,444,354,547,111,103,red blood cell,11433,0.9279279279279279,1.0776699029126213
23493,/images/6fb707b1-5c07-479f-8385-5404bf5747b0.png,567,876,690,991,123,115,red blood cell,14145,0.9349593495934959,1.0695652173913044
76613,/images/4184a235-d209-4151-86e9-6c77e7938dab.png,374,658,476,761,102,103,red blood cell,10506,1.0098039215686274,0.9902912621359223
15757,/images/64113b22-03b1-4ab8-89ab-b2f32154fbbd.png,248,25,358,148,110,123,red blood cell,13530,1.1181818181818182,0.8943089430894309
38731,/images/b426ef1d-4a59-4f90-b593-50226af60a60.png,130,362,251,479,121,117,red blood cell,14157,0.9669421487603306,1.0341880341880343
78296,/images/24115f58-a7d6-4022-a95a-86b515a78d3e.png,382,863,494,967,112,104,red blood cell,11648,0.9285714285714286,1.0769230769230769
71041,/images/59daa25e-85d6-42f2-8f39-cc9f9d5d252e.png,182,1016,287,1113,105,97,red blood cell,10185,0.9238095238095239,1.0824742268041236
76325,/images/3dad6483-ac30-4d2b-b045-9f24fe6ff75e.png,879,1277,981,1375,102,98,red blood cell,9996,0.9607843137254902,1.0408163265306123
52809,/images/0a747cb3-c720-4572-a661-ab5670a5c42e.png,455,242,571,360,116,118,red blood cell,13688,1.0172413793103448,0.9830508474576272
49667,/images/9842445c-5899-4189-9f2e-3a3a179fdad3.png,948,982,1074,1105,126,123,red blood cell,15498,0.9761904761904762,1.024390243902439
68827,/images/aa3ad405-828e-4986-8251-20fd981f34d3.png,929,967,1020,1058,91,91,red blood cell,8281,1.0,1.0
65473,/images/da49db57-0c2f-4213-b322-c88c19fb9296.png,297,411,409,522,112,111,red blood cell,12432,0.9910714285714286,1.009009009009009
69357,/images/2ac343e4-c889-47c1-8fe2-461b626def76.png,768,548,904,667,136,119,red blood cell,16184,0.875,1.1428571428571428
69021,/images/b5246b58-6f40-4c9e-8024-f49b0ed6bdbd.png,237,835,334,940,97,105,red blood cell,10185,1.0824742268041236,0.9238095238095239
20855,/images/c2ec116f-f091-422c-926c-70b548a8f6ef.png,393,1457,488,1556,95,99,red blood cell,9405,1.0421052631578946,0.9595959595959596
23003,/images/b687c30d-cf15-445c-b3f6-5aca86584708.png,925,395,1033,513,108,118,red blood cell,12744,1.0925925925925926,0.9152542372881356
19085,/images/6e39fb0a-aa41-4b16-b783-7589e97bf289.png,1069,486,1200,596,131,110,red blood cell,14410,0.8396946564885496,1.190909090909091
66819,/images/9106a6bb-1352-411f-ac26-0d6fe48c16a8.png,894,241,992,349,98,108,red blood cell,10584,1.1020408163265305,0.9074074074074074
75032,/images/9147a21d-0de2-4c04-88da-b788311696ac.png,564,550,696,656,132,106,red blood cell,13992,0.803030303030303,1.2452830188679245
15205,/images/3a8f468f-f9de-46a8-a7c8-f2be239fa207.png,1045,117,1148,208,103,91,red blood cell,9373,0.883495145631068,1.1318681318681318
3241,/images/96596a68-8c95-43f3-b74e-e9506c235144.png,57,637,165,753,108,116,red blood cell,12528,1.0740740740740742,0.9310344827586207
33614,/images/00c8364b-8c85-4502-bcfe-64736fe76815.png,87,94,182,200,95,106,red blood cell,10070,1.1157894736842104,0.8962264150943396
65457,/images/b523daee-317b-461d-bdc1-07b4add4d488.png,14,267,103,362,89,95,red blood cell,8455,1.0674157303370786,0.9368421052631579
53056,/images/69b5b3de-ec64-4e5d-bcc2-44f495e06e76.png,679,738,787,850,108,112,red blood cell,12096,1.037037037037037,0.9642857142857143
5007,/images/b7d0ae11-a393-4aec-8f68-6ba07147f78a.png,18,254,130,368,112,114,red blood cell,12768,1.0178571428571428,0.9824561403508771
7410,/images/76dbce7f-dc3e-4a29-b1fe-ab9dce583080.png,848,155,970,273,122,118,red blood cell,14396,0.9672131147540983,1.0338983050847457
57994,/images/7942691b-6376-4c75-ae8a-ddf65454dcb2.png,54,889,185,1023,131,134,red blood cell,17554,1.0229007633587786,0.9776119402985075
36045,/images/ca9626bc-21a4-46f4-ba94-e7ee7a4cf735.png,737,467,839,587,102,120,red blood cell,12240,1.1764705882352942,0.85
43821,/images/c84edeb4-311c-4e82-88f9-ae0505b3ad13.png,376,1390,501,1512,125,122,red blood cell,15250,0.976,1.0245901639344261
37841,/images/56a57a8d-c9b9-432a-a3b0-32a09355806c.png,860,1111,963,1213,103,102,red blood cell,10506,0.9902912621359223,1.0098039215686274
14919,/images/3090a362-1f3d-49e9-a76e-ce76ff9c2276.png,699,1303,796,1410,97,107,red blood cell,10379,1.1030927835051547,0.9065420560747663
77493,/images/a11ed7d0-12f6-468f-abad-5cba7d968123.png,524,1127,625,1223,101,96,red blood cell,9696,0.9504950495049505,1.0520833333333333
32939,/images/d1924af6-7512-4ccc-9c6b-adbbaa8db41f.png,522,68,649,194,127,126,red blood cell,16002,0.9921259842519685,1.007936507936508
16506,/images/1315c2a4-0794-4dfa-a709-e2451723d2b6.png,399,1191,530,1328,131,137,red blood cell,17947,1.0458015267175573,0.9562043795620438
62055,/images/7f528918-27d4-421f-ab57-0cf9c693e697.png,579,1268,702,1397,123,129,red blood cell,15867,1.048780487804878,0.9534883720930233
15767,/images/64113b22-03b1-4ab8-89ab-b2f32154fbbd.png,599,156,704,263,105,107,red blood cell,11235,1.019047619047619,0.9813084112149533
32019,/images/b8a4d467-c40c-4ebf-91dd-1c19d0f2a7ae.png,1074,36,1167,136,93,100,red blood cell,9300,1.075268817204301,0.93
14492,/images/458cb2e9-5a7f-437c-ac5d-a56f98a3efdf.png,739,848,836,955,97,107,red blood cell,10379,1.1030927835051547,0.9065420560747663
30315,/images/cecbf663-0751-4e7f-b298-770c88afc2c1.png,816,1359,917,1481,101,122,red blood cell,12322,1.2079207920792079,0.8278688524590164
52348,/images/a86e0647-ae41-4b75-9d45-dd58f5ea65f5.png,215,1293,343,1426,128,133,red blood cell,17024,1.0390625,0.9624060150375939
20069,/images/ebfd9f67-138e-49f0-9cef-a0352069eedb.png,326,812,439,930,113,118,red blood cell,13334,1.0442477876106195,0.9576271186440678
44539,/images/419309ef-da3f-4424-93cf-01ff4c52b017.png,656,545,762,655,106,110,red blood cell,11660,1.0377358490566038,0.9636363636363636
26059,/images/71925778-a26e-483e-a07c-f3aaf740122a.png,22,1295,150,1427,128,132,red blood cell,16896,1.03125,0.9696969696969697
76469,/images/34df8890-272d-423a-ae78-ff8d068d3306.png,234,899,321,981,87,82,red blood cell,7134,0.9425287356321839,1.0609756097560976
3345,/images/b1100ae1-0ac8-4fc2-b0ff-8819f7fbe724.png,1085,521,1194,647,109,126,red blood cell,13734,1.1559633027522935,0.8650793650793651
4165,/images/ac3358f1-ef9a-4ccc-b66c-da5e47e352e0.png,448,873,578,985,130,112,red blood cell,14560,0.8615384615384616,1.1607142857142858
48101,/images/05717db9-f1ef-4101-a9f7-7a007e83b1c9.png,135,68,238,177,103,109,red blood cell,11227,1.058252427184466,0.944954128440367
32626,/images/ed0d8763-e734-4506-b61b-53fc32a8d8c9.png,446,68,564,191,118,123,red blood cell,14514,1.0423728813559323,0.959349593495935
45013,/images/13bab3c3-3f79-44d9-a287-0ae6d71eff31.png,908,24,1001,124,93,100,red blood cell,9300,1.075268817204301,0.93
17065,/images/57e1879e-4294-45e7-9c1b-627e8cca0271.png,839,1454,941,1574,102,120,red blood cell,12240,1.1764705882352942,0.85
38953,/images/5939f341-a886-4f63-ae87-2219d000a1d4.png,160,1365,272,1476,112,111,red blood cell,12432,0.9910714285714286,1.009009009009009
30343,/images/4aad9589-6b32-4522-bcd7-ca04687a02ca.png,56,581,157,686,101,105,red blood cell,10605,1.0396039603960396,0.9619047619047619
30925,/images/533c47c9-02a6-419b-961b-81797f022f6c.png,916,349,1019,453,103,104,red blood cell,10712,1.0097087378640777,0.9903846153846154
71464,/images/191071ab-6515-428c-9f05-8e4309542b75.png,200,97,301,192,101,95,red blood cell,9595,0.9405940594059405,1.063157894736842
72820,/images/31435107-c77d-42f8-a619-75cba6a5161b.png,556,1278,673,1394,117,116,red blood cell,13572,0.9914529914529915,1.0086206896551724
74640,/images/5ccca8ee-abea-458a-a891-bedd31c3ddc3.png,528,116,648,219,120,103,red blood cell,12360,0.8583333333333333,1.1650485436893203
38186,/images/452ab003-ced5-40cb-82d1-5495d9e068b1.png,756,1107,869,1227,113,120,red blood cell,13560,1.0619469026548674,0.9416666666666667
15384,/images/035f6c4b-0897-46ab-9c3b-5f3b0feff043.png,395,256,503,366,108,110,red blood cell,11880,1.0185185185185186,0.9818181818181818
22040,/images/c5acd0ad-b0f2-478d-b0ad-5aa733aa7b32.png,712,1349,821,1451,109,102,red blood cell,11118,0.9357798165137615,1.0686274509803921
43857,/images/c84edeb4-311c-4e82-88f9-ae0505b3ad13.png,11,109,124,240,113,131,red blood cell,14803,1.1592920353982301,0.8625954198473282
58560,/images/7fd2d254-b062-4f3d-8970-687e73c5a00a.png,251,1036,360,1146,109,110,red blood cell,11990,1.0091743119266054,0.990909090909091
60659,/images/724e0c34-32cd-41f1-ae37-586038bc67ab.png,1082,1350,1161,1428,79,78,red blood cell,6162,0.9873417721518988,1.0128205128205128
35454,/images/3722d213-f2a9-46d5-aa76-9183b443e455.png,1023,920,1130,1033,107,113,red blood cell,12091,1.0560747663551402,0.9469026548672567
10918,/images/1380f9b4-bf54-4492-90c3-743c7aa8898b.png,317,658,419,773,102,115,red blood cell,11730,1.1274509803921569,0.8869565217391304
45375,/images/e4eea7ea-8989-46a9-9c98-25a178146b28.png,301,959,414,1077,113,118,red blood cell,13334,1.0442477876106195,0.9576271186440678
20519,/images/cbde7f7e-2458-4dda-9db2-3d5ccf950ced.png,472,1429,577,1538,105,109,red blood cell,11445,1.0380952380952382,0.963302752293578
17579,/images/e80bad38-66d0-473e-85dd-92142dba37e6.png,292,946,427,1061,135,115,red blood cell,15525,0.8518518518518519,1.173913043478261
65668,/images/397f37bc-a3a4-4257-9430-c8fc5716f8b1.png,1024,1073,1116,1179,92,106,red blood cell,9752,1.1521739130434783,0.8679245283018868
61392,/images/e16c0dab-780d-4035-872e-1bb91e49f9d2.png,398,969,501,1062,103,93,red blood cell,9579,0.9029126213592233,1.10752688172043
68664,/images/31653d0f-c4e6-4e12-8005-518c2de34687.png,437,316,542,413,105,97,red blood cell,10185,0.9238095238095239,1.0824742268041236
37414,/images/08f5a524-0554-49c2-83a8-ae9a6d51e8fd.png,103,1093,196,1191,93,98,red blood cell,9114,1.053763440860215,0.9489795918367347
80015,/images/38d1b930-dd97-4248-9160-e9389a1a8dd7.png,162,158,273,275,111,117,red blood cell,12987,1.054054054054054,0.9487179487179487
26082,/images/71925778-a26e-483e-a07c-f3aaf740122a.png,3,52,119,167,116,115,red blood cell,13340,0.9913793103448276,1.008695652173913
19689,/images/627d6331-7bb9-4d1a-b20d-e6541af4d0f9.png,716,263,820,366,104,103,red blood cell,10712,0.9903846153846154,1.0097087378640777
54099,/images/d9345456-b76d-46cc-b81e-46d4a0a7b652.png,380,690,469,772,89,82,red blood cell,7298,0.9213483146067416,1.0853658536585367
78829,/images/19979a60-df80-4111-bf69-81a7e9c4dd0b.png,941,32,1057,149,116,117,red blood cell,13572,1.0086206896551724,0.9914529914529915
74512,/images/cbb58718-6319-48db-b84b-78ac9b12ff89.png,116,219,216,318,100,99,red blood cell,9900,0.99,1.0101010101010102
20115,/images/81a2748d-51c9-4439-995d-f747871d6544.png,279,404,405,515,126,111,red blood cell,13986,0.8809523809523809,1.135135135135135
58252,/images/319c9c52-f316-49f3-baad-4444ab19f85b.png,448,1125,542,1231,94,106,red blood cell,9964,1.127659574468085,0.8867924528301887
61221,/images/0da07970-3146-479c-8a07-f61ed32814a9.png,554,935,667,1053,113,118,red blood cell,13334,1.0442477876106195,0.9576271186440678
30164,/images/a1669b59-fe09-4fe6-ba9f-06bec6725502.png,884,1130,988,1229,104,99,red blood cell,10296,0.9519230769230769,1.0505050505050506
9884,/images/b4261fa5-876d-48ea-b6da-ec7ca5b48fe2.png,820,776,917,872,97,96,red blood cell,9312,0.9896907216494846,1.0104166666666667
72753,/images/caeb2d62-1166-43f0-8eac-5b8fc48f02eb.png,76,1364,194,1480,118,116,red blood cell,13688,0.9830508474576272,1.0172413793103448
16020,/images/7e25ced3-5caf-47f8-ad0c-42946bd4468b.png,907,549,1026,654,119,105,red blood cell,12495,0.8823529411764706,1.1333333333333333
47851,/images/ab27173b-6e30-4957-bd68-29194328fd39.png,445,1419,548,1535,103,116,red blood cell,11948,1.1262135922330097,0.8879310344827587
45849,/images/7db1373d-5bbf-47e6-ab40-30cba7678745.png,976,383,1075,478,99,95,red blood cell,9405,0.9595959595959596,1.0421052631578946
38624,/images/3b601a1b-26d8-4873-afcf-fdd1b1e0010c.png,520,681,622,790,102,109,red blood cell,11118,1.0686274509803921,0.9357798165137615
35649,/images/45f18ac0-f097-4b20-a99d-8837cf488822.png,182,41,301,177,119,136,red blood cell,16184,1.1428571428571428,0.875
22099,/images/ac4d6507-d710-497b-ad7c-e0dd75c1d06d.png,798,793,930,910,132,117,red blood cell,15444,0.8863636363636364,1.1282051282051282
67071,/images/4272cbd7-5b0a-4bf7-b690-dee1c128f07b.png,632,540,726,641,94,101,red blood cell,9494,1.074468085106383,0.9306930693069307
20849,/images/c2ec116f-f091-422c-926c-70b548a8f6ef.png,368,396,462,493,94,97,red blood cell,9118,1.0319148936170213,0.9690721649484536
35775,/images/bb2042c5-35e1-43cc-8171-7de81b764361.png,91,676,191,780,100,104,red blood cell,10400,1.04,0.9615384615384616
3686,/images/dacf7e3f-1d8c-42a0-8539-3abe3971c956.png,685,894,802,1010,117,116,red blood cell,13572,0.9914529914529915,1.0086206896551724
44606,/images/6388e241-09a2-4fbe-a712-07d8fe714c51.png,809,1485,926,1599,117,114,red blood cell,13338,0.9743589743589743,1.0263157894736843
41668,/images/0fcd1ebe-ee4a-40a0-b787-29cee18bfa1b.png,795,1438,891,1516,96,78,red blood cell,7488,0.8125,1.2307692307692308
20703,/images/e6d7c5e1-43fc-4712-86d5-aa70252b978f.png,630,262,772,381,142,119,red blood cell,16898,0.8380281690140845,1.1932773109243697
16882,/images/4823c1fe-a7f9-4b92-959f-0d9be09cd14b.png,690,186,772,269,82,83,red blood cell,6806,1.0121951219512195,0.9879518072289156
2186,/images/e94a811d-3145-4313-ba42-2d5ed283179f.png,461,64,554,167,93,103,red blood cell,9579,1.10752688172043,0.9029126213592233
60781,/images/645cd195-af50-409f-8da9-6e7c7f18ea09.png,439,851,555,961,116,110,red blood cell,12760,0.9482758620689655,1.0545454545454545
52614,/images/a6fe423a-5204-4378-bcfa-d6d298a3e9aa.png,633,1429,756,1545,123,116,red blood cell,14268,0.943089430894309,1.0603448275862069
37767,/images/fe0c5e48-f65e-488c-9c3c-1ea7c7835c0c.png,517,1062,641,1195,124,133,red blood cell,16492,1.0725806451612903,0.9323308270676691
20201,/images/bb337c84-f727-42a5-9c3d-934323a16c6a.png,307,40,441,169,134,129,red blood cell,17286,0.9626865671641791,1.0387596899224807
42105,/images/46a03374-64c7-49ac-81c9-c3d62542bbf3.png,629,880,716,976,87,96,red blood cell,8352,1.103448275862069,0.90625
54399,/images/22a464ef-c3da-4d56-b37e-e22e95d945e7.png,216,606,314,695,98,89,red blood cell,8722,0.9081632653061225,1.101123595505618
34724,/images/6294153c-6db3-4f2b-a8ff-9c087225e737.png,863,106,969,211,106,105,red blood cell,11130,0.9905660377358491,1.0095238095238095
50277,/images/3d32a988-449d-4d58-b71f-abbfdc3f2fbc.png,786,641,886,753,100,112,red blood cell,11200,1.12,0.8928571428571429
27895,/images/948c94ad-395c-41f4-9a68-8a1dcb76888c.png,0,7,107,118,107,111,red blood cell,11877,1.0373831775700935,0.963963963963964
47784,/images/5a105b89-c592-4d78-b208-7db6c6572752.png,1031,399,1150,499,119,100,red blood cell,11900,0.8403361344537815,1.19
45504,/images/94b5a9a1-1c88-4400-aca4-3d56f543fc4a.png,641,116,751,225,110,109,red blood cell,11990,0.990909090909091,1.0091743119266054
59939,/images/f0fe292d-85ae-4c3a-a676-037dde2594e6.png,652,1378,773,1502,121,124,red blood cell,15004,1.024793388429752,0.9758064516129032
76059,/images/4c7d2382-a962-4237-a053-955eea3decd8.png,264,627,368,731,104,104,red blood cell,10816,1.0,1.0
4546,/images/0f26699f-a776-4424-b092-27da9a1d12e2.png,948,928,1035,1028,87,100,red blood cell,8700,1.1494252873563218,0.87
53541,/images/43158031-a335-4533-9c20-48bebba90123.png,198,1135,282,1237,84,102,red blood cell,8568,1.2142857142857142,0.8235294117647058
68315,/images/0f735cca-051c-4048-a1fa-cb36f389e12f.png,116,411,233,539,117,128,red blood cell,14976,1.0940170940170941,0.9140625
43009,/images/6c7095cd-ab6b-4f53-bd94-905d0cc95840.png,472,114,572,216,100,102,red blood cell,10200,1.02,0.9803921568627451
77362,/images/3ff98212-7c2a-46cd-afb7-34a2479bed07.png,147,1337,242,1438,95,101,red blood cell,9595,1.063157894736842,0.9405940594059405
32891,/images/e40000b4-1b26-42ce-909d-4715e04f0a6e.png,768,358,874,476,106,118,red blood cell,12508,1.1132075471698113,0.8983050847457628
37176,/images/befe6182-266b-4f8a-ac82-3a4154f05f60.png,958,1189,1065,1304,107,115,red blood cell,12305,1.074766355140187,0.9304347826086956
41960,/images/46a03374-64c7-49ac-81c9-c3d62542bbf3.png,650,688,769,798,119,110,red blood cell,13090,0.9243697478991597,1.0818181818181818
24981,/images/ed0bee2f-05e0-4392-8357-19750cec577c.png,169,1492,263,1595,94,103,red blood cell,9682,1.0957446808510638,0.912621359223301
36716,/images/21f001d6-f568-4ea4-82da-fab54c77c419.png,1067,1026,1179,1127,112,101,red blood cell,11312,0.9017857142857143,1.108910891089109
75336,/images/9ec1dcec-87c2-4aca-8e6b-0db3cd05509c.png,67,52,165,137,98,85,red blood cell,8330,0.8673469387755102,1.1529411764705881
49740,/images/5e17f8e6-fd8d-426c-b444-1515d14f04b7.png,470,504,588,612,118,108,red blood cell,12744,0.9152542372881356,1.0925925925925926
48608,/images/55836297-fc8e-4e00-9767-0d12b86e4604.png,860,1007,968,1122,108,115,red blood cell,12420,1.0648148148148149,0.9391304347826087
1522,/images/0ac747cd-ff32-49bf-bc1a-3e9b7702ce9c.png,1066,726,1176,834,110,108,red blood cell,11880,0.9818181818181818,1.0185185185185186
48995,/images/df3d98b9-3dd7-4107-8d4a-ae1b7f247793.png,395,703,491,795,96,92,red blood cell,8832,0.9583333333333334,1.0434782608695652
71319,/images/bcb447c9-5d37-414f-a513-d7076b04a532.png,691,912,785,1016,94,104,red blood cell,9776,1.1063829787234043,0.9038461538461539
57701,/images/5c037ffc-f515-48b3-b231-c110fbd2b8ca.png,729,915,834,1036,105,121,red blood cell,12705,1.1523809523809523,0.8677685950413223
37311,/images/4d88e2d2-5aad-410c-9bbc-702ee9496995.png,778,455,904,571,126,116,red blood cell,14616,0.9206349206349206,1.0862068965517242
44807,/images/6795acae-e84d-4e97-b9a1-b4f4f0a72cfd.png,635,349,738,464,103,115,red blood cell,11845,1.116504854368932,0.8956521739130435
21252,/images/0ceb4539-5c4c-487d-9826-452a88b5d537.png,217,475,308,580,91,105,red blood cell,9555,1.1538461538461537,0.8666666666666667
4172,/images/ac3358f1-ef9a-4ccc-b66c-da5e47e352e0.png,674,1141,786,1260,112,119,red blood cell,13328,1.0625,0.9411764705882353
73587,/images/7624ac36-1cf9-42fb-844d-376078309553.png,1077,1439,1182,1541,105,102,red blood cell,10710,0.9714285714285714,1.0294117647058822
63113,/images/d82c657e-5678-41da-9a6e-3ad29430b759.png,54,1441,158,1552,104,111,red blood cell,11544,1.0673076923076923,0.9369369369369369
44854,/images/83ec8923-6232-40d7-ba1f-a1b8bf7cb66c.png,462,64,569,156,107,92,red blood cell,9844,0.8598130841121495,1.1630434782608696
21577,/images/49efc89d-9cba-44f7-8257-7f911b73f68a.png,989,1009,1097,1118,108,109,red blood cell,11772,1.0092592592592593,0.9908256880733946
47887,/images/ab27173b-6e30-4957-bd68-29194328fd39.png,404,1160,513,1274,109,114,red blood cell,12426,1.0458715596330275,0.956140350877193
11544,/images/834a30bb-26bf-4e60-9ea1-3250b926892e.png,481,1121,567,1227,86,106,red blood cell,9116,1.2325581395348837,0.8113207547169812
16395,/images/e474a20b-2769-48f1-a520-4f6ef5a0dbf5.png,430,448,531,547,101,99,red blood cell,9999,0.9801980198019802,1.02020202020202
35540,/images/3e33ee12-ef02-4287-8318-7ad3b284a617.png,299,409,414,542,115,133,red blood cell,15295,1.1565217391304348,0.8646616541353384
20832,/images/c2ec116f-f091-422c-926c-70b548a8f6ef.png,561,1115,665,1214,104,99,red blood cell,10296,0.9519230769230769,1.0505050505050506
16104,/images/66557580-fd38-4d4b-80d8-88611ecc78c6.png,916,974,1043,1094,127,120,red blood cell,15240,0.9448818897637795,1.0583333333333333
45340,/images/e4eea7ea-8989-46a9-9c98-25a178146b28.png,611,567,693,656,82,89,red blood cell,7298,1.0853658536585367,0.9213483146067416
38768,/images/b426ef1d-4a59-4f90-b593-50226af60a60.png,886,1023,990,1138,104,115,red blood cell,11960,1.1057692307692308,0.9043478260869565
37693,/images/003a89b0-a095-417a-8dd6-f408339bbc68.png,13,1112,119,1231,106,119,red blood cell,12614,1.1226415094339623,0.8907563025210085
27164,/images/f232eec3-02c0-43f9-bf32-3e60245397e2.png,435,1154,556,1267,121,113,red blood cell,13673,0.9338842975206612,1.0707964601769913
75222,/images/61dfc937-a428-44b4-94fb-d682bdb8dff0.png,384,963,471,1050,87,87,red blood cell,7569,1.0,1.0
53125,/images/04a567df-5463-4043-81f1-d726223c19a9.png,176,699,267,781,91,82,red blood cell,7462,0.9010989010989011,1.1097560975609757
15646,/images/84d7545e-c3a8-4b1f-9a39-36aab78c8699.png,601,203,738,347,137,144,red blood cell,19728,1.051094890510949,0.9513888888888888
47661,/images/4b3a49bc-8536-4760-9553-440a6f64db37.png,488,1031,616,1144,128,113,red blood cell,14464,0.8828125,1.1327433628318584
17070,/images/57e1879e-4294-45e7-9c1b-627e8cca0271.png,886,1491,984,1600,98,109,red blood cell,10682,1.1122448979591837,0.8990825688073395
40358,/images/db249e5a-4142-432c-8288-bacd10d7273d.png,107,717,201,817,94,100,red blood cell,9400,1.0638297872340425,0.94
10012,/images/b9ccf7ca-953f-4832-9575-5e70b2a8c224.png,163,1159,257,1264,94,105,red blood cell,9870,1.1170212765957446,0.8952380952380953
79615,/images/a4409217-be11-4478-90a5-b406057d154d.png,417,944,512,1038,95,94,red blood cell,8930,0.9894736842105263,1.0106382978723405
44674,/images/8002cb71-0f25-4fa4-a46f-b49e5aeded0c.png,377,111,496,218,119,107,red blood cell,12733,0.8991596638655462,1.1121495327102804
10412,/images/46a2d369-4bea-4405-ac78-91bbe130b9a7.png,1051,324,1161,424,110,100,red blood cell,11000,0.9090909090909091,1.1
22951,/images/ecd68ba2-48af-4866-826a-7cd1c147c055.png,11,696,126,797,115,101,red blood cell,11615,0.8782608695652174,1.1386138613861385
32176,/images/25cfca07-2101-484f-b312-a927395f2651.png,24,835,149,963,125,128,red blood cell,16000,1.024,0.9765625
15283,/images/2d0f600d-f94e-4907-b712-52fb37d9ed52.png,431,114,534,224,103,110,red blood cell,11330,1.0679611650485437,0.9363636363636364
43770,/images/ef83ed4c-2724-4d5f-8abe-1a18d25cea35.png,1000,1122,1116,1231,116,109,red blood cell,12644,0.9396551724137931,1.0642201834862386
10685,/images/20d4f65e-6c63-433a-935c-d568d577967b.png,263,1303,359,1397,96,94,red blood cell,9024,0.9791666666666666,1.0212765957446808
55734,/images/c32b8bb8-c89d-4ae9-9c77-5b9356ca35a1.png,144,1396,272,1502,128,106,red blood cell,13568,0.828125,1.2075471698113207
58466,/images/5cac6ddf-c8c6-45de-bce0-a1db64b14fb5.png,564,110,667,206,103,96,red blood cell,9888,0.9320388349514563,1.0729166666666667
44903,/images/83ec8923-6232-40d7-ba1f-a1b8bf7cb66c.png,476,236,576,333,100,97,red blood cell,9700,0.97,1.0309278350515463
29090,/images/4c13e22e-dfd1-4fa1-b373-be9d0c272c0f.png,881,973,974,1081,93,108,red blood cell,10044,1.1612903225806452,0.8611111111111112
60196,/images/214f1d15-a081-476e-992d-6c3a77f03d59.png,428,338,511,413,83,75,red blood cell,6225,0.9036144578313253,1.1066666666666667
68250,/images/ff1b23d0-3cef-459b-b81f-39bfcdb6526f.png,817,196,896,287,79,91,red blood cell,7189,1.1518987341772151,0.8681318681318682
1494,/images/0ac747cd-ff32-49bf-bc1a-3e9b7702ce9c.png,749,925,852,1018,103,93,red blood cell,9579,0.9029126213592233,1.10752688172043
54601,/images/59dc7da9-35d1-421e-a61b-1e9637bfbfa1.png,73,1063,171,1172,98,109,red blood cell,10682,1.1122448979591837,0.8990825688073395
40006,/images/8271d0d8-9985-43eb-94b3-c702adca139f.png,745,356,857,453,112,97,red blood cell,10864,0.8660714285714286,1.1546391752577319
76631,/images/4184a235-d209-4151-86e9-6c77e7938dab.png,1,1280,94,1395,93,115,red blood cell,10695,1.2365591397849462,0.808695652173913
45326,/images/e4eea7ea-8989-46a9-9c98-25a178146b28.png,72,932,197,1035,125,103,red blood cell,12875,0.824,1.2135922330097086
1663,/images/5f783f43-0090-4f8a-bd75-9562f4aa2dd5.png,978,982,1089,1088,111,106,red blood cell,11766,0.954954954954955,1.0471698113207548
16435,/images/e474a20b-2769-48f1-a520-4f6ef5a0dbf5.png,740,1387,827,1484,87,97,red blood cell,8439,1.1149425287356323,0.8969072164948454
51784,/images/f07174a5-f799-4286-ac43-5b0f5c5777ac.png,1041,757,1148,858,107,101,red blood cell,10807,0.9439252336448598,1.0594059405940595
30928,/images/533c47c9-02a6-419b-961b-81797f022f6c.png,680,513,794,630,114,117,red blood cell,13338,1.0263157894736843,0.9743589743589743
41635,/images/0fcd1ebe-ee4a-40a0-b787-29cee18bfa1b.png,976,114,1068,212,92,98,red blood cell,9016,1.065217391304348,0.9387755102040817
21137,/images/fb05b297-180a-4171-b633-09d5616d7534.png,691,1028,801,1137,110,109,red blood cell,11990,0.990909090909091,1.0091743119266054
71156,/images/b666fcc2-d0b2-441e-bc5a-c660345eeb5d.png,0,1093,104,1209,104,116,red blood cell,12064,1.1153846153846154,0.896551724137931
18700,/images/f6f8a69a-3fd2-4684-ac77-3e83ea0fb36d.png,467,480,566,580,99,100,red blood cell,9900,1.0101010101010102,0.99
54022,/images/5e4f7425-11e6-4f9e-be2d-5a27deb9d1b4.png,497,639,616,747,119,108,red blood cell,12852,0.907563025210084,1.1018518518518519
2535,/images/a23f5539-bfe6-4885-9a0e-dba972475ea9.png,247,1150,351,1263,104,113,red blood cell,11752,1.0865384615384615,0.9203539823008849
62351,/images/e0ff3476-226f-4125-b182-8e524d5503dd.png,1019,949,1116,1061,97,112,red blood cell,10864,1.1546391752577319,0.8660714285714286
13790,/images/1b369bcf-ced4-4ae2-9196-2664bd2b1738.png,660,1461,780,1576,120,115,red blood cell,13800,0.9583333333333334,1.0434782608695652
50439,/images/a2de1248-7bc0-44dc-b508-70a357eedd68.png,546,759,657,873,111,114,red blood cell,12654,1.027027027027027,0.9736842105263158
45704,/images/584d62ed-4329-45dd-94ce-e929d8b2bb74.png,261,336,382,459,121,123,red blood cell,14883,1.0165289256198347,0.983739837398374
65864,/images/d7581cb0-7a12-471d-a3d8-68dcea362213.png,724,350,826,457,102,107,red blood cell,10914,1.0490196078431373,0.9532710280373832
19350,/images/a302a6fa-f635-4ade-b72b-b6f3c2a34ec9.png,977,1392,1079,1487,102,95,red blood cell,9690,0.9313725490196079,1.0736842105263158
74331,/images/8939e14b-fcdf-48b1-acb9-6514a2fc2fc0.png,0,521,99,624,99,103,red blood cell,10197,1.0404040404040404,0.9611650485436893
1203,/images/5ff7c0c8-d208-4e7d-958d-ca3c2260ff39.png,746,472,862,608,116,136,red blood cell,15776,1.1724137931034482,0.8529411764705882
30298,/images/cecbf663-0751-4e7f-b298-770c88afc2c1.png,281,435,382,537,101,102,red blood cell,10302,1.00990099009901,0.9901960784313726
28767,/images/686ed568-d5f8-475e-81ad-edab9dd473a0.png,995,371,1096,474,101,103,red blood cell,10403,1.0198019801980198,0.9805825242718447
34487,/images/fa1f9f89-cecb-4972-842c-d14c632f89a9.png,429,1431,549,1527,120,96,red blood cell,11520,0.8,1.25
66355,/images/fcdf6632-c03f-49a8-9fb3-42e87c99b9d0.png,323,668,431,766,108,98,red blood cell,10584,0.9074074074074074,1.1020408163265305
35983,/images/5836500a-221e-40ca-a8be-caaa37f7d300.png,231,918,334,1019,103,101,red blood cell,10403,0.9805825242718447,1.0198019801980198
47002,/images/9ebd623d-5534-4dd9-bff8-cdedf322db35.png,328,405,421,509,93,104,red blood cell,9672,1.118279569892473,0.8942307692307693
32286,/images/1c406ce1-023b-47fc-a2cd-5ea2e255de65.png,605,569,712,690,107,121,red blood cell,12947,1.1308411214953271,0.8842975206611571
8537,/images/dfc026a9-079f-4f45-8666-e0ccba5bb437.png,628,1093,755,1209,127,116,red blood cell,14732,0.9133858267716536,1.0948275862068966
78513,/images/c94827ce-d619-4705-a68a-df63a2c95ffa.png,1058,762,1155,874,97,112,red blood cell,10864,1.1546391752577319,0.8660714285714286
52993,/images/42e87148-a015-4148-923a-fb83016f64e7.png,675,1194,790,1303,115,109,red blood cell,12535,0.9478260869565217,1.055045871559633
28779,/images/686ed568-d5f8-475e-81ad-edab9dd473a0.png,972,1297,1077,1391,105,94,red blood cell,9870,0.8952380952380953,1.1170212765957446
73313,/images/67a4fb91-6f38-4ca2-8f20-6b2f5f1b29a7.png,1,671,88,755,87,84,red blood cell,7308,0.9655172413793104,1.0357142857142858
37330,/images/4d88e2d2-5aad-410c-9bbc-702ee9496995.png,786,765,896,886,110,121,red blood cell,13310,1.1,0.9090909090909091
50763,/images/db0a1123-0b35-48d7-8337-3b1ebd6af0cc.png,358,48,494,167,136,119,red blood cell,16184,0.875,1.1428571428571428
38175,/images/33bdb7b5-ad5b-4a73-bbc2-3350f8c2ac0c.png,929,571,1038,683,109,112,red blood cell,12208,1.0275229357798166,0.9732142857142857
7369,/images/89f10192-d3dd-4996-a571-4c851dbdc983.png,396,112,494,213,98,101,red blood cell,9898,1.030612244897959,0.9702970297029703
8681,/images/ea6b012a-3425-4bfc-a61d-88563aa2a264.png,437,669,548,780,111,111,red blood cell,12321,1.0,1.0
53680,/images/6f67a66b-56ec-4c36-ae7c-f250d3b86a23.png,650,1361,742,1463,92,102,red blood cell,9384,1.108695652173913,0.9019607843137255
72273,/images/ee57e743-a876-4f69-9fe5-bf5d01b44689.png,132,196,226,286,94,90,red blood cell,8460,0.9574468085106383,1.0444444444444445
74903,/images/dd090806-e4ac-4a78-b2ee-55a30626369c.png,224,152,322,246,98,94,red blood cell,9212,0.9591836734693877,1.0425531914893618
76652,/images/3317d733-ec0d-45e6-b631-40457392f343.png,376,915,486,1016,110,101,red blood cell,11110,0.9181818181818182,1.0891089108910892
19458,/images/361a3578-4cbb-422b-9e3c-b5e61395b12e.png,800,1236,919,1350,119,114,red blood cell,13566,0.957983193277311,1.043859649122807
64239,/images/2a91387a-d30f-418d-ac3a-f7cfa6836261.png,585,351,678,453,93,102,red blood cell,9486,1.096774193548387,0.9117647058823529
26642,/images/16ec6e1f-5020-40b3-ba26-51c340d03ee7.png,105,1405,223,1527,118,122,red blood cell,14396,1.0338983050847457,0.9672131147540983
65287,/images/24418314-f7a4-49fc-a03e-ec597ca6796e.png,836,1164,951,1269,115,105,red blood cell,12075,0.9130434782608695,1.0952380952380953
17318,/images/3d302619-473d-4c5b-af43-8833ff94233f.png,543,100,644,193,101,93,red blood cell,9393,0.9207920792079208,1.086021505376344
67174,/images/be6fe358-dee1-4dcf-9b0d-5d8612aba577.png,525,1093,647,1203,122,110,red blood cell,13420,0.9016393442622951,1.1090909090909091
41658,/images/0fcd1ebe-ee4a-40a0-b787-29cee18bfa1b.png,919,350,1006,432,87,82,red blood cell,7134,0.9425287356321839,1.0609756097560976
50040,/images/b1145408-feae-4637-b4cf-3e70b99cc62d.png,426,1338,538,1451,112,113,red blood cell,12656,1.0089285714285714,0.9911504424778761
23894,/images/c17523c5-90a0-4a6b-9b33-2b4a6cf58d36.png,1079,92,1188,203,109,111,red blood cell,12099,1.018348623853211,0.9819819819819819
16513,/images/1315c2a4-0794-4dfa-a709-e2451723d2b6.png,446,412,569,546,123,134,red blood cell,16482,1.089430894308943,0.917910447761194
28899,/images/686ed568-d5f8-475e-81ad-edab9dd473a0.png,997,249,1093,354,96,105,red blood cell,10080,1.09375,0.9142857142857143
67208,/images/5f491efd-a21c-4a80-aaba-70b8876238ac.png,1043,893,1153,992,110,99,red blood cell,10890,0.9,1.1111111111111112
66315,/images/fcdf6632-c03f-49a8-9fb3-42e87c99b9d0.png,1011,268,1109,367,98,99,red blood cell,9702,1.010204081632653,0.98989898989899
78366,/images/24115f58-a7d6-4022-a95a-86b515a78d3e.png,322,973,432,1094,110,121,red blood cell,13310,1.1,0.9090909090909091
2502,/images/a23f5539-bfe6-4885-9a0e-dba972475ea9.png,781,1447,875,1538,94,91,red blood cell,8554,0.9680851063829787,1.032967032967033
62716,/images/9e1b0217-0926-4fd1-bb9e-a815c05deb59.png,506,286,617,408,111,122,red blood cell,13542,1.0990990990990992,0.9098360655737705
3020,/images/5a386082-397f-4524-a6f9-c2b8efe5014d.png,766,828,892,954,126,126,red blood cell,15876,1.0,1.0
1131,/images/edcb4d77-a4d3-465d-9b59-eb3087766b1c.png,428,58,522,165,94,107,red blood cell,10058,1.1382978723404256,0.8785046728971962
23018,/images/0d095f3a-9243-472b-90b4-0ce8309e778c.png,189,66,313,178,124,112,red blood cell,13888,0.9032258064516129,1.1071428571428572
60742,/images/645cd195-af50-409f-8da9-6e7c7f18ea09.png,474,273,576,369,102,96,red blood cell,9792,0.9411764705882353,1.0625
16759,/images/4823c1fe-a7f9-4b92-959f-0d9be09cd14b.png,459,562,546,667,87,105,red blood cell,9135,1.206896551724138,0.8285714285714286
70610,/images/4ce5a070-9ede-4bb1-9ca2-1bae5746776b.png,875,373,989,489,114,116,red blood cell,13224,1.0175438596491229,0.9827586206896551
18289,/images/9ca20b10-e2fd-4bd2-93ef-78298f763ed5.png,93,498,200,609,107,111,red blood cell,11877,1.0373831775700935,0.963963963963964
40507,/images/e3ade58d-086c-47fa-9120-76beacb45395.png,576,1461,680,1567,104,106,red blood cell,11024,1.0192307692307692,0.9811320754716981
62337,/images/e0ff3476-226f-4125-b182-8e524d5503dd.png,736,1336,834,1438,98,102,red blood cell,9996,1.0408163265306123,0.9607843137254902
60991,/images/5397d8e2-bb09-42e7-9861-65ffad0fe94e.png,998,1118,1131,1232,133,114,red blood cell,15162,0.8571428571428571,1.1666666666666667
48615,/images/55836297-fc8e-4e00-9767-0d12b86e4604.png,780,1141,878,1244,98,103,red blood cell,10094,1.0510204081632653,0.9514563106796117
2095,/images/f3bd0fcc-647d-4ca0-8c43-a16bd6ea3878.png,435,1352,541,1478,106,126,red blood cell,13356,1.1886792452830188,0.8412698412698413
16456,/images/e474a20b-2769-48f1-a520-4f6ef5a0dbf5.png,281,411,375,507,94,96,red blood cell,9024,1.0212765957446808,0.9791666666666666
1022,/images/63d36d2c-43a9-49ac-9504-028b4968c860.png,400,106,534,215,134,109,red blood cell,14606,0.8134328358208955,1.2293577981651376
62313,/images/e0ff3476-226f-4125-b182-8e524d5503dd.png,306,1401,407,1500,101,99,red blood cell,9999,0.9801980198019802,1.02020202020202
48756,/images/fed6ba05-36a5-45dc-a4e1-9baa7de2c622.png,1040,116,1159,221,119,105,red blood cell,12495,0.8823529411764706,1.1333333333333333
28938,/images/b12ae3b1-613c-4c0e-9163-3c5cc314abf5.png,785,456,897,558,112,102,red blood cell,11424,0.9107142857142857,1.0980392156862746
57497,/images/00d04a90-80e5-4bce-9511-1b64eabb7a47.png,430,1387,512,1475,82,88,red blood cell,7216,1.0731707317073171,0.9318181818181818
50690,/images/6b4c79f5-b194-4586-be9f-e339c5af4188.png,999,742,1123,858,124,116,red blood cell,14384,0.9354838709677419,1.0689655172413792
65420,/images/b523daee-317b-461d-bdc1-07b4add4d488.png,984,1147,1086,1257,102,110,red blood cell,11220,1.0784313725490196,0.9272727272727272
78545,/images/c5084fb8-2b62-464c-8a77-1a07ea653266.png,245,1299,372,1413,127,114,red blood cell,14478,0.8976377952755905,1.1140350877192982
77,/images/10be6380-cbbb-4886-8b9e-ff56b1710576.png,307,766,400,864,93,98,red blood cell,9114,1.053763440860215,0.9489795918367347
59152,/images/4736f545-1f1f-4d77-9241-d69cbf4dae35.png,281,372,374,478,93,106,red blood cell,9858,1.1397849462365592,0.8773584905660378
22742,/images/8490c623-3d88-4532-baf5-0d266a45b16f.png,943,38,1053,154,110,116,red blood cell,12760,1.0545454545454545,0.9482758620689655
45789,/images/584d62ed-4329-45dd-94ce-e929d8b2bb74.png,843,1355,932,1451,89,96,red blood cell,8544,1.0786516853932584,0.9270833333333334
33826,/images/cb08956d-dd6a-4e13-817b-40a0a93068f1.png,853,53,969,169,116,116,red blood cell,13456,1.0,1.0
68135,/images/5dec94a3-e3ca-4a58-9702-88e5a83ef612.png,306,680,399,786,93,106,red blood cell,9858,1.1397849462365592,0.8773584905660378
71501,/images/191071ab-6515-428c-9f05-8e4309542b75.png,756,363,863,468,107,105,red blood cell,11235,0.9813084112149533,1.019047619047619
9173,/images/d3ed519e-2152-4e30-838d-a3ea23be512f.png,937,1335,1043,1463,106,128,red blood cell,13568,1.2075471698113207,0.828125
42980,/images/ff37dd9b-2e3c-444d-9d29-6db186cfa2fb.png,972,372,1091,501,119,129,red blood cell,15351,1.084033613445378,0.9224806201550387
80029,/images/38d1b930-dd97-4248-9160-e9389a1a8dd7.png,388,235,483,336,95,101,red blood cell,9595,1.063157894736842,0.9405940594059405
66661,/images/b88fe674-fb9a-41d4-b100-cb1c86440d44.png,1018,1051,1122,1136,104,85,red blood cell,8840,0.8173076923076923,1.223529411764706
68513,/images/74261741-4d6e-4dba-8ad4-4fbdf919c30f.png,323,693,419,780,96,87,red blood cell,8352,0.90625,1.103448275862069
35539,/images/3e33ee12-ef02-4287-8318-7ad3b284a617.png,329,844,460,952,131,108,red blood cell,14148,0.8244274809160306,1.212962962962963
52711,/images/9dc6ed5d-6698-48cf-aab3-fd156673729c.png,613,817,714,914,101,97,red blood cell,9797,0.9603960396039604,1.041237113402062
59723,/images/f77d7469-d083-4c2d-a4ea-5a9ff162e3e2.png,123,817,199,895,76,78,red blood cell,5928,1.0263157894736843,0.9743589743589743
75036,/images/9147a21d-0de2-4c04-88da-b788311696ac.png,753,184,860,295,107,111,red blood cell,11877,1.0373831775700935,0.963963963963964
25391,/images/fbb1b44c-d75a-4550-a6c0-0eb62b96bfce.png,970,1485,1089,1600,119,115,red blood cell,13685,0.9663865546218487,1.0347826086956522
1965,/images/b95ceeeb-8870-4492-9037-2091ff268c5a.png,825,165,928,283,103,118,red blood cell,12154,1.145631067961165,0.8728813559322034
28563,/images/dbdfad64-110c-421f-a1c7-f68fd9e82d67.png,1091,245,1199,358,108,113,red blood cell,12204,1.0462962962962963,0.9557522123893806
16967,/images/8eeb378e-90f0-47ea-ac1c-2a201eb8d090.png,192,980,288,1093,96,113,red blood cell,10848,1.1770833333333333,0.8495575221238938
58443,/images/7eae1169-e294-4594-8e03-1366d23ff2d1.png,1028,1043,1131,1144,103,101,red blood cell,10403,0.9805825242718447,1.0198019801980198
53564,/images/7c1cd7c7-7452-4428-a98e-dd7675c8ddea.png,159,1198,269,1308,110,110,red blood cell,12100,1.0,1.0
33613,/images/00c8364b-8c85-4502-bcfe-64736fe76815.png,820,487,923,598,103,111,red blood cell,11433,1.0776699029126213,0.9279279279279279
29962,/images/deeaa5b3-3895-4aec-a2ce-ed6404862cdf.png,537,114,670,222,133,108,red blood cell,14364,0.8120300751879699,1.2314814814814814
9145,/images/d3ed519e-2152-4e30-838d-a3ea23be512f.png,10,837,114,965,104,128,red blood cell,13312,1.2307692307692308,0.8125
40874,/images/550cf4ce-b641-44a3-8487-3e16d4049187.png,707,1354,810,1471,103,117,red blood cell,12051,1.1359223300970873,0.8803418803418803
41928,/images/46a03374-64c7-49ac-81c9-c3d62542bbf3.png,149,222,246,315,97,93,red blood cell,9021,0.9587628865979382,1.043010752688172
60143,/images/214f1d15-a081-476e-992d-6c3a77f03d59.png,693,173,805,278,112,105,red blood cell,11760,0.9375,1.0666666666666667
67734,/images/48e2f0bd-2164-40c3-af43-1f2708359978.png,1009,1310,1113,1410,104,100,red blood cell,10400,0.9615384615384616,1.04
2928,/images/a1c140f9-75d7-42a3-b767-4c01a118892b.png,0,1452,107,1565,107,113,red blood cell,12091,1.0560747663551402,0.9469026548672567
65089,/images/5e042380-6ef2-496f-8231-0ca550fbfa71.png,216,1403,311,1506,95,103,red blood cell,9785,1.0842105263157895,0.9223300970873787
74655,/images/5ccca8ee-abea-458a-a891-bedd31c3ddc3.png,823,1250,923,1353,100,103,red blood cell,10300,1.03,0.970873786407767
60385,/images/1c87b997-a8e6-48ca-bf40-19b9a7fd6a96.png,359,121,424,200,65,79,red blood cell,5135,1.2153846153846153,0.8227848101265823
28852,/images/686ed568-d5f8-475e-81ad-edab9dd473a0.png,456,1483,540,1585,84,102,red blood cell,8568,1.2142857142857142,0.8235294117647058
22974,/images/b687c30d-cf15-445c-b3f6-5aca86584708.png,199,1238,338,1358,139,120,red blood cell,16680,0.8633093525179856,1.1583333333333334
43886,/images/679ae89f-4a02-4301-862e-1d844cc66cbf.png,258,851,395,976,137,125,red blood cell,17125,0.9124087591240876,1.096
58189,/images/2f68686f-1fe8-46e7-ad92-a08e3523ea79.png,849,895,968,1004,119,109,red blood cell,12971,0.9159663865546218,1.091743119266055
44672,/images/8002cb71-0f25-4fa4-a46f-b49e5aeded0c.png,271,1237,393,1348,122,111,red blood cell,13542,0.9098360655737705,1.0990990990990992
41099,/images/e871f52c-77a6-4813-80d4-95bd97985f1a.png,211,938,324,1046,113,108,red blood cell,12204,0.9557522123893806,1.0462962962962963
56553,/images/ac8df764-c8d8-4312-916d-70bfb37574b4.png,929,1097,1039,1223,110,126,red blood cell,13860,1.1454545454545455,0.873015873015873
47855,/images/ab27173b-6e30-4957-bd68-29194328fd39.png,340,1473,451,1580,111,107,red blood cell,11877,0.963963963963964,1.0373831775700935
51735,/images/592c941a-aa54-4971-b499-dc47356f80a3.png,188,238,273,329,85,91,red blood cell,7735,1.0705882352941176,0.9340659340659341
41566,/images/0fcd1ebe-ee4a-40a0-b787-29cee18bfa1b.png,20,497,109,588,89,91,red blood cell,8099,1.0224719101123596,0.978021978021978
64430,/images/34a70114-d3e3-4351-b8db-f6caab17e743.png,476,399,593,515,117,116,red blood cell,13572,0.9914529914529915,1.0086206896551724
64673,/images/6dfafdf1-f588-4e80-8cf8-0126e1bf7af9.png,18,0,135,116,117,116,red blood cell,13572,0.9914529914529915,1.0086206896551724
8148,/images/694222bb-cddf-469a-9526-f873c6fba58e.png,329,389,437,494,108,105,red blood cell,11340,0.9722222222222222,1.0285714285714285
37682,/images/003a89b0-a095-417a-8dd6-f408339bbc68.png,713,90,823,198,110,108,red blood cell,11880,0.9818181818181818,1.0185185185185186
77426,/images/c7ec51d5-9f45-4209-8357-39e9a984a733.png,716,193,826,290,110,97,red blood cell,10670,0.8818181818181818,1.134020618556701
48047,/images/1d4f06e1-9c9b-487e-84cd-e7e50cc754da.png,1048,189,1163,306,115,117,red blood cell,13455,1.017391304347826,0.9829059829059829
22400,/images/78c35732-7e31-4153-842e-55ab1cd656f6.png,422,487,526,598,104,111,red blood cell,11544,1.0673076923076923,0.9369369369369369
42349,/images/5c5b7965-1a44-44b8-aa43-660823e61821.png,1010,967,1121,1074,111,107,red blood cell,11877,0.963963963963964,1.0373831775700935
26619,/images/5893e081-04f2-4e33-9851-bed5f0e4d333.png,585,897,703,1021,118,124,red blood cell,14632,1.0508474576271187,0.9516129032258065
59936,/images/f0fe292d-85ae-4c3a-a676-037dde2594e6.png,999,190,1130,309,131,119,red blood cell,15589,0.9083969465648855,1.1008403361344539
12792,/images/b634137b-bc8b-4e88-b0e3-b536ad6e7e18.png,862,1356,969,1452,107,96,red blood cell,10272,0.897196261682243,1.1145833333333333
45258,/images/9e793460-d94c-47ac-b3a7-0d6ad86357da.png,670,943,784,1058,114,115,red blood cell,13110,1.0087719298245614,0.991304347826087
45514,/images/94b5a9a1-1c88-4400-aca4-3d56f543fc4a.png,882,690,982,777,100,87,red blood cell,8700,0.87,1.1494252873563218
72592,/images/a63ce82f-f3d1-4818-9035-d3d230e5f686.png,142,585,243,697,101,112,red blood cell,11312,1.108910891089109,0.9017857142857143
43034,/images/1345dc89-a3d9-4b71-8a75-b3bff01ba518.png,1046,949,1182,1066,136,117,red blood cell,15912,0.8602941176470589,1.1623931623931625
45353,/images/e4eea7ea-8989-46a9-9c98-25a178146b28.png,91,96,203,204,112,108,red blood cell,12096,0.9642857142857143,1.037037037037037
51176,/images/d64cd75a-df26-44d5-ac25-69061a4e4d57.png,1027,1236,1133,1344,106,108,red blood cell,11448,1.0188679245283019,0.9814814814814815
36975,/images/b2e34f5f-904e-4473-9dc7-c6bc1ce12640.png,430,684,519,761,89,77,red blood cell,6853,0.8651685393258427,1.155844155844156
66781,/images/334bf865-e3fb-4200-bd53-d9ff5808ed9f.png,1064,1372,1177,1467,113,95,red blood cell,10735,0.8407079646017699,1.1894736842105262
15279,/images/2d0f600d-f94e-4907-b712-52fb37d9ed52.png,590,202,695,314,105,112,red blood cell,11760,1.0666666666666667,0.9375
75274,/images/9ec1dcec-87c2-4aca-8e6b-0db3cd05509c.png,426,902,520,1002,94,100,red blood cell,9400,1.0638297872340425,0.94
43672,/images/a4851ed0-1499-4eae-9157-dcd34773254f.png,737,1181,854,1281,117,100,red blood cell,11700,0.8547008547008547,1.17
48236,/images/71204a6d-814e-44b6-9cee-7b979f478021.png,319,770,426,877,107,107,red blood cell,11449,1.0,1.0
22838,/images/72105bb0-8e39-48be-b7f7-5b32f047b99e.png,140,780,258,889,118,109,red blood cell,12862,0.923728813559322,1.0825688073394495
12261,/images/3b55c42f-ad59-422f-ba99-4f4f4ca9cb2e.png,622,694,724,804,102,110,red blood cell,11220,1.0784313725490196,0.9272727272727272
73830,/images/3eba916c-998b-40a7-993c-7ed916c2a04c.png,161,292,272,393,111,101,red blood cell,11211,0.9099099099099099,1.099009900990099
73700,/images/f11d05e4-538a-4024-8711-b08a4ce3c540.png,905,319,1001,433,96,114,red blood cell,10944,1.1875,0.8421052631578947
7585,/images/21cc498b-8cb2-42ed-8f80-bfa27b86ef11.png,1006,664,1130,785,124,121,red blood cell,15004,0.9758064516129032,1.024793388429752
60003,/images/49288109-80e9-4ec8-96d1-26a0166b8883.png,222,303,338,422,116,119,red blood cell,13804,1.0258620689655173,0.9747899159663865
40201,/images/ef1a9020-5e45-450d-a237-165114308592.png,1083,327,1200,461,117,134,red blood cell,15678,1.1452991452991452,0.8731343283582089
50671,/images/c956e531-6805-4fe1-b61c-8b96a9815a77.png,478,546,592,648,114,102,red blood cell,11628,0.8947368421052632,1.1176470588235294
5642,/images/afa470d9-c74c-41cd-b4dc-7bf93fde8263.png,875,320,981,433,106,113,red blood cell,11978,1.0660377358490567,0.9380530973451328
21996,/images/393df10a-5d64-476b-88f5-14ac56d6ed60.png,497,1323,633,1441,136,118,red blood cell,16048,0.8676470588235294,1.152542372881356
25913,/images/4811fdf2-d7e8-475e-a840-45dda5282bf3.png,203,751,329,884,126,133,red blood cell,16758,1.0555555555555556,0.9473684210526315
46668,/images/da111ca5-520f-4ea8-97ad-ae5fce58ee91.png,320,621,436,716,116,95,red blood cell,11020,0.8189655172413793,1.2210526315789474
45870,/images/939ad732-d7c5-4339-b087-4335b49d6a3c.png,169,357,284,481,115,124,red blood cell,14260,1.0782608695652174,0.9274193548387096
68304,/images/0f735cca-051c-4048-a1fa-cb36f389e12f.png,700,1024,807,1132,107,108,red blood cell,11556,1.0093457943925233,0.9907407407407407
30110,/images/81c3c8f0-d5a9-4dda-afd5-e86f6afd9424.png,315,977,424,1091,109,114,red blood cell,12426,1.0458715596330275,0.956140350877193
17831,/images/1863da5f-c595-4541-a8f4-21fe78678168.png,297,967,402,1063,105,96,red blood cell,10080,0.9142857142857143,1.09375
53099,/images/04a567df-5463-4043-81f1-d726223c19a9.png,775,359,878,470,103,111,red blood cell,11433,1.0776699029126213,0.9279279279279279
76657,/images/3317d733-ec0d-45e6-b631-40457392f343.png,760,1378,883,1486,123,108,red blood cell,13284,0.8780487804878049,1.1388888888888888
27108,/images/f232eec3-02c0-43f9-bf32-3e60245397e2.png,935,358,1046,467,111,109,red blood cell,12099,0.9819819819819819,1.018348623853211
69306,/images/3f8c5ae1-b9fd-464b-8e91-98143ddd8d29.png,94,477,218,584,124,107,red blood cell,13268,0.8629032258064516,1.158878504672897
80042,/images/38d1b930-dd97-4248-9160-e9389a1a8dd7.png,97,545,185,633,88,88,red blood cell,7744,1.0,1.0
61989,/images/bdb5d571-27bc-4a42-ae45-aa5a9af40a81.png,56,680,172,804,116,124,red blood cell,14384,1.0689655172413792,0.9354838709677419
68699,/images/77e76e62-2c71-4b52-9b21-0d1bcde9f9bf.png,550,310,652,404,102,94,red blood cell,9588,0.9215686274509803,1.0851063829787233
78732,/images/dc6ac71b-2616-431e-bfd5-4c38139e4ddd.png,1069,955,1174,1063,105,108,red blood cell,11340,1.0285714285714285,0.9722222222222222
36617,/images/21f001d6-f568-4ea4-82da-fab54c77c419.png,450,788,535,871,85,83,red blood cell,7055,0.9764705882352941,1.0240963855421688
67302,/images/49c4dbd3-6269-4d4c-9648-a2146c57bab1.png,286,1393,403,1509,117,116,red blood cell,13572,0.9914529914529915,1.0086206896551724
53794,/images/76b24246-8571-4e7b-8815-b185414a2c51.png,343,1473,441,1582,98,109,red blood cell,10682,1.1122448979591837,0.8990825688073395
70732,/images/8ab5c462-045e-4b59-b53a-9b2bc3ed2487.png,337,1168,424,1247,87,79,red blood cell,6873,0.9080459770114943,1.1012658227848102
35499,/images/3722d213-f2a9-46d5-aa76-9183b443e455.png,71,416,186,520,115,104,red blood cell,11960,0.9043478260869565,1.1057692307692308
3043,/images/5a386082-397f-4524-a6f9-c2b8efe5014d.png,700,283,811,382,111,99,red blood cell,10989,0.8918918918918919,1.121212121212121
26844,/images/2518f6e4-29cc-4ae4-a914-b215a4c56099.png,436,462,558,576,122,114,red blood cell,13908,0.9344262295081968,1.0701754385964912
41394,/images/65e8b0cd-05d1-4c8d-8efd-24bf71df3167.png,1063,1359,1199,1492,136,133,red blood cell,18088,0.9779411764705882,1.0225563909774436
55624,/images/c32b8bb8-c89d-4ae9-9c77-5b9356ca35a1.png,554,1390,663,1496,109,106,red blood cell,11554,0.9724770642201835,1.028301886792453
76746,/images/3317d733-ec0d-45e6-b631-40457392f343.png,297,64,384,165,87,101,red blood cell,8787,1.160919540229885,0.8613861386138614
30421,/images/58d75854-be99-484e-89f0-4ab208fe07e0.png,784,236,888,338,104,102,red blood cell,10608,0.9807692307692307,1.0196078431372548
32301,/images/1c406ce1-023b-47fc-a2cd-5ea2e255de65.png,708,108,842,230,134,122,red blood cell,16348,0.9104477611940298,1.098360655737705
73463,/images/5f2b32bd-fdca-4d6f-b13a-ee9f83626c8d.png,64,927,170,1044,106,117,red blood cell,12402,1.1037735849056605,0.905982905982906
79918,/images/0b923ab7-ebff-4079-a4bb-af7da89f374e.png,567,735,671,841,104,106,red blood cell,11024,1.0192307692307692,0.9811320754716981
7870,/images/1493d140-c9d5-4c3a-9caf-3eafb290a49b.png,523,1199,645,1298,122,99,red blood cell,12078,0.8114754098360656,1.2323232323232323
65718,/images/c54fcef1-0c51-4426-9a93-15ec5f2bf58a.png,768,1214,864,1305,96,91,red blood cell,8736,0.9479166666666666,1.054945054945055
52393,/images/a2a20600-f851-4db7-90f9-6f7be027c8b5.png,40,1045,127,1149,87,104,red blood cell,9048,1.1954022988505748,0.8365384615384616
39911,/images/71cf2467-77d3-4fac-ac6e-1d8767717c34.png,794,915,927,1046,133,131,red blood cell,17423,0.9849624060150376,1.015267175572519
52988,/images/e81bf478-27ff-458c-ac30-9e1f8480bc5c.png,954,528,1057,632,103,104,red blood cell,10712,1.0097087378640777,0.9903846153846154
69120,/images/de2b8835-552c-4f01-98b7-67bc4910062e.png,223,810,306,901,83,91,red blood cell,7553,1.0963855421686748,0.9120879120879121
7584,/images/21cc498b-8cb2-42ed-8f80-bfa27b86ef11.png,190,370,307,486,117,116,red blood cell,13572,0.9914529914529915,1.0086206896551724
70322,/images/90246988-0d6d-4bf8-8a76-94107de4121e.png,751,57,858,175,107,118,red blood cell,12626,1.102803738317757,0.9067796610169492
30418,/images/58d75854-be99-484e-89f0-4ab208fe07e0.png,329,1488,451,1599,122,111,red blood cell,13542,0.9098360655737705,1.0990990990990992
58594,/images/a4d7a7e1-5ae1-486d-b6ee-c9af1476ccad.png,330,547,461,670,131,123,red blood cell,16113,0.9389312977099237,1.065040650406504
36745,/images/aa2dfa24-2dc3-4279-a232-f84780ace190.png,10,1010,126,1115,116,105,red blood cell,12180,0.9051724137931034,1.1047619047619048
2989,/images/5a386082-397f-4524-a6f9-c2b8efe5014d.png,607,166,723,274,116,108,red blood cell,12528,0.9310344827586207,1.0740740740740742
28443,/images/c3042130-a6e2-458f-9fde-bb012f68f5f2.png,469,391,587,509,118,118,red blood cell,13924,1.0,1.0
42767,/images/7c68c343-a7d3-4d26-b330-a5bb97ab8d9c.png,756,495,875,609,119,114,red blood cell,13566,0.957983193277311,1.043859649122807
79038,/images/6144887d-a1c1-46db-91a1-f7ff5bf8c8a5.png,462,1494,561,1600,99,106,red blood cell,10494,1.0707070707070707,0.9339622641509434
41244,/images/eed298b3-35f2-4127-88ad-0c4a9062207b.png,863,1298,954,1402,91,104,red blood cell,9464,1.1428571428571428,0.875
9168,/images/d3ed519e-2152-4e30-838d-a3ea23be512f.png,288,1439,408,1561,120,122,red blood cell,14640,1.0166666666666666,0.9836065573770492
78454,/images/72029aca-f0bc-477f-b790-f345f86228ce.png,911,304,1009,410,98,106,red blood cell,10388,1.0816326530612246,0.9245283018867925
54500,/images/db871d17-28fd-4ceb-b421-e4e4afa0a7a0.png,224,420,335,524,111,104,red blood cell,11544,0.9369369369369369,1.0673076923076923
69101,/images/de2b8835-552c-4f01-98b7-67bc4910062e.png,895,318,997,418,102,100,red blood cell,10200,0.9803921568627451,1.02
17323,/images/3d302619-473d-4c5b-af43-8833ff94233f.png,796,1260,908,1370,112,110,red blood cell,12320,0.9821428571428571,1.018181818181818
33534,/images/255d5f0c-87fc-4337-bb51-07c440df4f1b.png,173,640,284,770,111,130,red blood cell,14430,1.1711711711711712,0.8538461538461538
61124,/images/80da32ce-8c22-470e-9f35-558c5f7a5df9.png,550,1183,649,1282,99,99,red blood cell,9801,1.0,1.0
21092,/images/c680004e-6ee2-43d7-877c-edc9b5ebeecc.png,310,718,419,825,109,107,red blood cell,11663,0.981651376146789,1.0186915887850467
49067,/images/df3d98b9-3dd7-4107-8d4a-ae1b7f247793.png,519,162,626,263,107,101,red blood cell,10807,0.9439252336448598,1.0594059405940595
28824,/images/686ed568-d5f8-475e-81ad-edab9dd473a0.png,617,37,735,156,118,119,red blood cell,14042,1.0084745762711864,0.9915966386554622
53933,/images/540a5fee-175b-4b92-bf62-1ea9b59c86c6.png,956,807,1069,930,113,123,red blood cell,13899,1.0884955752212389,0.9186991869918699
10427,/images/46a2d369-4bea-4405-ac78-91bbe130b9a7.png,697,648,799,773,102,125,red blood cell,12750,1.2254901960784315,0.816
35493,/images/3722d213-f2a9-46d5-aa76-9183b443e455.png,524,1409,628,1510,104,101,red blood cell,10504,0.9711538461538461,1.0297029702970297
64890,/images/dec61ae1-5037-4c3a-8952-15371becca7d.png,589,1292,698,1416,109,124,red blood cell,13516,1.1376146788990826,0.8790322580645161
24456,/images/b78ba2c8-ecb3-45b2-9cda-2c8088fa95d1.png,521,349,624,470,103,121,red blood cell,12463,1.174757281553398,0.8512396694214877
51265,/images/216f9d43-6869-4ba1-9106-4f5ea6aac223.png,866,931,982,1049,116,118,red blood cell,13688,1.0172413793103448,0.9830508474576272
30061,/images/81c3c8f0-d5a9-4dda-afd5-e86f6afd9424.png,819,575,913,675,94,100,red blood cell,9400,1.0638297872340425,0.94
64719,/images/76021d69-8919-4688-95ef-7418eff620cc.png,1015,599,1105,698,90,99,red blood cell,8910,1.1,0.9090909090909091
11278,/images/6303f964-98ef-47c6-bb2d-283aa393f918.png,140,1440,235,1548,95,108,red blood cell,10260,1.1368421052631579,0.8796296296296297
79802,/images/fc15659f-6264-4dd5-ab17-43d89fb297b9.png,46,678,163,788,117,110,red blood cell,12870,0.9401709401709402,1.0636363636363637
58328,/images/319c9c52-f316-49f3-baad-4444ab19f85b.png,882,636,971,740,89,104,red blood cell,9256,1.1685393258426966,0.8557692307692307
73559,/images/7624ac36-1cf9-42fb-844d-376078309553.png,262,896,367,1005,105,109,red blood cell,11445,1.0380952380952382,0.963302752293578
10583,/images/20d4f65e-6c63-433a-935c-d568d577967b.png,222,1040,337,1136,115,96,red blood cell,11040,0.8347826086956521,1.1979166666666667
40141,/images/b34e65f6-c32e-42f1-a437-4a037c75a231.png,1086,47,1187,142,101,95,red blood cell,9595,0.9405940594059405,1.063157894736842
10538,/images/46a2d369-4bea-4405-ac78-91bbe130b9a7.png,604,693,695,793,91,100,red blood cell,9100,1.098901098901099,0.91
57537,/images/00d04a90-80e5-4bce-9511-1b64eabb7a47.png,615,464,692,550,77,86,red blood cell,6622,1.1168831168831168,0.8953488372093024
21473,/images/b701b5c5-b922-4315-b12a-aac4ec65ee8b.png,492,607,593,721,101,114,red blood cell,11514,1.1287128712871286,0.8859649122807017
10804,/images/2a02cec2-a09b-483a-ad38-14359a763fa4.png,350,512,461,619,111,107,red blood cell,11877,0.963963963963964,1.0373831775700935
65690,/images/397f37bc-a3a4-4257-9430-c8fc5716f8b1.png,641,172,769,306,128,134,red blood cell,17152,1.046875,0.9552238805970149
78064,/images/105af41b-13cc-4ad1-8a1f-8bc4d47cdd94.png,338,1398,443,1490,105,92,red blood cell,9660,0.8761904761904762,1.141304347826087
73637,/images/a51d6c18-f9e8-4714-9dbb-38e1577445f2.png,745,1197,837,1301,92,104,red blood cell,9568,1.1304347826086956,0.8846153846153846
75093,/images/073c10c9-5749-44b5-b08b-1be556a960f0.png,762,940,871,1053,109,113,red blood cell,12317,1.036697247706422,0.9646017699115044
76169,/images/16244280-6c74-47d3-b544-9fd6831a6bf9.png,377,1411,465,1514,88,103,red blood cell,9064,1.1704545454545454,0.8543689320388349
48170,/images/913099c5-8085-4908-bf4b-1f098bbfcf66.png,392,1273,509,1399,117,126,red blood cell,14742,1.0769230769230769,0.9285714285714286
78244,/images/adff6e1d-ba9d-4c7b-a8fe-1ec458eaeeb8.png,86,373,195,492,109,119,red blood cell,12971,1.091743119266055,0.9159663865546218
23396,/images/8757be1e-b832-407a-8e95-62abae485b24.png,121,756,230,861,109,105,red blood cell,11445,0.963302752293578,1.0380952380952382
59589,/images/faead1c7-bb2c-4adf-bfce-9ff36cd2cf6a.png,1013,224,1131,336,118,112,red blood cell,13216,0.9491525423728814,1.0535714285714286
5224,/images/729733ff-a349-4a96-b636-ccabe7d7e167.png,933,104,1050,214,117,110,red blood cell,12870,0.9401709401709402,1.0636363636363637
4231,/images/ac3358f1-ef9a-4ccc-b66c-da5e47e352e0.png,268,222,388,332,120,110,red blood cell,13200,0.9166666666666666,1.0909090909090908
65861,/images/d7581cb0-7a12-471d-a3d8-68dcea362213.png,474,416,579,521,105,105,red blood cell,11025,1.0,1.0
62706,/images/9e1b0217-0926-4fd1-bb9e-a815c05deb59.png,121,1097,242,1212,121,115,red blood cell,13915,0.9504132231404959,1.0521739130434782
9548,/images/a18f122f-3a3e-4478-8ac4-91b83e050e65.png,139,439,262,554,123,115,red blood cell,14145,0.9349593495934959,1.0695652173913044
78839,/images/19979a60-df80-4111-bf69-81a7e9c4dd0b.png,869,617,980,732,111,115,red blood cell,12765,1.0360360360360361,0.9652173913043478
38503,/images/aa4a023b-55bd-4259-b15d-7086a9b491e0.png,754,545,863,659,109,114,red blood cell,12426,1.0458715596330275,0.956140350877193
58291,/images/319c9c52-f316-49f3-baad-4444ab19f85b.png,894,1468,1002,1558,108,90,red blood cell,9720,0.8333333333333334,1.2
66420,/images/5f66d20c-fbfe-44ec-a01b-8a09da24807e.png,723,1309,835,1410,112,101,red blood cell,11312,0.9017857142857143,1.108910891089109
55055,/images/1f8f08ea-b5b3-4f68-94d4-3cc071b7dce8.png,452,925,577,1037,125,112,red blood cell,14000,0.896,1.1160714285714286
59338,/images/565513be-2c20-4ee3-94f3-093869515d3d.png,520,1433,635,1556,115,123,red blood cell,14145,1.0695652173913044,0.9349593495934959
42063,/images/46a03374-64c7-49ac-81c9-c3d62542bbf3.png,823,444,905,535,82,91,red blood cell,7462,1.1097560975609757,0.9010989010989011
34549,/images/3af90874-59f3-4f0c-a7e6-cc889e80c605.png,832,455,959,571,127,116,red blood cell,14732,0.9133858267716536,1.0948275862068966
51970,/images/4f62b14e-c6f4-4155-8f50-881558f83fae.png,643,114,727,202,84,88,red blood cell,7392,1.0476190476190477,0.9545454545454546
41055,/images/e871f52c-77a6-4813-80d4-95bd97985f1a.png,835,1051,952,1168,117,117,red blood cell,13689,1.0,1.0
38703,/images/b5acf759-1115-42f0-a753-656736192528.png,777,1221,902,1329,125,108,red blood cell,13500,0.864,1.1574074074074074
15744,/images/64113b22-03b1-4ab8-89ab-b2f32154fbbd.png,656,732,778,855,122,123,red blood cell,15006,1.0081967213114753,0.991869918699187
43481,/images/5a539312-6cfa-43e6-8d5d-db883f343ad9.png,549,251,679,387,130,136,red blood cell,17680,1.0461538461538462,0.9558823529411765
28276,/images/ffd59802-46c6-4b58-80fe-e534e39781a7.png,934,1392,1034,1493,100,101,red blood cell,10100,1.01,0.9900990099009901
48017,/images/eba73bff-fbe1-436d-9a5f-0a61331a0ea2.png,995,684,1093,774,98,90,red blood cell,8820,0.9183673469387755,1.0888888888888888
62639,/images/f7a4334a-4332-4de8-b39b-22da907976f2.png,691,578,800,688,109,110,red blood cell,11990,1.0091743119266054,0.990909090909091
6098,/images/c147584d-4c61-412a-bdaf-b02b22c18708.png,607,1042,725,1155,118,113,red blood cell,13334,0.9576271186440678,1.0442477876106195
72388,/images/a15e0fa8-2620-4f66-896e-175115c9dc3d.png,350,965,468,1067,118,102,red blood cell,12036,0.864406779661017,1.1568627450980393
21365,/images/5077f87d-a19f-494c-b911-14ccb03bd230.png,343,188,459,301,116,113,red blood cell,13108,0.9741379310344828,1.0265486725663717
2238,/images/5bf91ff9-80df-49c0-9c3e-599357d95530.png,313,744,452,867,139,123,red blood cell,17097,0.8848920863309353,1.1300813008130082
2294,/images/fe851c88-692d-4199-87e0-d19d9c4eb591.png,460,1093,551,1180,91,87,red blood cell,7917,0.9560439560439561,1.0459770114942528
4651,/images/a2d07312-2f97-40d2-8b09-7f2aca7b16fb.png,61,783,184,910,123,127,red blood cell,15621,1.032520325203252,0.968503937007874
62549,/images/9ecf2006-8d49-4ae8-a14b-ed8b3b14ee7c.png,881,1125,977,1218,96,93,red blood cell,8928,0.96875,1.032258064516129
78872,/images/4d0a1598-e4dd-45c4-8a90-dd7c780fe1da.png,535,165,628,261,93,96,red blood cell,8928,1.032258064516129,0.96875
4499,/images/0f26699f-a776-4424-b092-27da9a1d12e2.png,257,963,355,1068,98,105,red blood cell,10290,1.0714285714285714,0.9333333333333333
19119,/images/2196389c-45ec-46b5-bc6c-1f4a33df7f7c.png,786,870,901,982,115,112,red blood cell,12880,0.9739130434782609,1.0267857142857142
50735,/images/6b4c79f5-b194-4586-be9f-e339c5af4188.png,718,615,822,732,104,117,red blood cell,12168,1.125,0.8888888888888888
2791,/images/e79bd81b-f878-4bee-9be2-d91a722c031e.png,268,301,392,424,124,123,red blood cell,15252,0.9919354838709677,1.008130081300813
35500,/images/3722d213-f2a9-46d5-aa76-9183b443e455.png,927,918,1026,1038,99,120,red blood cell,11880,1.2121212121212122,0.825
60882,/images/11b72c7b-5c52-44b7-adb7-21eacc25e441.png,832,487,923,593,91,106,red blood cell,9646,1.164835164835165,0.8584905660377359
18914,/images/e9e78ff8-831b-46e9-9785-3eee9acbfcd8.png,76,199,189,300,113,101,red blood cell,11413,0.8938053097345132,1.118811881188119
49039,/images/df3d98b9-3dd7-4107-8d4a-ae1b7f247793.png,1004,741,1102,828,98,87,red blood cell,8526,0.8877551020408163,1.1264367816091954
59336,/images/565513be-2c20-4ee3-94f3-093869515d3d.png,158,514,260,611,102,97,red blood cell,9894,0.9509803921568627,1.0515463917525774
24963,/images/ed0bee2f-05e0-4392-8357-19750cec577c.png,748,463,839,575,91,112,red blood cell,10192,1.2307692307692308,0.8125
77364,/images/3ff98212-7c2a-46cd-afb7-34a2479bed07.png,770,168,883,280,113,112,red blood cell,12656,0.9911504424778761,1.0089285714285714
19838,/images/b318889c-3c60-477c-b8f6-d18cb01a59df.png,1091,1253,1177,1338,86,85,red blood cell,7310,0.9883720930232558,1.011764705882353
69561,/images/4a49841f-216c-4815-8140-b8762c4f6603.png,709,724,814,838,105,114,red blood cell,11970,1.0857142857142856,0.9210526315789473
67911,/images/41ebf9a1-24dc-454e-8bf8-508218f5ee57.png,62,604,142,691,80,87,red blood cell,6960,1.0875,0.9195402298850575
77147,/images/dd6f047e-af73-43df-9c46-354534fc20e0.png,98,1169,197,1287,99,118,red blood cell,11682,1.1919191919191918,0.8389830508474576
38490,/images/aa4a023b-55bd-4259-b15d-7086a9b491e0.png,457,508,583,623,126,115,red blood cell,14490,0.9126984126984127,1.0956521739130434
49083,/images/df3d98b9-3dd7-4107-8d4a-ae1b7f247793.png,778,1203,877,1310,99,107,red blood cell,10593,1.0808080808080809,0.9252336448598131
10679,/images/20d4f65e-6c63-433a-935c-d568d577967b.png,4,544,100,638,96,94,red blood cell,9024,0.9791666666666666,1.0212765957446808
12782,/images/b634137b-bc8b-4e88-b0e3-b536ad6e7e18.png,304,97,399,190,95,93,red blood cell,8835,0.9789473684210527,1.021505376344086
73213,/images/85546330-4efd-43e2-87aa-d53a30220bfc.png,71,313,182,402,111,89,red blood cell,9879,0.8018018018018018,1.247191011235955
73743,/images/22cbf509-c9bf-46ec-bfce-f079c6b76c8c.png,1023,246,1144,363,121,117,red blood cell,14157,0.9669421487603306,1.0341880341880343
71720,/images/5c99cd97-39f6-4809-9528-9d380cc16b16.png,227,104,320,204,93,100,red blood cell,9300,1.075268817204301,0.93
66999,/images/3b4440f7-a69b-4042-a9d0-d6958abcdf4e.png,338,965,430,1058,92,93,red blood cell,8556,1.0108695652173914,0.989247311827957
42047,/images/46a03374-64c7-49ac-81c9-c3d62542bbf3.png,226,85,334,196,108,111,red blood cell,11988,1.0277777777777777,0.972972972972973
51240,/images/216f9d43-6869-4ba1-9106-4f5ea6aac223.png,642,739,746,855,104,116,red blood cell,12064,1.1153846153846154,0.896551724137931
61537,/images/4a717a39-80f8-4b75-a25e-c46d65d7dcd5.png,655,691,751,800,96,109,red blood cell,10464,1.1354166666666667,0.8807339449541285
12456,/images/cc94eabb-a3dc-4cfc-9fff-55c76b5b4a71.png,926,639,1061,770,135,131,red blood cell,17685,0.9703703703703703,1.0305343511450382
60901,/images/11b72c7b-5c52-44b7-adb7-21eacc25e441.png,199,1081,297,1189,98,108,red blood cell,10584,1.1020408163265305,0.9074074074074074
293,/images/0dcca702-a4ef-4fb3-a940-9c0c140b21c7.png,249,384,353,470,104,86,red blood cell,8944,0.8269230769230769,1.2093023255813953
42605,/images/184b376b-03cb-4c2d-af51-fc1a62196293.png,648,7,737,101,89,94,red blood cell,8366,1.0561797752808988,0.9468085106382979
70483,/images/8cca114a-ed05-4b87-95b7-fae02487f08c.png,967,414,1083,533,116,119,red blood cell,13804,1.0258620689655173,0.9747899159663865
67380,/images/266180ed-77a3-4284-8292-50a49fc47fce.png,330,907,443,1021,113,114,red blood cell,12882,1.008849557522124,0.9912280701754386
30213,/images/f81806a8-5883-446c-be78-f0145b12dbdd.png,427,199,545,321,118,122,red blood cell,14396,1.0338983050847457,0.9672131147540983
47285,/images/1dd3e6dd-343f-4cc9-b0ed-e4d27fb36f0a.png,425,967,533,1079,108,112,red blood cell,12096,1.037037037037037,0.9642857142857143
63591,/images/de0321fa-6f7d-4dd1-b96b-186701c3b1d9.png,886,125,1002,251,116,126,red blood cell,14616,1.0862068965517242,0.9206349206349206
61930,/images/f32b21ae-5ca7-490b-bc40-6db9396d933c.png,189,1000,285,1085,96,85,red blood cell,8160,0.8854166666666666,1.1294117647058823
19071,/images/6e39fb0a-aa41-4b16-b783-7589e97bf289.png,787,215,914,320,127,105,red blood cell,13335,0.8267716535433071,1.2095238095238094
59975,/images/f0fe292d-85ae-4c3a-a676-037dde2594e6.png,864,70,987,193,123,123,red blood cell,15129,1.0,1.0
55889,/images/afd39466-aafa-4d81-9520-483727418723.png,607,146,704,254,97,108,red blood cell,10476,1.1134020618556701,0.8981481481481481
44504,/images/b6573be3-9e04-49c3-9f48-6a145d065363.png,851,1354,967,1465,116,111,red blood cell,12876,0.9568965517241379,1.045045045045045
44597,/images/6388e241-09a2-4fbe-a712-07d8fe714c51.png,60,306,177,420,117,114,red blood cell,13338,0.9743589743589743,1.0263157894736843
2604,/images/a23f5539-bfe6-4885-9a0e-dba972475ea9.png,796,939,912,1044,116,105,red blood cell,12180,0.9051724137931034,1.1047619047619048
2674,/images/a2ccbf70-e444-49a9-8b7e-9797a05220d8.png,85,871,214,988,129,117,red blood cell,15093,0.9069767441860465,1.1025641025641026
5686,/images/d3dcdf92-9328-4796-adf4-918646877ba1.png,70,1310,201,1447,131,137,red blood cell,17947,1.0458015267175573,0.9562043795620438
50886,/images/0906111b-bac7-4541-a6dc-da435c0724a8.png,933,1263,1031,1354,98,91,red blood cell,8918,0.9285714285714286,1.0769230769230769
75919,/images/3006096f-ceeb-42be-b69e-785179d7438b.png,9,533,98,632,89,99,red blood cell,8811,1.1123595505617978,0.898989898989899
63316,/images/43bc935a-f655-45e1-a64d-fcb8b78267a6.png,388,285,483,376,95,91,red blood cell,8645,0.9578947368421052,1.043956043956044
7326,/images/89f10192-d3dd-4996-a571-4c851dbdc983.png,556,875,661,965,105,90,red blood cell,9450,0.8571428571428571,1.1666666666666667
9540,/images/a18f122f-3a3e-4478-8ac4-91b83e050e65.png,384,1165,496,1280,112,115,red blood cell,12880,1.0267857142857142,0.9739130434782609
35249,/images/a9159b11-ba49-4885-902e-00c8d5095b98.png,20,338,115,450,95,112,red blood cell,10640,1.1789473684210525,0.8482142857142857
76275,/images/1574565f-f45b-4160-947e-25ce1a81aaca.png,602,1003,727,1129,125,126,red blood cell,15750,1.008,0.9920634920634921
65387,/images/24418314-f7a4-49fc-a03e-ec597ca6796e.png,780,310,854,394,74,84,red blood cell,6216,1.135135135135135,0.8809523809523809
34131,/images/de5d19b7-e670-4ac7-843b-7ce7bcebdf45.png,385,210,486,310,101,100,red blood cell,10100,0.9900990099009901,1.01
44682,/images/8002cb71-0f25-4fa4-a46f-b49e5aeded0c.png,1097,935,1198,1026,101,91,red blood cell,9191,0.900990099009901,1.10989010989011
32879,/images/e40000b4-1b26-42ce-909d-4715e04f0a6e.png,261,837,371,949,110,112,red blood cell,12320,1.018181818181818,0.9821428571428571
28010,/images/c4d34e35-4db2-41de-ba77-1a94aa9ef788.png,105,2,224,119,119,117,red blood cell,13923,0.9831932773109243,1.017094017094017
40835,/images/bf20d04d-ff8a-4910-91d7-94054c267d1b.png,779,1044,896,1175,117,131,red blood cell,15327,1.1196581196581197,0.8931297709923665
18637,/images/c22f7031-9cf8-48ce-b03b-1b12d0db4951.png,302,1365,393,1456,91,91,red blood cell,8281,1.0,1.0
20118,/images/81a2748d-51c9-4439-995d-f747871d6544.png,683,807,810,937,127,130,red blood cell,16510,1.0236220472440944,0.9769230769230769
60707,/images/45651e76-4bd0-45e5-895b-edec65f51987.png,93,1441,194,1555,101,114,red blood cell,11514,1.1287128712871286,0.8859649122807017
27591,/images/715761a2-745e-4743-9849-956a034ad3c4.png,1000,113,1106,215,106,102,red blood cell,10812,0.9622641509433962,1.0392156862745099
42509,/images/29648565-fe28-4517-ba72-68df0c82c9c5.png,307,859,411,972,104,113,red blood cell,11752,1.0865384615384615,0.9203539823008849
6546,/images/640c4a52-3742-4f57-aee3-9e3dc0887622.png,116,913,221,1002,105,89,red blood cell,9345,0.8476190476190476,1.1797752808988764
76096,/images/4c7d2382-a962-4237-a053-955eea3decd8.png,372,1189,462,1269,90,80,red blood cell,7200,0.8888888888888888,1.125
16420,/images/e474a20b-2769-48f1-a520-4f6ef5a0dbf5.png,317,277,425,379,108,102,red blood cell,11016,0.9444444444444444,1.0588235294117647
9688,/images/53afd70c-08a7-4b9a-b137-7003b2ecbeab.png,1025,285,1155,413,130,128,red blood cell,16640,0.9846153846153847,1.015625
6817,/images/e36cb882-c6d0-4467-812e-d18c169a9a47.png,892,462,1014,580,122,118,red blood cell,14396,0.9672131147540983,1.0338983050847457
44047,/images/8b494b40-cab5-49d3-893d-c805000fbe88.png,81,520,187,632,106,112,red blood cell,11872,1.0566037735849056,0.9464285714285714
55927,/images/afd39466-aafa-4d81-9520-483727418723.png,618,806,724,895,106,89,red blood cell,9434,0.839622641509434,1.1910112359550562
79760,/images/03b9d6ad-39ca-4097-a98b-77f02b3c00a7.png,62,459,157,555,95,96,red blood cell,9120,1.0105263157894737,0.9895833333333334
71152,/images/b666fcc2-d0b2-441e-bc5a-c660345eeb5d.png,764,1305,908,1447,144,142,red blood cell,20448,0.9861111111111112,1.0140845070422535
16738,/images/d6352a03-ef81-421d-915e-226499555d20.png,677,235,812,362,135,127,red blood cell,17145,0.9407407407407408,1.062992125984252
19254,/images/b4d22412-a495-43a9-bec0-73a2322f8dad.png,800,1105,890,1209,90,104,red blood cell,9360,1.1555555555555554,0.8653846153846154
39697,/images/56adbb1e-96a8-40a5-a5a2-243c97ea889b.png,1075,997,1188,1100,113,103,red blood cell,11639,0.911504424778761,1.0970873786407767
45486,/images/e4eea7ea-8989-46a9-9c98-25a178146b28.png,624,1289,722,1396,98,107,red blood cell,10486,1.0918367346938775,0.9158878504672897
63783,/images/6013bff0-dc4b-4bde-9409-0f6139c3495c.png,836,170,941,270,105,100,red blood cell,10500,0.9523809523809523,1.05
9040,/images/ef815e3a-02a6-4cf8-9262-45bc74c50b00.png,233,762,347,877,114,115,red blood cell,13110,1.0087719298245614,0.991304347826087
30835,/images/93a306b8-594a-4c7f-8b4a-127fb6ad8f1a.png,644,1213,753,1323,109,110,red blood cell,11990,1.0091743119266054,0.990909090909091
20194,/images/bb337c84-f727-42a5-9c3d-934323a16c6a.png,602,73,732,192,130,119,red blood cell,15470,0.9153846153846154,1.0924369747899159
41785,/images/28bd16ba-2bcf-46af-b889-41b78d2a50c0.png,414,620,510,725,96,105,red blood cell,10080,1.09375,0.9142857142857143
47725,/images/afbb264e-ff60-443a-83f5-49d09be1b835.png,33,14,164,148,131,134,red blood cell,17554,1.0229007633587786,0.9776119402985075
26431,/images/d532e31c-10ce-4313-9a36-bd5e01230254.png,827,190,972,317,145,127,red blood cell,18415,0.8758620689655172,1.141732283464567
434,/images/84c88143-940d-4b62-bbd2-7acc4cadcb6b.png,524,44,629,160,105,116,red blood cell,12180,1.1047619047619048,0.9051724137931034
32242,/images/f4722a74-35e7-42bd-8ef6-dfff04b9cd22.png,104,726,234,853,130,127,red blood cell,16510,0.9769230769230769,1.0236220472440944
78328,/images/24115f58-a7d6-4022-a95a-86b515a78d3e.png,1065,173,1162,274,97,101,red blood cell,9797,1.041237113402062,0.9603960396039604
25114,/images/9e74feb8-017d-4d53-8896-9ebda4327dd1.png,381,902,499,1011,118,109,red blood cell,12862,0.923728813559322,1.0825688073394495
53750,/images/76b24246-8571-4e7b-8815-b185414a2c51.png,314,1076,424,1196,110,120,red blood cell,13200,1.0909090909090908,0.9166666666666666
29258,/images/6274fe0d-0d71-40be-b61b-f0bd5b5df1e2.png,60,436,164,539,104,103,red blood cell,10712,0.9903846153846154,1.0097087378640777
71001,/images/deaa1931-5f97-45bf-8c00-be6ddeb37b9a.png,278,32,390,134,112,102,red blood cell,11424,0.9107142857142857,1.0980392156862746
1863,/images/8855c685-5a8c-4967-a356-942ed89e3471.png,970,1119,1073,1233,103,114,red blood cell,11742,1.1067961165048543,0.9035087719298246
27214,/images/9f38055f-4fe6-47fd-a6dd-c0743db4eccf.png,119,120,238,225,119,105,red blood cell,12495,0.8823529411764706,1.1333333333333333
63748,/images/06401963-8b02-46c5-ab2a-3d70bd01623f.png,324,234,413,326,89,92,red blood cell,8188,1.0337078651685394,0.967391304347826
77770,/images/4849866a-73a2-4fcf-a407-2d0a25a09a89.png,918,1117,1001,1201,83,84,red blood cell,6972,1.0120481927710843,0.9880952380952381
30222,/images/f81806a8-5883-446c-be78-f0145b12dbdd.png,355,649,452,732,97,83,red blood cell,8051,0.8556701030927835,1.1686746987951808
13740,/images/1b369bcf-ced4-4ae2-9196-2664bd2b1738.png,969,113,1080,242,111,129,red blood cell,14319,1.162162162162162,0.8604651162790697
49491,/images/9f33e0ea-065b-4703-9df9-15829b891860.png,446,201,553,297,107,96,red blood cell,10272,0.897196261682243,1.1145833333333333
35021,/images/2b369d75-9c55-43e0-b352-d981aea544e3.png,1084,269,1183,388,99,119,red blood cell,11781,1.202020202020202,0.8319327731092437
9828,/images/3859deaf-6ae1-49a3-9051-898d0f0d7de6.png,149,454,250,547,101,93,red blood cell,9393,0.9207920792079208,1.086021505376344
17182,/images/471f75c6-bd5d-4c20-bcc1-258e836f4d69.png,176,1460,275,1574,99,114,red blood cell,11286,1.1515151515151516,0.868421052631579
70625,/images/4ce5a070-9ede-4bb1-9ca2-1bae5746776b.png,988,639,1115,756,127,117,red blood cell,14859,0.9212598425196851,1.0854700854700854
58249,/images/319c9c52-f316-49f3-baad-4444ab19f85b.png,492,306,604,413,112,107,red blood cell,11984,0.9553571428571429,1.0467289719626167
27473,/images/f5869ba8-6253-426b-93f3-82af59a86144.png,145,436,254,531,109,95,red blood cell,10355,0.8715596330275229,1.1473684210526316
6825,/images/e36cb882-c6d0-4467-812e-d18c169a9a47.png,1077,1117,1192,1230,115,113,red blood cell,12995,0.9826086956521739,1.0176991150442478
75682,/images/50d7c6c9-3230-48fe-947c-7dcfd0aad710.png,185,60,291,160,106,100,red blood cell,10600,0.9433962264150944,1.06
55794,/images/68f34a9c-f73d-4238-8f55-4b05a8a2154c.png,645,1089,752,1196,107,107,red blood cell,11449,1.0,1.0
55696,/images/c32b8bb8-c89d-4ae9-9c77-5b9356ca35a1.png,416,623,530,727,114,104,red blood cell,11856,0.9122807017543859,1.0961538461538463
8275,/images/65e3d6a6-012c-4b40-9a42-83078eb85e31.png,935,481,1022,576,87,95,red blood cell,8265,1.0919540229885059,0.9157894736842105
11099,/images/98175327-da9e-4e0c-8912-ee68490a4672.png,644,605,756,711,112,106,red blood cell,11872,0.9464285714285714,1.0566037735849056
58005,/images/a7c91b63-b97c-4f4b-8d34-7ad2b08d7a17.png,241,564,341,680,100,116,red blood cell,11600,1.16,0.8620689655172413
9748,/images/3859deaf-6ae1-49a3-9051-898d0f0d7de6.png,54,653,167,756,113,103,red blood cell,11639,0.911504424778761,1.0970873786407767
13706,/images/0b04ec46-5119-4cda-8c35-c4e5b6f0eed0.png,57,1149,167,1258,110,109,red blood cell,11990,0.990909090909091,1.0091743119266054
77596,/images/f20a4fcf-ea8e-4c14-883d-d26a9e08ce25.png,603,1442,693,1540,90,98,red blood cell,8820,1.0888888888888888,0.9183673469387755
67511,/images/45902b63-be9a-49ae-9ede-3a8015671bc4.png,722,1073,828,1171,106,98,red blood cell,10388,0.9245283018867925,1.0816326530612246
56040,/images/177a3141-fa93-426a-9b52-7da71547ce44.png,471,1343,582,1432,111,89,red blood cell,9879,0.8018018018018018,1.247191011235955
44336,/images/415409ac-97b3-4cd9-b203-11ef00662352.png,748,605,878,711,130,106,red blood cell,13780,0.8153846153846154,1.2264150943396226
15240,/images/dd7142e4-2d86-4170-a41f-e825743e8907.png,1061,115,1176,248,115,133,red blood cell,15295,1.1565217391304348,0.8646616541353384
32372,/images/a6526894-e290-482d-ac43-f1df34864817.png,763,1172,871,1278,108,106,red blood cell,11448,0.9814814814814815,1.0188679245283019
72921,/images/a20d0b4b-6e2e-4507-bc22-f321dedc4ed9.png,1006,230,1109,338,103,108,red blood cell,11124,1.0485436893203883,0.9537037037037037
11646,/images/0ed416f9-7c20-4829-9016-559e4009568e.png,667,965,791,1067,124,102,red blood cell,12648,0.8225806451612904,1.2156862745098038
72685,/images/6ab870ba-b24b-49a9-9570-8eafe63aa74e.png,883,1448,993,1536,110,88,red blood cell,9680,0.8,1.25
25454,/images/5f742392-278d-461c-a848-08def2c28878.png,825,25,950,138,125,113,red blood cell,14125,0.904,1.1061946902654867
79651,/images/a4409217-be11-4478-90a5-b406057d154d.png,236,315,357,420,121,105,red blood cell,12705,0.8677685950413223,1.1523809523809523
54636,/images/6473ddb6-ad56-48a2-81e8-c7cb45f06825.png,862,1224,972,1329,110,105,red blood cell,11550,0.9545454545454546,1.0476190476190477
62742,/images/e1937e32-85d5-4cd8-bb4a-b9cf8ee7ceeb.png,401,226,501,329,100,103,red blood cell,10300,1.03,0.970873786407767
43281,/images/36569710-a574-40be-ad42-897a6e74a128.png,453,418,567,524,114,106,red blood cell,12084,0.9298245614035088,1.0754716981132075
19061,/images/6e39fb0a-aa41-4b16-b783-7589e97bf289.png,855,1084,992,1214,137,130,red blood cell,17810,0.948905109489051,1.0538461538461539
63162,/images/f0804a5e-e7f5-4cf2-a5df-b65e66502bf1.png,992,971,1106,1095,114,124,red blood cell,14136,1.087719298245614,0.9193548387096774
55372,/images/4fb83278-adc5-4424-9f45-b6d0db2955b6.png,607,1451,719,1575,112,124,red blood cell,13888,1.1071428571428572,0.9032258064516129
66027,/images/25c6cfb1-01d0-4864-87f9-02b7593683c7.png,497,1004,581,1097,84,93,red blood cell,7812,1.1071428571428572,0.9032258064516129
78896,/images/4d0a1598-e4dd-45c4-8a90-dd7c780fe1da.png,623,831,729,942,106,111,red blood cell,11766,1.0471698113207548,0.954954954954955
43379,/images/aabca37c-f9ef-4415-aab6-3246caa348e9.png,357,869,460,992,103,123,red blood cell,12669,1.1941747572815533,0.8373983739837398
65925,/images/d7581cb0-7a12-471d-a3d8-68dcea362213.png,521,841,607,930,86,89,red blood cell,7654,1.0348837209302326,0.9662921348314607
30503,/images/5955289d-19e5-45ef-a012-c8ea08ef45e2.png,1010,536,1132,659,122,123,red blood cell,15006,1.0081967213114753,0.991869918699187
54153,/images/c415532c-4cce-4580-9fcd-623c172a1abd.png,917,1119,1032,1227,115,108,red blood cell,12420,0.9391304347826087,1.0648148148148149
522,/images/67acd5bc-4658-4c6e-a9b9-cd8ea3a03418.png,869,126,992,240,123,114,red blood cell,14022,0.926829268292683,1.0789473684210527
19624,/images/a3ada657-de00-44db-b1e2-54ba17e39983.png,577,1024,703,1147,126,123,red blood cell,15498,0.9761904761904762,1.024390243902439
61667,/images/a3c0a876-be12-4ede-8aed-18b32a64401b.png,757,1026,873,1137,116,111,red blood cell,12876,0.9568965517241379,1.045045045045045
24077,/images/5107dcb7-164f-4e10-bbff-822b39b76efc.png,1017,652,1125,769,108,117,red blood cell,12636,1.0833333333333333,0.9230769230769231
13294,/images/030f3421-ed3f-4bf1-8f27-4d02590bffbc.png,155,215,267,325,112,110,red blood cell,12320,0.9821428571428571,1.018181818181818
66891,/images/9acf303a-fcba-4e52-be3e-8d061aa5e72a.png,987,1079,1095,1179,108,100,red blood cell,10800,0.9259259259259259,1.08
7577,/images/071901eb-4c3f-404b-a747-3d0b9d0a5158.png,975,1020,1078,1114,103,94,red blood cell,9682,0.912621359223301,1.0957446808510638
40523,/images/e3ade58d-086c-47fa-9120-76beacb45395.png,1026,598,1145,715,119,117,red blood cell,13923,0.9831932773109243,1.017094017094017
14131,/images/eaf4b781-b3aa-41ce-8c5e-287979b4e15a.png,363,1500,460,1596,97,96,red blood cell,9312,0.9896907216494846,1.0104166666666667
17651,/images/70a95e58-ba60-4c1f-adcd-49c198dc2ba0.png,218,1278,297,1362,79,84,red blood cell,6636,1.0632911392405062,0.9404761904761905
64042,/images/03cbfcf2-8da6-462c-b30d-16d63357371f.png,987,493,1077,577,90,84,red blood cell,7560,0.9333333333333333,1.0714285714285714
17066,/images/57e1879e-4294-45e7-9c1b-627e8cca0271.png,556,466,661,584,105,118,red blood cell,12390,1.1238095238095238,0.8898305084745762
25405,/images/5f742392-278d-461c-a848-08def2c28878.png,20,1470,118,1583,98,113,red blood cell,11074,1.153061224489796,0.8672566371681416
31088,/images/9c48fdf4-621d-4f40-bcd7-6a28cd530de7.png,415,50,525,162,110,112,red blood cell,12320,1.018181818181818,0.9821428571428571
33405,/images/f632981c-1330-4078-8a12-691beb2dab02.png,655,667,766,768,111,101,red blood cell,11211,0.9099099099099099,1.099009900990099
17613,/images/70a95e58-ba60-4c1f-adcd-49c198dc2ba0.png,300,741,405,842,105,101,red blood cell,10605,0.9619047619047619,1.0396039603960396
28996,/images/4c13e22e-dfd1-4fa1-b373-be9d0c272c0f.png,17,880,120,973,103,93,red blood cell,9579,0.9029126213592233,1.10752688172043
62203,/images/a72cd558-b7ac-4bf2-a344-2ce6c73a354e.png,774,707,872,815,98,108,red blood cell,10584,1.1020408163265305,0.9074074074074074
50302,/images/3d32a988-449d-4d58-b71f-abbfdc3f2fbc.png,400,334,500,423,100,89,red blood cell,8900,0.89,1.1235955056179776
77868,/images/464055b6-3351-4636-a919-8be9840fb850.png,836,876,941,976,105,100,red blood cell,10500,0.9523809523809523,1.05
70235,/images/a5c3b3f8-7ceb-4573-a400-a76b9479af46.png,546,1096,653,1208,107,112,red blood cell,11984,1.0467289719626167,0.9553571428571429
35183,/images/bfc61c48-685d-470b-86b1-e4c7eb85c4fd.png,756,832,879,966,123,134,red blood cell,16482,1.089430894308943,0.917910447761194
55994,/images/4c460388-e0c1-4970-8527-c9e5b42bea49.png,1013,1168,1131,1273,118,105,red blood cell,12390,0.8898305084745762,1.1238095238095238
33877,/images/1a332b2c-9d49-4ff2-810c-5633d2314527.png,497,1298,622,1412,125,114,red blood cell,14250,0.912,1.0964912280701755
27937,/images/46f5bd4f-8bea-48d1-a1da-4dea28e3b814.png,541,1133,661,1253,120,120,red blood cell,14400,1.0,1.0
3099,/images/14efbfc8-39f6-4599-9994-a8cc95605b9c.png,597,1285,724,1395,127,110,red blood cell,13970,0.8661417322834646,1.1545454545454545
61253,/images/b3058064-d817-47dd-a8c4-cdb1f62374f8.png,811,220,935,332,124,112,red blood cell,13888,0.9032258064516129,1.1071428571428572
20489,/images/b809b407-7b69-4334-873d-d6c49135f04a.png,1013,1051,1146,1159,133,108,red blood cell,14364,0.8120300751879699,1.2314814814814814
8546,/images/a6aa3b72-2970-4c78-b655-ea8dfe6e018c.png,310,517,409,603,99,86,red blood cell,8514,0.8686868686868687,1.1511627906976745
41436,/images/c4494d4f-732f-431a-8a9d-62403f0b74fe.png,1074,897,1176,1015,102,118,red blood cell,12036,1.1568627450980393,0.864406779661017
38329,/images/674b0fd3-f247-4b7f-97f7-3e6c57c9ba9e.png,619,1029,721,1122,102,93,red blood cell,9486,0.9117647058823529,1.096774193548387
1165,/images/4411fea2-d785-4eeb-80c6-c739ab6114c4.png,1061,1006,1183,1125,122,119,red blood cell,14518,0.9754098360655737,1.0252100840336134
26599,/images/5893e081-04f2-4e33-9851-bed5f0e4d333.png,859,456,965,567,106,111,red blood cell,11766,1.0471698113207548,0.954954954954955
78408,/images/fe00fa09-d3c8-485b-9d0f-3cce556c9edd.png,338,300,448,426,110,126,red blood cell,13860,1.1454545454545455,0.873015873015873
4074,/images/e02edd82-c424-4dee-98a7-575640655d9b.png,912,972,1034,1088,122,116,red blood cell,14152,0.9508196721311475,1.0517241379310345
8318,/images/65e3d6a6-012c-4b40-9a42-83078eb85e31.png,96,798,192,901,96,103,red blood cell,9888,1.0729166666666667,0.9320388349514563
48207,/images/913099c5-8085-4908-bf4b-1f098bbfcf66.png,222,1253,324,1351,102,98,red blood cell,9996,0.9607843137254902,1.0408163265306123
72486,/images/22516db4-8687-4051-90c4-2bb1ca3204a5.png,544,345,642,435,98,90,red blood cell,8820,0.9183673469387755,1.0888888888888888
1367,/images/6d91d1f0-636b-4f5a-a526-7c17fc857190.png,907,149,1003,236,96,87,red blood cell,8352,0.90625,1.103448275862069
11104,/images/98175327-da9e-4e0c-8912-ee68490a4672.png,315,913,426,1016,111,103,red blood cell,11433,0.9279279279279279,1.0776699029126213
32679,/images/0154dd8e-72f8-4d78-a4dd-93e139577bd1.png,503,1159,609,1287,106,128,red blood cell,13568,1.2075471698113207,0.828125
27919,/images/46f5bd4f-8bea-48d1-a1da-4dea28e3b814.png,683,1049,803,1146,120,97,red blood cell,11640,0.8083333333333333,1.2371134020618557
50786,/images/db0a1123-0b35-48d7-8337-3b1ebd6af0cc.png,469,672,574,765,105,93,red blood cell,9765,0.8857142857142857,1.1290322580645162
70577,/images/8cca114a-ed05-4b87-95b7-fae02487f08c.png,617,213,697,297,80,84,red blood cell,6720,1.05,0.9523809523809523
66079,/images/c8af0297-ce1f-40ea-bf44-9256dcdae4e9.png,39,1348,153,1452,114,104,red blood cell,11856,0.9122807017543859,1.0961538461538463
11309,/images/6303f964-98ef-47c6-bb2d-283aa393f918.png,428,276,517,352,89,76,red blood cell,6764,0.8539325842696629,1.1710526315789473
19585,/images/883d9731-a04d-4f84-83c9-d3bef954759d.png,415,84,537,185,122,101,red blood cell,12322,0.8278688524590164,1.2079207920792079
10328,/images/affa429c-0315-4c18-a002-13bb3ecab259.png,959,362,1074,494,115,132,red blood cell,15180,1.1478260869565218,0.8712121212121212
31200,/images/1976cd04-d24f-457c-b423-7e4cdb05de9e.png,20,1289,137,1401,117,112,red blood cell,13104,0.9572649572649573,1.0446428571428572
3332,/images/b1100ae1-0ac8-4fc2-b0ff-8819f7fbe724.png,228,1030,345,1163,117,133,red blood cell,15561,1.1367521367521367,0.8796992481203008
58217,/images/2f68686f-1fe8-46e7-ad92-a08e3523ea79.png,265,77,351,180,86,103,red blood cell,8858,1.197674418604651,0.8349514563106796
73033,/images/2bd26501-2fbc-4c1a-bef0-4ad57e02b4d0.png,731,924,817,1008,86,84,red blood cell,7224,0.9767441860465116,1.0238095238095237
2884,/images/a1c140f9-75d7-42a3-b767-4c01a118892b.png,342,1216,458,1350,116,134,red blood cell,15544,1.1551724137931034,0.8656716417910447
40184,/images/ef1a9020-5e45-450d-a237-165114308592.png,583,513,698,625,115,112,red blood cell,12880,0.9739130434782609,1.0267857142857142
58646,/images/a4d7a7e1-5ae1-486d-b6ee-c9af1476ccad.png,388,114,462,197,74,83,red blood cell,6142,1.1216216216216217,0.891566265060241
54350,/images/19370afd-f897-47d8-bfae-c0d257bbf795.png,205,981,312,1088,107,107,red blood cell,11449,1.0,1.0
17291,/images/3d302619-473d-4c5b-af43-8833ff94233f.png,723,1393,849,1500,126,107,red blood cell,13482,0.8492063492063492,1.1775700934579438
78302,/images/24115f58-a7d6-4022-a95a-86b515a78d3e.png,840,552,946,654,106,102,red blood cell,10812,0.9622641509433962,1.0392156862745099
15671,/images/3892b776-f49a-4368-b0fa-7e855e76ccec.png,92,504,190,607,98,103,red blood cell,10094,1.0510204081632653,0.9514563106796117
5279,/images/729733ff-a349-4a96-b636-ccabe7d7e167.png,438,604,543,701,105,97,red blood cell,10185,0.9238095238095239,1.0824742268041236
23371,/images/a7688988-2bcc-4458-83d3-5e482da5f87b.png,368,710,469,819,101,109,red blood cell,11009,1.0792079207920793,0.926605504587156
12588,/images/8e4bdd0d-1c72-4836-ae3e-05e2e50e4983.png,630,934,731,1033,101,99,red blood cell,9999,0.9801980198019802,1.02020202020202
7760,/images/e726dac6-f962-449c-acff-4dd56847b685.png,348,905,450,1005,102,100,red blood cell,10200,0.9803921568627451,1.02
3632,/images/8bd71314-e38a-4670-bb25-5cd6c9acb595.png,929,679,1044,787,115,108,red blood cell,12420,0.9391304347826087,1.0648148148148149
36156,/images/749df49e-5212-49ea-9e88-7d66f258f1df.png,845,750,954,874,109,124,red blood cell,13516,1.1376146788990826,0.8790322580645161
48114,/images/05717db9-f1ef-4101-a9f7-7a007e83b1c9.png,29,892,150,1001,121,109,red blood cell,13189,0.9008264462809917,1.110091743119266
37544,/images/205306da-0ed8-475a-ace6-f2f81d4be88a.png,393,879,486,968,93,89,red blood cell,8277,0.956989247311828,1.0449438202247192
10304,/images/f91670db-be74-474c-bd72-68120aed4756.png,205,37,326,137,121,100,red blood cell,12100,0.8264462809917356,1.21
54358,/images/19370afd-f897-47d8-bfae-c0d257bbf795.png,856,1305,958,1406,102,101,red blood cell,10302,0.9901960784313726,1.00990099009901
43259,/images/fe1ee954-ba71-47b3-954a-d20ab940cd7b.png,421,1437,538,1554,117,117,red blood cell,13689,1.0,1.0
25674,/images/c118ff18-f9f2-4617-bddb-dc4091fb8f5f.png,977,1088,1100,1210,123,122,red blood cell,15006,0.991869918699187,1.0081967213114753
26094,/images/71925778-a26e-483e-a07c-f3aaf740122a.png,152,732,267,861,115,129,red blood cell,14835,1.1217391304347826,0.8914728682170543
52976,/images/e81bf478-27ff-458c-ac30-9e1f8480bc5c.png,743,320,834,421,91,101,red blood cell,9191,1.10989010989011,0.900990099009901
32484,/images/3911fcd2-4e26-4ad9-aaf0-d1c5bf41defc.png,848,1285,949,1399,101,114,red blood cell,11514,1.1287128712871286,0.8859649122807017
29717,/images/f25a2ac8-cb6e-4e05-a0cd-cc00ac47718a.png,799,488,921,612,122,124,red blood cell,15128,1.0163934426229508,0.9838709677419355
20282,/images/c66cb6b2-1480-446a-a9d2-b8032a3de0d7.png,473,225,594,322,121,97,red blood cell,11737,0.8016528925619835,1.2474226804123711
66818,/images/9106a6bb-1352-411f-ac26-0d6fe48c16a8.png,42,1245,147,1345,105,100,red blood cell,10500,0.9523809523809523,1.05
56077,/images/ffb7be9a-65df-4f0b-99ae-cfd34e81cd34.png,623,878,741,1002,118,124,red blood cell,14632,1.0508474576271187,0.9516129032258065
16305,/images/d5009906-bce1-4353-90b4-f4c79362f4cf.png,905,48,1010,170,105,122,red blood cell,12810,1.161904761904762,0.860655737704918
73376,/images/c890ee00-daa5-4b20-9cd5-930748ecc4e0.png,922,1209,1009,1301,87,92,red blood cell,8004,1.0574712643678161,0.9456521739130435
55398,/images/d67655e6-0a80-4a86-b552-1f5e85788377.png,13,145,128,248,115,103,red blood cell,11845,0.8956521739130435,1.116504854368932
71418,/images/bcb447c9-5d37-414f-a513-d7076b04a532.png,185,549,284,651,99,102,red blood cell,10098,1.0303030303030303,0.9705882352941176
37898,/images/56a57a8d-c9b9-432a-a3b0-32a09355806c.png,688,1209,775,1307,87,98,red blood cell,8526,1.1264367816091954,0.8877551020408163
54215,/images/3b5a8060-dec6-4a83-b7f2-b604e4e69dfc.png,969,1225,1066,1328,97,103,red blood cell,9991,1.0618556701030928,0.941747572815534
11203,/images/6303f964-98ef-47c6-bb2d-283aa393f918.png,845,932,950,1039,105,107,red blood cell,11235,1.019047619047619,0.9813084112149533
8134,/images/694222bb-cddf-469a-9526-f873c6fba58e.png,304,869,402,985,98,116,red blood cell,11368,1.183673469387755,0.8448275862068966
44651,/images/8002cb71-0f25-4fa4-a46f-b49e5aeded0c.png,873,151,984,276,111,125,red blood cell,13875,1.1261261261261262,0.888
31582,/images/0d7bf56f-3b5a-40bd-971c-2ca33dd89b2c.png,868,291,973,398,105,107,red blood cell,11235,1.019047619047619,0.9813084112149533
18480,/images/9b410534-3b70-4a88-9f93-205cf4e55a05.png,865,100,973,218,108,118,red blood cell,12744,1.0925925925925926,0.9152542372881356
56979,/images/003d1cdc-0aec-430b-90e0-f4d82135b1ac.png,1052,628,1165,766,113,138,red blood cell,15594,1.2212389380530972,0.8188405797101449
73801,/images/3eba916c-998b-40a7-993c-7ed916c2a04c.png,1083,751,1186,853,103,102,red blood cell,10506,0.9902912621359223,1.0098039215686274
55075,/images/1f8f08ea-b5b3-4f68-94d4-3cc071b7dce8.png,757,301,858,399,101,98,red blood cell,9898,0.9702970297029703,1.030612244897959
25230,/images/90171428-f208-428a-b40e-f57ee3bea457.png,320,97,418,198,98,101,red blood cell,9898,1.030612244897959,0.9702970297029703
25312,/images/587e5464-d70b-4279-8562-010279f6efbd.png,842,906,979,1029,137,123,red blood cell,16851,0.8978102189781022,1.113821138211382
54955,/images/f1872d08-f8a6-4b21-aa29-f56bbf607883.png,534,115,643,234,109,119,red blood cell,12971,1.091743119266055,0.9159663865546218
69854,/images/9edba799-e169-46cd-b100-c9f8fc7a8c7d.png,456,319,563,427,107,108,red blood cell,11556,1.0093457943925233,0.9907407407407407
768,/images/27fab82c-5bf0-426f-aeb9-47da829b6629.png,124,340,216,436,92,96,red blood cell,8832,1.0434782608695652,0.9583333333333334
56209,/images/b600b38d-225b-46a5-b6f8-b607430f6a10.png,909,1035,1010,1160,101,125,red blood cell,12625,1.2376237623762376,0.808
25958,/images/e683144c-0465-43a2-86b1-3cf52599d5e0.png,969,238,1070,353,101,115,red blood cell,11615,1.1386138613861385,0.8782608695652174
15267,/images/2d0f600d-f94e-4907-b712-52fb37d9ed52.png,134,1136,254,1250,120,114,red blood cell,13680,0.95,1.0526315789473684
40619,/images/252071ac-e9f2-41d2-abbb-87ef01b8a997.png,653,699,762,798,109,99,red blood cell,10791,0.908256880733945,1.101010101010101
49361,/images/28c96a4a-4549-4761-99e4-ace4ea7e7ac9.png,472,15,591,125,119,110,red blood cell,13090,0.9243697478991597,1.0818181818181818
51574,/images/d0347b49-8f98-4632-a384-1a4f57ac6374.png,434,55,536,162,102,107,red blood cell,10914,1.0490196078431373,0.9532710280373832
61522,/images/7e837856-3519-4dc0-b357-4cdcfd30b4eb.png,2,1206,84,1296,82,90,red blood cell,7380,1.0975609756097562,0.9111111111111111
33668,/images/84ee2ea3-9edd-4672-a1b3-f09c607d833a.png,3,1471,111,1574,108,103,red blood cell,11124,0.9537037037037037,1.0485436893203883
52568,/images/0546d843-d778-4aca-b8b5-bfe23d7c87da.png,335,1026,432,1125,97,99,red blood cell,9603,1.0206185567010309,0.9797979797979798
37843,/images/56a57a8d-c9b9-432a-a3b0-32a09355806c.png,567,720,672,820,105,100,red blood cell,10500,0.9523809523809523,1.05
3746,/images/dacf7e3f-1d8c-42a0-8539-3abe3971c956.png,736,30,849,148,113,118,red blood cell,13334,1.0442477876106195,0.9576271186440678
11246,/images/6303f964-98ef-47c6-bb2d-283aa393f918.png,907,1397,1010,1481,103,84,red blood cell,8652,0.8155339805825242,1.2261904761904763
60965,/images/5397d8e2-bb09-42e7-9861-65ffad0fe94e.png,337,1412,460,1512,123,100,red blood cell,12300,0.8130081300813008,1.23
46970,/images/9ebd623d-5534-4dd9-bff8-cdedf322db35.png,526,259,640,378,114,119,red blood cell,13566,1.043859649122807,0.957983193277311
13363,/images/a7f1bbb1-6058-4642-bd66-cfb90dce762e.png,203,526,310,643,107,117,red blood cell,12519,1.0934579439252337,0.9145299145299145
27955,/images/46f5bd4f-8bea-48d1-a1da-4dea28e3b814.png,1034,840,1160,954,126,114,red blood cell,14364,0.9047619047619048,1.105263157894737
6571,/images/640c4a52-3742-4f57-aee3-9e3dc0887622.png,334,1372,430,1454,96,82,red blood cell,7872,0.8541666666666666,1.170731707317073
20710,/images/79b3a64f-2fb9-46e0-85d4-2bdd59c2075e.png,252,1238,355,1331,103,93,red blood cell,9579,0.9029126213592233,1.10752688172043
75869,/images/3006096f-ceeb-42be-b69e-785179d7438b.png,614,1007,734,1112,120,105,red blood cell,12600,0.875,1.1428571428571428
25991,/images/e683144c-0465-43a2-86b1-3cf52599d5e0.png,952,2,1055,103,103,101,red blood cell,10403,0.9805825242718447,1.0198019801980198
20512,/images/cbde7f7e-2458-4dda-9db2-3d5ccf950ced.png,351,1043,486,1171,135,128,red blood cell,17280,0.9481481481481482,1.0546875
14606,/images/c649e1cb-4029-4433-b231-d67d68f7391a.png,610,200,745,317,135,117,red blood cell,15795,0.8666666666666667,1.1538461538461537
13917,/images/de00f9a5-aa8b-4679-8ec6-85528a942d6f.png,319,128,423,243,104,115,red blood cell,11960,1.1057692307692308,0.9043478260869565
34927,/images/a4fbb9f2-9b75-4fdc-877d-2feaafac25b3.png,214,667,336,782,122,115,red blood cell,14030,0.9426229508196722,1.0608695652173914
8990,/images/ef815e3a-02a6-4cf8-9262-45bc74c50b00.png,129,1292,240,1401,111,109,red blood cell,12099,0.9819819819819819,1.018348623853211
42235,/images/ca734448-0d52-42fa-b41c-17b2939e58ae.png,944,1009,1061,1124,117,115,red blood cell,13455,0.9829059829059829,1.017391304347826
71716,/images/5c99cd97-39f6-4809-9528-9d380cc16b16.png,276,1355,367,1430,91,75,red blood cell,6825,0.8241758241758241,1.2133333333333334
11796,/images/082e1f81-4f49-44ad-b5bb-9dfc155b2ed8.png,39,648,152,747,113,99,red blood cell,11187,0.8761061946902655,1.1414141414141414
10507,/images/46a2d369-4bea-4405-ac78-91bbe130b9a7.png,668,1412,752,1500,84,88,red blood cell,7392,1.0476190476190477,0.9545454545454546
9956,/images/b9ccf7ca-953f-4832-9575-5e70b2a8c224.png,260,439,357,538,97,99,red blood cell,9603,1.0206185567010309,0.9797979797979798
33054,/images/6231d81d-9e84-4a5a-8cb8-47c6a37a0176.png,82,1284,181,1391,99,107,red blood cell,10593,1.0808080808080809,0.9252336448598131
54837,/images/b6364a57-72a9-43f3-8d02-9f53a992dc95.png,505,968,599,1076,94,108,red blood cell,10152,1.148936170212766,0.8703703703703703
11959,/images/f8a8b148-60e4-4a5c-ae19-941b19ec0846.png,741,1300,858,1405,117,105,red blood cell,12285,0.8974358974358975,1.1142857142857143
69355,/images/2ac343e4-c889-47c1-8fe2-461b626def76.png,524,640,651,755,127,115,red blood cell,14605,0.905511811023622,1.1043478260869566
78566,/images/c5084fb8-2b62-464c-8a77-1a07ea653266.png,958,316,1076,426,118,110,red blood cell,12980,0.9322033898305084,1.0727272727272728
71358,/images/bcb447c9-5d37-414f-a513-d7076b04a532.png,964,1179,1075,1286,111,107,red blood cell,11877,0.963963963963964,1.0373831775700935
8119,/images/694222bb-cddf-469a-9526-f873c6fba58e.png,155,1428,265,1536,110,108,red blood cell,11880,0.9818181818181818,1.0185185185185186
70431,/images/8cca114a-ed05-4b87-95b7-fae02487f08c.png,129,62,242,161,113,99,red blood cell,11187,0.8761061946902655,1.1414141414141414
29087,/images/4c13e22e-dfd1-4fa1-b373-be9d0c272c0f.png,789,1506,882,1598,93,92,red blood cell,8556,0.989247311827957,1.0108695652173914
18287,/images/947348fe-4c70-468e-8009-3c14daeca69b.png,41,1200,132,1303,91,103,red blood cell,9373,1.1318681318681318,0.883495145631068
79246,/images/05ac7b2a-6a77-4464-926b-8570f7c01693.png,838,1028,930,1122,92,94,red blood cell,8648,1.0217391304347827,0.9787234042553191
27022,/images/ec301f62-1302-4407-96f9-fcfe45c150ae.png,812,1458,932,1573,120,115,red blood cell,13800,0.9583333333333334,1.0434782608695652
41817,/images/c3b07675-9d02-477c-91fe-f0737867049b.png,1055,348,1183,472,128,124,red blood cell,15872,0.96875,1.032258064516129
23148,/images/c94a5851-b846-4fde-8c89-05bec3a8ac53.png,470,110,574,199,104,89,red blood cell,9256,0.8557692307692307,1.1685393258426966
52690,/images/9dc6ed5d-6698-48cf-aab3-fd156673729c.png,539,725,653,827,114,102,red blood cell,11628,0.8947368421052632,1.1176470588235294
70706,/images/8ab5c462-045e-4b59-b53a-9b2bc3ed2487.png,20,452,115,555,95,103,red blood cell,9785,1.0842105263157895,0.9223300970873787
79368,/images/dcb21739-3c36-459d-b3cc-1be5871d6fe7.png,817,365,925,480,108,115,red blood cell,12420,1.0648148148148149,0.9391304347826087
2460,/images/fe851c88-692d-4199-87e0-d19d9c4eb591.png,164,1236,261,1321,97,85,red blood cell,8245,0.8762886597938144,1.1411764705882352
71396,/images/bcb447c9-5d37-414f-a513-d7076b04a532.png,990,497,1094,605,104,108,red blood cell,11232,1.0384615384615385,0.9629629629629629
63758,/images/06401963-8b02-46c5-ab2a-3d70bd01623f.png,332,1024,418,1119,86,95,red blood cell,8170,1.1046511627906976,0.9052631578947369
662,/images/e61e6af2-7f8b-47b0-bbe7-acb2ed0299ab.png,529,403,629,492,100,89,red blood cell,8900,0.89,1.1235955056179776
59002,/images/597bbff8-6592-41cf-8946-e59b0d1f289a.png,747,695,860,813,113,118,red blood cell,13334,1.0442477876106195,0.9576271186440678
74850,/images/81edcae1-65bf-4752-b0e4-494376b71e49.png,603,674,705,783,102,109,red blood cell,11118,1.0686274509803921,0.9357798165137615
55903,/images/afd39466-aafa-4d81-9520-483727418723.png,832,1277,945,1385,113,108,red blood cell,12204,0.9557522123893806,1.0462962962962963
61303,/images/b3058064-d817-47dd-a8c4-cdb1f62374f8.png,354,850,446,965,92,115,red blood cell,10580,1.25,0.8
61464,/images/7e837856-3519-4dc0-b357-4cdcfd30b4eb.png,133,1499,234,1596,101,97,red blood cell,9797,0.9603960396039604,1.041237113402062
12034,/images/b234b6ea-b54d-470c-8461-ba7f4a024796.png,220,597,333,716,113,119,red blood cell,13447,1.0530973451327434,0.9495798319327731
66241,/images/e8058bed-c362-4e1c-85dc-62f80f32938f.png,736,437,842,526,106,89,red blood cell,9434,0.839622641509434,1.1910112359550562
16191,/images/1e978dfa-d339-4025-809d-09cee76728ed.png,900,681,1022,780,122,99,red blood cell,12078,0.8114754098360656,1.2323232323232323
42730,/images/b8dd6125-5027-47e2-a283-14e199274c80.png,527,685,666,810,139,125,red blood cell,17375,0.8992805755395683,1.112
17276,/images/3d302619-473d-4c5b-af43-8833ff94233f.png,332,774,428,875,96,101,red blood cell,9696,1.0520833333333333,0.9504950495049505
21797,/images/f68ae8e9-e760-4106-88e0-4bdef2785f06.png,379,1476,496,1587,117,111,red blood cell,12987,0.9487179487179487,1.054054054054054
1004,/images/63d36d2c-43a9-49ac-9504-028b4968c860.png,550,656,666,759,116,103,red blood cell,11948,0.8879310344827587,1.1262135922330097
51505,/images/baa87bf8-786c-444c-81e8-9fa0a41d8149.png,613,653,711,761,98,108,red blood cell,10584,1.1020408163265305,0.9074074074074074
41769,/images/32a1ea24-b6b7-4253-ad3e-bdf99c2c9b9d.png,534,393,648,501,114,108,red blood cell,12312,0.9473684210526315,1.0555555555555556
66307,/images/fcdf6632-c03f-49a8-9fb3-42e87c99b9d0.png,620,1426,723,1522,103,96,red blood cell,9888,0.9320388349514563,1.0729166666666667
59202,/images/4736f545-1f1f-4d77-9241-d69cbf4dae35.png,185,711,265,807,80,96,red blood cell,7680,1.2,0.8333333333333334
48123,/images/05717db9-f1ef-4101-a9f7-7a007e83b1c9.png,446,1243,552,1363,106,120,red blood cell,12720,1.1320754716981132,0.8833333333333333
60022,/images/49288109-80e9-4ec8-96d1-26a0166b8883.png,808,175,904,268,96,93,red blood cell,8928,0.96875,1.032258064516129
72229,/images/7d4d0646-26b5-46fa-ab25-452d986e887b.png,133,478,220,561,87,83,red blood cell,7221,0.9540229885057471,1.0481927710843373
6859,/images/b21f6c6e-4b45-407a-b4c7-034a115f3ee4.png,604,364,727,486,123,122,red blood cell,15006,0.991869918699187,1.0081967213114753
69629,/images/4a49841f-216c-4815-8140-b8762c4f6603.png,358,795,440,882,82,87,red blood cell,7134,1.0609756097560976,0.9425287356321839
70024,/images/3e36698f-8c09-4c8b-8948-737310bf97e5.png,76,833,177,941,101,108,red blood cell,10908,1.0693069306930694,0.9351851851851852
23554,/images/177f883a-f0f1-4b8e-b598-2ca4bab27381.png,510,23,638,138,128,115,red blood cell,14720,0.8984375,1.1130434782608696
32710,/images/0154dd8e-72f8-4d78-a4dd-93e139577bd1.png,568,941,669,1041,101,100,red blood cell,10100,0.9900990099009901,1.01
77295,/images/07a80340-f65e-4f58-9317-94bb6ebd5a28.png,138,159,238,246,100,87,red blood cell,8700,0.87,1.1494252873563218
3413,/images/fd1302e2-3cd2-4a1a-9c13-00f810a9c41b.png,767,500,867,605,100,105,red blood cell,10500,1.05,0.9523809523809523
61112,/images/80da32ce-8c22-470e-9f35-558c5f7a5df9.png,406,702,513,814,107,112,red blood cell,11984,1.0467289719626167,0.9553571428571429
35813,/images/bb2042c5-35e1-43cc-8171-7de81b764361.png,710,1289,798,1374,88,85,red blood cell,7480,0.9659090909090909,1.035294117647059
64377,/images/0a7bfa8a-ee52-4f7a-b9c5-2919ecfa93ef.png,718,1354,804,1439,86,85,red blood cell,7310,0.9883720930232558,1.011764705882353
7502,/images/071901eb-4c3f-404b-a747-3d0b9d0a5158.png,288,599,392,712,104,113,red blood cell,11752,1.0865384615384615,0.9203539823008849
29879,/images/bc1a58fd-736b-4812-a051-2c376cff50b7.png,113,1454,242,1572,129,118,red blood cell,15222,0.9147286821705426,1.0932203389830508
39252,/images/f7cced00-9b41-45ec-9fdf-fb9e1a74da90.png,187,61,302,181,115,120,red blood cell,13800,1.0434782608695652,0.9583333333333334
69768,/images/2bd15b6e-fe2d-49f3-b394-940d024d1f91.png,220,1350,320,1440,100,90,red blood cell,9000,0.9,1.1111111111111112
54709,/images/6473ddb6-ad56-48a2-81e8-c7cb45f06825.png,908,464,996,546,88,82,red blood cell,7216,0.9318181818181818,1.0731707317073171
39637,/images/04d21589-b777-43c2-86b5-038cbf8c3a4e.png,770,1085,884,1187,114,102,red blood cell,11628,0.8947368421052632,1.1176470588235294
62820,/images/631340cc-cedf-4bca-a3d8-a0731a5482b4.png,55,1449,143,1540,88,91,red blood cell,8008,1.0340909090909092,0.967032967032967
41568,/images/0fcd1ebe-ee4a-40a0-b787-29cee18bfa1b.png,242,697,334,796,92,99,red blood cell,9108,1.076086956521739,0.9292929292929293
33719,/images/441d7843-b20b-4c10-84e3-e6d32621e880.png,512,320,612,418,100,98,red blood cell,9800,0.98,1.0204081632653061
35583,/images/a1ff36df-71df-4e6e-a65f-ced9a2b381c3.png,68,235,188,356,120,121,red blood cell,14520,1.0083333333333333,0.9917355371900827
13759,/images/1b369bcf-ced4-4ae2-9196-2664bd2b1738.png,837,986,951,1096,114,110,red blood cell,12540,0.9649122807017544,1.0363636363636364
74317,/images/8939e14b-fcdf-48b1-acb9-6514a2fc2fc0.png,656,95,739,198,83,103,red blood cell,8549,1.2409638554216869,0.8058252427184466
23268,/images/157ac97a-396e-4f6c-94c6-72a4d06ccc5f.png,91,1014,217,1125,126,111,red blood cell,13986,0.8809523809523809,1.135135135135135
7226,/images/89f10192-d3dd-4996-a571-4c851dbdc983.png,583,123,675,213,92,90,red blood cell,8280,0.9782608695652174,1.0222222222222221
55199,/images/9c5f48c0-0544-4c0c-92b4-59b7d7b7814c.png,11,833,124,936,113,103,red blood cell,11639,0.911504424778761,1.0970873786407767
65581,/images/01b38a56-13eb-447b-89ee-fc21cb40dcc1.png,621,791,715,889,94,98,red blood cell,9212,1.0425531914893618,0.9591836734693877
26580,/images/4935818a-7e7a-4f44-a3b6-b361d1abfe16.png,277,101,406,224,129,123,red blood cell,15867,0.9534883720930233,1.048780487804878
46279,/images/815bf40c-371a-4d34-aa41-c549c8221881.png,628,568,743,677,115,109,red blood cell,12535,0.9478260869565217,1.055045871559633
8747,/images/29dc8176-dfe1-40e0-8247-2dc3c530057e.png,979,139,1098,254,119,115,red blood cell,13685,0.9663865546218487,1.0347826086956522
64771,/images/76021d69-8919-4688-95ef-7418eff620cc.png,839,157,963,267,124,110,red blood cell,13640,0.8870967741935484,1.1272727272727272
61751,/images/985627c9-7b85-40de-a106-eb9cc47b47cb.png,695,1043,804,1157,109,114,red blood cell,12426,1.0458715596330275,0.956140350877193
48189,/images/913099c5-8085-4908-bf4b-1f098bbfcf66.png,350,28,457,148,107,120,red blood cell,12840,1.1214953271028036,0.8916666666666667
28058,/images/f1f9df6d-c4cb-4b42-9ca2-8fb47b1b0e91.png,927,29,1055,156,128,127,red blood cell,16256,0.9921875,1.0078740157480315
70486,/images/8cca114a-ed05-4b87-95b7-fae02487f08c.png,83,380,181,496,98,116,red blood cell,11368,1.183673469387755,0.8448275862068966
60788,/images/645cd195-af50-409f-8da9-6e7c7f18ea09.png,1,771,118,889,117,118,red blood cell,13806,1.0085470085470085,0.9915254237288136
52555,/images/0546d843-d778-4aca-b8b5-bfe23d7c87da.png,913,557,1020,658,107,101,red blood cell,10807,0.9439252336448598,1.0594059405940595
56282,/images/6b473806-e936-4b19-98cf-a2b94cac35ff.png,1009,149,1123,277,114,128,red blood cell,14592,1.1228070175438596,0.890625
31151,/images/1976cd04-d24f-457c-b423-7e4cdb05de9e.png,520,523,644,639,124,116,red blood cell,14384,0.9354838709677419,1.0689655172413792
49230,/images/a9daf82a-a46d-4296-bd72-2c374ed0a193.png,186,11,297,113,111,102,red blood cell,11322,0.918918918918919,1.088235294117647
13658,/images/1e86933d-6a5a-4a3c-a0f2-ca22afd767b3.png,666,47,792,167,126,120,red blood cell,15120,0.9523809523809523,1.05
25808,/images/14b68d86-ac7f-419d-b4a5-6b0b1d9aaa18.png,164,775,288,900,124,125,red blood cell,15500,1.0080645161290323,0.992
43229,/images/fe1ee954-ba71-47b3-954a-d20ab940cd7b.png,579,823,690,944,111,121,red blood cell,13431,1.09009009009009,0.9173553719008265
51326,/images/b4f3b2a4-f4b9-48de-ac5d-0e681b77be27.png,607,809,719,921,112,112,red blood cell,12544,1.0,1.0
79658,/images/a4409217-be11-4478-90a5-b406057d154d.png,90,80,182,190,92,110,red blood cell,10120,1.1956521739130435,0.8363636363636363
39150,/images/7bde7de1-889b-4218-b0e1-e2c04f6a7986.png,1065,1422,1166,1534,101,112,red blood cell,11312,1.108910891089109,0.9017857142857143
56602,/images/a824b499-3736-4581-bbdc-be1b3b4cf756.png,10,998,124,1114,114,116,red blood cell,13224,1.0175438596491229,0.9827586206896551
58391,/images/7eae1169-e294-4594-8e03-1366d23ff2d1.png,423,945,522,1044,99,99,red blood cell,9801,1.0,1.0
43232,/images/fe1ee954-ba71-47b3-954a-d20ab940cd7b.png,688,1054,810,1171,122,117,red blood cell,14274,0.9590163934426229,1.0427350427350428
76867,/images/2165fe38-b474-467d-be11-d1d728085efd.png,431,260,536,378,105,118,red blood cell,12390,1.1238095238095238,0.8898305084745762
32948,/images/d1924af6-7512-4ccc-9c6b-adbbaa8db41f.png,547,815,661,936,114,121,red blood cell,13794,1.0614035087719298,0.9421487603305785
31676,/images/bd432159-5956-457c-bdeb-1b5e702ba513.png,603,839,730,951,127,112,red blood cell,14224,0.8818897637795275,1.1339285714285714
76082,/images/4c7d2382-a962-4237-a053-955eea3decd8.png,981,1262,1090,1354,109,92,red blood cell,10028,0.8440366972477065,1.184782608695652
6746,/images/672e4ecf-a56b-462e-b83b-76f4efaa6634.png,570,975,682,1080,112,105,red blood cell,11760,0.9375,1.0666666666666667
44313,/images/b197093e-2928-46a4-8e35-fa5ea7ea6dac.png,237,1244,371,1373,134,129,red blood cell,17286,0.9626865671641791,1.0387596899224807
9388,/images/e3a4b3e7-9500-4b6c-a402-b6d3f45e714b.png,833,100,948,231,115,131,red blood cell,15065,1.1391304347826088,0.8778625954198473
60220,/images/214f1d15-a081-476e-992d-6c3a77f03d59.png,49,1114,146,1209,97,95,red blood cell,9215,0.979381443298969,1.0210526315789474
53310,/images/d8f7e159-b7e3-49e4-86e8-aed8c5fbcd97.png,821,1486,923,1589,102,103,red blood cell,10506,1.0098039215686274,0.9902912621359223
5242,/images/729733ff-a349-4a96-b636-ccabe7d7e167.png,824,646,940,761,116,115,red blood cell,13340,0.9913793103448276,1.008695652173913
63788,/images/6013bff0-dc4b-4bde-9409-0f6139c3495c.png,12,345,115,444,103,99,red blood cell,10197,0.9611650485436893,1.0404040404040404
63555,/images/de0321fa-6f7d-4dd1-b96b-186701c3b1d9.png,406,401,495,509,89,108,red blood cell,9612,1.2134831460674158,0.8240740740740741
16228,/images/acdc6e12-73d9-44ba-be8c-2a56aaffef4f.png,884,51,1006,163,122,112,red blood cell,13664,0.9180327868852459,1.0892857142857142
6002,/images/97eff653-3908-4e66-931f-eab36bc336c8.png,215,536,332,656,117,120,red blood cell,14040,1.0256410256410255,0.975
6864,/images/b21f6c6e-4b45-407a-b4c7-034a115f3ee4.png,137,1150,256,1278,119,128,red blood cell,15232,1.0756302521008403,0.9296875
73543,/images/7624ac36-1cf9-42fb-844d-376078309553.png,407,806,526,923,119,117,red blood cell,13923,0.9831932773109243,1.017094017094017
18528,/images/c22f7031-9cf8-48ce-b03b-1b12d0db4951.png,917,1192,1039,1298,122,106,red blood cell,12932,0.8688524590163934,1.150943396226415
57441,/images/00d04a90-80e5-4bce-9511-1b64eabb7a47.png,900,510,1014,613,114,103,red blood cell,11742,0.9035087719298246,1.1067961165048543
74645,/images/5ccca8ee-abea-458a-a891-bedd31c3ddc3.png,807,438,909,544,102,106,red blood cell,10812,1.0392156862745099,0.9622641509433962
34016,/images/1012abf2-cb05-4337-86c5-513ec4ca904d.png,174,983,279,1094,105,111,red blood cell,11655,1.0571428571428572,0.9459459459459459
17127,/images/dc3bdfe9-1565-4cda-9c4e-0979846dab60.png,1013,1468,1108,1578,95,110,red blood cell,10450,1.1578947368421053,0.8636363636363636
79137,/images/1c90231b-2830-42d9-884e-7301edb16933.png,1031,1078,1123,1170,92,92,red blood cell,8464,1.0,1.0
46258,/images/815bf40c-371a-4d34-aa41-c549c8221881.png,184,1062,310,1188,126,126,red blood cell,15876,1.0,1.0
3954,/images/f09acb0c-b270-4e91-99f8-410adfa7f34a.png,131,143,235,259,104,116,red blood cell,12064,1.1153846153846154,0.896551724137931
49099,/images/df3d98b9-3dd7-4107-8d4a-ae1b7f247793.png,290,704,373,795,83,91,red blood cell,7553,1.0963855421686748,0.9120879120879121
55592,/images/a27b451d-44a6-4740-861a-9e7e99915563.png,213,1471,348,1587,135,116,red blood cell,15660,0.8592592592592593,1.1637931034482758
65233,/images/50715879-2300-4dba-8f4a-3314ff8cfcce.png,807,37,917,141,110,104,red blood cell,11440,0.9454545454545454,1.0576923076923077
56579,/images/a824b499-3736-4581-bbdc-be1b3b4cf756.png,116,1154,247,1283,131,129,red blood cell,16899,0.9847328244274809,1.0155038759689923
77247,/images/07a80340-f65e-4f58-9317-94bb6ebd5a28.png,741,245,841,346,100,101,red blood cell,10100,1.01,0.9900990099009901
79366,/images/dcb21739-3c36-459d-b3cc-1be5871d6fe7.png,681,497,776,605,95,108,red blood cell,10260,1.1368421052631579,0.8796296296296297
63319,/images/43bc935a-f655-45e1-a64d-fcb8b78267a6.png,248,159,352,267,104,108,red blood cell,11232,1.0384615384615385,0.9629629629629629
3294,/images/b901c906-91be-48c4-88ec-2c527544a258.png,160,636,268,761,108,125,red blood cell,13500,1.1574074074074074,0.864
79530,/images/161978c3-3a05-47a5-9fee-be7d25693eae.png,959,506,1065,619,106,113,red blood cell,11978,1.0660377358490567,0.9380530973451328
33658,/images/84ee2ea3-9edd-4672-a1b3-f09c607d833a.png,1028,1287,1135,1400,107,113,red blood cell,12091,1.0560747663551402,0.9469026548672567
55141,/images/29d4b75f-d400-4702-a9ac-e5a4ed1a1db1.png,728,940,823,1047,95,107,red blood cell,10165,1.1263157894736842,0.8878504672897196
43636,/images/a4851ed0-1499-4eae-9157-dcd34773254f.png,550,1469,651,1572,101,103,red blood cell,10403,1.0198019801980198,0.9805825242718447
52211,/images/f4c00b8c-d675-4255-8277-ca65bd757f51.png,530,112,617,198,87,86,red blood cell,7482,0.9885057471264368,1.0116279069767442
68990,/images/b5246b58-6f40-4c9e-8024-f49b0ed6bdbd.png,996,1443,1111,1563,115,120,red blood cell,13800,1.0434782608695652,0.9583333333333334
72426,/images/a15e0fa8-2620-4f66-896e-175115c9dc3d.png,1071,31,1178,129,107,98,red blood cell,10486,0.9158878504672897,1.0918367346938775
45003,/images/13bab3c3-3f79-44d9-a287-0ae6d71eff31.png,39,89,149,200,110,111,red blood cell,12210,1.009090909090909,0.990990990990991
29120,/images/4c13e22e-dfd1-4fa1-b373-be9d0c272c0f.png,272,146,380,251,108,105,red blood cell,11340,0.9722222222222222,1.0285714285714285
16515,/images/1315c2a4-0794-4dfa-a709-e2451723d2b6.png,223,350,359,484,136,134,red blood cell,18224,0.9852941176470589,1.0149253731343284
8925,/images/04628a94-b674-469b-aff6-b476b70df87d.png,505,273,653,395,148,122,red blood cell,18056,0.8243243243243243,1.2131147540983607
53157,/images/801296d9-3403-426f-859e-5c532858e025.png,315,466,441,577,126,111,red blood cell,13986,0.8809523809523809,1.135135135135135
70288,/images/90246988-0d6d-4bf8-8a76-94107de4121e.png,887,1315,976,1407,89,92,red blood cell,8188,1.0337078651685394,0.967391304347826
12381,/images/3b55c42f-ad59-422f-ba99-4f4f4ca9cb2e.png,414,487,498,588,84,101,red blood cell,8484,1.2023809523809523,0.8316831683168316
48802,/images/fed6ba05-36a5-45dc-a4e1-9baa7de2c622.png,367,826,467,924,100,98,red blood cell,9800,0.98,1.0204081632653061
16265,/images/acdc6e12-73d9-44ba-be8c-2a56aaffef4f.png,736,650,847,748,111,98,red blood cell,10878,0.8828828828828829,1.1326530612244898
52004,/images/4f62b14e-c6f4-4155-8f50-881558f83fae.png,688,1364,764,1458,76,94,red blood cell,7144,1.236842105263158,0.8085106382978723
59818,/images/acb16781-11ad-4327-874a-5c9c35dcb085.png,427,768,528,871,101,103,red blood cell,10403,1.0198019801980198,0.9805825242718447
26540,/images/4935818a-7e7a-4f44-a3b6-b361d1abfe16.png,512,988,627,1110,115,122,red blood cell,14030,1.0608695652173914,0.9426229508196722
51248,/images/216f9d43-6869-4ba1-9106-4f5ea6aac223.png,252,1430,353,1538,101,108,red blood cell,10908,1.0693069306930694,0.9351851851851852
2306,/images/fe851c88-692d-4199-87e0-d19d9c4eb591.png,530,1232,622,1321,92,89,red blood cell,8188,0.967391304347826,1.0337078651685394
6275,/images/f4a27dfd-4c52-459f-96b5-ee6b452a3395.png,826,510,962,622,136,112,red blood cell,15232,0.8235294117647058,1.2142857142857142
9928,/images/b4261fa5-876d-48ea-b6da-ec7ca5b48fe2.png,1085,847,1191,963,106,116,red blood cell,12296,1.0943396226415094,0.9137931034482759
55591,/images/a27b451d-44a6-4740-861a-9e7e99915563.png,163,1443,262,1527,99,84,red blood cell,8316,0.8484848484848485,1.1785714285714286
43620,/images/a4851ed0-1499-4eae-9157-dcd34773254f.png,601,893,689,994,88,101,red blood cell,8888,1.1477272727272727,0.8712871287128713
35837,/images/027ab174-e47a-44f8-b85b-372449eeb7d8.png,363,171,451,266,88,95,red blood cell,8360,1.0795454545454546,0.9263157894736842
47392,/images/477e541c-0519-4542-9b13-8ee7922644d3.png,918,880,1015,986,97,106,red blood cell,10282,1.092783505154639,0.9150943396226415
74876,/images/81edcae1-65bf-4752-b0e4-494376b71e49.png,239,874,321,976,82,102,red blood cell,8364,1.2439024390243902,0.803921568627451
28081,/images/f1f9df6d-c4cb-4b42-9ca2-8fb47b1b0e91.png,867,167,975,276,108,109,red blood cell,11772,1.0092592592592593,0.9908256880733946
34107,/images/de5d19b7-e670-4ac7-843b-7ce7bcebdf45.png,11,498,123,603,112,105,red blood cell,11760,0.9375,1.0666666666666667
75617,/images/c35ee701-fde2-46b5-b178-1fe3f1ea7da2.png,621,310,729,425,108,115,red blood cell,12420,1.0648148148148149,0.9391304347826087
60487,/images/93b47b14-7f78-4b31-8897-d63a81fdab01.png,242,897,334,1004,92,107,red blood cell,9844,1.1630434782608696,0.8598130841121495
1295,/images/6d91d1f0-636b-4f5a-a526-7c17fc857190.png,830,642,916,738,86,96,red blood cell,8256,1.1162790697674418,0.8958333333333334
53833,/images/f24c8fe0-a534-44cf-9995-b2b314d945ba.png,18,1319,133,1423,115,104,red blood cell,11960,0.9043478260869565,1.1057692307692308
51514,/images/baa87bf8-786c-444c-81e8-9fa0a41d8149.png,861,1494,958,1593,97,99,red blood cell,9603,1.0206185567010309,0.9797979797979798
15206,/images/3a8f468f-f9de-46a8-a7c8-f2be239fa207.png,1012,149,1116,274,104,125,red blood cell,13000,1.2019230769230769,0.832
52589,/images/0546d843-d778-4aca-b8b5-bfe23d7c87da.png,639,878,755,988,116,110,red blood cell,12760,0.9482758620689655,1.0545454545454545
70282,/images/90246988-0d6d-4bf8-8a76-94107de4121e.png,444,592,549,705,105,113,red blood cell,11865,1.0761904761904761,0.9292035398230089
55988,/images/4c460388-e0c1-4970-8527-c9e5b42bea49.png,304,748,439,872,135,124,red blood cell,16740,0.9185185185185185,1.0887096774193548
46442,/images/bbecf1a8-a728-4c83-87f8-4dfbac0a1e03.png,615,532,709,647,94,115,red blood cell,10810,1.2234042553191489,0.8173913043478261
65917,/images/d7581cb0-7a12-471d-a3d8-68dcea362213.png,118,471,220,573,102,102,red blood cell,10404,1.0,1.0
19887,/images/b318889c-3c60-477c-b8f6-d18cb01a59df.png,320,911,422,1038,102,127,red blood cell,12954,1.2450980392156863,0.8031496062992126
70564,/images/8cca114a-ed05-4b87-95b7-fae02487f08c.png,670,948,775,1036,105,88,red blood cell,9240,0.8380952380952381,1.1931818181818181
43677,/images/a4851ed0-1499-4eae-9157-dcd34773254f.png,797,1113,895,1201,98,88,red blood cell,8624,0.8979591836734694,1.1136363636363635
17818,/images/1863da5f-c595-4541-a8f4-21fe78678168.png,390,118,489,214,99,96,red blood cell,9504,0.9696969696969697,1.03125
38078,/images/e3e9c2de-0a24-4c7e-8a69-3d3093d5bdab.png,828,292,917,391,89,99,red blood cell,8811,1.1123595505617978,0.898989898989899
34427,/images/b4bde4e8-f48b-4ae2-be01-86d8c91d0af9.png,784,933,893,1037,109,104,red blood cell,11336,0.9541284403669725,1.0480769230769231
70954,/images/deaa1931-5f97-45bf-8c00-be6ddeb37b9a.png,868,1337,978,1439,110,102,red blood cell,11220,0.9272727272727272,1.0784313725490196
1508,/images/0ac747cd-ff32-49bf-bc1a-3e9b7702ce9c.png,473,1353,577,1459,104,106,red blood cell,11024,1.0192307692307692,0.9811320754716981
63289,/images/43bc935a-f655-45e1-a64d-fcb8b78267a6.png,17,1021,119,1118,102,97,red blood cell,9894,0.9509803921568627,1.0515463917525774
61351,/images/e16c0dab-780d-4035-872e-1bb91e49f9d2.png,1030,1373,1135,1470,105,97,red blood cell,10185,0.9238095238095239,1.0824742268041236
3204,/images/c3215597-a032-46be-9058-d6de1e5191d7.png,643,41,776,165,133,124,red blood cell,16492,0.9323308270676691,1.0725806451612903
2628,/images/a2ccbf70-e444-49a9-8b7e-9797a05220d8.png,94,1132,211,1264,117,132,red blood cell,15444,1.1282051282051282,0.8863636363636364
12288,/images/3b55c42f-ad59-422f-ba99-4f4f4ca9cb2e.png,44,841,121,933,77,92,red blood cell,7084,1.1948051948051948,0.8369565217391305
43910,/images/d7c7eb2c-2acd-4f86-8a5a-09ab3dd02d16.png,613,66,741,201,128,135,red blood cell,17280,1.0546875,0.9481481481481482
23374,/images/a7688988-2bcc-4458-83d3-5e482da5f87b.png,966,471,1073,579,107,108,red blood cell,11556,1.0093457943925233,0.9907407407407407
77750,/images/4849866a-73a2-4fcf-a407-2d0a25a09a89.png,375,447,468,539,93,92,red blood cell,8556,0.989247311827957,1.0108695652173914
34117,/images/de5d19b7-e670-4ac7-843b-7ce7bcebdf45.png,515,1294,623,1401,108,107,red blood cell,11556,0.9907407407407407,1.0093457943925233
75382,/images/468c261d-f5d8-423f-883e-48af2bbbc5d1.png,937,1123,1030,1228,93,105,red blood cell,9765,1.1290322580645162,0.8857142857142857
34154,/images/f1cda808-69a9-4d10-ba0a-6607c98e362d.png,1015,1153,1140,1274,125,121,red blood cell,15125,0.968,1.0330578512396693
42302,/images/ca734448-0d52-42fa-b41c-17b2939e58ae.png,113,727,220,828,107,101,red blood cell,10807,0.9439252336448598,1.0594059405940595
48578,/images/f3d84be2-8af0-4d62-9f72-23d3dc08cbbe.png,142,716,261,825,119,109,red blood cell,12971,0.9159663865546218,1.091743119266055
52046,/images/de6d3020-9347-473b-9146-8909627790f6.png,374,732,491,854,117,122,red blood cell,14274,1.0427350427350428,0.9590163934426229
44481,/images/b6573be3-9e04-49c3-9f48-6a145d065363.png,983,329,1099,433,116,104,red blood cell,12064,0.896551724137931,1.1153846153846154
44134,/images/8b494b40-cab5-49d3-893d-c805000fbe88.png,40,716,183,837,143,121,red blood cell,17303,0.8461538461538461,1.1818181818181819
25515,/images/f6ab936d-924b-4038-aa47-71b07c26b4e2.png,902,1237,1013,1354,111,117,red blood cell,12987,1.054054054054054,0.9487179487179487
32295,/images/1c406ce1-023b-47fc-a2cd-5ea2e255de65.png,748,763,848,878,100,115,red blood cell,11500,1.15,0.8695652173913043
75455,/images/468c261d-f5d8-423f-883e-48af2bbbc5d1.png,338,1454,404,1536,66,82,red blood cell,5412,1.2424242424242424,0.8048780487804879
72883,/images/31435107-c77d-42f8-a619-75cba6a5161b.png,73,671,172,766,99,95,red blood cell,9405,0.9595959595959596,1.0421052631578946
60557,/images/58065a0c-d4c5-40fd-bcdc-037f61788482.png,438,122,555,243,117,121,red blood cell,14157,1.0341880341880343,0.9669421487603306
70852,/images/bf002a25-6535-4621-be19-56d468be5413.png,141,1133,259,1240,118,107,red blood cell,12626,0.9067796610169492,1.102803738317757
46192,/images/d8632217-ec33-4d0a-98e6-427824c58869.png,66,457,188,579,122,122,red blood cell,14884,1.0,1.0
54203,/images/3b5a8060-dec6-4a83-b7f2-b604e4e69dfc.png,615,906,730,1011,115,105,red blood cell,12075,0.9130434782608695,1.0952380952380953
6842,/images/e36cb882-c6d0-4467-812e-d18c169a9a47.png,729,1234,843,1352,114,118,red blood cell,13452,1.0350877192982457,0.9661016949152542
78686,/images/76a8a5f5-1328-4539-a131-baf877f40cf3.png,176,133,281,237,105,104,red blood cell,10920,0.9904761904761905,1.0096153846153846
77072,/images/637957ef-df75-4a7b-86d5-9f6e9c042ca2.png,503,532,603,638,100,106,red blood cell,10600,1.06,0.9433962264150944
5679,/images/d3dcdf92-9328-4796-adf4-918646877ba1.png,1027,231,1131,348,104,117,red blood cell,12168,1.125,0.8888888888888888
6246,/images/effd6334-516f-4d48-9f3c-5272a99780fb.png,332,877,447,996,115,119,red blood cell,13685,1.0347826086956522,0.9663865546218487
45358,/images/e4eea7ea-8989-46a9-9c98-25a178146b28.png,603,1314,690,1413,87,99,red blood cell,8613,1.1379310344827587,0.8787878787878788
61086,/images/6e86206f-dafe-4c28-bacc-7b83b2d40f0c.png,522,445,625,554,103,109,red blood cell,11227,1.058252427184466,0.944954128440367
70591,/images/4ce5a070-9ede-4bb1-9ca2-1bae5746776b.png,31,542,165,668,134,126,red blood cell,16884,0.9402985074626866,1.0634920634920635
8237,/images/65e3d6a6-012c-4b40-9a42-83078eb85e31.png,1075,203,1182,308,107,105,red blood cell,11235,0.9813084112149533,1.019047619047619
55000,/images/7beee655-6156-43b8-b185-dbae0eaf7f45.png,461,100,563,212,102,112,red blood cell,11424,1.0980392156862746,0.9107142857142857
62150,/images/a63fa2c7-3ec8-4bb7-bde6-a39e09d2f806.png,326,1220,457,1355,131,135,red blood cell,17685,1.0305343511450382,0.9703703703703703
78699,/images/76a8a5f5-1328-4539-a131-baf877f40cf3.png,823,421,943,531,120,110,red blood cell,13200,0.9166666666666666,1.0909090909090908
12714,/images/68442532-9cd2-4b42-9d4f-ddf8c13bb38c.png,981,326,1112,434,131,108,red blood cell,14148,0.8244274809160306,1.212962962962963
18457,/images/9b410534-3b70-4a88-9f93-205cf4e55a05.png,1054,1089,1173,1225,119,136,red blood cell,16184,1.1428571428571428,0.875
1135,/images/edcb4d77-a4d3-465d-9b59-eb3087766b1c.png,338,1307,439,1408,101,101,red blood cell,10201,1.0,1.0
69777,/images/2bd15b6e-fe2d-49f3-b394-940d024d1f91.png,517,186,595,276,78,90,red blood cell,7020,1.1538461538461537,0.8666666666666667
52413,/images/a2a20600-f851-4db7-90f9-6f7be027c8b5.png,892,781,973,867,81,86,red blood cell,6966,1.0617283950617284,0.9418604651162791
64324,/images/0a7bfa8a-ee52-4f7a-b9c5-2919ecfa93ef.png,359,1056,462,1170,103,114,red blood cell,11742,1.1067961165048543,0.9035087719298246
56989,/images/003d1cdc-0aec-430b-90e0-f4d82135b1ac.png,468,489,580,626,112,137,red blood cell,15344,1.2232142857142858,0.8175182481751825
78079,/images/105af41b-13cc-4ad1-8a1f-8bc4d47cdd94.png,727,652,844,778,117,126,red blood cell,14742,1.0769230769230769,0.9285714285714286
35207,/images/a9159b11-ba49-4885-902e-00c8d5095b98.png,772,873,860,977,88,104,red blood cell,9152,1.1818181818181819,0.8461538461538461
7731,/images/187f92b2-71ed-484a-9bd3-599ca0d2636f.png,671,1461,774,1570,103,109,red blood cell,11227,1.058252427184466,0.944954128440367
60283,/images/7abc0d26-dd66-4ef4-8c4e-4a661e589a7f.png,404,928,508,1024,104,96,red blood cell,9984,0.9230769230769231,1.0833333333333333
66382,/images/e5fd5949-4cd0-4cb6-837a-02c26a5eb87a.png,345,951,451,1059,106,108,red blood cell,11448,1.0188679245283019,0.9814814814814815
77645,/images/07d15855-eb9b-46a9-b894-7cfe4d097826.png,17,520,127,646,110,126,red blood cell,13860,1.1454545454545455,0.873015873015873
68763,/images/eb5f4f2f-2275-4a80-84a5-78a1eaf4ce4d.png,902,760,1031,865,129,105,red blood cell,13545,0.813953488372093,1.2285714285714286
5831,/images/143f5959-5b6d-4f95-bcee-9e110450fc22.png,548,1243,678,1365,130,122,red blood cell,15860,0.9384615384615385,1.0655737704918034
60284,/images/7abc0d26-dd66-4ef4-8c4e-4a661e589a7f.png,560,1215,666,1332,106,117,red blood cell,12402,1.1037735849056605,0.905982905982906
76752,/images/3317d733-ec0d-45e6-b631-40457392f343.png,187,482,274,567,87,85,red blood cell,7395,0.9770114942528736,1.0235294117647058
19918,/images/0ca25c88-457f-4f03-bbc1-98fb6663f1d1.png,260,1274,367,1370,107,96,red blood cell,10272,0.897196261682243,1.1145833333333333
26004,/images/612bdd3c-da43-4321-a76b-c73c614928d1.png,633,442,761,575,128,133,red blood cell,17024,1.0390625,0.9624060150375939
25779,/images/1f8edb2a-40bc-4beb-aa6b-884d2473df0f.png,296,183,417,308,121,125,red blood cell,15125,1.0330578512396693,0.968
61397,/images/e16c0dab-780d-4035-872e-1bb91e49f9d2.png,206,494,328,596,122,102,red blood cell,12444,0.8360655737704918,1.196078431372549
573,/images/065af549-320a-4862-b92a-8ef750d7b5fb.png,264,842,393,967,129,125,red blood cell,16125,0.9689922480620154,1.032
18811,/images/cc882eae-a341-4783-bd19-8bdedf798538.png,561,9,680,132,119,123,red blood cell,14637,1.0336134453781514,0.967479674796748
14347,/images/f5eb7c5e-bd77-4638-ba9f-58d42f87476b.png,480,1163,586,1272,106,109,red blood cell,11554,1.028301886792453,0.9724770642201835
46466,/images/bbecf1a8-a728-4c83-87f8-4dfbac0a1e03.png,736,1200,839,1305,103,105,red blood cell,10815,1.0194174757281553,0.9809523809523809
52724,/images/9dc6ed5d-6698-48cf-aab3-fd156673729c.png,243,369,344,488,101,119,red blood cell,12019,1.1782178217821782,0.8487394957983193
32622,/images/ed0d8763-e734-4506-b61b-53fc32a8d8c9.png,642,1332,747,1443,105,111,red blood cell,11655,1.0571428571428572,0.9459459459459459
54746,/images/10891eed-b0f2-4dd0-90cb-da185f6761b2.png,626,455,729,577,103,122,red blood cell,12566,1.1844660194174756,0.8442622950819673
14907,/images/3090a362-1f3d-49e9-a76e-ce76ff9c2276.png,834,1020,945,1119,111,99,red blood cell,10989,0.8918918918918919,1.121212121212121
14861,/images/3090a362-1f3d-49e9-a76e-ce76ff9c2276.png,403,38,516,165,113,127,red blood cell,14351,1.1238938053097345,0.889763779527559
41943,/images/46a03374-64c7-49ac-81c9-c3d62542bbf3.png,119,1169,220,1267,101,98,red blood cell,9898,0.9702970297029703,1.030612244897959
30491,/images/5955289d-19e5-45ef-a012-c8ea08ef45e2.png,131,1037,244,1148,113,111,red blood cell,12543,0.9823008849557522,1.018018018018018
52834,/images/58f7e1da-3478-48f4-958c-e9b1cb8696aa.png,804,1157,899,1261,95,104,red blood cell,9880,1.0947368421052632,0.9134615384615384
16302,/images/d5009906-bce1-4353-90b4-f4c79362f4cf.png,246,59,345,167,99,108,red blood cell,10692,1.0909090909090908,0.9166666666666666
19142,/images/bb795ddf-ce72-42d5-9006-124db4d5cf1c.png,929,550,1038,666,109,116,red blood cell,12644,1.0642201834862386,0.9396551724137931
33278,/images/5721e41b-90ef-4851-8587-8dc71227ef90.png,738,62,855,182,117,120,red blood cell,14040,1.0256410256410255,0.975
68746,/images/eb5f4f2f-2275-4a80-84a5-78a1eaf4ce4d.png,490,1117,603,1231,113,114,red blood cell,12882,1.008849557522124,0.9912280701754386
52100,/images/de6d3020-9347-473b-9146-8909627790f6.png,748,1327,828,1411,80,84,red blood cell,6720,1.05,0.9523809523809523
43352,/images/36569710-a574-40be-ad42-897a6e74a128.png,240,1230,329,1328,89,98,red blood cell,8722,1.101123595505618,0.9081632653061225
2911,/images/a1c140f9-75d7-42a3-b767-4c01a118892b.png,1063,653,1191,776,128,123,red blood cell,15744,0.9609375,1.0406504065040652
68303,/images/0f735cca-051c-4048-a1fa-cb36f389e12f.png,116,1385,236,1500,120,115,red blood cell,13800,0.9583333333333334,1.0434782608695652
46264,/images/815bf40c-371a-4d34-aa41-c549c8221881.png,1044,78,1161,205,117,127,red blood cell,14859,1.0854700854700854,0.9212598425196851
58089,/images/a7c91b63-b97c-4f4b-8d34-7ad2b08d7a17.png,1010,441,1086,528,76,87,red blood cell,6612,1.144736842105263,0.8735632183908046
55961,/images/afd39466-aafa-4d81-9520-483727418723.png,412,859,501,965,89,106,red blood cell,9434,1.1910112359550562,0.839622641509434
42632,/images/184b376b-03cb-4c2d-af51-fc1a62196293.png,59,1083,134,1166,75,83,red blood cell,6225,1.1066666666666667,0.9036144578313253
70792,/images/b62d47f9-2ff5-4902-abdc-b3610acfc7ba.png,413,157,499,260,86,103,red blood cell,8858,1.197674418604651,0.8349514563106796
19962,/images/0ca25c88-457f-4f03-bbc1-98fb6663f1d1.png,700,104,802,206,102,102,red blood cell,10404,1.0,1.0
25401,/images/fbb1b44c-d75a-4550-a6c0-0eb62b96bfce.png,589,1485,711,1600,122,115,red blood cell,14030,0.9426229508196722,1.0608695652173914
49685,/images/9842445c-5899-4189-9f2e-3a3a179fdad3.png,94,1289,209,1398,115,109,red blood cell,12535,0.9478260869565217,1.055045871559633
63065,/images/6afd8203-d61a-4e9b-a4cf-dcb53a16b57c.png,504,700,631,810,127,110,red blood cell,13970,0.8661417322834646,1.1545454545454545
78258,/images/adff6e1d-ba9d-4c7b-a8fe-1ec458eaeeb8.png,681,801,793,910,112,109,red blood cell,12208,0.9732142857142857,1.0275229357798166
30955,/images/533c47c9-02a6-419b-961b-81797f022f6c.png,486,1477,612,1586,126,109,red blood cell,13734,0.8650793650793651,1.1559633027522935
64207,/images/2a91387a-d30f-418d-ac3a-f7cfa6836261.png,185,11,286,118,101,107,red blood cell,10807,1.0594059405940595,0.9439252336448598
53196,/images/d8f7e159-b7e3-49e4-86e8-aed8c5fbcd97.png,202,336,299,444,97,108,red blood cell,10476,1.1134020618556701,0.8981481481481481
29907,/images/f2a8a483-b254-43aa-817f-7d525adb8911.png,587,276,712,390,125,114,red blood cell,14250,0.912,1.0964912280701755
73239,/images/85546330-4efd-43e2-87aa-d53a30220bfc.png,743,1520,827,1600,84,80,red blood cell,6720,0.9523809523809523,1.05
5593,/images/75c243e2-610d-4d5a-bc5a-4c53d99d9ae9.png,562,636,681,769,119,133,red blood cell,15827,1.1176470588235294,0.8947368421052632
11064,/images/85a4d82e-cfb7-4983-b272-626c9e8c7583.png,50,95,157,223,107,128,red blood cell,13696,1.1962616822429906,0.8359375
52251,/images/4903d9c7-de88-426a-b42d-a7e797e5ebcd.png,916,168,1026,278,110,110,red blood cell,12100,1.0,1.0
16625,/images/a27858ef-6533-413e-bc75-cc54690261a2.png,67,64,180,169,113,105,red blood cell,11865,0.9292035398230089,1.0761904761904761
38890,/images/d79b4e90-c45d-4f5d-a498-49c3e323c291.png,543,201,648,310,105,109,red blood cell,11445,1.0380952380952382,0.963302752293578
26353,/images/ef1419e0-3a3a-458a-b3b2-7efddac50404.png,403,143,531,254,128,111,red blood cell,14208,0.8671875,1.1531531531531531
64353,/images/0a7bfa8a-ee52-4f7a-b9c5-2919ecfa93ef.png,585,319,677,428,92,109,red blood cell,10028,1.184782608695652,0.8440366972477065
49383,/images/f2574be3-81c6-4fc3-8a40-0230d1264f52.png,643,457,761,577,118,120,red blood cell,14160,1.0169491525423728,0.9833333333333333
41173,/images/2240b991-48f6-4c59-9b62-5a8b5e541fae.png,558,1358,661,1461,103,103,red blood cell,10609,1.0,1.0
47958,/images/eba73bff-fbe1-436d-9a5f-0a61331a0ea2.png,869,926,985,1046,116,120,red blood cell,13920,1.0344827586206897,0.9666666666666667
33949,/images/1a332b2c-9d49-4ff2-810c-5633d2314527.png,942,177,1056,284,114,107,red blood cell,12198,0.9385964912280702,1.0654205607476634
62257,/images/59f5699f-885f-4004-b783-a60060144e43.png,1068,837,1191,954,123,117,red blood cell,14391,0.9512195121951219,1.0512820512820513
56651,/images/4adcaa26-aa1f-47b5-bdf0-18c9f814f576.png,151,755,264,873,113,118,red blood cell,13334,1.0442477876106195,0.9576271186440678
35358,/images/452482bc-24a3-413e-ba03-fad4c9d61f3c.png,463,589,579,698,116,109,red blood cell,12644,0.9396551724137931,1.0642201834862386
51337,/images/b4f3b2a4-f4b9-48de-ac5d-0e681b77be27.png,595,703,696,802,101,99,red blood cell,9999,0.9801980198019802,1.02020202020202
22190,/images/ca677c3c-083f-4d54-9dec-39f79f6a17d8.png,312,714,419,813,107,99,red blood cell,10593,0.9252336448598131,1.0808080808080809
6422,/images/1ecb0405-a6e9-4485-819e-2fbbf2b718aa.png,677,750,787,876,110,126,red blood cell,13860,1.1454545454545455,0.873015873015873
53367,/images/f23ae29e-1bda-4784-b10c-d736757d39b8.png,843,1317,938,1427,95,110,red blood cell,10450,1.1578947368421053,0.8636363636363636
17653,/images/b5143aae-6e98-4dc6-b546-980cb472de67.png,794,222,903,333,109,111,red blood cell,12099,1.018348623853211,0.9819819819819819
52846,/images/58f7e1da-3478-48f4-958c-e9b1cb8696aa.png,17,897,120,1010,103,113,red blood cell,11639,1.0970873786407767,0.911504424778761
25204,/images/90171428-f208-428a-b40e-f57ee3bea457.png,828,1448,943,1553,115,105,red blood cell,12075,0.9130434782608695,1.0952380952380953
3684,/images/dacf7e3f-1d8c-42a0-8539-3abe3971c956.png,334,1198,438,1313,104,115,red blood cell,11960,1.1057692307692308,0.9043478260869565
30554,/images/7d9c1422-6332-44e9-b134-3ac94f07b0f0.png,671,116,784,222,113,106,red blood cell,11978,0.9380530973451328,1.0660377358490567
48195,/images/913099c5-8085-4908-bf4b-1f098bbfcf66.png,20,1240,111,1349,91,109,red blood cell,9919,1.1978021978021978,0.8348623853211009
56463,/images/d75933ed-d26e-4d1f-bda3-96bc0d77fb36.png,394,322,500,434,106,112,red blood cell,11872,1.0566037735849056,0.9464285714285714
37374,/images/08f5a524-0554-49c2-83a8-ae9a6d51e8fd.png,1057,1365,1175,1472,118,107,red blood cell,12626,0.9067796610169492,1.102803738317757
13924,/images/de00f9a5-aa8b-4679-8ec6-85528a942d6f.png,483,112,607,254,124,142,red blood cell,17608,1.1451612903225807,0.8732394366197183
17700,/images/b5143aae-6e98-4dc6-b546-980cb472de67.png,510,197,642,316,132,119,red blood cell,15708,0.9015151515151515,1.1092436974789917
36681,/images/21f001d6-f568-4ea4-82da-fab54c77c419.png,418,759,517,844,99,85,red blood cell,8415,0.8585858585858586,1.1647058823529413
74915,/images/dd090806-e4ac-4a78-b2ee-55a30626369c.png,269,513,380,619,111,106,red blood cell,11766,0.954954954954955,1.0471698113207548
77725,/images/4849866a-73a2-4fcf-a407-2d0a25a09a89.png,567,800,671,891,104,91,red blood cell,9464,0.875,1.1428571428571428
40462,/images/db249e5a-4142-432c-8288-bacd10d7273d.png,100,1166,197,1251,97,85,red blood cell,8245,0.8762886597938144,1.1411764705882352
31079,/images/9c48fdf4-621d-4f40-bcd7-6a28cd530de7.png,866,1390,982,1498,116,108,red blood cell,12528,0.9310344827586207,1.0740740740740742
7203,/images/56551792-4aa1-4301-9f8f-8bfebcd20050.png,68,758,184,877,116,119,red blood cell,13804,1.0258620689655173,0.9747899159663865
43581,/images/e0ef520d-7b65-485d-9888-e6859f189f70.png,665,656,780,749,115,93,red blood cell,10695,0.808695652173913,1.2365591397849462
23288,/images/e5731221-814c-4894-a44e-e46b71460fa4.png,568,1413,665,1516,97,103,red blood cell,9991,1.0618556701030928,0.941747572815534
53212,/images/d8f7e159-b7e3-49e4-86e8-aed8c5fbcd97.png,617,244,713,345,96,101,red blood cell,9696,1.0520833333333333,0.9504950495049505
3350,/images/b1100ae1-0ac8-4fc2-b0ff-8819f7fbe724.png,1054,990,1165,1117,111,127,red blood cell,14097,1.1441441441441442,0.8740157480314961
47022,/images/9ebd623d-5534-4dd9-bff8-cdedf322db35.png,315,121,415,229,100,108,red blood cell,10800,1.08,0.9259259259259259
18265,/images/947348fe-4c70-468e-8009-3c14daeca69b.png,651,800,752,903,101,103,red blood cell,10403,1.0198019801980198,0.9805825242718447
43615,/images/a4851ed0-1499-4eae-9157-dcd34773254f.png,285,1296,382,1398,97,102,red blood cell,9894,1.0515463917525774,0.9509803921568627
68510,/images/74261741-4d6e-4dba-8ad4-4fbdf919c30f.png,555,360,651,459,96,99,red blood cell,9504,1.03125,0.9696969696969697
46946,/images/9e0e1928-d19a-4100-b093-0b962ac09e05.png,14,491,114,599,100,108,red blood cell,10800,1.08,0.9259259259259259
59564,/images/6bfe6a90-8a69-4171-8e7f-42dc9417c6d9.png,365,723,455,825,90,102,red blood cell,9180,1.1333333333333333,0.8823529411764706
60997,/images/3d1429ed-4619-41f7-8ff3-d698ad28034c.png,770,950,877,1054,107,104,red blood cell,11128,0.9719626168224299,1.0288461538461537
23443,/images/8757be1e-b832-407a-8e95-62abae485b24.png,949,1307,1060,1426,111,119,red blood cell,13209,1.072072072072072,0.9327731092436975
79182,/images/1c90231b-2830-42d9-884e-7301edb16933.png,198,882,280,972,82,90,red blood cell,7380,1.0975609756097562,0.9111111111111111
54895,/images/8f84a2c9-ca38-4405-a488-12fcd101278b.png,938,1486,1043,1593,105,107,red blood cell,11235,1.019047619047619,0.9813084112149533
30409,/images/58d75854-be99-484e-89f0-4ab208fe07e0.png,1057,63,1158,165,101,102,red blood cell,10302,1.00990099009901,0.9901960784313726
32741,/images/eef2ac0b-42de-4bc3-a3c3-d5fcd597fbe4.png,481,780,596,887,115,107,red blood cell,12305,0.9304347826086956,1.074766355140187
20806,/images/c2ec116f-f091-422c-926c-70b548a8f6ef.png,616,648,726,770,110,122,red blood cell,13420,1.1090909090909091,0.9016393442622951
5583,/images/75c243e2-610d-4d5a-bc5a-4c53d99d9ae9.png,228,1395,350,1517,122,122,red blood cell,14884,1.0,1.0
1365,/images/6d91d1f0-636b-4f5a-a526-7c17fc857190.png,684,121,773,220,89,99,red blood cell,8811,1.1123595505617978,0.898989898989899
11839,/images/3cdcb09b-6a8c-43ca-b1d0-c1a289202f65.png,595,15,704,126,109,111,red blood cell,12099,1.018348623853211,0.9819819819819819
47268,/images/1dd3e6dd-343f-4cc9-b0ed-e4d27fb36f0a.png,519,800,629,923,110,123,red blood cell,13530,1.1181818181818182,0.8943089430894309
13842,/images/345cb914-7583-49df-96e3-3cf19c2ba8f1.png,760,183,882,313,122,130,red blood cell,15860,1.0655737704918034,0.9384615384615385
41324,/images/a065c50b-341d-4803-b4b0-0fe8f04fdbb5.png,57,759,164,865,107,106,red blood cell,11342,0.9906542056074766,1.009433962264151
63754,/images/06401963-8b02-46c5-ab2a-3d70bd01623f.png,800,1188,879,1263,79,75,red blood cell,5925,0.9493670886075949,1.0533333333333332
3529,/images/ad36bd67-594b-4f63-93e3-886af0bc618e.png,1022,0,1115,107,93,107,red blood cell,9951,1.1505376344086022,0.8691588785046729
23902,/images/3d8fb5bf-3315-48fb-8ab1-802eafd550bc.png,828,199,930,296,102,97,red blood cell,9894,0.9509803921568627,1.0515463917525774
79331,/images/dcb21739-3c36-459d-b3cc-1be5871d6fe7.png,320,631,423,739,103,108,red blood cell,11124,1.0485436893203883,0.9537037037037037
61311,/images/b3058064-d817-47dd-a8c4-cdb1f62374f8.png,26,1073,105,1151,79,78,red blood cell,6162,0.9873417721518988,1.0128205128205128
37483,/images/c6530038-6d4e-49e1-8427-d1d3acc9fa21.png,345,682,464,819,119,137,red blood cell,16303,1.1512605042016806,0.8686131386861314
78777,/images/9174f910-3859-4839-8e30-2c3b25269322.png,1063,690,1179,803,116,113,red blood cell,13108,0.9741379310344828,1.0265486725663717
47962,/images/eba73bff-fbe1-436d-9a5f-0a61331a0ea2.png,170,1424,302,1545,132,121,red blood cell,15972,0.9166666666666666,1.0909090909090908
71878,/images/61575482-91e1-4db9-83c7-687b7ddbbfc4.png,55,815,152,919,97,104,red blood cell,10088,1.0721649484536082,0.9326923076923077
20475,/images/b809b407-7b69-4334-873d-d6c49135f04a.png,826,1424,948,1552,122,128,red blood cell,15616,1.0491803278688525,0.953125
25187,/images/90171428-f208-428a-b40e-f57ee3bea457.png,506,927,611,1051,105,124,red blood cell,13020,1.180952380952381,0.8467741935483871
74271,/images/8939e14b-fcdf-48b1-acb9-6514a2fc2fc0.png,889,503,997,618,108,115,red blood cell,12420,1.0648148148148149,0.9391304347826087
59248,/images/03c8da48-04b9-4520-b674-44a0ecd35688.png,583,1166,688,1273,105,107,red blood cell,11235,1.019047619047619,0.9813084112149533
30228,/images/f81806a8-5883-446c-be78-f0145b12dbdd.png,877,56,997,175,120,119,red blood cell,14280,0.9916666666666667,1.0084033613445378
32066,/images/b8a4d467-c40c-4ebf-91dd-1c19d0f2a7ae.png,1027,505,1121,620,94,115,red blood cell,10810,1.2234042553191489,0.8173913043478261
7415,/images/76dbce7f-dc3e-4a29-b1fe-ab9dce583080.png,735,381,874,493,139,112,red blood cell,15568,0.8057553956834532,1.2410714285714286
68522,/images/74261741-4d6e-4dba-8ad4-4fbdf919c30f.png,4,264,99,359,95,95,red blood cell,9025,1.0,1.0
36304,/images/81fed4a1-9d48-4938-90c9-c8bf3f5e6b1f.png,248,801,360,935,112,134,red blood cell,15008,1.1964285714285714,0.835820895522388
36356,/images/4a0a05e1-11ad-4bfc-bfa3-adf3b9bd0b56.png,312,721,446,849,134,128,red blood cell,17152,0.9552238805970149,1.046875
74985,/images/b4c52960-bbee-439e-83dc-f89ddaade71b.png,158,224,252,332,94,108,red blood cell,10152,1.148936170212766,0.8703703703703703
60216,/images/214f1d15-a081-476e-992d-6c3a77f03d59.png,115,613,224,714,109,101,red blood cell,11009,0.926605504587156,1.0792079207920793
1489,/images/0ac747cd-ff32-49bf-bc1a-3e9b7702ce9c.png,1078,621,1196,716,118,95,red blood cell,11210,0.8050847457627118,1.2421052631578948
62196,/images/a72cd558-b7ac-4bf2-a344-2ce6c73a354e.png,268,1129,364,1248,96,119,red blood cell,11424,1.2395833333333333,0.8067226890756303
14490,/images/458cb2e9-5a7f-437c-ac5d-a56f98a3efdf.png,679,1279,772,1388,93,109,red blood cell,10137,1.1720430107526882,0.8532110091743119
14762,/images/1fdf99d1-a494-4174-bcd7-efbe457ab899.png,632,1439,749,1553,117,114,red blood cell,13338,0.9743589743589743,1.0263157894736843
18084,/images/947348fe-4c70-468e-8009-3c14daeca69b.png,922,113,1043,230,121,117,red blood cell,14157,0.9669421487603306,1.0341880341880343
60352,/images/1c87b997-a8e6-48ca-bf40-19b9a7fd6a96.png,380,454,478,556,98,102,red blood cell,9996,1.0408163265306123,0.9607843137254902
19472,/images/a85cd1ae-0c94-4387-8305-84ab8d96d137.png,960,1063,1071,1192,111,129,red blood cell,14319,1.162162162162162,0.8604651162790697
76507,/images/34df8890-272d-423a-ae78-ff8d068d3306.png,741,742,837,822,96,80,red blood cell,7680,0.8333333333333334,1.2
31463,/images/6695a204-e39c-4418-b904-3f080fdbe7e8.png,307,1340,409,1449,102,109,red blood cell,11118,1.0686274509803921,0.9357798165137615
24704,/images/78a5d1c3-44dd-44bc-ad5b-5e25bdcc4fae.png,402,716,517,834,115,118,red blood cell,13570,1.0260869565217392,0.9745762711864406
22306,/images/49b03a6e-6b26-4a96-a061-e05647a02138.png,438,164,562,284,124,120,red blood cell,14880,0.967741935483871,1.0333333333333334
47717,/images/afbb264e-ff60-443a-83f5-49d09be1b835.png,842,890,965,1015,123,125,red blood cell,15375,1.016260162601626,0.984
63164,/images/f0804a5e-e7f5-4cf2-a5df-b65e66502bf1.png,255,352,366,470,111,118,red blood cell,13098,1.063063063063063,0.940677966101695
1474,/images/0ac747cd-ff32-49bf-bc1a-3e9b7702ce9c.png,727,1020,830,1119,103,99,red blood cell,10197,0.9611650485436893,1.0404040404040404
67640,/images/59542a24-b409-4c95-8608-d9691a741526.png,970,123,1047,209,77,86,red blood cell,6622,1.1168831168831168,0.8953488372093024
525,/images/67acd5bc-4658-4c6e-a9b9-cd8ea3a03418.png,139,1145,264,1272,125,127,red blood cell,15875,1.016,0.984251968503937
43143,/images/c5db0fc0-b96c-496e-90b4-f9fb1b85b28e.png,624,317,728,425,104,108,red blood cell,11232,1.0384615384615385,0.9629629629629629
34784,/images/4fc9a597-aaa8-43b0-ad1c-2eabbe442e84.png,469,1099,576,1201,107,102,red blood cell,10914,0.9532710280373832,1.0490196078431373
48661,/images/55836297-fc8e-4e00-9767-0d12b86e4604.png,11,134,100,229,89,95,red blood cell,8455,1.0674157303370786,0.9368421052631579
70295,/images/90246988-0d6d-4bf8-8a76-94107de4121e.png,256,1045,358,1150,102,105,red blood cell,10710,1.0294117647058822,0.9714285714285714
7602,/images/21cc498b-8cb2-42ed-8f80-bfa27b86ef11.png,451,677,574,796,123,119,red blood cell,14637,0.967479674796748,1.0336134453781514
63245,/images/d3283f5b-3b3a-40ea-800b-79960ca851cb.png,357,1097,471,1203,114,106,red blood cell,12084,0.9298245614035088,1.0754716981132075
72901,/images/a20d0b4b-6e2e-4507-bc22-f321dedc4ed9.png,540,479,644,604,104,125,red blood cell,13000,1.2019230769230769,0.832
6714,/images/672e4ecf-a56b-462e-b83b-76f4efaa6634.png,272,116,373,232,101,116,red blood cell,11716,1.1485148514851484,0.8706896551724138
25826,/images/14b68d86-ac7f-419d-b4a5-6b0b1d9aaa18.png,599,1317,716,1430,117,113,red blood cell,13221,0.9658119658119658,1.0353982300884956
77931,/images/464055b6-3351-4636-a919-8be9840fb850.png,825,44,935,146,110,102,red blood cell,11220,0.9272727272727272,1.0784313725490196
10550,/images/9fbf38ab-44b9-4096-a818-603017a4300e.png,276,1281,420,1410,144,129,red blood cell,18576,0.8958333333333334,1.1162790697674418
12338,/images/3b55c42f-ad59-422f-ba99-4f4f4ca9cb2e.png,448,706,554,800,106,94,red blood cell,9964,0.8867924528301887,1.127659574468085
19955,/images/0ca25c88-457f-4f03-bbc1-98fb6663f1d1.png,800,693,913,811,113,118,red blood cell,13334,1.0442477876106195,0.9576271186440678
13404,/images/a7f1bbb1-6058-4642-bd66-cfb90dce762e.png,385,261,485,361,100,100,red blood cell,10000,1.0,1.0
48779,/images/fed6ba05-36a5-45dc-a4e1-9baa7de2c622.png,60,1448,166,1542,106,94,red blood cell,9964,0.8867924528301887,1.127659574468085
31229,/images/1976cd04-d24f-457c-b423-7e4cdb05de9e.png,533,843,635,965,102,122,red blood cell,12444,1.196078431372549,0.8360655737704918
30467,/images/5955289d-19e5-45ef-a012-c8ea08ef45e2.png,520,1166,650,1287,130,121,red blood cell,15730,0.9307692307692308,1.0743801652892562
47591,/images/06cd484f-e864-4fee-8819-688b45eed98e.png,628,526,762,648,134,122,red blood cell,16348,0.9104477611940298,1.098360655737705
13076,/images/9691c57a-ccf8-47f9-a8e9-9a324974585b.png,600,369,698,476,98,107,red blood cell,10486,1.0918367346938775,0.9158878504672897
73932,/images/2ae3e6e6-7482-4ab8-ad73-b530b5c2ee3b.png,593,594,679,680,86,86,red blood cell,7396,1.0,1.0
13669,/images/1e86933d-6a5a-4a3c-a0f2-ca22afd767b3.png,1087,100,1185,210,98,110,red blood cell,10780,1.1224489795918366,0.8909090909090909
48212,/images/913099c5-8085-4908-bf4b-1f098bbfcf66.png,1004,1324,1097,1428,93,104,red blood cell,9672,1.118279569892473,0.8942307692307693
40239,/images/f05ffdca-dc3a-47bd-a231-2a0d9bd1d50e.png,266,1348,391,1480,125,132,red blood cell,16500,1.056,0.946969696969697
67901,/images/41ebf9a1-24dc-454e-8bf8-508218f5ee57.png,553,688,652,787,99,99,red blood cell,9801,1.0,1.0
21909,/images/d57b3894-c912-47e8-b00a-e1a2a7aba644.png,486,649,605,773,119,124,red blood cell,14756,1.0420168067226891,0.9596774193548387
38255,/images/b834cbf7-ff97-49d9-9561-566c9343735c.png,984,595,1102,726,118,131,red blood cell,15458,1.1101694915254237,0.9007633587786259
32822,/images/67f5ca94-d84e-490e-bf0d-4ffba7bdbe30.png,45,67,167,201,122,134,red blood cell,16348,1.098360655737705,0.9104477611940298
32574,/images/3f26fbbc-deb1-494f-b71c-c7cb3d4819fb.png,822,803,958,940,136,137,red blood cell,18632,1.0073529411764706,0.9927007299270073
999,/images/63d36d2c-43a9-49ac-9504-028b4968c860.png,428,583,543,707,115,124,red blood cell,14260,1.0782608695652174,0.9274193548387096
5297,/images/06df7bbe-60d4-4f7c-ba4a-5a42ac4be91b.png,960,1302,1073,1423,113,121,red blood cell,13673,1.0707964601769913,0.9338842975206612
68167,/images/5dec94a3-e3ca-4a58-9702-88e5a83ef612.png,765,1479,872,1589,107,110,red blood cell,11770,1.02803738317757,0.9727272727272728
50309,/images/3d32a988-449d-4d58-b71f-abbfdc3f2fbc.png,442,44,539,140,97,96,red blood cell,9312,0.9896907216494846,1.0104166666666667
56601,/images/a824b499-3736-4581-bbdc-be1b3b4cf756.png,1029,909,1120,1008,91,99,red blood cell,9009,1.0879120879120878,0.9191919191919192
30634,/images/f939782b-f5a2-40a3-9c22-6c6d7e18edc3.png,725,14,844,119,119,105,red blood cell,12495,0.8823529411764706,1.1333333333333333
9901,/images/b4261fa5-876d-48ea-b6da-ec7ca5b48fe2.png,461,735,597,861,136,126,red blood cell,17136,0.9264705882352942,1.0793650793650793
70542,/images/8cca114a-ed05-4b87-95b7-fae02487f08c.png,1088,645,1188,743,100,98,red blood cell,9800,0.98,1.0204081632653061
77838,/images/6bc7b53c-5a98-48ef-a9de-59a476707ea4.png,383,903,487,1000,104,97,red blood cell,10088,0.9326923076923077,1.0721649484536082
77054,/images/637957ef-df75-4a7b-86d5-9f6e9c042ca2.png,1003,281,1105,392,102,111,red blood cell,11322,1.088235294117647,0.918918918918919
8665,/images/ea6b012a-3425-4bfc-a61d-88563aa2a264.png,694,590,824,699,130,109,red blood cell,14170,0.8384615384615385,1.1926605504587156
37315,/images/4d88e2d2-5aad-410c-9bbc-702ee9496995.png,215,701,335,826,120,125,red blood cell,15000,1.0416666666666667,0.96
35866,/images/2102e5d1-8bec-4ab6-ab35-2705485da1f8.png,47,43,182,173,135,130,red blood cell,17550,0.9629629629629629,1.0384615384615385
14676,/images/4e2873dd-651e-4ecc-ac70-7335cf21a469.png,783,920,903,1043,120,123,red blood cell,14760,1.025,0.975609756097561
15858,/images/c7c1b873-0548-4a73-9618-f60912e164df.png,1084,576,1190,698,106,122,red blood cell,12932,1.150943396226415,0.8688524590163934
34052,/images/1012abf2-cb05-4337-86c5-513ec4ca904d.png,648,1407,754,1510,106,103,red blood cell,10918,0.9716981132075472,1.029126213592233
6521,/images/640c4a52-3742-4f57-aee3-9e3dc0887622.png,397,616,504,719,107,103,red blood cell,11021,0.9626168224299065,1.0388349514563107
58021,/images/a7c91b63-b97c-4f4b-8d34-7ad2b08d7a17.png,599,1447,691,1547,92,100,red blood cell,9200,1.0869565217391304,0.92
65471,/images/da49db57-0c2f-4213-b322-c88c19fb9296.png,701,753,801,867,100,114,red blood cell,11400,1.14,0.8771929824561403
59786,/images/f77d7469-d083-4c2d-a4ea-5a9ff162e3e2.png,936,177,1024,270,88,93,red blood cell,8184,1.0568181818181819,0.946236559139785
67970,/images/bcaefb02-682a-41b9-acc7-e6cc010f5b30.png,540,775,636,881,96,106,red blood cell,10176,1.1041666666666667,0.9056603773584906
25337,/images/c52f8cc8-afd7-441c-9f1f-18b6e16d79cf.png,889,1475,1010,1586,121,111,red blood cell,13431,0.9173553719008265,1.09009009009009
61247,/images/b3058064-d817-47dd-a8c4-cdb1f62374f8.png,295,1075,376,1169,81,94,red blood cell,7614,1.1604938271604939,0.8617021276595744
9990,/images/b9ccf7ca-953f-4832-9575-5e70b2a8c224.png,190,74,308,178,118,104,red blood cell,12272,0.8813559322033898,1.1346153846153846
75886,/images/3006096f-ceeb-42be-b69e-785179d7438b.png,202,516,306,627,104,111,red blood cell,11544,1.0673076923076923,0.9369369369369369
38468,/images/674b0fd3-f247-4b7f-97f7-3e6c57c9ba9e.png,850,1012,937,1104,87,92,red blood cell,8004,1.0574712643678161,0.9456521739130435
43972,/images/d7c7eb2c-2acd-4f86-8a5a-09ab3dd02d16.png,1082,543,1172,631,90,88,red blood cell,7920,0.9777777777777777,1.0227272727272727
66531,/images/b87fb62d-2c36-4f68-aba9-37fcd7d46eef.png,615,518,731,632,116,114,red blood cell,13224,0.9827586206896551,1.0175438596491229
12900,/images/b10ea12f-cd36-4f2c-994a-67d1665269ab.png,548,59,629,155,81,96,red blood cell,7776,1.1851851851851851,0.84375
1532,/images/0ac747cd-ff32-49bf-bc1a-3e9b7702ce9c.png,150,1094,263,1196,113,102,red blood cell,11526,0.9026548672566371,1.107843137254902
11143,/images/6303f964-98ef-47c6-bb2d-283aa393f918.png,696,813,807,917,111,104,red blood cell,11544,0.9369369369369369,1.0673076923076923
19325,/images/b4d22412-a495-43a9-bec0-73a2322f8dad.png,237,237,340,342,103,105,red blood cell,10815,1.0194174757281553,0.9809523809523809
38161,/images/33bdb7b5-ad5b-4a73-bbc2-3350f8c2ac0c.png,18,213,150,348,132,135,red blood cell,17820,1.0227272727272727,0.9777777777777777
25678,/images/c118ff18-f9f2-4617-bddb-dc4091fb8f5f.png,535,1205,653,1331,118,126,red blood cell,14868,1.0677966101694916,0.9365079365079365
8396,/images/9a1cd456-310c-47b6-a1f8-0fbd8e33d1fd.png,555,1316,668,1440,113,124,red blood cell,14012,1.0973451327433628,0.9112903225806451
67494,/images/75660b56-51c2-45a9-9c15-e18d12a3af8c.png,797,309,913,417,116,108,red blood cell,12528,0.9310344827586207,1.0740740740740742
37917,/images/56a57a8d-c9b9-432a-a3b0-32a09355806c.png,188,484,284,586,96,102,red blood cell,9792,1.0625,0.9411764705882353
5461,/images/3f106606-9a21-40d5-b849-273866fe0f49.png,612,130,738,238,126,108,red blood cell,13608,0.8571428571428571,1.1666666666666667
74171,/images/4e43fc22-dc08-4cde-b3ce-ce8a4f377c47.png,1008,968,1110,1081,102,113,red blood cell,11526,1.107843137254902,0.9026548672566371
71018,/images/deaa1931-5f97-45bf-8c00-be6ddeb37b9a.png,209,9,301,107,92,98,red blood cell,9016,1.065217391304348,0.9387755102040817
41620,/images/0fcd1ebe-ee4a-40a0-b787-29cee18bfa1b.png,923,1146,1011,1248,88,102,red blood cell,8976,1.1590909090909092,0.8627450980392157
41781,/images/28bd16ba-2bcf-46af-b889-41b78d2a50c0.png,651,105,763,217,112,112,red blood cell,12544,1.0,1.0
76662,/images/3317d733-ec0d-45e6-b631-40457392f343.png,514,616,632,728,118,112,red blood cell,13216,0.9491525423728814,1.0535714285714286
56549,/images/ac8df764-c8d8-4312-916d-70bfb37574b4.png,289,499,395,600,106,101,red blood cell,10706,0.9528301886792453,1.0495049504950495
44216,/images/8b494b40-cab5-49d3-893d-c805000fbe88.png,940,1077,1042,1188,102,111,red blood cell,11322,1.088235294117647,0.918918918918919
25868,/images/461a3ed6-039f-4a70-97cf-c474ecf51ccd.png,310,1222,416,1345,106,123,red blood cell,13038,1.1603773584905661,0.8617886178861789
57655,/images/5c037ffc-f515-48b3-b231-c110fbd2b8ca.png,1019,882,1132,987,113,105,red blood cell,11865,0.9292035398230089,1.0761904761904761
2191,/images/e94a811d-3145-4313-ba42-2d5ed283179f.png,484,0,581,97,97,97,red blood cell,9409,1.0,1.0
64684,/images/6dfafdf1-f588-4e80-8cf8-0126e1bf7af9.png,48,876,144,960,96,84,red blood cell,8064,0.875,1.1428571428571428
51210,/images/ad8731b7-0dae-4983-9dc6-dec31767d761.png,575,998,681,1111,106,113,red blood cell,11978,1.0660377358490567,0.9380530973451328
77723,/images/4849866a-73a2-4fcf-a407-2d0a25a09a89.png,778,981,884,1091,106,110,red blood cell,11660,1.0377358490566038,0.9636363636363636
12547,/images/8e4bdd0d-1c72-4836-ae3e-05e2e50e4983.png,515,917,626,1038,111,121,red blood cell,13431,1.09009009009009,0.9173553719008265
51296,/images/216f9d43-6869-4ba1-9106-4f5ea6aac223.png,716,1002,801,1098,85,96,red blood cell,8160,1.1294117647058823,0.8854166666666666
13813,/images/345cb914-7583-49df-96e3-3cf19c2ba8f1.png,764,1095,875,1215,111,120,red blood cell,13320,1.0810810810810811,0.925
27036,/images/ec301f62-1302-4407-96f9-fcfe45c150ae.png,68,618,187,733,119,115,red blood cell,13685,0.9663865546218487,1.0347826086956522
58761,/images/e4827c85-311a-4df1-89c2-99dad0c3558c.png,452,1183,539,1265,87,82,red blood cell,7134,0.9425287356321839,1.0609756097560976
55174,/images/29d4b75f-d400-4702-a9ac-e5a4ed1a1db1.png,218,783,331,880,113,97,red blood cell,10961,0.8584070796460177,1.1649484536082475
10789,/images/2a02cec2-a09b-483a-ad38-14359a763fa4.png,797,290,918,413,121,123,red blood cell,14883,1.0165289256198347,0.983739837398374
74984,/images/b4c52960-bbee-439e-83dc-f89ddaade71b.png,148,355,262,480,114,125,red blood cell,14250,1.0964912280701755,0.912
14516,/images/458cb2e9-5a7f-437c-ac5d-a56f98a3efdf.png,105,811,207,904,102,93,red blood cell,9486,0.9117647058823529,1.096774193548387
18798,/images/cc882eae-a341-4783-bd19-8bdedf798538.png,424,1099,536,1209,112,110,red blood cell,12320,0.9821428571428571,1.018181818181818
67812,/images/04de3a31-fc09-40be-9c2c-9830c57f809d.png,1017,713,1131,834,114,121,red blood cell,13794,1.0614035087719298,0.9421487603305785
29095,/images/4c13e22e-dfd1-4fa1-b373-be9d0c272c0f.png,563,814,658,903,95,89,red blood cell,8455,0.9368421052631579,1.0674157303370786
69102,/images/de2b8835-552c-4f01-98b7-67bc4910062e.png,41,1175,132,1276,91,101,red blood cell,9191,1.10989010989011,0.900990099009901
27649,/images/a0785022-e82b-4878-b9d4-19cb7b75213f.png,882,983,997,1104,115,121,red blood cell,13915,1.0521739130434782,0.9504132231404959
35263,/images/a9159b11-ba49-4885-902e-00c8d5095b98.png,657,1331,775,1452,118,121,red blood cell,14278,1.0254237288135593,0.9752066115702479
47205,/images/58ced55c-bf0d-4204-b6b2-4f8992d92779.png,300,797,418,907,118,110,red blood cell,12980,0.9322033898305084,1.0727272727272728
35996,/images/5836500a-221e-40ca-a8be-caaa37f7d300.png,412,664,512,769,100,105,red blood cell,10500,1.05,0.9523809523809523
48669,/images/03359d4d-69cb-4146-8286-ca7399366f97.png,326,1,430,109,104,108,red blood cell,11232,1.0384615384615385,0.9629629629629629
32802,/images/67f5ca94-d84e-490e-bf0d-4ffba7bdbe30.png,502,546,596,648,94,102,red blood cell,9588,1.0851063829787233,0.9215686274509803
68326,/images/0f735cca-051c-4048-a1fa-cb36f389e12f.png,810,944,943,1060,133,116,red blood cell,15428,0.8721804511278195,1.146551724137931
72487,/images/22516db4-8687-4051-90c4-2bb1ca3204a5.png,469,150,560,256,91,106,red blood cell,9646,1.164835164835165,0.8584905660377359
15335,/images/2d0f600d-f94e-4907-b712-52fb37d9ed52.png,828,742,937,849,109,107,red blood cell,11663,0.981651376146789,1.0186915887850467
22489,/images/dd60b6a7-c545-45b9-8250-d1633aa1ac75.png,640,548,731,640,91,92,red blood cell,8372,1.010989010989011,0.9891304347826086
62493,/images/7dfbfeaf-e3b1-4159-8dcd-d7f731280ac8.png,854,968,944,1065,90,97,red blood cell,8730,1.0777777777777777,0.9278350515463918
21233,/images/0ceb4539-5c4c-487d-9826-452a88b5d537.png,203,1410,327,1517,124,107,red blood cell,13268,0.8629032258064516,1.158878504672897
14263,/images/6382976c-ee87-4916-b798-4ef1373b2df0.png,307,339,429,453,122,114,red blood cell,13908,0.9344262295081968,1.0701754385964912
8581,/images/a6aa3b72-2970-4c78-b655-ea8dfe6e018c.png,518,470,618,580,100,110,red blood cell,11000,1.1,0.9090909090909091
41630,/images/0fcd1ebe-ee4a-40a0-b787-29cee18bfa1b.png,764,1451,853,1538,89,87,red blood cell,7743,0.9775280898876404,1.0229885057471264
8960,/images/04628a94-b674-469b-aff6-b476b70df87d.png,897,438,1021,563,124,125,red blood cell,15500,1.0080645161290323,0.992
61900,/images/f32b21ae-5ca7-490b-bc40-6db9396d933c.png,556,165,669,270,113,105,red blood cell,11865,0.9292035398230089,1.0761904761904761
41286,/images/2374ae5b-c2df-4db5-afea-c54180aa22e3.png,391,137,510,261,119,124,red blood cell,14756,1.0420168067226891,0.9596774193548387
76166,/images/16244280-6c74-47d3-b544-9fd6831a6bf9.png,492,106,584,210,92,104,red blood cell,9568,1.1304347826086956,0.8846153846153846
40016,/images/8271d0d8-9985-43eb-94b3-c702adca139f.png,59,827,151,928,92,101,red blood cell,9292,1.0978260869565217,0.9108910891089109
73694,/images/f11d05e4-538a-4024-8711-b08a4ce3c540.png,636,193,735,296,99,103,red blood cell,10197,1.0404040404040404,0.9611650485436893
34246,/images/259da25f-40f3-4d37-bca9-a9c807af1547.png,519,1224,636,1344,117,120,red blood cell,14040,1.0256410256410255,0.975
69000,/images/b5246b58-6f40-4c9e-8024-f49b0ed6bdbd.png,550,245,647,340,97,95,red blood cell,9215,0.979381443298969,1.0210526315789474
53790,/images/76b24246-8571-4e7b-8815-b185414a2c51.png,165,1012,257,1111,92,99,red blood cell,9108,1.076086956521739,0.9292929292929293
77346,/images/3ff98212-7c2a-46cd-afb7-34a2479bed07.png,465,59,584,170,119,111,red blood cell,13209,0.9327731092436975,1.072072072072072
66711,/images/334bf865-e3fb-4200-bd53-d9ff5808ed9f.png,495,712,607,820,112,108,red blood cell,12096,0.9642857142857143,1.037037037037037
79994,/images/e640ae51-cbf1-4a84-b7cf-d38b17f59c2f.png,551,1025,667,1121,116,96,red blood cell,11136,0.8275862068965517,1.2083333333333333
72928,/images/a20d0b4b-6e2e-4507-bc22-f321dedc4ed9.png,503,858,602,963,99,105,red blood cell,10395,1.0606060606060606,0.9428571428571428
23375,/images/a7688988-2bcc-4458-83d3-5e482da5f87b.png,95,396,215,525,120,129,red blood cell,15480,1.075,0.9302325581395349
55799,/images/68f34a9c-f73d-4238-8f55-4b05a8a2154c.png,718,931,801,1008,83,77,red blood cell,6391,0.927710843373494,1.077922077922078
26968,/images/1f337b61-1b0d-4539-91f9-73d4a0798a4a.png,541,502,633,597,92,95,red blood cell,8740,1.0326086956521738,0.968421052631579
48804,/images/fed6ba05-36a5-45dc-a4e1-9baa7de2c622.png,720,1427,822,1535,102,108,red blood cell,11016,1.0588235294117647,0.9444444444444444
44110,/images/8b494b40-cab5-49d3-893d-c805000fbe88.png,1052,403,1164,501,112,98,red blood cell,10976,0.875,1.1428571428571428
12602,/images/8e4bdd0d-1c72-4836-ae3e-05e2e50e4983.png,889,123,1014,231,125,108,red blood cell,13500,0.864,1.1574074074074074
52650,/images/3f390b82-8859-4c27-bbfe-d1b242477f63.png,149,1334,254,1442,105,108,red blood cell,11340,1.0285714285714285,0.9722222222222222
3168,/images/729a38d6-66db-48e5-a00d-7d90d224290f.png,547,61,677,196,130,135,red blood cell,17550,1.0384615384615385,0.9629629629629629
7550,/images/071901eb-4c3f-404b-a747-3d0b9d0a5158.png,1014,323,1104,423,90,100,red blood cell,9000,1.1111111111111112,0.9
3192,/images/c3215597-a032-46be-9058-d6de1e5191d7.png,144,890,266,1003,122,113,red blood cell,13786,0.9262295081967213,1.079646017699115
1045,/images/63d36d2c-43a9-49ac-9504-028b4968c860.png,338,1444,463,1554,125,110,red blood cell,13750,0.88,1.1363636363636365
56867,/images/a588091c-5e4c-4e61-914d-e96f3ee3e505.png,1010,323,1129,443,119,120,red blood cell,14280,1.0084033613445378,0.9916666666666667
52272,/images/4903d9c7-de88-426a-b42d-a7e797e5ebcd.png,451,1377,552,1487,101,110,red blood cell,11110,1.0891089108910892,0.9181818181818182
18680,/images/c22f7031-9cf8-48ce-b03b-1b12d0db4951.png,73,82,180,178,107,96,red blood cell,10272,0.897196261682243,1.1145833333333333
43372,/images/aabca37c-f9ef-4415-aab6-3246caa348e9.png,724,363,830,473,106,110,red blood cell,11660,1.0377358490566038,0.9636363636363636
4993,/images/2cc3c4ad-670f-41b6-8910-0704cbc192ef.png,932,486,1036,598,104,112,red blood cell,11648,1.0769230769230769,0.9285714285714286
39478,/images/5a631871-2fc7-4a68-9c39-f3b9a0bf4a04.png,817,864,926,965,109,101,red blood cell,11009,0.926605504587156,1.0792079207920793
67726,/images/48e2f0bd-2164-40c3-af43-1f2708359978.png,268,104,383,220,115,116,red blood cell,13340,1.008695652173913,0.9913793103448276
16251,/images/acdc6e12-73d9-44ba-be8c-2a56aaffef4f.png,529,1467,649,1568,120,101,red blood cell,12120,0.8416666666666667,1.188118811881188
67616,/images/59542a24-b409-4c95-8608-d9691a741526.png,0,588,121,706,121,118,red blood cell,14278,0.9752066115702479,1.0254237288135593
8968,/images/ef815e3a-02a6-4cf8-9262-45bc74c50b00.png,88,970,187,1074,99,104,red blood cell,10296,1.0505050505050506,0.9519230769230769
48381,/images/0fa5b35d-6c44-4207-b6f8-d5b355086b5f.png,899,1449,1034,1577,135,128,red blood cell,17280,0.9481481481481482,1.0546875
41944,/images/46a03374-64c7-49ac-81c9-c3d62542bbf3.png,64,560,164,656,100,96,red blood cell,9600,0.96,1.0416666666666667
71730,/images/093a831a-bf71-4333-bc06-942ae70cb164.png,747,114,856,229,109,115,red blood cell,12535,1.055045871559633,0.9478260869565217
61784,/images/985627c9-7b85-40de-a106-eb9cc47b47cb.png,403,196,491,284,88,88,red blood cell,7744,1.0,1.0
4300,/images/882b91b7-5906-4091-bad4-688d4375eeb5.png,156,702,259,826,103,124,red blood cell,12772,1.203883495145631,0.8306451612903226
65799,/images/daea4860-a296-4f6d-acef-996ab0882676.png,1081,1364,1185,1483,104,119,red blood cell,12376,1.1442307692307692,0.8739495798319328
21076,/images/c680004e-6ee2-43d7-877c-edc9b5ebeecc.png,588,353,711,473,123,120,red blood cell,14760,0.975609756097561,1.025
34522,/images/fa1f9f89-cecb-4972-842c-d14c632f89a9.png,934,1064,1045,1172,111,108,red blood cell,11988,0.972972972972973,1.0277777777777777
31410,/images/6695a204-e39c-4418-b904-3f080fdbe7e8.png,687,1153,804,1276,117,123,red blood cell,14391,1.0512820512820513,0.9512195121951219
51007,/images/cc275c45-7511-4070-84af-10b8ffebda53.png,90,969,224,1101,134,132,red blood cell,17688,0.9850746268656716,1.0151515151515151
14147,/images/eaf4b781-b3aa-41ce-8c5e-287979b4e15a.png,900,1458,992,1545,92,87,red blood cell,8004,0.9456521739130435,1.0574712643678161
44719,/images/ccb4b13d-ab20-4222-892f-5adf70249aaa.png,938,672,1055,792,117,120,red blood cell,14040,1.0256410256410255,0.975
17227,/images/471f75c6-bd5d-4c20-bcc1-258e836f4d69.png,156,1083,242,1190,86,107,red blood cell,9202,1.244186046511628,0.8037383177570093
37549,/images/205306da-0ed8-475a-ace6-f2f81d4be88a.png,341,1321,430,1412,89,91,red blood cell,8099,1.0224719101123596,0.978021978021978
10660,/images/20d4f65e-6c63-433a-935c-d568d577967b.png,225,554,331,670,106,116,red blood cell,12296,1.0943396226415094,0.9137931034482759
22331,/images/49b03a6e-6b26-4a96-a061-e05647a02138.png,379,327,486,432,107,105,red blood cell,11235,0.9813084112149533,1.019047619047619
46036,/images/72088c26-d2dd-4906-b791-b8947fc7fbe4.png,14,206,121,302,107,96,red blood cell,10272,0.897196261682243,1.1145833333333333
59235,/images/03c8da48-04b9-4520-b674-44a0ecd35688.png,337,483,431,573,94,90,red blood cell,8460,0.9574468085106383,1.0444444444444445
70984,/images/deaa1931-5f97-45bf-8c00-be6ddeb37b9a.png,978,1180,1098,1294,120,114,red blood cell,13680,0.95,1.0526315789473684
55434,/images/d67655e6-0a80-4a86-b552-1f5e85788377.png,558,440,644,539,86,99,red blood cell,8514,1.1511627906976745,0.8686868686868687
8138,/images/694222bb-cddf-469a-9526-f873c6fba58e.png,208,759,292,855,84,96,red blood cell,8064,1.1428571428571428,0.875
31670,/images/0d7bf56f-3b5a-40bd-971c-2ca33dd89b2c.png,481,434,571,537,90,103,red blood cell,9270,1.1444444444444444,0.8737864077669902
61696,/images/12269960-075f-40ca-9630-49ea2ce78294.png,175,452,278,556,103,104,red blood cell,10712,1.0097087378640777,0.9903846153846154
59098,/images/5e2cea49-0823-49d1-83cf-8fd1559cdd93.png,667,1055,758,1156,91,101,red blood cell,9191,1.10989010989011,0.900990099009901
41654,/images/0fcd1ebe-ee4a-40a0-b787-29cee18bfa1b.png,370,128,468,215,98,87,red blood cell,8526,0.8877551020408163,1.1264367816091954
74753,/images/c53fd511-31bd-4901-baac-3b44891f6744.png,13,1103,121,1207,108,104,red blood cell,11232,0.9629629629629629,1.0384615384615385
5264,/images/729733ff-a349-4a96-b636-ccabe7d7e167.png,897,258,1008,370,111,112,red blood cell,12432,1.009009009009009,0.9910714285714286
73714,/images/f11d05e4-538a-4024-8711-b08a4ce3c540.png,216,1395,336,1517,120,122,red blood cell,14640,1.0166666666666666,0.9836065573770492
39191,/images/2aeb7b85-7df9-4a63-8d37-2eecaaa190e7.png,1032,999,1131,1081,99,82,red blood cell,8118,0.8282828282828283,1.2073170731707317
29183,/images/6274fe0d-0d71-40be-b61b-f0bd5b5df1e2.png,1090,654,1197,756,107,102,red blood cell,10914,0.9532710280373832,1.0490196078431373
544,/images/67acd5bc-4658-4c6e-a9b9-cd8ea3a03418.png,29,585,147,704,118,119,red blood cell,14042,1.0084745762711864,0.9915966386554622
53635,/images/7bcd3735-3134-46d1-8ca2-d4379f2d51c0.png,256,798,357,895,101,97,red blood cell,9797,0.9603960396039604,1.041237113402062
2796,/images/e79bd81b-f878-4bee-9be2-d91a722c031e.png,496,378,610,494,114,116,red blood cell,13224,1.0175438596491229,0.9827586206896551
68314,/images/0f735cca-051c-4048-a1fa-cb36f389e12f.png,22,520,134,619,112,99,red blood cell,11088,0.8839285714285714,1.1313131313131313
855,/images/c7a2d648-47cb-4b39-afa4-1b7fcfe51934.png,988,343,1118,491,130,148,red blood cell,19240,1.1384615384615384,0.8783783783783784
68642,/images/31653d0f-c4e6-4e12-8005-518c2de34687.png,628,236,725,344,97,108,red blood cell,10476,1.1134020618556701,0.8981481481481481
38023,/images/e3e9c2de-0a24-4c7e-8a69-3d3093d5bdab.png,837,1318,937,1410,100,92,red blood cell,9200,0.92,1.0869565217391304
9768,/images/3859deaf-6ae1-49a3-9051-898d0f0d7de6.png,1029,540,1117,640,88,100,red blood cell,8800,1.1363636363636365,0.88
52699,/images/9dc6ed5d-6698-48cf-aab3-fd156673729c.png,205,1054,312,1166,107,112,red blood cell,11984,1.0467289719626167,0.9553571428571429
51532,/images/6afb3717-f197-4668-929a-4fab389ae6e8.png,503,205,596,295,93,90,red blood cell,8370,0.967741935483871,1.0333333333333334
17927,/images/eb77e4a9-acb0-4d83-8055-2c5fcaa54b45.png,354,1157,486,1270,132,113,red blood cell,14916,0.8560606060606061,1.168141592920354
21717,/images/f68ae8e9-e760-4106-88e0-4bdef2785f06.png,1013,1147,1104,1255,91,108,red blood cell,9828,1.1868131868131868,0.8425925925925926
7192,/images/56551792-4aa1-4301-9f8f-8bfebcd20050.png,116,797,230,898,114,101,red blood cell,11514,0.8859649122807017,1.1287128712871286
26254,/images/52767904-4cdc-4821-ba68-8cd0c28f9023.png,614,1423,736,1535,122,112,red blood cell,13664,0.9180327868852459,1.0892857142857142
40709,/images/252071ac-e9f2-41d2-abbb-87ef01b8a997.png,930,1447,1020,1556,90,109,red blood cell,9810,1.211111111111111,0.8256880733944955
66265,/images/e8058bed-c362-4e1c-85dc-62f80f32938f.png,951,1344,1046,1422,95,78,red blood cell,7410,0.8210526315789474,1.2179487179487178
66489,/images/5f66d20c-fbfe-44ec-a01b-8a09da24807e.png,647,1495,723,1576,76,81,red blood cell,6156,1.0657894736842106,0.9382716049382716
50083,/images/e98baeb2-aa58-4cce-8c61-66685dd2b239.png,228,387,330,498,102,111,red blood cell,11322,1.088235294117647,0.918918918918919
46984,/images/9ebd623d-5534-4dd9-bff8-cdedf322db35.png,172,249,287,360,115,111,red blood cell,12765,0.9652173913043478,1.0360360360360361
7849,/images/1493d140-c9d5-4c3a-9caf-3eafb290a49b.png,261,1398,391,1514,130,116,red blood cell,15080,0.8923076923076924,1.1206896551724137
41739,/images/32a1ea24-b6b7-4253-ad3e-bdf99c2c9b9d.png,654,132,771,260,117,128,red blood cell,14976,1.0940170940170941,0.9140625
24233,/images/bb3ae957-0f6d-4615-bfe5-24fbca50b459.png,950,1017,1050,1126,100,109,red blood cell,10900,1.09,0.9174311926605505
39928,/images/8271d0d8-9985-43eb-94b3-c702adca139f.png,519,1306,638,1419,119,113,red blood cell,13447,0.9495798319327731,1.0530973451327434
28485,/images/dc4270fb-e5c2-414f-96e9-6769ba1d77e4.png,739,1358,857,1465,118,107,red blood cell,12626,0.9067796610169492,1.102803738317757
71747,/images/093a831a-bf71-4333-bc06-942ae70cb164.png,215,1336,320,1443,105,107,red blood cell,11235,1.019047619047619,0.9813084112149533
69505,/images/664c570b-4822-413c-9724-11b1d91fac44.png,153,1003,249,1096,96,93,red blood cell,8928,0.96875,1.032258064516129
72756,/images/caeb2d62-1166-43f0-8eac-5b8fc48f02eb.png,926,1424,1020,1526,94,102,red blood cell,9588,1.0851063829787233,0.9215686274509803
17523,/images/56077789-8580-41b4-89d6-deea227e5c60.png,865,454,981,561,116,107,red blood cell,12412,0.9224137931034483,1.0841121495327102
14500,/images/458cb2e9-5a7f-437c-ac5d-a56f98a3efdf.png,987,520,1093,622,106,102,red blood cell,10812,0.9622641509433962,1.0392156862745099
1448,/images/5f17d2fb-22fa-4aa6-9dad-6a1d50c03815.png,70,1156,187,1280,117,124,red blood cell,14508,1.0598290598290598,0.9435483870967742
67953,/images/bcaefb02-682a-41b9-acc7-e6cc010f5b30.png,609,710,716,820,107,110,red blood cell,11770,1.02803738317757,0.9727272727272728
33786,/images/cb08956d-dd6a-4e13-817b-40a0a93068f1.png,965,1419,1098,1540,133,121,red blood cell,16093,0.9097744360902256,1.0991735537190082
26410,/images/d532e31c-10ce-4313-9a36-bd5e01230254.png,71,809,188,921,117,112,red blood cell,13104,0.9572649572649573,1.0446428571428572
71911,/images/61575482-91e1-4db9-83c7-687b7ddbbfc4.png,466,189,558,282,92,93,red blood cell,8556,1.0108695652173914,0.989247311827957
34022,/images/1012abf2-cb05-4337-86c5-513ec4ca904d.png,964,448,1072,564,108,116,red blood cell,12528,1.0740740740740742,0.9310344827586207
44822,/images/6795acae-e84d-4e97-b9a1-b4f4f0a72cfd.png,1,1462,111,1572,110,110,red blood cell,12100,1.0,1.0
22746,/images/8490c623-3d88-4532-baf5-0d266a45b16f.png,452,758,576,877,124,119,red blood cell,14756,0.9596774193548387,1.0420168067226891
12110,/images/984caf56-f400-4a29-be97-a4d6b9d1468d.png,694,331,791,429,97,98,red blood cell,9506,1.0103092783505154,0.9897959183673469
365,/images/7c66d2fd-68ee-4628-b860-9d7ad25b2a80.png,826,1321,935,1409,109,88,red blood cell,9592,0.8073394495412844,1.2386363636363635
36454,/images/cfe6086f-eb0b-4cb0-a430-8cd7de6556e2.png,440,1493,548,1596,108,103,red blood cell,11124,0.9537037037037037,1.0485436893203883
23805,/images/eeb06e39-482b-443d-8cf6-b9b5c763df78.png,581,1072,683,1176,102,104,red blood cell,10608,1.0196078431372548,0.9807692307692307
37813,/images/8d56197c-21d7-4cb6-92df-80637efd129b.png,515,541,626,668,111,127,red blood cell,14097,1.1441441441441442,0.8740157480314961
52997,/images/42e87148-a015-4148-923a-fb83016f64e7.png,697,1405,817,1525,120,120,red blood cell,14400,1.0,1.0
41777,/images/32a1ea24-b6b7-4253-ad3e-bdf99c2c9b9d.png,396,1184,527,1333,131,149,red blood cell,19519,1.1374045801526718,0.8791946308724832
17914,/images/eb77e4a9-acb0-4d83-8055-2c5fcaa54b45.png,318,1481,425,1588,107,107,red blood cell,11449,1.0,1.0
33852,/images/b9de8b1a-f96a-4eb5-bc05-84ad43a054f3.png,863,332,991,457,128,125,red blood cell,16000,0.9765625,1.024
6627,/images/640c4a52-3742-4f57-aee3-9e3dc0887622.png,901,501,999,583,98,82,red blood cell,8036,0.8367346938775511,1.1951219512195121
41731,/images/32a1ea24-b6b7-4253-ad3e-bdf99c2c9b9d.png,268,581,383,703,115,122,red blood cell,14030,1.0608695652173914,0.9426229508196722
3495,/images/ad36bd67-594b-4f63-93e3-886af0bc618e.png,860,523,976,636,116,113,red blood cell,13108,0.9741379310344828,1.0265486725663717
65934,/images/25c6cfb1-01d0-4864-87f9-02b7593683c7.png,256,716,370,838,114,122,red blood cell,13908,1.0701754385964912,0.9344262295081968
71671,/images/5c99cd97-39f6-4809-9528-9d380cc16b16.png,426,551,525,667,99,116,red blood cell,11484,1.1717171717171717,0.853448275862069
58127,/images/e9916e11-9be6-4dec-9df6-2e7d1a8e1735.png,583,12,697,113,114,101,red blood cell,11514,0.8859649122807017,1.1287128712871286
73427,/images/58594235-0d32-4a4e-91cd-4c800eaaaa73.png,235,842,357,959,122,117,red blood cell,14274,0.9590163934426229,1.0427350427350428
75300,/images/9ec1dcec-87c2-4aca-8e6b-0db3cd05509c.png,890,1204,978,1280,88,76,red blood cell,6688,0.8636363636363636,1.1578947368421053
20355,/images/11e517bf-943b-4928-929a-e9f72c097880.png,736,745,839,871,103,126,red blood cell,12978,1.2233009708737863,0.8174603174603174
22017,/images/c5acd0ad-b0f2-478d-b0ad-5aa733aa7b32.png,767,1144,901,1266,134,122,red blood cell,16348,0.9104477611940298,1.098360655737705
35031,/images/67582df6-bf13-4c83-a531-1214692b70de.png,40,334,156,451,116,117,red blood cell,13572,1.0086206896551724,0.9914529914529915
23721,/images/79d7a014-21ff-40f1-9ac4-a69839390654.png,12,1004,112,1090,100,86,red blood cell,8600,0.86,1.1627906976744187
9081,/images/21c2a8aa-407c-4569-8212-96fcafa84138.png,199,704,338,825,139,121,red blood cell,16819,0.8705035971223022,1.1487603305785123
8518,/images/dfc026a9-079f-4f45-8666-e0ccba5bb437.png,1010,1471,1124,1578,114,107,red blood cell,12198,0.9385964912280702,1.0654205607476634
28799,/images/686ed568-d5f8-475e-81ad-edab9dd473a0.png,328,672,428,786,100,114,red blood cell,11400,1.14,0.8771929824561403
32551,/images/318de807-7232-4ab1-843e-a901547c0125.png,621,1162,741,1292,120,130,red blood cell,15600,1.0833333333333333,0.9230769230769231
6072,/images/c147584d-4c61-412a-bdaf-b02b22c18708.png,419,380,540,511,121,131,red blood cell,15851,1.0826446280991735,0.9236641221374046
39538,/images/5a631871-2fc7-4a68-9c39-f3b9a0bf4a04.png,688,1425,812,1526,124,101,red blood cell,12524,0.8145161290322581,1.2277227722772277
42472,/images/29648565-fe28-4517-ba72-68df0c82c9c5.png,381,793,502,915,121,122,red blood cell,14762,1.0082644628099173,0.9918032786885246
65023,/images/ff3b9d4d-373c-48ef-a75a-d23e2c2ade87.png,1059,114,1160,225,101,111,red blood cell,11211,1.099009900990099,0.9099099099099099
2096,/images/f3bd0fcc-647d-4ca0-8c43-a16bd6ea3878.png,927,1483,1047,1597,120,114,red blood cell,13680,0.95,1.0526315789473684
58296,/images/319c9c52-f316-49f3-baad-4444ab19f85b.png,899,1125,1007,1232,108,107,red blood cell,11556,0.9907407407407407,1.0093457943925233
1707,/images/5f783f43-0090-4f8a-bd75-9562f4aa2dd5.png,713,226,823,322,110,96,red blood cell,10560,0.8727272727272727,1.1458333333333333
32083,/images/b8a4d467-c40c-4ebf-91dd-1c19d0f2a7ae.png,173,1343,278,1444,105,101,red blood cell,10605,0.9619047619047619,1.0396039603960396
1704,/images/5f783f43-0090-4f8a-bd75-9562f4aa2dd5.png,428,900,529,1017,101,117,red blood cell,11817,1.1584158415841583,0.8632478632478633
50740,/images/6b4c79f5-b194-4586-be9f-e339c5af4188.png,1017,355,1125,463,108,108,red blood cell,11664,1.0,1.0
42129,/images/c63f190a-e860-44fc-a2db-7980e1c80519.png,11,1168,124,1294,113,126,red blood cell,14238,1.1150442477876106,0.8968253968253969
41965,/images/46a03374-64c7-49ac-81c9-c3d62542bbf3.png,634,571,734,679,100,108,red blood cell,10800,1.08,0.9259259259259259
73667,/images/a51d6c18-f9e8-4714-9dbb-38e1577445f2.png,268,1505,386,1600,118,95,red blood cell,11210,0.8050847457627118,1.2421052631578948
41152,/images/2240b991-48f6-4c59-9b62-5a8b5e541fae.png,547,33,655,146,108,113,red blood cell,12204,1.0462962962962963,0.9557522123893806
48730,/images/bc832bde-d3ea-4a8e-be90-7a3329dcc314.png,513,682,633,797,120,115,red blood cell,13800,0.9583333333333334,1.0434782608695652
45845,/images/7db1373d-5bbf-47e6-ab40-30cba7678745.png,519,1440,616,1556,97,116,red blood cell,11252,1.1958762886597938,0.8362068965517241
57675,/images/5c037ffc-f515-48b3-b231-c110fbd2b8ca.png,200,161,292,267,92,106,red blood cell,9752,1.1521739130434783,0.8679245283018868
60800,/images/645cd195-af50-409f-8da9-6e7c7f18ea09.png,1082,46,1188,161,106,115,red blood cell,12190,1.0849056603773586,0.9217391304347826
54328,/images/3b5a8060-dec6-4a83-b7f2-b604e4e69dfc.png,485,439,583,535,98,96,red blood cell,9408,0.9795918367346939,1.0208333333333333
25217,/images/90171428-f208-428a-b40e-f57ee3bea457.png,374,1330,472,1431,98,101,red blood cell,9898,1.030612244897959,0.9702970297029703
13019,/images/b10ea12f-cd36-4f2c-994a-67d1665269ab.png,964,965,1077,1065,113,100,red blood cell,11300,0.8849557522123894,1.13
76506,/images/34df8890-272d-423a-ae78-ff8d068d3306.png,1049,30,1141,122,92,92,red blood cell,8464,1.0,1.0
1056,/images/63d36d2c-43a9-49ac-9504-028b4968c860.png,231,72,335,169,104,97,red blood cell,10088,0.9326923076923077,1.0721649484536082
22310,/images/49b03a6e-6b26-4a96-a061-e05647a02138.png,1015,413,1132,525,117,112,red blood cell,13104,0.9572649572649573,1.0446428571428572
14019,/images/eaf4b781-b3aa-41ce-8c5e-287979b4e15a.png,717,1039,812,1131,95,92,red blood cell,8740,0.968421052631579,1.0326086956521738
35244,/images/a9159b11-ba49-4885-902e-00c8d5095b98.png,747,1114,838,1198,91,84,red blood cell,7644,0.9230769230769231,1.0833333333333333
41190,/images/eed298b3-35f2-4127-88ad-0c4a9062207b.png,121,971,217,1065,96,94,red blood cell,9024,0.9791666666666666,1.0212765957446808
42504,/images/29648565-fe28-4517-ba72-68df0c82c9c5.png,376,438,494,548,118,110,red blood cell,12980,0.9322033898305084,1.0727272727272728
15574,/images/169d541c-daed-468e-8b41-0f1abccdf319.png,297,420,414,534,117,114,red blood cell,13338,0.9743589743589743,1.0263157894736843
34890,/images/a4fbb9f2-9b75-4fdc-877d-2feaafac25b3.png,852,1483,937,1578,85,95,red blood cell,8075,1.1176470588235294,0.8947368421052632
54147,/images/c415532c-4cce-4580-9fcd-623c172a1abd.png,643,952,767,1063,124,111,red blood cell,13764,0.8951612903225806,1.117117117117117
79415,/images/dcb21739-3c36-459d-b3cc-1be5871d6fe7.png,1036,144,1136,249,100,105,red blood cell,10500,1.05,0.9523809523809523
35986,/images/5836500a-221e-40ca-a8be-caaa37f7d300.png,843,319,940,415,97,96,red blood cell,9312,0.9896907216494846,1.0104166666666667
65579,/images/01b38a56-13eb-447b-89ee-fc21cb40dcc1.png,483,138,590,247,107,109,red blood cell,11663,1.0186915887850467,0.981651376146789
72342,/images/ee57e743-a876-4f69-9fe5-bf5d01b44689.png,608,644,689,732,81,88,red blood cell,7128,1.0864197530864197,0.9204545454545454
52671,/images/3f390b82-8859-4c27-bbfe-d1b242477f63.png,918,154,1030,268,112,114,red blood cell,12768,1.0178571428571428,0.9824561403508771
23537,/images/177f883a-f0f1-4b8e-b598-2ca4bab27381.png,900,1104,1004,1217,104,113,red blood cell,11752,1.0865384615384615,0.9203539823008849
62468,/images/7dfbfeaf-e3b1-4159-8dcd-d7f731280ac8.png,820,1324,916,1413,96,89,red blood cell,8544,0.9270833333333334,1.0786516853932584
53173,/images/801296d9-3403-426f-859e-5c532858e025.png,169,961,289,1079,120,118,red blood cell,14160,0.9833333333333333,1.0169491525423728
61666,/images/a3c0a876-be12-4ede-8aed-18b32a64401b.png,1099,893,1200,975,101,82,red blood cell,8282,0.8118811881188119,1.2317073170731707
28269,/images/036404d1-b9fc-497b-bbe1-f4d9c5ac3ce0.png,461,1279,565,1388,104,109,red blood cell,11336,1.0480769230769231,0.9541284403669725
9910,/images/b4261fa5-876d-48ea-b6da-ec7ca5b48fe2.png,591,212,699,314,108,102,red blood cell,11016,0.9444444444444444,1.0588235294117647
35162,/images/bfc61c48-685d-470b-86b1-e4c7eb85c4fd.png,894,956,1026,1079,132,123,red blood cell,16236,0.9318181818181818,1.0731707317073171
23674,/images/79d7a014-21ff-40f1-9ac4-a69839390654.png,87,1376,188,1483,101,107,red blood cell,10807,1.0594059405940595,0.9439252336448598
39581,/images/5a631871-2fc7-4a68-9c39-f3b9a0bf4a04.png,697,719,809,832,112,113,red blood cell,12656,1.0089285714285714,0.9911504424778761
226,/images/2559636b-f01a-4414-93da-210c3b12d153.png,772,1454,907,1575,135,121,red blood cell,16335,0.8962962962962963,1.115702479338843
8786,/images/ae17a099-18b5-4a42-a901-850ea056423e.png,290,586,386,682,96,96,red blood cell,9216,1.0,1.0
21221,/images/0ceb4539-5c4c-487d-9826-452a88b5d537.png,636,119,733,226,97,107,red blood cell,10379,1.1030927835051547,0.9065420560747663
11180,/images/6303f964-98ef-47c6-bb2d-283aa393f918.png,336,987,416,1074,80,87,red blood cell,6960,1.0875,0.9195402298850575
12324,/images/3b55c42f-ad59-422f-ba99-4f4f4ca9cb2e.png,898,700,999,800,101,100,red blood cell,10100,0.9900990099009901,1.01
35038,/images/67582df6-bf13-4c83-a531-1214692b70de.png,1012,913,1120,1034,108,121,red blood cell,13068,1.1203703703703705,0.8925619834710744
11399,/images/b5513d5b-46fc-4f44-a616-791087fbd608.png,287,1205,395,1313,108,108,red blood cell,11664,1.0,1.0
55059,/images/1f8f08ea-b5b3-4f68-94d4-3cc071b7dce8.png,241,361,343,470,102,109,red blood cell,11118,1.0686274509803921,0.9357798165137615
2944,/images/00a02700-2ea2-4590-9e15-ffc9160fd3de.png,189,1442,318,1564,129,122,red blood cell,15738,0.9457364341085271,1.0573770491803278
48329,/images/6fa2b30f-9b89-46ac-9b79-c0bc105d4271.png,926,835,1030,945,104,110,red blood cell,11440,1.0576923076923077,0.9454545454545454
23284,/images/157ac97a-396e-4f6c-94c6-72a4d06ccc5f.png,407,1010,529,1123,122,113,red blood cell,13786,0.9262295081967213,1.079646017699115
72740,/images/caeb2d62-1166-43f0-8eac-5b8fc48f02eb.png,11,1443,112,1556,101,113,red blood cell,11413,1.118811881188119,0.8938053097345132
75541,/images/c35ee701-fde2-46b5-b178-1fe3f1ea7da2.png,348,130,452,235,104,105,red blood cell,10920,1.0096153846153846,0.9904761904761905
61307,/images/b3058064-d817-47dd-a8c4-cdb1f62374f8.png,449,6,558,126,109,120,red blood cell,13080,1.1009174311926606,0.9083333333333333
21874,/images/30ad83f1-a9b3-4a07-aea6-6c06b71e9ace.png,649,1411,751,1522,102,111,red blood cell,11322,1.088235294117647,0.918918918918919
1803,/images/5f783f43-0090-4f8a-bd75-9562f4aa2dd5.png,1092,421,1189,512,97,91,red blood cell,8827,0.9381443298969072,1.065934065934066
31546,/images/3130f950-8345-4315-9711-92f7af3f5c14.png,258,438,389,553,131,115,red blood cell,15065,0.8778625954198473,1.1391304347826088
7215,/images/89f10192-d3dd-4996-a571-4c851dbdc983.png,984,9,1068,110,84,101,red blood cell,8484,1.2023809523809523,0.8316831683168316
3234,/images/96596a68-8c95-43f3-b74e-e9506c235144.png,585,519,682,622,97,103,red blood cell,9991,1.0618556701030928,0.941747572815534
44120,/images/8b494b40-cab5-49d3-893d-c805000fbe88.png,1082,691,1197,808,115,117,red blood cell,13455,1.017391304347826,0.9829059829059829
79140,/images/1c90231b-2830-42d9-884e-7301edb16933.png,925,610,1009,701,84,91,red blood cell,7644,1.0833333333333333,0.9230769230769231
13556,/images/370277f8-436b-4103-8210-b4feb5ab95ea.png,1072,1452,1163,1556,91,104,red blood cell,9464,1.1428571428571428,0.875
43567,/images/e0ef520d-7b65-485d-9888-e6859f189f70.png,1055,143,1163,261,108,118,red blood cell,12744,1.0925925925925926,0.9152542372881356
17786,/images/1863da5f-c595-4541-a8f4-21fe78678168.png,588,1482,700,1575,112,93,red blood cell,10416,0.8303571428571429,1.2043010752688172
28049,/images/c4d34e35-4db2-41de-ba77-1a94aa9ef788.png,43,558,156,677,113,119,red blood cell,13447,1.0530973451327434,0.9495798319327731
6969,/images/c776eb78-3323-4571-b39f-7ffc73ae63ce.png,545,1082,657,1199,112,117,red blood cell,13104,1.0446428571428572,0.9572649572649573
55264,/images/8ad7ba46-5db8-4ba9-b3e0-3cac52f7efc3.png,453,702,533,801,80,99,red blood cell,7920,1.2375,0.8080808080808081
47700,/images/afbb264e-ff60-443a-83f5-49d09be1b835.png,267,880,384,1000,117,120,red blood cell,14040,1.0256410256410255,0.975
57667,/images/5c037ffc-f515-48b3-b231-c110fbd2b8ca.png,671,1195,779,1300,108,105,red blood cell,11340,0.9722222222222222,1.0285714285714285
37977,/images/56a57a8d-c9b9-432a-a3b0-32a09355806c.png,795,1028,878,1127,83,99,red blood cell,8217,1.1927710843373494,0.8383838383838383
78177,/images/2bed2796-75a9-4d93-bb2d-e3ccbe1a5cbe.png,374,175,486,294,112,119,red blood cell,13328,1.0625,0.9411764705882353
25900,/images/4811fdf2-d7e8-475e-a840-45dda5282bf3.png,113,721,230,847,117,126,red blood cell,14742,1.0769230769230769,0.9285714285714286
31095,/images/9c48fdf4-621d-4f40-bcd7-6a28cd530de7.png,372,679,485,783,113,104,red blood cell,11752,0.9203539823008849,1.0865384615384615
17399,/images/6f4ffe7b-395f-41ea-ad61-df5e0cbd531c.png,935,632,1040,737,105,105,red blood cell,11025,1.0,1.0
33885,/images/1a332b2c-9d49-4ff2-810c-5633d2314527.png,822,1464,932,1568,110,104,red blood cell,11440,0.9454545454545454,1.0576923076923077
46792,/images/63055d1b-5221-4c80-8b39-37ac069a1b5c.png,466,694,557,796,91,102,red blood cell,9282,1.120879120879121,0.8921568627450981
61719,/images/12269960-075f-40ca-9630-49ea2ce78294.png,355,1039,461,1141,106,102,red blood cell,10812,0.9622641509433962,1.0392156862745099
58419,/images/7eae1169-e294-4594-8e03-1366d23ff2d1.png,242,1142,344,1228,102,86,red blood cell,8772,0.8431372549019608,1.186046511627907
16001,/images/c7c1b873-0548-4a73-9618-f60912e164df.png,560,859,672,956,112,97,red blood cell,10864,0.8660714285714286,1.1546391752577319
61400,/images/e16c0dab-780d-4035-872e-1bb91e49f9d2.png,646,41,740,140,94,99,red blood cell,9306,1.053191489361702,0.9494949494949495
80054,/images/99e979d4-ee97-4d7f-9da6-00bead40db4d.png,830,1381,931,1489,101,108,red blood cell,10908,1.0693069306930694,0.9351851851851852
78468,/images/72029aca-f0bc-477f-b790-f345f86228ce.png,93,766,191,880,98,114,red blood cell,11172,1.163265306122449,0.8596491228070176
8646,/images/ea6b012a-3425-4bfc-a61d-88563aa2a264.png,184,145,298,262,114,117,red blood cell,13338,1.0263157894736843,0.9743589743589743
42574,/images/184b376b-03cb-4c2d-af51-fc1a62196293.png,709,874,808,971,99,97,red blood cell,9603,0.9797979797979798,1.0206185567010309
2693,/images/a89cace5-c818-4f23-a432-052b3433b81e.png,265,1475,367,1584,102,109,red blood cell,11118,1.0686274509803921,0.9357798165137615
5182,/images/16a51468-9f93-45df-9ae2-5a74c25c5a4b.png,870,772,984,879,114,107,red blood cell,12198,0.9385964912280702,1.0654205607476634
77995,/images/c691c8ef-d3c7-47b6-a941-f6a1089f21a9.png,276,357,382,454,106,97,red blood cell,10282,0.9150943396226415,1.092783505154639
10213,/images/e3ea07d7-884a-412e-874a-40fd6b856736.png,83,1397,197,1498,114,101,red blood cell,11514,0.8859649122807017,1.1287128712871286
65112,/images/5e042380-6ef2-496f-8231-0ca550fbfa71.png,278,504,384,603,106,99,red blood cell,10494,0.9339622641509434,1.0707070707070707
34002,/images/701206c5-aaac-4b99-9cc0-4a6854359457.png,458,1140,589,1256,131,116,red blood cell,15196,0.8854961832061069,1.1293103448275863
23269,/images/157ac97a-396e-4f6c-94c6-72a4d06ccc5f.png,567,32,678,153,111,121,red blood cell,13431,1.09009009009009,0.9173553719008265
57841,/images/c9ad92d4-b408-4506-916e-def47b2e6ed0.png,1078,1296,1177,1404,99,108,red blood cell,10692,1.0909090909090908,0.9166666666666666
56075,/images/ffb7be9a-65df-4f0b-99ae-cfd34e81cd34.png,963,215,1062,314,99,99,red blood cell,9801,1.0,1.0
51281,/images/216f9d43-6869-4ba1-9106-4f5ea6aac223.png,64,52,165,160,101,108,red blood cell,10908,1.0693069306930694,0.9351851851851852
73777,/images/22cbf509-c9bf-46ec-bfce-f079c6b76c8c.png,326,724,449,852,123,128,red blood cell,15744,1.0406504065040652,0.9609375
17440,/images/56077789-8580-41b4-89d6-deea227e5c60.png,627,791,735,909,108,118,red blood cell,12744,1.0925925925925926,0.9152542372881356
3934,/images/f09acb0c-b270-4e91-99f8-410adfa7f34a.png,630,321,749,440,119,119,red blood cell,14161,1.0,1.0
12430,/images/cc94eabb-a3dc-4cfc-9fff-55c76b5b4a71.png,490,875,596,1001,106,126,red blood cell,13356,1.1886792452830188,0.8412698412698413
46433,/images/bbecf1a8-a728-4c83-87f8-4dfbac0a1e03.png,74,748,192,877,118,129,red blood cell,15222,1.0932203389830508,0.9147286821705426
9581,/images/239f17eb-a2e2-47e9-82e3-fa0d9a70fb9f.png,663,1376,784,1499,121,123,red blood cell,14883,1.0165289256198347,0.983739837398374
20193,/images/bb337c84-f727-42a5-9c3d-934323a16c6a.png,488,1347,616,1479,128,132,red blood cell,16896,1.03125,0.9696969696969697
42626,/images/184b376b-03cb-4c2d-af51-fc1a62196293.png,569,251,670,359,101,108,red blood cell,10908,1.0693069306930694,0.9351851851851852
77590,/images/f20a4fcf-ea8e-4c14-883d-d26a9e08ce25.png,220,1030,320,1148,100,118,red blood cell,11800,1.18,0.847457627118644
61549,/images/4a717a39-80f8-4b75-a25e-c46d65d7dcd5.png,757,696,857,798,100,102,red blood cell,10200,1.02,0.9803921568627451
3032,/images/5a386082-397f-4524-a6f9-c2b8efe5014d.png,990,418,1097,532,107,114,red blood cell,12198,1.0654205607476634,0.9385964912280702
25463,/images/5f742392-278d-461c-a848-08def2c28878.png,63,1276,161,1387,98,111,red blood cell,10878,1.1326530612244898,0.8828828828828829
60601,/images/724e0c34-32cd-41f1-ae37-586038bc67ab.png,701,933,821,1046,120,113,red blood cell,13560,0.9416666666666667,1.0619469026548674
21678,/images/66183740-e1e5-43c9-8539-a87028bb3621.png,869,1230,971,1330,102,100,red blood cell,10200,0.9803921568627451,1.02
40831,/images/bf20d04d-ff8a-4910-91d7-94054c267d1b.png,835,1475,941,1595,106,120,red blood cell,12720,1.1320754716981132,0.8833333333333333
71411,/images/bcb447c9-5d37-414f-a513-d7076b04a532.png,820,932,908,1036,88,104,red blood cell,9152,1.1818181818181819,0.8461538461538461
70874,/images/bf002a25-6535-4621-be19-56d468be5413.png,66,43,156,121,90,78,red blood cell,7020,0.8666666666666667,1.1538461538461537
36730,/images/aa2dfa24-2dc3-4279-a232-f84780ace190.png,550,14,673,143,123,129,red blood cell,15867,1.048780487804878,0.9534883720930233
38677,/images/b5acf759-1115-42f0-a753-656736192528.png,898,394,997,496,99,102,red blood cell,10098,1.0303030303030303,0.9705882352941176
13937,/images/3061aac0-cda3-47d1-8c48-6293e9ffdf36.png,559,77,673,186,114,109,red blood cell,12426,0.956140350877193,1.0458715596330275
38918,/images/d79b4e90-c45d-4f5d-a498-49c3e323c291.png,635,274,738,381,103,107,red blood cell,11021,1.0388349514563107,0.9626168224299065
36508,/images/bd856928-96ee-4fc4-a377-f2fc4e84448b.png,590,471,688,575,98,104,red blood cell,10192,1.0612244897959184,0.9423076923076923
62957,/images/f234a2de-f3c8-4521-a306-8cfdf52dd597.png,558,633,680,758,122,125,red blood cell,15250,1.0245901639344261,0.976
3776,/images/c9499a06-fb31-4552-a9e2-fb4ebb440859.png,832,949,967,1065,135,116,red blood cell,15660,0.8592592592592593,1.1637931034482758
69240,/images/f274b784-b995-4a7e-a2c2-6cc31c24c4b4.png,538,801,622,895,84,94,red blood cell,7896,1.119047619047619,0.8936170212765957
72064,/images/64b0e49a-0e48-447d-8872-c1dd255e7a21.png,607,1492,718,1594,111,102,red blood cell,11322,0.918918918918919,1.088235294117647
56087,/images/ffb7be9a-65df-4f0b-99ae-cfd34e81cd34.png,903,1049,1020,1166,117,117,red blood cell,13689,1.0,1.0
15088,/images/3a8f468f-f9de-46a8-a7c8-f2be239fa207.png,74,941,172,1026,98,85,red blood cell,8330,0.8673469387755102,1.1529411764705881
33314,/images/5721e41b-90ef-4851-8587-8dc71227ef90.png,75,420,192,532,117,112,red blood cell,13104,0.9572649572649573,1.0446428571428572
72678,/images/6ab870ba-b24b-49a9-9570-8eafe63aa74e.png,120,1493,202,1592,82,99,red blood cell,8118,1.2073170731707317,0.8282828282828283
43856,/images/c84edeb4-311c-4e82-88f9-ae0505b3ad13.png,700,1283,785,1373,85,90,red blood cell,7650,1.0588235294117647,0.9444444444444444
60431,/images/93b47b14-7f78-4b31-8897-d63a81fdab01.png,109,1171,229,1285,120,114,red blood cell,13680,0.95,1.0526315789473684
63282,/images/43bc935a-f655-45e1-a64d-fcb8b78267a6.png,688,690,790,779,102,89,red blood cell,9078,0.8725490196078431,1.146067415730337
22535,/images/bfe65b11-8aff-46aa-908b-1e989d25fdc4.png,293,226,398,323,105,97,red blood cell,10185,0.9238095238095239,1.0824742268041236
59383,/images/565513be-2c20-4ee3-94f3-093869515d3d.png,517,432,602,517,85,85,red blood cell,7225,1.0,1.0
32096,/images/b8a4d467-c40c-4ebf-91dd-1c19d0f2a7ae.png,223,385,312,479,89,94,red blood cell,8366,1.0561797752808988,0.9468085106382979
76592,/images/4184a235-d209-4151-86e9-6c77e7938dab.png,535,1395,660,1517,125,122,red blood cell,15250,0.976,1.0245901639344261
78758,/images/9174f910-3859-4839-8e30-2c3b25269322.png,694,54,795,153,101,99,red blood cell,9999,0.9801980198019802,1.02020202020202
40356,/images/db249e5a-4142-432c-8288-bacd10d7273d.png,294,874,387,977,93,103,red blood cell,9579,1.10752688172043,0.9029126213592233
80069,/images/99e979d4-ee97-4d7f-9da6-00bead40db4d.png,39,109,156,219,117,110,red blood cell,12870,0.9401709401709402,1.0636363636363637
18477,/images/9b410534-3b70-4a88-9f93-205cf4e55a05.png,97,1394,212,1490,115,96,red blood cell,11040,0.8347826086956521,1.1979166666666667
22879,/images/be779f52-0bfa-4c01-a16f-b7f0bc92ed7c.png,594,773,712,893,118,120,red blood cell,14160,1.0169491525423728,0.9833333333333333
65946,/images/25c6cfb1-01d0-4864-87f9-02b7593683c7.png,211,24,323,122,112,98,red blood cell,10976,0.875,1.1428571428571428
26840,/images/2518f6e4-29cc-4ae4-a914-b215a4c56099.png,434,1463,532,1563,98,100,red blood cell,9800,1.0204081632653061,0.98
58365,/images/50f2f514-6c8e-4c79-b3b3-0be56dd0b78b.png,113,1089,208,1182,95,93,red blood cell,8835,0.9789473684210527,1.021505376344086
21303,/images/8dace03a-10c4-4d59-bcd9-a2c314c5df33.png,633,803,748,921,115,118,red blood cell,13570,1.0260869565217392,0.9745762711864406
49560,/images/9f33e0ea-065b-4703-9df9-15829b891860.png,471,299,572,407,101,108,red blood cell,10908,1.0693069306930694,0.9351851851851852
67476,/images/8e72e20e-e714-4db6-a1da-c05a409257d4.png,1019,414,1108,514,89,100,red blood cell,8900,1.1235955056179776,0.89
10009,/images/b9ccf7ca-953f-4832-9575-5e70b2a8c224.png,954,811,1050,922,96,111,red blood cell,10656,1.15625,0.8648648648648649
54640,/images/6473ddb6-ad56-48a2-81e8-c7cb45f06825.png,257,1314,357,1432,100,118,red blood cell,11800,1.18,0.847457627118644
54717,/images/10891eed-b0f2-4dd0-90cb-da185f6761b2.png,605,366,717,462,112,96,red blood cell,10752,0.8571428571428571,1.1666666666666667
15467,/images/1b7f47fc-26cd-4273-b848-88a7cbfd9f85.png,321,471,430,573,109,102,red blood cell,11118,0.9357798165137615,1.0686274509803921
75439,/images/468c261d-f5d8-423f-883e-48af2bbbc5d1.png,94,1357,182,1448,88,91,red blood cell,8008,1.0340909090909092,0.967032967032967
35410,/images/002f20ad-2ace-499c-9335-c9080bc3e6b5.png,749,1282,871,1414,122,132,red blood cell,16104,1.0819672131147542,0.9242424242424242
15873,/images/c7c1b873-0548-4a73-9618-f60912e164df.png,670,1390,764,1484,94,94,red blood cell,8836,1.0,1.0
73264,/images/67a4fb91-6f38-4ca2-8f20-6b2f5f1b29a7.png,951,18,1058,132,107,114,red blood cell,12198,1.0654205607476634,0.9385964912280702
5988,/images/97eff653-3908-4e66-931f-eab36bc336c8.png,983,44,1110,167,127,123,red blood cell,15621,0.968503937007874,1.032520325203252
76117,/images/16244280-6c74-47d3-b544-9fd6831a6bf9.png,579,137,668,238,89,101,red blood cell,8989,1.1348314606741574,0.8811881188118812
49147,/images/df3d98b9-3dd7-4107-8d4a-ae1b7f247793.png,930,508,1028,597,98,89,red blood cell,8722,0.9081632653061225,1.101123595505618
19629,/images/a3ada657-de00-44db-b1e2-54ba17e39983.png,351,619,482,747,131,128,red blood cell,16768,0.9770992366412213,1.0234375
35757,/images/bb2042c5-35e1-43cc-8171-7de81b764361.png,125,561,219,653,94,92,red blood cell,8648,0.9787234042553191,1.0217391304347827
77262,/images/07a80340-f65e-4f58-9317-94bb6ebd5a28.png,166,389,256,493,90,104,red blood cell,9360,1.1555555555555554,0.8653846153846154
26623,/images/16ec6e1f-5020-40b3-ba26-51c340d03ee7.png,226,589,338,699,112,110,red blood cell,12320,0.9821428571428571,1.018181818181818
42725,/images/b8dd6125-5027-47e2-a283-14e199274c80.png,151,1160,265,1299,114,139,red blood cell,15846,1.219298245614035,0.8201438848920863
70755,/images/8ab5c462-045e-4b59-b53a-9b2bc3ed2487.png,815,1497,893,1570,78,73,red blood cell,5694,0.9358974358974359,1.0684931506849316
31049,/images/9c48fdf4-621d-4f40-bcd7-6a28cd530de7.png,392,1450,507,1581,115,131,red blood cell,15065,1.1391304347826088,0.8778625954198473
63847,/images/5e974892-0ebe-4037-8427-ea8616d6d3b8.png,676,814,776,905,100,91,red blood cell,9100,0.91,1.098901098901099
3913,/images/65e865f3-acfb-4d01-a75f-ff5a535ffa6a.png,983,1317,1122,1467,139,150,red blood cell,20850,1.079136690647482,0.9266666666666666
56569,/images/a824b499-3736-4581-bbdc-be1b3b4cf756.png,57,1397,167,1499,110,102,red blood cell,11220,0.9272727272727272,1.0784313725490196
2440,/images/fe851c88-692d-4199-87e0-d19d9c4eb591.png,14,1083,126,1191,112,108,red blood cell,12096,0.9642857142857143,1.037037037037037
31352,/images/04fb49a2-07b8-4cdf-b6f7-df5c3688e5f8.png,625,1184,730,1288,105,104,red blood cell,10920,0.9904761904761905,1.0096153846153846
36780,/images/aa2dfa24-2dc3-4279-a232-f84780ace190.png,627,1168,723,1251,96,83,red blood cell,7968,0.8645833333333334,1.1566265060240963
52425,/images/a2a20600-f851-4db7-90f9-6f7be027c8b5.png,723,895,793,977,70,82,red blood cell,5740,1.1714285714285715,0.8536585365853658
32799,/images/67f5ca94-d84e-490e-bf0d-4ffba7bdbe30.png,888,1170,1003,1277,115,107,red blood cell,12305,0.9304347826086956,1.074766355140187
3607,/images/8bd71314-e38a-4670-bb25-5cd6c9acb595.png,997,1004,1116,1104,119,100,red blood cell,11900,0.8403361344537815,1.19
32373,/images/a6526894-e290-482d-ac43-f1df34864817.png,779,1266,886,1369,107,103,red blood cell,11021,0.9626168224299065,1.0388349514563107
50972,/images/ef8fcfa4-8466-4186-8c69-f5f4904eb489.png,922,37,1035,135,113,98,red blood cell,11074,0.8672566371681416,1.153061224489796
6845,/images/b21f6c6e-4b45-407a-b4c7-034a115f3ee4.png,829,276,927,384,98,108,red blood cell,10584,1.1020408163265305,0.9074074074074074
18158,/images/947348fe-4c70-468e-8009-3c14daeca69b.png,322,754,416,845,94,91,red blood cell,8554,0.9680851063829787,1.032967032967033
54776,/images/10891eed-b0f2-4dd0-90cb-da185f6761b2.png,295,200,398,292,103,92,red blood cell,9476,0.8932038834951457,1.1195652173913044
63515,/images/44b4a765-104e-4182-8871-e933c83c91ef.png,633,797,737,920,104,123,red blood cell,12792,1.1826923076923077,0.8455284552845529
64462,/images/34a70114-d3e3-4351-b8db-f6caab17e743.png,269,1126,354,1225,85,99,red blood cell,8415,1.1647058823529413,0.8585858585858586
39675,/images/04d21589-b777-43c2-86b5-038cbf8c3a4e.png,419,366,522,473,103,107,red blood cell,11021,1.0388349514563107,0.9626168224299065
69875,/images/9edba799-e169-46cd-b100-c9f8fc7a8c7d.png,580,1303,687,1414,107,111,red blood cell,11877,1.0373831775700935,0.963963963963964
5167,/images/a777e78c-ad1f-4380-9ab2-b4f9f32b2d78.png,60,937,158,1035,98,98,red blood cell,9604,1.0,1.0
46190,/images/d8632217-ec33-4d0a-98e6-427824c58869.png,30,1064,141,1160,111,96,red blood cell,10656,0.8648648648648649,1.15625
53935,/images/540a5fee-175b-4b92-bf62-1ea9b59c86c6.png,652,1343,754,1449,102,106,red blood cell,10812,1.0392156862745099,0.9622641509433962
40752,/images/252071ac-e9f2-41d2-abbb-87ef01b8a997.png,28,1463,103,1547,75,84,red blood cell,6300,1.12,0.8928571428571429
52208,/images/f4c00b8c-d675-4255-8277-ca65bd757f51.png,406,1186,500,1280,94,94,red blood cell,8836,1.0,1.0
49145,/images/df3d98b9-3dd7-4107-8d4a-ae1b7f247793.png,1036,1019,1132,1099,96,80,red blood cell,7680,0.8333333333333334,1.2
45930,/images/0d098413-6911-4535-b70a-3c3effd8cf49.png,425,1389,546,1505,121,116,red blood cell,14036,0.9586776859504132,1.043103448275862
47217,/images/58ced55c-bf0d-4204-b6b2-4f8992d92779.png,323,248,427,353,104,105,red blood cell,10920,1.0096153846153846,0.9904761904761905
47046,/images/997eabd9-55bf-4683-83c4-4cee4673a4ef.png,520,497,645,613,125,116,red blood cell,14500,0.928,1.0775862068965518
71975,/images/61575482-91e1-4db9-83c7-687b7ddbbfc4.png,780,657,904,759,124,102,red blood cell,12648,0.8225806451612904,1.2156862745098038
7075,/images/8be185e7-2a1a-441c-a5c7-b50a9eb926cb.png,380,1101,470,1198,90,97,red blood cell,8730,1.0777777777777777,0.9278350515463918
71964,/images/61575482-91e1-4db9-83c7-687b7ddbbfc4.png,301,270,378,354,77,84,red blood cell,6468,1.0909090909090908,0.9166666666666666
46964,/images/9e0e1928-d19a-4100-b093-0b962ac09e05.png,81,1119,175,1217,94,98,red blood cell,9212,1.0425531914893618,0.9591836734693877
39219,/images/2aeb7b85-7df9-4a63-8d37-2eecaaa190e7.png,984,325,1078,419,94,94,red blood cell,8836,1.0,1.0
38263,/images/b834cbf7-ff97-49d9-9561-566c9343735c.png,151,1369,265,1469,114,100,red blood cell,11400,0.8771929824561403,1.14
68187,/images/5dec94a3-e3ca-4a58-9702-88e5a83ef612.png,699,1492,785,1581,86,89,red blood cell,7654,1.0348837209302326,0.9662921348314607
42701,/images/3abbc4d3-1d7e-40c9-9963-33732da7cc50.png,400,1244,491,1337,91,93,red blood cell,8463,1.021978021978022,0.978494623655914
57921,/images/09bcedaa-e007-4692-a13f-ab02c3f872c4.png,79,153,200,269,121,116,red blood cell,14036,0.9586776859504132,1.043103448275862
25893,/images/4811fdf2-d7e8-475e-a840-45dda5282bf3.png,831,441,951,576,120,135,red blood cell,16200,1.125,0.8888888888888888
15301,/images/2d0f600d-f94e-4907-b712-52fb37d9ed52.png,52,537,175,645,123,108,red blood cell,13284,0.8780487804878049,1.1388888888888888
32790,/images/67f5ca94-d84e-490e-bf0d-4ffba7bdbe30.png,243,217,337,322,94,105,red blood cell,9870,1.1170212765957446,0.8952380952380953
8768,/images/29dc8176-dfe1-40e0-8247-2dc3c530057e.png,72,1359,192,1485,120,126,red blood cell,15120,1.05,0.9523809523809523
51452,/images/baa87bf8-786c-444c-81e8-9fa0a41d8149.png,885,1244,995,1349,110,105,red blood cell,11550,0.9545454545454546,1.0476190476190477
7567,/images/071901eb-4c3f-404b-a747-3d0b9d0a5158.png,554,1132,654,1234,100,102,red blood cell,10200,1.02,0.9803921568627451
76904,/images/25ddc1ca-d368-4fff-b1ad-1dbf1e7c97aa.png,928,845,1037,956,109,111,red blood cell,12099,1.018348623853211,0.9819819819819819
669,/images/e61e6af2-7f8b-47b0-bbe7-acb2ed0299ab.png,518,1422,648,1544,130,122,red blood cell,15860,0.9384615384615385,1.0655737704918034
3183,/images/c3215597-a032-46be-9058-d6de1e5191d7.png,787,1113,894,1222,107,109,red blood cell,11663,1.0186915887850467,0.981651376146789
33961,/images/701206c5-aaac-4b99-9cc0-4a6854359457.png,650,395,769,514,119,119,red blood cell,14161,1.0,1.0
16030,/images/7e25ced3-5caf-47f8-ad0c-42946bd4468b.png,638,332,734,443,96,111,red blood cell,10656,1.15625,0.8648648648648649
34730,/images/6294153c-6db3-4f2b-a8ff-9c087225e737.png,1027,807,1154,930,127,123,red blood cell,15621,0.968503937007874,1.032520325203252
33533,/images/255d5f0c-87fc-4337-bb51-07c440df4f1b.png,641,0,751,115,110,115,red blood cell,12650,1.0454545454545454,0.9565217391304348
7220,/images/89f10192-d3dd-4996-a571-4c851dbdc983.png,582,367,687,471,105,104,red blood cell,10920,0.9904761904761905,1.0096153846153846
13610,/images/d47cd049-d78b-4ba3-a7d4-399be4dd1dde.png,154,335,270,451,116,116,red blood cell,13456,1.0,1.0
39632,/images/04d21589-b777-43c2-86b5-038cbf8c3a4e.png,23,578,130,691,107,113,red blood cell,12091,1.0560747663551402,0.9469026548672567
67685,/images/2b128a1a-95ed-408b-b9f8-8795cc814d80.png,538,129,655,247,117,118,red blood cell,13806,1.0085470085470085,0.9915254237288136
46663,/images/da111ca5-520f-4ea8-97ad-ae5fce58ee91.png,956,135,1063,265,107,130,red blood cell,13910,1.2149532710280373,0.823076923076923
39492,/images/5a631871-2fc7-4a68-9c39-f3b9a0bf4a04.png,1091,1021,1193,1141,102,120,red blood cell,12240,1.1764705882352942,0.85
36612,/images/21f001d6-f568-4ea4-82da-fab54c77c419.png,852,1445,958,1534,106,89,red blood cell,9434,0.839622641509434,1.1910112359550562
44787,/images/6795acae-e84d-4e97-b9a1-b4f4f0a72cfd.png,905,1137,1005,1233,100,96,red blood cell,9600,0.96,1.0416666666666667
50936,/images/ef8fcfa4-8466-4186-8c69-f5f4904eb489.png,989,1422,1097,1543,108,121,red blood cell,13068,1.1203703703703705,0.8925619834710744
6688,/images/95fea6d8-413f-421e-b331-5d51c31df150.png,732,1275,843,1365,111,90,red blood cell,9990,0.8108108108108109,1.2333333333333334
23928,/images/3d8fb5bf-3315-48fb-8ab1-802eafd550bc.png,178,1263,265,1359,87,96,red blood cell,8352,1.103448275862069,0.90625
59807,/images/acb16781-11ad-4327-874a-5c9c35dcb085.png,543,579,653,695,110,116,red blood cell,12760,1.0545454545454545,0.9482758620689655
53461,/images/766d5547-8dd2-4c8d-b78e-3007f83932e8.png,730,1444,802,1521,72,77,red blood cell,5544,1.0694444444444444,0.935064935064935
14116,/images/eaf4b781-b3aa-41ce-8c5e-287979b4e15a.png,924,409,1017,507,93,98,red blood cell,9114,1.053763440860215,0.9489795918367347
73207,/images/85546330-4efd-43e2-87aa-d53a30220bfc.png,230,1338,336,1427,106,89,red blood cell,9434,0.839622641509434,1.1910112359550562
13932,/images/de00f9a5-aa8b-4679-8ec6-85528a942d6f.png,648,664,760,781,112,117,red blood cell,13104,1.0446428571428572,0.9572649572649573
38515,/images/c3ae7090-fc68-41b4-85a1-8d9bce9825a7.png,12,504,129,624,117,120,red blood cell,14040,1.0256410256410255,0.975
1198,/images/5ff7c0c8-d208-4e7d-958d-ca3c2260ff39.png,883,1320,998,1436,115,116,red blood cell,13340,1.008695652173913,0.9913793103448276
13376,/images/a7f1bbb1-6058-4642-bd66-cfb90dce762e.png,1040,533,1172,651,132,118,red blood cell,15576,0.8939393939393939,1.11864406779661
14421,/images/3b13e20f-ec0d-44ec-b2f4-eaebfa09150e.png,428,267,533,390,105,123,red blood cell,12915,1.1714285714285715,0.8536585365853658
21718,/images/f68ae8e9-e760-4106-88e0-4bdef2785f06.png,973,413,1074,507,101,94,red blood cell,9494,0.9306930693069307,1.074468085106383
6352,/images/f06ba705-5509-479b-8067-127ffb37c5b6.png,503,409,633,522,130,113,red blood cell,14690,0.8692307692307693,1.1504424778761062
37997,/images/e3e9c2de-0a24-4c7e-8a69-3d3093d5bdab.png,700,393,803,493,103,100,red blood cell,10300,0.970873786407767,1.03
67397,/images/266180ed-77a3-4284-8292-50a49fc47fce.png,1015,551,1123,656,108,105,red blood cell,11340,0.9722222222222222,1.0285714285714285
28923,/images/b12ae3b1-613c-4c0e-9163-3c5cc314abf5.png,861,815,983,918,122,103,red blood cell,12566,0.8442622950819673,1.1844660194174756
60134,/images/ec60ab26-3343-4c5f-9667-cdae999c7d86.png,26,1030,111,1110,85,80,red blood cell,6800,0.9411764705882353,1.0625
38473,/images/674b0fd3-f247-4b7f-97f7-3e6c57c9ba9e.png,620,101,704,188,84,87,red blood cell,7308,1.0357142857142858,0.9655172413793104
3452,/images/ad36bd67-594b-4f63-93e3-886af0bc618e.png,451,661,567,779,116,118,red blood cell,13688,1.0172413793103448,0.9830508474576272
51151,/images/d64cd75a-df26-44d5-ac25-69061a4e4d57.png,516,1231,616,1341,100,110,red blood cell,11000,1.1,0.9090909090909091
26100,/images/71925778-a26e-483e-a07c-f3aaf740122a.png,752,1262,848,1371,96,109,red blood cell,10464,1.1354166666666667,0.8807339449541285
75437,/images/468c261d-f5d8-423f-883e-48af2bbbc5d1.png,810,1473,907,1583,97,110,red blood cell,10670,1.134020618556701,0.8818181818181818
78615,/images/3612aa3b-2906-44a6-9c80-6144511a35ce.png,756,461,883,585,127,124,red blood cell,15748,0.9763779527559056,1.0241935483870968
21644,/images/66183740-e1e5-43c9-8539-a87028bb3621.png,474,822,593,936,119,114,red blood cell,13566,0.957983193277311,1.043859649122807
56971,/images/a93c35ba-1690-4358-8837-669bcd850bb7.png,7,757,122,873,115,116,red blood cell,13340,1.008695652173913,0.9913793103448276
1639,/images/7094c11a-1e62-4f98-894e-d17d138a88e9.png,956,577,1038,672,82,95,red blood cell,7790,1.1585365853658536,0.8631578947368421
32091,/images/b8a4d467-c40c-4ebf-91dd-1c19d0f2a7ae.png,383,377,471,473,88,96,red blood cell,8448,1.0909090909090908,0.9166666666666666
7285,/images/89f10192-d3dd-4996-a571-4c851dbdc983.png,115,1004,226,1108,111,104,red blood cell,11544,0.9369369369369369,1.0673076923076923
8501,/images/dfc026a9-079f-4f45-8666-e0ccba5bb437.png,946,28,1035,131,89,103,red blood cell,9167,1.1573033707865168,0.8640776699029126
62652,/images/f7a4334a-4332-4de8-b39b-22da907976f2.png,223,649,303,741,80,92,red blood cell,7360,1.15,0.8695652173913043
2631,/images/a2ccbf70-e444-49a9-8b7e-9797a05220d8.png,1023,435,1119,522,96,87,red blood cell,8352,0.90625,1.103448275862069
43586,/images/e0ef520d-7b65-485d-9888-e6859f189f70.png,643,1144,764,1260,121,116,red blood cell,14036,0.9586776859504132,1.043103448275862
12342,/images/3b55c42f-ad59-422f-ba99-4f4f4ca9cb2e.png,533,908,629,1004,96,96,red blood cell,9216,1.0,1.0
11325,/images/2f6224be-50d0-4e85-94ef-88315df561b6.png,795,245,902,358,107,113,red blood cell,12091,1.0560747663551402,0.9469026548672567
10657,/images/20d4f65e-6c63-433a-935c-d568d577967b.png,468,827,570,911,102,84,red blood cell,8568,0.8235294117647058,1.2142857142857142
32113,/images/9258fe22-6406-4d00-b6f0-3f9492925405.png,275,496,383,596,108,100,red blood cell,10800,0.9259259259259259,1.08
13741,/images/1b369bcf-ced4-4ae2-9196-2664bd2b1738.png,826,1452,935,1569,109,117,red blood cell,12753,1.073394495412844,0.9316239316239316
74877,/images/81edcae1-65bf-4752-b0e4-494376b71e49.png,327,472,429,587,102,115,red blood cell,11730,1.1274509803921569,0.8869565217391304
42259,/images/ca734448-0d52-42fa-b41c-17b2939e58ae.png,620,380,719,488,99,108,red blood cell,10692,1.0909090909090908,0.9166666666666666
33881,/images/1a332b2c-9d49-4ff2-810c-5633d2314527.png,36,929,155,1044,119,115,red blood cell,13685,0.9663865546218487,1.0347826086956522
29814,/images/7ef90770-6aeb-45eb-9744-49c5247dde30.png,860,434,950,530,90,96,red blood cell,8640,1.0666666666666667,0.9375
62361,/images/e0ff3476-226f-4125-b182-8e524d5503dd.png,763,1372,875,1474,112,102,red blood cell,11424,0.9107142857142857,1.0980392156862746
50194,/images/8b89b3fc-95ef-4f2e-b94b-0291dbffe0f4.png,944,71,1055,172,111,101,red blood cell,11211,0.9099099099099099,1.099009900990099
62735,/images/e1937e32-85d5-4cd8-bb4a-b9cf8ee7ceeb.png,239,322,340,424,101,102,red blood cell,10302,1.00990099009901,0.9901960784313726
58482,/images/5cac6ddf-c8c6-45de-bce0-a1db64b14fb5.png,131,800,241,895,110,95,red blood cell,10450,0.8636363636363636,1.1578947368421053
5357,/images/716273ea-19c4-49af-8604-df587b295eca.png,1027,804,1141,917,114,113,red blood cell,12882,0.9912280701754386,1.008849557522124
47752,/images/6b5ed184-cb15-4d54-93bb-9a3ca00184a1.png,440,981,553,1098,113,117,red blood cell,13221,1.0353982300884956,0.9658119658119658
1352,/images/6d91d1f0-636b-4f5a-a526-7c17fc857190.png,34,315,121,402,87,87,red blood cell,7569,1.0,1.0
54723,/images/10891eed-b0f2-4dd0-90cb-da185f6761b2.png,1021,767,1142,870,121,103,red blood cell,12463,0.8512396694214877,1.174757281553398
48934,/images/5dec0204-af81-44ef-a942-8a173669c123.png,130,1010,242,1123,112,113,red blood cell,12656,1.0089285714285714,0.9911504424778761
77301,/images/07a80340-f65e-4f58-9317-94bb6ebd5a28.png,213,1301,297,1401,84,100,red blood cell,8400,1.1904761904761905,0.84
30087,/images/81c3c8f0-d5a9-4dda-afd5-e86f6afd9424.png,985,688,1100,809,115,121,red blood cell,13915,1.0521739130434782,0.9504132231404959
24779,/images/530761d4-1931-44cd-b220-d60db0e228f9.png,48,313,171,416,123,103,red blood cell,12669,0.8373983739837398,1.1941747572815533
55187,/images/9c5f48c0-0544-4c0c-92b4-59b7d7b7814c.png,452,1093,562,1213,110,120,red blood cell,13200,1.0909090909090908,0.9166666666666666
35588,/images/a1ff36df-71df-4e6e-a65f-ced9a2b381c3.png,491,1253,604,1367,113,114,red blood cell,12882,1.008849557522124,0.9912280701754386
61621,/images/a3c0a876-be12-4ede-8aed-18b32a64401b.png,77,845,184,938,107,93,red blood cell,9951,0.8691588785046729,1.1505376344086022
20919,/images/c2ec116f-f091-422c-926c-70b548a8f6ef.png,1092,110,1195,213,103,103,red blood cell,10609,1.0,1.0
26420,/images/d532e31c-10ce-4313-9a36-bd5e01230254.png,130,1320,241,1439,111,119,red blood cell,13209,1.072072072072072,0.9327731092436975
63079,/images/6afd8203-d61a-4e9b-a4cf-dcb53a16b57c.png,1100,125,1199,220,99,95,red blood cell,9405,0.9595959595959596,1.0421052631578946
6138,/images/cbec07ed-69d3-40e7-8b04-b3bd6680885b.png,793,568,900,690,107,122,red blood cell,13054,1.1401869158878504,0.8770491803278688
17249,/images/471f75c6-bd5d-4c20-bcc1-258e836f4d69.png,924,552,1054,664,130,112,red blood cell,14560,0.8615384615384616,1.1607142857142858
75901,/images/3006096f-ceeb-42be-b69e-785179d7438b.png,108,662,208,766,100,104,red blood cell,10400,1.04,0.9615384615384616
26858,/images/2518f6e4-29cc-4ae4-a914-b215a4c56099.png,197,644,306,738,109,94,red blood cell,10246,0.8623853211009175,1.1595744680851063
6054,/images/72732579-a812-4496-b2dd-ea1556924337.png,20,1235,122,1342,102,107,red blood cell,10914,1.0490196078431373,0.9532710280373832
64136,/images/0d3c2521-da55-4df5-bf06-56b3bd4fb2fc.png,105,1116,186,1202,81,86,red blood cell,6966,1.0617283950617284,0.9418604651162791
14551,/images/458cb2e9-5a7f-437c-ac5d-a56f98a3efdf.png,43,1061,147,1166,104,105,red blood cell,10920,1.0096153846153846,0.9904761904761905
40524,/images/e3ade58d-086c-47fa-9120-76beacb45395.png,353,1333,483,1447,130,114,red blood cell,14820,0.8769230769230769,1.1403508771929824
14024,/images/eaf4b781-b3aa-41ce-8c5e-287979b4e15a.png,463,306,548,405,85,99,red blood cell,8415,1.1647058823529413,0.8585858585858586
38275,/images/b834cbf7-ff97-49d9-9561-566c9343735c.png,367,659,489,773,122,114,red blood cell,13908,0.9344262295081968,1.0701754385964912
35082,/images/67582df6-bf13-4c83-a531-1214692b70de.png,599,374,715,486,116,112,red blood cell,12992,0.9655172413793104,1.0357142857142858
62892,/images/4b346035-b8c0-46ca-8fdb-a01b1421ee4a.png,694,1322,798,1442,104,120,red blood cell,12480,1.1538461538461537,0.8666666666666667
41589,/images/0fcd1ebe-ee4a-40a0-b787-29cee18bfa1b.png,525,323,624,415,99,92,red blood cell,9108,0.9292929292929293,1.076086956521739
72623,/images/a63ce82f-f3d1-4818-9035-d3d230e5f686.png,1046,412,1131,507,85,95,red blood cell,8075,1.1176470588235294,0.8947368421052632
66847,/images/9106a6bb-1352-411f-ac26-0d6fe48c16a8.png,331,180,418,288,87,108,red blood cell,9396,1.2413793103448276,0.8055555555555556
35618,/images/45f18ac0-f097-4b20-a99d-8837cf488822.png,665,1460,793,1580,128,120,red blood cell,15360,0.9375,1.0666666666666667
389,/images/84c88143-940d-4b62-bbd2-7acc4cadcb6b.png,606,863,740,982,134,119,red blood cell,15946,0.8880597014925373,1.1260504201680672
44738,/images/ccb4b13d-ab20-4222-892f-5adf70249aaa.png,253,843,361,960,108,117,red blood cell,12636,1.0833333333333333,0.9230769230769231
38732,/images/b426ef1d-4a59-4f90-b593-50226af60a60.png,232,732,335,833,103,101,red blood cell,10403,0.9805825242718447,1.0198019801980198
69732,/images/f0713bee-2a71-4ced-b953-4041ea99496a.png,576,993,667,1093,91,100,red blood cell,9100,1.098901098901099,0.91
68963,/images/bbaa004f-05dc-4cb8-8768-e148085bb0f9.png,835,252,937,342,102,90,red blood cell,9180,0.8823529411764706,1.1333333333333333
13380,/images/a7f1bbb1-6058-4642-bd66-cfb90dce762e.png,302,221,405,332,103,111,red blood cell,11433,1.0776699029126213,0.9279279279279279
17599,/images/70a95e58-ba60-4c1f-adcd-49c198dc2ba0.png,168,1045,264,1141,96,96,red blood cell,9216,1.0,1.0
12795,/images/b634137b-bc8b-4e88-b0e3-b536ad6e7e18.png,1077,1265,1177,1356,100,91,red blood cell,9100,0.91,1.098901098901099
48444,/images/0fa5b35d-6c44-4207-b6f8-d5b355086b5f.png,293,233,411,375,118,142,red blood cell,16756,1.2033898305084745,0.8309859154929577
31849,/images/f62d4fb6-df7c-446c-94a8-d5aede0b1e0c.png,415,485,539,585,124,100,red blood cell,12400,0.8064516129032258,1.24
30483,/images/5955289d-19e5-45ef-a012-c8ea08ef45e2.png,979,762,1095,879,116,117,red blood cell,13572,1.0086206896551724,0.9914529914529915
48759,/images/fed6ba05-36a5-45dc-a4e1-9baa7de2c622.png,901,1412,999,1499,98,87,red blood cell,8526,0.8877551020408163,1.1264367816091954
30680,/images/f939782b-f5a2-40a3-9c22-6c6d7e18edc3.png,678,839,791,955,113,116,red blood cell,13108,1.0265486725663717,0.9741379310344828
33153,/images/6231d81d-9e84-4a5a-8cb8-47c6a37a0176.png,619,226,706,329,87,103,red blood cell,8961,1.1839080459770115,0.8446601941747572
69319,/images/3f8c5ae1-b9fd-464b-8e91-98143ddd8d29.png,482,182,587,284,105,102,red blood cell,10710,0.9714285714285714,1.0294117647058822
78866,/images/4d0a1598-e4dd-45c4-8a90-dd7c780fe1da.png,673,447,762,541,89,94,red blood cell,8366,1.0561797752808988,0.9468085106382979
33198,/images/877d5e7f-19b6-40e7-81bd-c92f25e72503.png,155,1306,271,1429,116,123,red blood cell,14268,1.0603448275862069,0.943089430894309
374,/images/7c66d2fd-68ee-4628-b860-9d7ad25b2a80.png,415,709,538,822,123,113,red blood cell,13899,0.9186991869918699,1.0884955752212389
52947,/images/e81bf478-27ff-458c-ac30-9e1f8480bc5c.png,626,1163,737,1281,111,118,red blood cell,13098,1.063063063063063,0.940677966101695
42530,/images/29648565-fe28-4517-ba72-68df0c82c9c5.png,1025,597,1147,695,122,98,red blood cell,11956,0.8032786885245902,1.2448979591836735
30055,/images/81c3c8f0-d5a9-4dda-afd5-e86f6afd9424.png,959,344,1056,444,97,100,red blood cell,9700,1.0309278350515463,0.97
7297,/images/89f10192-d3dd-4996-a571-4c851dbdc983.png,868,289,970,381,102,92,red blood cell,9384,0.9019607843137255,1.108695652173913
53876,/images/540a5fee-175b-4b92-bf62-1ea9b59c86c6.png,734,1402,834,1514,100,112,red blood cell,11200,1.12,0.8928571428571429
58915,/images/8a7deb24-d2b4-4acf-86c4-3aadd39157fa.png,281,1310,408,1423,127,113,red blood cell,14351,0.889763779527559,1.1238938053097345
35352,/images/452482bc-24a3-413e-ba03-fad4c9d61f3c.png,399,881,503,982,104,101,red blood cell,10504,0.9711538461538461,1.0297029702970297
5363,/images/716273ea-19c4-49af-8604-df587b295eca.png,541,1050,656,1171,115,121,red blood cell,13915,1.0521739130434782,0.9504132231404959
26622,/images/16ec6e1f-5020-40b3-ba26-51c340d03ee7.png,139,1,262,120,123,119,red blood cell,14637,0.967479674796748,1.0336134453781514
75567,/images/c35ee701-fde2-46b5-b178-1fe3f1ea7da2.png,489,1006,579,1101,90,95,red blood cell,8550,1.0555555555555556,0.9473684210526315
25496,/images/f6ab936d-924b-4038-aa47-71b07c26b4e2.png,1043,640,1159,743,116,103,red blood cell,11948,0.8879310344827587,1.1262135922330097
6170,/images/27cdd837-e40f-491e-8adb-61e493189832.png,306,969,420,1092,114,123,red blood cell,14022,1.0789473684210527,0.926829268292683
72551,/images/01b99da8-b66b-464b-a7ee-1cadab8db18b.png,89,620,173,704,84,84,red blood cell,7056,1.0,1.0
2282,/images/fe851c88-692d-4199-87e0-d19d9c4eb591.png,820,26,923,119,103,93,red blood cell,9579,0.9029126213592233,1.10752688172043
66998,/images/3b4440f7-a69b-4042-a9d0-d6958abcdf4e.png,339,1345,447,1457,108,112,red blood cell,12096,1.037037037037037,0.9642857142857143
34193,/images/f1cda808-69a9-4d10-ba0a-6607c98e362d.png,505,1335,618,1433,113,98,red blood cell,11074,0.8672566371681416,1.153061224489796
69374,/images/2ac343e4-c889-47c1-8fe2-461b626def76.png,670,1139,784,1262,114,123,red blood cell,14022,1.0789473684210527,0.926829268292683
78427,/images/fe00fa09-d3c8-485b-9d0f-3cce556c9edd.png,467,1215,581,1336,114,121,red blood cell,13794,1.0614035087719298,0.9421487603305785
10206,/images/e3ea07d7-884a-412e-874a-40fd6b856736.png,785,757,918,881,133,124,red blood cell,16492,0.9323308270676691,1.0725806451612903
71666,/images/5c99cd97-39f6-4809-9528-9d380cc16b16.png,126,72,217,159,91,87,red blood cell,7917,0.9560439560439561,1.0459770114942528
67817,/images/04de3a31-fc09-40be-9c2c-9830c57f809d.png,743,994,846,1101,103,107,red blood cell,11021,1.0388349514563107,0.9626168224299065
7390,/images/89f10192-d3dd-4996-a571-4c851dbdc983.png,206,551,299,649,93,98,red blood cell,9114,1.053763440860215,0.9489795918367347
6475,/images/640c4a52-3742-4f57-aee3-9e3dc0887622.png,247,1454,352,1566,105,112,red blood cell,11760,1.0666666666666667,0.9375
28961,/images/b12ae3b1-613c-4c0e-9163-3c5cc314abf5.png,551,197,665,309,114,112,red blood cell,12768,0.9824561403508771,1.0178571428571428
1635,/images/7094c11a-1e62-4f98-894e-d17d138a88e9.png,276,535,392,633,116,98,red blood cell,11368,0.8448275862068966,1.183673469387755
23168,/images/c94a5851-b846-4fde-8c89-05bec3a8ac53.png,781,133,888,233,107,100,red blood cell,10700,0.9345794392523364,1.07
27235,/images/9f38055f-4fe6-47fd-a6dd-c0743db4eccf.png,481,1155,602,1295,121,140,red blood cell,16940,1.1570247933884297,0.8642857142857143
10999,/images/c442e2d6-aaf9-417a-9905-4737a1115f33.png,498,910,621,1030,123,120,red blood cell,14760,0.975609756097561,1.025
72277,/images/ee57e743-a876-4f69-9fe5-bf5d01b44689.png,106,67,210,164,104,97,red blood cell,10088,0.9326923076923077,1.0721649484536082
31362,/images/04fb49a2-07b8-4cdf-b6f7-df5c3688e5f8.png,1068,1269,1168,1366,100,97,red blood cell,9700,0.97,1.0309278350515463
40860,/images/bf20d04d-ff8a-4910-91d7-94054c267d1b.png,353,329,489,478,136,149,red blood cell,20264,1.0955882352941178,0.912751677852349
26641,/images/16ec6e1f-5020-40b3-ba26-51c340d03ee7.png,503,952,634,1074,131,122,red blood cell,15982,0.9312977099236641,1.0737704918032787
62752,/images/e1937e32-85d5-4cd8-bb4a-b9cf8ee7ceeb.png,1080,1321,1191,1435,111,114,red blood cell,12654,1.027027027027027,0.9736842105263158
9643,/images/d997337e-e4a8-4ef0-b8ba-975e6c43b62c.png,815,856,943,966,128,110,red blood cell,14080,0.859375,1.1636363636363636
57431,/images/00d04a90-80e5-4bce-9511-1b64eabb7a47.png,565,989,664,1093,99,104,red blood cell,10296,1.0505050505050506,0.9519230769230769
44766,/images/ccb4b13d-ab20-4222-892f-5adf70249aaa.png,435,927,541,1024,106,97,red blood cell,10282,0.9150943396226415,1.092783505154639
24654,/images/30948737-0d0d-4b68-b9ab-50577e0fe026.png,990,169,1120,298,130,129,red blood cell,16770,0.9923076923076923,1.0077519379844961
14359,/images/f5eb7c5e-bd77-4638-ba9f-58d42f87476b.png,476,306,592,434,116,128,red blood cell,14848,1.103448275862069,0.90625
72142,/images/64b0e49a-0e48-447d-8872-c1dd255e7a21.png,17,1460,88,1527,71,67,red blood cell,4757,0.9436619718309859,1.0597014925373134
6040,/images/72732579-a812-4496-b2dd-ea1556924337.png,335,1260,433,1360,98,100,red blood cell,9800,1.0204081632653061,0.98
27926,/images/46f5bd4f-8bea-48d1-a1da-4dea28e3b814.png,940,382,1052,506,112,124,red blood cell,13888,1.1071428571428572,0.9032258064516129
39638,/images/04d21589-b777-43c2-86b5-038cbf8c3a4e.png,85,1051,212,1157,127,106,red blood cell,13462,0.8346456692913385,1.1981132075471699
48418,/images/0fa5b35d-6c44-4207-b6f8-d5b355086b5f.png,1022,937,1111,1045,89,108,red blood cell,9612,1.2134831460674158,0.8240740740740741
5052,/images/b7d0ae11-a393-4aec-8f68-6ba07147f78a.png,263,501,362,600,99,99,red blood cell,9801,1.0,1.0
71376,/images/bcb447c9-5d37-414f-a513-d7076b04a532.png,809,1446,913,1547,104,101,red blood cell,10504,0.9711538461538461,1.0297029702970297
8411,/images/ae779806-6d01-4dc6-89df-294c368db6bc.png,506,1359,626,1474,120,115,red blood cell,13800,0.9583333333333334,1.0434782608695652
26258,/images/52767904-4cdc-4821-ba68-8cd0c28f9023.png,459,1135,584,1257,125,122,red blood cell,15250,0.976,1.0245901639344261
9545,/images/a18f122f-3a3e-4478-8ac4-91b83e050e65.png,983,141,1090,255,107,114,red blood cell,12198,1.0654205607476634,0.9385964912280702
72887,/images/31435107-c77d-42f8-a619-75cba6a5161b.png,11,240,102,333,91,93,red blood cell,8463,1.021978021978022,0.978494623655914
51251,/images/216f9d43-6869-4ba1-9106-4f5ea6aac223.png,895,62,1006,195,111,133,red blood cell,14763,1.1981981981981982,0.8345864661654135
57724,/images/5c037ffc-f515-48b3-b231-c110fbd2b8ca.png,659,895,783,999,124,104,red blood cell,12896,0.8387096774193549,1.1923076923076923
73178,/images/85546330-4efd-43e2-87aa-d53a30220bfc.png,482,414,594,523,112,109,red blood cell,12208,0.9732142857142857,1.0275229357798166
48500,/images/9c4cb048-d64a-4b7f-84ff-ca28a8084fc7.png,979,918,1078,1041,99,123,red blood cell,12177,1.2424242424242424,0.8048780487804879
36308,/images/81fed4a1-9d48-4938-90c9-c8bf3f5e6b1f.png,543,217,664,341,121,124,red blood cell,15004,1.024793388429752,0.9758064516129032
44562,/images/419309ef-da3f-4424-93cf-01ff4c52b017.png,661,621,788,732,127,111,red blood cell,14097,0.8740157480314961,1.1441441441441442
36920,/images/b2e34f5f-904e-4473-9dc7-c6bc1ce12640.png,692,400,804,508,112,108,red blood cell,12096,0.9642857142857143,1.037037037037037
57668,/images/5c037ffc-f515-48b3-b231-c110fbd2b8ca.png,491,1105,593,1207,102,102,red blood cell,10404,1.0,1.0
59757,/images/f77d7469-d083-4c2d-a4ea-5a9ff162e3e2.png,1012,341,1121,442,109,101,red blood cell,11009,0.926605504587156,1.0792079207920793
14911,/images/3090a362-1f3d-49e9-a76e-ce76ff9c2276.png,731,1112,826,1210,95,98,red blood cell,9310,1.0315789473684212,0.9693877551020408
46064,/images/72088c26-d2dd-4906-b791-b8947fc7fbe4.png,124,879,219,963,95,84,red blood cell,7980,0.8842105263157894,1.130952380952381
21961,/images/393df10a-5d64-476b-88f5-14ac56d6ed60.png,975,675,1109,799,134,124,red blood cell,16616,0.9253731343283582,1.0806451612903225
45599,/images/e597f7ce-46c6-4dce-9063-50a2703fdd45.png,632,988,721,1077,89,89,red blood cell,7921,1.0,1.0
69873,/images/9edba799-e169-46cd-b100-c9f8fc7a8c7d.png,14,867,126,962,112,95,red blood cell,10640,0.8482142857142857,1.1789473684210525
16544,/images/69565501-6e77-4f40-bd80-caa3dda34d8b.png,400,1024,517,1131,117,107,red blood cell,12519,0.9145299145299145,1.0934579439252337
1516,/images/0ac747cd-ff32-49bf-bc1a-3e9b7702ce9c.png,677,118,769,227,92,109,red blood cell,10028,1.184782608695652,0.8440366972477065
23454,/images/8757be1e-b832-407a-8e95-62abae485b24.png,697,587,802,689,105,102,red blood cell,10710,0.9714285714285714,1.0294117647058822
65321,/images/24418314-f7a4-49fc-a03e-ec597ca6796e.png,404,791,476,865,72,74,red blood cell,5328,1.0277777777777777,0.972972972972973
28515,/images/dbdfad64-110c-421f-a1c7-f68fd9e82d67.png,957,757,1053,861,96,104,red blood cell,9984,1.0833333333333333,0.9230769230769231
73511,/images/5f2b32bd-fdca-4d6f-b13a-ee9f83626c8d.png,473,216,581,313,108,97,red blood cell,10476,0.8981481481481481,1.1134020618556701
57337,/images/a88a48b6-f85c-45c1-b42f-79716c8463f1.png,1069,828,1183,936,114,108,red blood cell,12312,0.9473684210526315,1.0555555555555556
28981,/images/4c13e22e-dfd1-4fa1-b373-be9d0c272c0f.png,780,548,882,643,102,95,red blood cell,9690,0.9313725490196079,1.0736842105263158
65899,/images/d7581cb0-7a12-471d-a3d8-68dcea362213.png,320,492,407,578,87,86,red blood cell,7482,0.9885057471264368,1.0116279069767442
26628,/images/16ec6e1f-5020-40b3-ba26-51c340d03ee7.png,745,256,872,374,127,118,red blood cell,14986,0.9291338582677166,1.076271186440678
22833,/images/72105bb0-8e39-48be-b7f7-5b32f047b99e.png,252,974,386,1097,134,123,red blood cell,16482,0.917910447761194,1.089430894308943
19124,/images/2196389c-45ec-46b5-bc6c-1f4a33df7f7c.png,377,563,490,671,113,108,red blood cell,12204,0.9557522123893806,1.0462962962962963
79431,/images/dcb21739-3c36-459d-b3cc-1be5871d6fe7.png,286,1151,383,1245,97,94,red blood cell,9118,0.9690721649484536,1.0319148936170213
41435,/images/c4494d4f-732f-431a-8a9d-62403f0b74fe.png,726,435,827,528,101,93,red blood cell,9393,0.9207920792079208,1.086021505376344
8754,/images/29dc8176-dfe1-40e0-8247-2dc3c530057e.png,91,188,213,292,122,104,red blood cell,12688,0.8524590163934426,1.1730769230769231
27229,/images/9f38055f-4fe6-47fd-a6dd-c0743db4eccf.png,223,53,341,157,118,104,red blood cell,12272,0.8813559322033898,1.1346153846153846
51942,/images/4f62b14e-c6f4-4155-8f50-881558f83fae.png,741,59,841,177,100,118,red blood cell,11800,1.18,0.847457627118644
43989,/images/de81bf7a-7a56-437f-a068-4d9c3e01134c.png,728,500,848,609,120,109,red blood cell,13080,0.9083333333333333,1.1009174311926606
9227,/images/261562a8-ffd8-4e0e-919b-22e267000b74.png,342,951,459,1056,117,105,red blood cell,12285,0.8974358974358975,1.1142857142857143
7388,/images/89f10192-d3dd-4996-a571-4c851dbdc983.png,139,507,242,603,103,96,red blood cell,9888,0.9320388349514563,1.0729166666666667
71872,/images/61575482-91e1-4db9-83c7-687b7ddbbfc4.png,386,25,496,156,110,131,red blood cell,14410,1.190909090909091,0.8396946564885496
47691,/images/4b3a49bc-8536-4760-9553-440a6f64db37.png,1063,1005,1191,1114,128,109,red blood cell,13952,0.8515625,1.1743119266055047
65525,/images/da49db57-0c2f-4213-b322-c88c19fb9296.png,126,612,228,721,102,109,red blood cell,11118,1.0686274509803921,0.9357798165137615
26291,/images/d33bc9fc-3444-4f26-8082-307f9fccc52b.png,802,976,922,1089,120,113,red blood cell,13560,0.9416666666666667,1.0619469026548674
29901,/images/f2a8a483-b254-43aa-817f-7d525adb8911.png,242,1327,361,1449,119,122,red blood cell,14518,1.0252100840336134,0.9754098360655737
27492,/images/f5869ba8-6253-426b-93f3-82af59a86144.png,350,1335,436,1427,86,92,red blood cell,7912,1.069767441860465,0.9347826086956522
36674,/images/21f001d6-f568-4ea4-82da-fab54c77c419.png,164,665,281,768,117,103,red blood cell,12051,0.8803418803418803,1.1359223300970873
23082,/images/be5bb7d0-7c3f-4bb9-8bb4-f8bc8d875943.png,1080,799,1189,916,109,117,red blood cell,12753,1.073394495412844,0.9316239316239316
29657,/images/b85fc640-de49-4f7e-afc0-978ff020f2e2.png,593,501,710,616,117,115,red blood cell,13455,0.9829059829059829,1.017391304347826
71915,/images/61575482-91e1-4db9-83c7-687b7ddbbfc4.png,203,240,294,345,91,105,red blood cell,9555,1.1538461538461537,0.8666666666666667
47892,/images/ab27173b-6e30-4957-bd68-29194328fd39.png,688,1111,809,1224,121,113,red blood cell,13673,0.9338842975206612,1.0707964601769913
75923,/images/3006096f-ceeb-42be-b69e-785179d7438b.png,558,331,653,431,95,100,red blood cell,9500,1.0526315789473684,0.95
13531,/images/370277f8-436b-4103-8210-b4feb5ab95ea.png,590,279,679,377,89,98,red blood cell,8722,1.101123595505618,0.9081632653061225
8002,/images/694222bb-cddf-469a-9526-f873c6fba58e.png,953,990,1061,1093,108,103,red blood cell,11124,0.9537037037037037,1.0485436893203883
36004,/images/5836500a-221e-40ca-a8be-caaa37f7d300.png,36,523,138,613,102,90,red blood cell,9180,0.8823529411764706,1.1333333333333333
66742,/images/334bf865-e3fb-4200-bd53-d9ff5808ed9f.png,167,1297,276,1402,109,105,red blood cell,11445,0.963302752293578,1.0380952380952382
56112,/images/50d9fc90-8642-4bb6-91a7-0069a7e37392.png,150,1403,258,1508,108,105,red blood cell,11340,0.9722222222222222,1.0285714285714285
60127,/images/ec60ab26-3343-4c5f-9667-cdae999c7d86.png,153,227,244,332,91,105,red blood cell,9555,1.1538461538461537,0.8666666666666667
78404,/images/24115f58-a7d6-4022-a95a-86b515a78d3e.png,1,424,100,511,99,87,red blood cell,8613,0.8787878787878788,1.1379310344827587
9080,/images/21c2a8aa-407c-4569-8212-96fcafa84138.png,921,1115,1057,1237,136,122,red blood cell,16592,0.8970588235294118,1.1147540983606556
78321,/images/24115f58-a7d6-4022-a95a-86b515a78d3e.png,673,327,780,432,107,105,red blood cell,11235,0.9813084112149533,1.019047619047619
70708,/images/8ab5c462-045e-4b59-b53a-9b2bc3ed2487.png,434,764,527,851,93,87,red blood cell,8091,0.9354838709677419,1.0689655172413792
25982,/images/e683144c-0465-43a2-86b1-3cf52599d5e0.png,949,841,1044,949,95,108,red blood cell,10260,1.1368421052631579,0.8796296296296297
2625,/images/a2ccbf70-e444-49a9-8b7e-9797a05220d8.png,408,316,533,442,125,126,red blood cell,15750,1.008,0.9920634920634921
9011,/images/ef815e3a-02a6-4cf8-9262-45bc74c50b00.png,395,547,515,673,120,126,red blood cell,15120,1.05,0.9523809523809523
66400,/images/e5fd5949-4cd0-4cb6-837a-02c26a5eb87a.png,772,247,917,386,145,139,red blood cell,20155,0.9586206896551724,1.0431654676258992
53363,/images/f23ae29e-1bda-4784-b10c-d736757d39b8.png,741,1259,852,1372,111,113,red blood cell,12543,1.018018018018018,0.9823008849557522
8585,/images/a6aa3b72-2970-4c78-b655-ea8dfe6e018c.png,296,24,417,148,121,124,red blood cell,15004,1.024793388429752,0.9758064516129032
23087,/images/be5bb7d0-7c3f-4bb9-8bb4-f8bc8d875943.png,603,1492,710,1597,107,105,red blood cell,11235,0.9813084112149533,1.019047619047619
37488,/images/c6530038-6d4e-49e1-8427-d1d3acc9fa21.png,570,796,690,906,120,110,red blood cell,13200,0.9166666666666666,1.0909090909090908
72435,/images/a15e0fa8-2620-4f66-896e-175115c9dc3d.png,433,1053,537,1156,104,103,red blood cell,10712,0.9903846153846154,1.0097087378640777
37892,/images/56a57a8d-c9b9-432a-a3b0-32a09355806c.png,252,91,347,181,95,90,red blood cell,8550,0.9473684210526315,1.0555555555555556
64965,/images/dec61ae1-5037-4c3a-8952-15371becca7d.png,849,347,929,430,80,83,red blood cell,6640,1.0375,0.963855421686747
70302,/images/90246988-0d6d-4bf8-8a76-94107de4121e.png,529,951,606,1031,77,80,red blood cell,6160,1.0389610389610389,0.9625
27782,/images/e3c1442a-717f-41dd-bf97-81e1233ac9fa.png,609,1147,708,1248,99,101,red blood cell,9999,1.02020202020202,0.9801980198019802
50379,/images/3d32a988-449d-4d58-b71f-abbfdc3f2fbc.png,395,1451,489,1527,94,76,red blood cell,7144,0.8085106382978723,1.236842105263158
67791,/images/48e2f0bd-2164-40c3-af43-1f2708359978.png,1099,440,1194,542,95,102,red blood cell,9690,1.0736842105263158,0.9313725490196079
63718,/images/06401963-8b02-46c5-ab2a-3d70bd01623f.png,376,286,474,381,98,95,red blood cell,9310,0.9693877551020408,1.0315789473684212
54389,/images/22a464ef-c3da-4d56-b37e-e22e95d945e7.png,600,1438,703,1561,103,123,red blood cell,12669,1.1941747572815533,0.8373983739837398
25651,/images/770b8ca4-8377-479b-9ad5-5455ec3b44f8.png,958,137,1068,252,110,115,red blood cell,12650,1.0454545454545454,0.9565217391304348
49896,/images/5e17f8e6-fd8d-426c-b444-1515d14f04b7.png,123,37,226,148,103,111,red blood cell,11433,1.0776699029126213,0.9279279279279279
65720,/images/c54fcef1-0c51-4426-9a93-15ec5f2bf58a.png,758,672,868,765,110,93,red blood cell,10230,0.8454545454545455,1.1827956989247312
27671,/images/18dbe7c4-89d2-42a6-a969-1e951ab313b1.png,134,307,255,428,121,121,red blood cell,14641,1.0,1.0
47722,/images/afbb264e-ff60-443a-83f5-49d09be1b835.png,711,432,820,545,109,113,red blood cell,12317,1.036697247706422,0.9646017699115044
57483,/images/00d04a90-80e5-4bce-9511-1b64eabb7a47.png,309,1,404,97,95,96,red blood cell,9120,1.0105263157894737,0.9895833333333334
68290,/images/a6391703-0820-4913-a7cd-e843ff0d84ba.png,530,1266,648,1371,118,105,red blood cell,12390,0.8898305084745762,1.1238095238095238
57439,/images/00d04a90-80e5-4bce-9511-1b64eabb7a47.png,667,839,776,963,109,124,red blood cell,13516,1.1376146788990826,0.8790322580645161
22772,/images/8490c623-3d88-4532-baf5-0d266a45b16f.png,368,37,493,143,125,106,red blood cell,13250,0.848,1.179245283018868
17205,/images/471f75c6-bd5d-4c20-bcc1-258e836f4d69.png,660,661,755,759,95,98,red blood cell,9310,1.0315789473684212,0.9693877551020408
38402,/images/674b0fd3-f247-4b7f-97f7-3e6c57c9ba9e.png,1020,384,1111,471,91,87,red blood cell,7917,0.9560439560439561,1.0459770114942528
12881,/images/b10ea12f-cd36-4f2c-994a-67d1665269ab.png,756,672,863,777,107,105,red blood cell,11235,0.9813084112149533,1.019047619047619
30236,/images/f81806a8-5883-446c-be78-f0145b12dbdd.png,736,1194,865,1311,129,117,red blood cell,15093,0.9069767441860465,1.1025641025641026
51305,/images/216f9d43-6869-4ba1-9106-4f5ea6aac223.png,6,1151,100,1244,94,93,red blood cell,8742,0.9893617021276596,1.010752688172043
57055,/images/9e82c996-2cfa-418d-9482-8ee23e9d0a5d.png,439,1305,548,1401,109,96,red blood cell,10464,0.8807339449541285,1.1354166666666667
19017,/images/e9e78ff8-831b-46e9-9785-3eee9acbfcd8.png,855,107,944,204,89,97,red blood cell,8633,1.0898876404494382,0.9175257731958762
4947,/images/755e5bf8-e8e1-492b-a32f-f7d87cccaa40.png,1083,834,1200,938,117,104,red blood cell,12168,0.8888888888888888,1.125
19043,/images/6e39fb0a-aa41-4b16-b783-7589e97bf289.png,292,590,416,706,124,116,red blood cell,14384,0.9354838709677419,1.0689655172413792
68681,/images/77e76e62-2c71-4b52-9b21-0d1bcde9f9bf.png,435,695,561,799,126,104,red blood cell,13104,0.8253968253968254,1.2115384615384615
53503,/images/43158031-a335-4533-9c20-48bebba90123.png,253,1152,344,1254,91,102,red blood cell,9282,1.120879120879121,0.8921568627450981
19049,/images/6e39fb0a-aa41-4b16-b783-7589e97bf289.png,499,390,629,505,130,115,red blood cell,14950,0.8846153846153846,1.1304347826086956
26017,/images/612bdd3c-da43-4321-a76b-c73c614928d1.png,549,1311,668,1431,119,120,red blood cell,14280,1.0084033613445378,0.9916666666666667
1596,/images/7094c11a-1e62-4f98-894e-d17d138a88e9.png,941,184,1059,301,118,117,red blood cell,13806,0.9915254237288136,1.0085470085470085
31836,/images/f62d4fb6-df7c-446c-94a8-d5aede0b1e0c.png,1021,642,1136,780,115,138,red blood cell,15870,1.2,0.8333333333333334
73152,/images/f39e2289-fedd-4d12-9e64-ffdafb89247e.png,1056,156,1159,267,103,111,red blood cell,11433,1.0776699029126213,0.9279279279279279
71166,/images/4fac16e1-8e62-499b-a66b-c4c890372914.png,677,403,799,527,122,124,red blood cell,15128,1.0163934426229508,0.9838709677419355
28940,/images/b12ae3b1-613c-4c0e-9163-3c5cc314abf5.png,134,904,261,1023,127,119,red blood cell,15113,0.937007874015748,1.0672268907563025
70109,/images/c742ee2c-6814-46cd-af56-ae87bb9972f4.png,989,804,1086,897,97,93,red blood cell,9021,0.9587628865979382,1.043010752688172
17452,/images/56077789-8580-41b4-89d6-deea227e5c60.png,583,556,717,683,134,127,red blood cell,17018,0.9477611940298507,1.0551181102362204
69533,/images/664c570b-4822-413c-9724-11b1d91fac44.png,1074,317,1191,420,117,103,red blood cell,12051,0.8803418803418803,1.1359223300970873
62240,/images/a72cd558-b7ac-4bf2-a344-2ce6c73a354e.png,796,457,898,548,102,91,red blood cell,9282,0.8921568627450981,1.120879120879121
59156,/images/4736f545-1f1f-4d77-9241-d69cbf4dae35.png,179,1364,270,1470,91,106,red blood cell,9646,1.164835164835165,0.8584905660377359
12659,/images/5a043d69-f435-46d4-8691-395c1602a76a.png,136,1470,248,1597,112,127,red blood cell,14224,1.1339285714285714,0.8818897637795275
33353,/images/f632981c-1330-4078-8a12-691beb2dab02.png,996,152,1091,262,95,110,red blood cell,10450,1.1578947368421053,0.8636363636363636
62966,/images/f234a2de-f3c8-4521-a306-8cfdf52dd597.png,548,22,648,117,100,95,red blood cell,9500,0.95,1.0526315789473684
32152,/images/25cfca07-2101-484f-b312-a927395f2651.png,100,667,217,791,117,124,red blood cell,14508,1.0598290598290598,0.9435483870967742
34903,/images/a4fbb9f2-9b75-4fdc-877d-2feaafac25b3.png,907,1378,997,1470,90,92,red blood cell,8280,1.0222222222222221,0.9782608695652174
48472,/images/e13f2327-fbf4-4d84-a8c1-09cb1e449c8c.png,439,1302,555,1430,116,128,red blood cell,14848,1.103448275862069,0.90625
48326,/images/6fa2b30f-9b89-46ac-9b79-c0bc105d4271.png,24,90,135,203,111,113,red blood cell,12543,1.018018018018018,0.9823008849557522
52937,/images/e81bf478-27ff-458c-ac30-9e1f8480bc5c.png,608,188,718,296,110,108,red blood cell,11880,0.9818181818181818,1.0185185185185186
44521,/images/419309ef-da3f-4424-93cf-01ff4c52b017.png,855,1043,950,1135,95,92,red blood cell,8740,0.968421052631579,1.0326086956521738
74078,/images/fe436c09-b680-4f4c-8faf-aa10a55a335b.png,64,1462,171,1572,107,110,red blood cell,11770,1.02803738317757,0.9727272727272728
2577,/images/a23f5539-bfe6-4885-9a0e-dba972475ea9.png,263,485,366,581,103,96,red blood cell,9888,0.9320388349514563,1.0729166666666667
35537,/images/3e33ee12-ef02-4287-8318-7ad3b284a617.png,836,16,948,108,112,92,red blood cell,10304,0.8214285714285714,1.2173913043478262
69026,/images/b5246b58-6f40-4c9e-8024-f49b0ed6bdbd.png,327,464,419,550,92,86,red blood cell,7912,0.9347826086956522,1.069767441860465
3330,/images/b1100ae1-0ac8-4fc2-b0ff-8819f7fbe724.png,897,583,1003,713,106,130,red blood cell,13780,1.2264150943396226,0.8153846153846154
78269,/images/adff6e1d-ba9d-4c7b-a8fe-1ec458eaeeb8.png,816,384,904,484,88,100,red blood cell,8800,1.1363636363636365,0.88
64670,/images/6dfafdf1-f588-4e80-8cf8-0126e1bf7af9.png,836,433,937,533,101,100,red blood cell,10100,0.9900990099009901,1.01
2792,/images/e79bd81b-f878-4bee-9be2-d91a722c031e.png,558,1094,683,1217,125,123,red blood cell,15375,0.984,1.016260162601626
25838,/images/14b68d86-ac7f-419d-b4a5-6b0b1d9aaa18.png,848,744,935,824,87,80,red blood cell,6960,0.9195402298850575,1.0875
54689,/images/6473ddb6-ad56-48a2-81e8-c7cb45f06825.png,879,645,961,742,82,97,red blood cell,7954,1.1829268292682926,0.845360824742268
11298,/images/6303f964-98ef-47c6-bb2d-283aa393f918.png,288,768,389,873,101,105,red blood cell,10605,1.0396039603960396,0.9619047619047619
68178,/images/5dec94a3-e3ca-4a58-9702-88e5a83ef612.png,232,125,343,218,111,93,red blood cell,10323,0.8378378378378378,1.1935483870967742
46611,/images/da111ca5-520f-4ea8-97ad-ae5fce58ee91.png,173,1405,278,1502,105,97,red blood cell,10185,0.9238095238095239,1.0824742268041236
28793,/images/686ed568-d5f8-475e-81ad-edab9dd473a0.png,114,21,225,141,111,120,red blood cell,13320,1.0810810810810811,0.925
71213,/images/86495bbf-687b-429c-b9d3-6c2681ade7e2.png,159,1432,272,1548,113,116,red blood cell,13108,1.0265486725663717,0.9741379310344828
74379,/images/06a3effb-996c-4767-afd2-6aa3b697cb4e.png,951,26,1041,113,90,87,red blood cell,7830,0.9666666666666667,1.0344827586206897
38636,/images/3b601a1b-26d8-4873-afcf-fdd1b1e0010c.png,328,202,461,339,133,137,red blood cell,18221,1.0300751879699248,0.9708029197080292
49597,/images/bd7937db-fca2-44d0-8538-460110210927.png,556,256,678,361,122,105,red blood cell,12810,0.860655737704918,1.161904761904762
67248,/images/5f491efd-a21c-4a80-aaba-70b8876238ac.png,828,855,952,980,124,125,red blood cell,15500,1.0080645161290323,0.992
38984,/images/5939f341-a886-4f63-ae87-2219d000a1d4.png,692,438,820,554,128,116,red blood cell,14848,0.90625,1.103448275862069
63930,/images/5e974892-0ebe-4037-8427-ea8616d6d3b8.png,177,1238,277,1359,100,121,red blood cell,12100,1.21,0.8264462809917356
2006,/images/bfefa21c-11e1-4dab-ac5d-8ff6f046d65f.png,402,25,517,143,115,118,red blood cell,13570,1.0260869565217392,0.9745762711864406
1465,/images/5f17d2fb-22fa-4aa6-9dad-6a1d50c03815.png,344,1441,476,1559,132,118,red blood cell,15576,0.8939393939393939,1.11864406779661
52685,/images/9dc6ed5d-6698-48cf-aab3-fd156673729c.png,1016,348,1118,443,102,95,red blood cell,9690,0.9313725490196079,1.0736842105263158
42861,/images/a7b6894d-eeea-4ed5-bc0e-785d6c6da8df.png,613,404,722,520,109,116,red blood cell,12644,1.0642201834862386,0.9396551724137931
79129,/images/1c90231b-2830-42d9-884e-7301edb16933.png,537,1076,630,1163,93,87,red blood cell,8091,0.9354838709677419,1.0689655172413792
5430,/images/75579b27-8191-4044-859b-268be969c42b.png,752,600,867,731,115,131,red blood cell,15065,1.1391304347826088,0.8778625954198473
24660,/images/30948737-0d0d-4b68-b9ab-50577e0fe026.png,540,555,647,686,107,131,red blood cell,14017,1.2242990654205608,0.816793893129771
34914,/images/a4fbb9f2-9b75-4fdc-877d-2feaafac25b3.png,690,103,794,207,104,104,red blood cell,10816,1.0,1.0
20802,/images/c2ec116f-f091-422c-926c-70b548a8f6ef.png,146,1059,256,1187,110,128,red blood cell,14080,1.1636363636363636,0.859375
46723,/images/da111ca5-520f-4ea8-97ad-ae5fce58ee91.png,1026,782,1141,878,115,96,red blood cell,11040,0.8347826086956521,1.1979166666666667
21315,/images/8dace03a-10c4-4d59-bcd9-a2c314c5df33.png,149,19,280,133,131,114,red blood cell,14934,0.8702290076335878,1.1491228070175439
4928,/images/755e5bf8-e8e1-492b-a32f-f7d87cccaa40.png,871,31,983,134,112,103,red blood cell,11536,0.9196428571428571,1.087378640776699
35112,/images/a6ba808f-ec60-42a5-ad91-7b32412ab708.png,400,1416,512,1531,112,115,red blood cell,12880,1.0267857142857142,0.9739130434782609
78195,/images/2bed2796-75a9-4d93-bb2d-e3ccbe1a5cbe.png,145,1186,240,1294,95,108,red blood cell,10260,1.1368421052631579,0.8796296296296297
51856,/images/d67398c5-8b0e-463f-a04e-8583c820786c.png,625,211,721,319,96,108,red blood cell,10368,1.125,0.8888888888888888
52531,/images/d1144956-5a0c-4bd2-b67d-8498c82d6a12.png,305,495,402,598,97,103,red blood cell,9991,1.0618556701030928,0.941747572815534
25864,/images/461a3ed6-039f-4a70-97cf-c474ecf51ccd.png,705,1098,807,1212,102,114,red blood cell,11628,1.1176470588235294,0.8947368421052632
24850,/images/93f7e207-0d8e-47f8-8258-09a0e03dbdd6.png,787,682,908,805,121,123,red blood cell,14883,1.0165289256198347,0.983739837398374
57169,/images/7c870293-2665-4a6b-a4fa-336959051dfc.png,116,912,215,1008,99,96,red blood cell,9504,0.9696969696969697,1.03125
5096,/images/a777e78c-ad1f-4380-9ab2-b4f9f32b2d78.png,171,396,288,514,117,118,red blood cell,13806,1.0085470085470085,0.9915254237288136
22289,/images/49b03a6e-6b26-4a96-a061-e05647a02138.png,184,259,280,365,96,106,red blood cell,10176,1.1041666666666667,0.9056603773584906
50973,/images/ef8fcfa4-8466-4186-8c69-f5f4904eb489.png,356,422,445,519,89,97,red blood cell,8633,1.0898876404494382,0.9175257731958762
33429,/images/244ac6fa-8a92-4214-9cf4-ae0811d9ec7e.png,557,173,664,283,107,110,red blood cell,11770,1.02803738317757,0.9727272727272728
17611,/images/70a95e58-ba60-4c1f-adcd-49c198dc2ba0.png,946,538,1053,632,107,94,red blood cell,10058,0.8785046728971962,1.1382978723404256
45261,/images/9e793460-d94c-47ac-b3a7-0d6ad86357da.png,224,1299,357,1420,133,121,red blood cell,16093,0.9097744360902256,1.0991735537190082
54388,/images/22a464ef-c3da-4d56-b37e-e22e95d945e7.png,294,1434,409,1559,115,125,red blood cell,14375,1.0869565217391304,0.92
15505,/images/79f63258-24ce-4e69-a5cb-8529635a89a9.png,615,802,721,909,106,107,red blood cell,11342,1.009433962264151,0.9906542056074766
53590,/images/7c1cd7c7-7452-4428-a98e-dd7675c8ddea.png,313,927,409,1035,96,108,red blood cell,10368,1.125,0.8888888888888888
4523,/images/0f26699f-a776-4424-b092-27da9a1d12e2.png,485,844,569,932,84,88,red blood cell,7392,1.0476190476190477,0.9545454545454546
14282,/images/6382976c-ee87-4916-b798-4ef1373b2df0.png,187,579,292,684,105,105,red blood cell,11025,1.0,1.0
38696,/images/b5acf759-1115-42f0-a753-656736192528.png,598,483,721,593,123,110,red blood cell,13530,0.8943089430894309,1.1181818181818182
42768,/images/7c68c343-a7d3-4d26-b330-a5bb97ab8d9c.png,686,1228,788,1342,102,114,red blood cell,11628,1.1176470588235294,0.8947368421052632
64822,/images/a74b6d6a-7e04-40ac-9292-d62f13f7ded3.png,1080,1102,1181,1220,101,118,red blood cell,11918,1.1683168316831682,0.8559322033898306
56154,/images/137d540f-d71e-47e8-bd9b-6cd0a6433c33.png,50,233,155,336,105,103,red blood cell,10815,0.9809523809523809,1.0194174757281553
79648,/images/a4409217-be11-4478-90a5-b406057d154d.png,528,882,637,985,109,103,red blood cell,11227,0.944954128440367,1.058252427184466
4347,/images/84041bf9-dace-4066-9fe0-52170d08f826.png,575,423,682,525,107,102,red blood cell,10914,0.9532710280373832,1.0490196078431373
1713,/images/5f783f43-0090-4f8a-bd75-9562f4aa2dd5.png,438,71,551,169,113,98,red blood cell,11074,0.8672566371681416,1.153061224489796
36010,/images/5836500a-221e-40ca-a8be-caaa37f7d300.png,420,742,508,852,88,110,red blood cell,9680,1.25,0.8
67051,/images/1fe1e118-adb8-4b10-a41e-1e5814e8f067.png,551,419,674,563,123,144,red blood cell,17712,1.170731707317073,0.8541666666666666
78519,/images/c94827ce-d619-4705-a68a-df63a2c95ffa.png,350,783,444,886,94,103,red blood cell,9682,1.0957446808510638,0.912621359223301
72953,/images/a20d0b4b-6e2e-4507-bc22-f321dedc4ed9.png,834,628,922,717,88,89,red blood cell,7832,1.0113636363636365,0.9887640449438202
6977,/images/c776eb78-3323-4571-b39f-7ffc73ae63ce.png,858,1238,962,1333,104,95,red blood cell,9880,0.9134615384615384,1.0947368421052632
407,/images/84c88143-940d-4b62-bbd2-7acc4cadcb6b.png,590,118,717,236,127,118,red blood cell,14986,0.9291338582677166,1.076271186440678
62866,/images/4b346035-b8c0-46ca-8fdb-a01b1421ee4a.png,620,180,725,280,105,100,red blood cell,10500,0.9523809523809523,1.05
54273,/images/3b5a8060-dec6-4a83-b7f2-b604e4e69dfc.png,1,485,108,596,107,111,red blood cell,11877,1.0373831775700935,0.963963963963964
7225,/images/89f10192-d3dd-4996-a571-4c851dbdc983.png,696,885,788,978,92,93,red blood cell,8556,1.0108695652173914,0.989247311827957
33960,/images/701206c5-aaac-4b99-9cc0-4a6854359457.png,86,61,186,170,100,109,red blood cell,10900,1.09,0.9174311926605505
13703,/images/0b04ec46-5119-4cda-8c35-c4e5b6f0eed0.png,486,167,600,269,114,102,red blood cell,11628,0.8947368421052632,1.1176470588235294
53030,/images/42e87148-a015-4148-923a-fb83016f64e7.png,148,336,237,427,89,91,red blood cell,8099,1.0224719101123596,0.978021978021978
7301,/images/89f10192-d3dd-4996-a571-4c851dbdc983.png,663,1164,769,1277,106,113,red blood cell,11978,1.0660377358490567,0.9380530973451328
33988,/images/701206c5-aaac-4b99-9cc0-4a6854359457.png,497,419,614,533,117,114,red blood cell,13338,0.9743589743589743,1.0263157894736843
13662,/images/1e86933d-6a5a-4a3c-a0f2-ca22afd767b3.png,624,482,748,589,124,107,red blood cell,13268,0.8629032258064516,1.158878504672897
25555,/images/f6ab936d-924b-4038-aa47-71b07c26b4e2.png,292,898,413,1023,121,125,red blood cell,15125,1.0330578512396693,0.968
71077,/images/2dbf6f69-e020-4948-9e49-4b33edb7cebd.png,184,1170,302,1279,118,109,red blood cell,12862,0.923728813559322,1.0825688073394495
3086,/images/14efbfc8-39f6-4599-9994-a8cc95605b9c.png,188,593,304,704,116,111,red blood cell,12876,0.9568965517241379,1.045045045045045
36597,/images/21f001d6-f568-4ea4-82da-fab54c77c419.png,886,1062,982,1162,96,100,red blood cell,9600,1.0416666666666667,0.96
23523,/images/177f883a-f0f1-4b8e-b598-2ca4bab27381.png,665,1308,773,1421,108,113,red blood cell,12204,1.0462962962962963,0.9557522123893806
38010,/images/e3e9c2de-0a24-4c7e-8a69-3d3093d5bdab.png,279,236,380,331,101,95,red blood cell,9595,0.9405940594059405,1.063157894736842
7553,/images/071901eb-4c3f-404b-a747-3d0b9d0a5158.png,764,203,847,287,83,84,red blood cell,6972,1.0120481927710843,0.9880952380952381
51152,/images/d64cd75a-df26-44d5-ac25-69061a4e4d57.png,634,160,734,264,100,104,red blood cell,10400,1.04,0.9615384615384616
20934,/images/c2ec116f-f091-422c-926c-70b548a8f6ef.png,581,1154,676,1250,95,96,red blood cell,9120,1.0105263157894737,0.9895833333333334
51825,/images/f07174a5-f799-4286-ac43-5b0f5c5777ac.png,968,735,1060,836,92,101,red blood cell,9292,1.0978260869565217,0.9108910891089109
15385,/images/035f6c4b-0897-46ab-9c3b-5f3b0feff043.png,873,89,977,182,104,93,red blood cell,9672,0.8942307692307693,1.118279569892473
32909,/images/e40000b4-1b26-42ce-909d-4715e04f0a6e.png,348,202,471,318,123,116,red blood cell,14268,0.943089430894309,1.0603448275862069
56266,/images/6b473806-e936-4b19-98cf-a2b94cac35ff.png,967,824,1087,936,120,112,red blood cell,13440,0.9333333333333333,1.0714285714285714
39781,/images/5c68070c-3391-4db6-8c01-94175105dbea.png,936,634,1046,747,110,113,red blood cell,12430,1.0272727272727273,0.9734513274336283
1612,/images/7094c11a-1e62-4f98-894e-d17d138a88e9.png,318,762,446,891,128,129,red blood cell,16512,1.0078125,0.9922480620155039
24894,/images/ed0bee2f-05e0-4392-8357-19750cec577c.png,951,1201,1045,1301,94,100,red blood cell,9400,1.0638297872340425,0.94
77380,/images/3ff98212-7c2a-46cd-afb7-34a2479bed07.png,872,1327,1002,1438,130,111,red blood cell,14430,0.8538461538461538,1.1711711711711712
13733,/images/1b369bcf-ced4-4ae2-9196-2664bd2b1738.png,910,417,1017,519,107,102,red blood cell,10914,0.9532710280373832,1.0490196078431373
49154,/images/df3d98b9-3dd7-4107-8d4a-ae1b7f247793.png,613,217,715,309,102,92,red blood cell,9384,0.9019607843137255,1.108695652173913
56261,/images/6b473806-e936-4b19-98cf-a2b94cac35ff.png,669,743,779,853,110,110,red blood cell,12100,1.0,1.0
16475,/images/9e5437c6-b0d3-473b-b7c3-8f5afeb90c7a.png,892,531,1004,653,112,122,red blood cell,13664,1.0892857142857142,0.9180327868852459
27977,/images/c4d34e35-4db2-41de-ba77-1a94aa9ef788.png,305,1314,429,1445,124,131,red blood cell,16244,1.0564516129032258,0.9465648854961832
72769,/images/caeb2d62-1166-43f0-8eac-5b8fc48f02eb.png,378,449,462,533,84,84,red blood cell,7056,1.0,1.0
11662,/images/0ed416f9-7c20-4829-9016-559e4009568e.png,750,138,854,249,104,111,red blood cell,11544,1.0673076923076923,0.9369369369369369
6982,/images/c776eb78-3323-4571-b39f-7ffc73ae63ce.png,115,727,224,840,109,113,red blood cell,12317,1.036697247706422,0.9646017699115044
17783,/images/1863da5f-c595-4541-a8f4-21fe78678168.png,560,1267,653,1368,93,101,red blood cell,9393,1.086021505376344,0.9207920792079208
31601,/images/0d7bf56f-3b5a-40bd-971c-2ca33dd89b2c.png,704,1075,806,1176,102,101,red blood cell,10302,0.9901960784313726,1.00990099009901
44725,/images/ccb4b13d-ab20-4222-892f-5adf70249aaa.png,474,558,606,668,132,110,red blood cell,14520,0.8333333333333334,1.2
9015,/images/ef815e3a-02a6-4cf8-9262-45bc74c50b00.png,839,1336,936,1436,97,100,red blood cell,9700,1.0309278350515463,0.97
57925,/images/09bcedaa-e007-4692-a13f-ab02c3f872c4.png,904,1300,1022,1419,118,119,red blood cell,14042,1.0084745762711864,0.9915966386554622
33021,/images/6231d81d-9e84-4a5a-8cb8-47c6a37a0176.png,363,745,455,841,92,96,red blood cell,8832,1.0434782608695652,0.9583333333333334
37447,/images/c6530038-6d4e-49e1-8427-d1d3acc9fa21.png,395,291,519,407,124,116,red blood cell,14384,0.9354838709677419,1.0689655172413792
28011,/images/c4d34e35-4db2-41de-ba77-1a94aa9ef788.png,949,81,1069,204,120,123,red blood cell,14760,1.025,0.975609756097561
20048,/images/ebfd9f67-138e-49f0-9cef-a0352069eedb.png,751,67,856,163,105,96,red blood cell,10080,0.9142857142857143,1.09375
55511,/images/43072c64-4c08-47cd-ae8a-b74d31f80008.png,104,521,197,632,93,111,red blood cell,10323,1.1935483870967742,0.8378378378378378
25304,/images/587e5464-d70b-4279-8562-010279f6efbd.png,266,1430,384,1544,118,114,red blood cell,13452,0.9661016949152542,1.0350877192982457
77017,/images/637957ef-df75-4a7b-86d5-9f6e9c042ca2.png,167,231,258,327,91,96,red blood cell,8736,1.054945054945055,0.9479166666666666
27169,/images/f232eec3-02c0-43f9-bf32-3e60245397e2.png,537,1327,654,1438,117,111,red blood cell,12987,0.9487179487179487,1.054054054054054
48006,/images/eba73bff-fbe1-436d-9a5f-0a61331a0ea2.png,1089,1146,1189,1264,100,118,red blood cell,11800,1.18,0.847457627118644
52085,/images/de6d3020-9347-473b-9146-8909627790f6.png,148,197,252,324,104,127,red blood cell,13208,1.2211538461538463,0.8188976377952756
17977,/images/eb77e4a9-acb0-4d83-8055-2c5fcaa54b45.png,933,416,1017,507,84,91,red blood cell,7644,1.0833333333333333,0.9230769230769231
2271,/images/fe851c88-692d-4199-87e0-d19d9c4eb591.png,816,468,916,574,100,106,red blood cell,10600,1.06,0.9433962264150944
53585,/images/7c1cd7c7-7452-4428-a98e-dd7675c8ddea.png,997,792,1099,895,102,103,red blood cell,10506,1.0098039215686274,0.9902912621359223
11780,/images/082e1f81-4f49-44ad-b5bb-9dfc155b2ed8.png,901,113,1009,232,108,119,red blood cell,12852,1.1018518518518519,0.907563025210084
25551,/images/f6ab936d-924b-4038-aa47-71b07c26b4e2.png,246,1408,359,1537,113,129,red blood cell,14577,1.1415929203539823,0.875968992248062
32080,/images/b8a4d467-c40c-4ebf-91dd-1c19d0f2a7ae.png,111,554,207,661,96,107,red blood cell,10272,1.1145833333333333,0.897196261682243
55283,/images/8ad7ba46-5db8-4ba9-b3e0-3cac52f7efc3.png,5,382,119,492,114,110,red blood cell,12540,0.9649122807017544,1.0363636363636364
36237,/images/b2103776-9b32-4160-b4f0-0692deda19dc.png,139,336,242,442,103,106,red blood cell,10918,1.029126213592233,0.9716981132075472
62787,/images/631340cc-cedf-4bca-a3d8-a0731a5482b4.png,689,26,793,141,104,115,red blood cell,11960,1.1057692307692308,0.9043478260869565
46828,/images/63055d1b-5221-4c80-8b39-37ac069a1b5c.png,868,1031,955,1123,87,92,red blood cell,8004,1.0574712643678161,0.9456521739130435
74269,/images/8939e14b-fcdf-48b1-acb9-6514a2fc2fc0.png,280,975,385,1071,105,96,red blood cell,10080,0.9142857142857143,1.09375
41419,/images/65e8b0cd-05d1-4c8d-8efd-24bf71df3167.png,369,365,508,487,139,122,red blood cell,16958,0.8776978417266187,1.139344262295082
10630,/images/20d4f65e-6c63-433a-935c-d568d577967b.png,21,191,119,298,98,107,red blood cell,10486,1.0918367346938775,0.9158878504672897
53156,/images/801296d9-3403-426f-859e-5c532858e025.png,974,1305,1077,1410,103,105,red blood cell,10815,1.0194174757281553,0.9809523809523809
30169,/images/a1669b59-fe09-4fe6-ba9f-06bec6725502.png,900,732,1004,850,104,118,red blood cell,12272,1.1346153846153846,0.8813559322033898
46062,/images/72088c26-d2dd-4906-b791-b8947fc7fbe4.png,330,356,423,443,93,87,red blood cell,8091,0.9354838709677419,1.0689655172413792
73772,/images/22cbf509-c9bf-46ec-bfce-f079c6b76c8c.png,864,4,992,131,128,127,red blood cell,16256,0.9921875,1.0078740157480315
62075,/images/7f528918-27d4-421f-ab57-0cf9c693e697.png,170,371,283,485,113,114,red blood cell,12882,1.008849557522124,0.9912280701754386
66594,/images/087f2c9c-188d-43cc-a94c-0eb8f10ac092.png,647,655,743,743,96,88,red blood cell,8448,0.9166666666666666,1.0909090909090908
8440,/images/ae779806-6d01-4dc6-89df-294c368db6bc.png,266,369,385,496,119,127,red blood cell,15113,1.0672268907563025,0.937007874015748
28311,/images/34e024a5-5698-42d4-972f-fee234b4bd64.png,488,257,573,352,85,95,red blood cell,8075,1.1176470588235294,0.8947368421052632
75178,/images/7fdc8be8-7579-4a5c-b369-8a07ee0a8b7d.png,45,1492,144,1596,99,104,red blood cell,10296,1.0505050505050506,0.9519230769230769
69679,/images/f0713bee-2a71-4ced-b953-4041ea99496a.png,1070,183,1159,280,89,97,red blood cell,8633,1.0898876404494382,0.9175257731958762
26140,/images/27388ff2-4000-4c9a-a2e3-addc448a5f92.png,534,1256,642,1382,108,126,red blood cell,13608,1.1666666666666667,0.8571428571428571
66428,/images/5f66d20c-fbfe-44ec-a01b-8a09da24807e.png,330,109,440,222,110,113,red blood cell,12430,1.0272727272727273,0.9734513274336283
5932,/images/e0e6b676-c39c-4542-8adf-de257a8e92e2.png,577,1166,682,1288,105,122,red blood cell,12810,1.161904761904762,0.860655737704918
19467,/images/a85cd1ae-0c94-4387-8305-84ab8d96d137.png,334,802,453,927,119,125,red blood cell,14875,1.050420168067227,0.952
2787,/images/e79bd81b-f878-4bee-9be2-d91a722c031e.png,23,87,129,209,106,122,red blood cell,12932,1.150943396226415,0.8688524590163934
51546,/images/6afb3717-f197-4668-929a-4fab389ae6e8.png,666,299,766,419,100,120,red blood cell,12000,1.2,0.8333333333333334
45312,/images/9e793460-d94c-47ac-b3a7-0d6ad86357da.png,491,754,613,864,122,110,red blood cell,13420,0.9016393442622951,1.1090909090909091
39803,/images/5c68070c-3391-4db6-8c01-94175105dbea.png,456,1312,578,1444,122,132,red blood cell,16104,1.0819672131147542,0.9242424242424242
59533,/images/6bfe6a90-8a69-4171-8e7f-42dc9417c6d9.png,920,656,1012,759,92,103,red blood cell,9476,1.1195652173913044,0.8932038834951457
13910,/images/de00f9a5-aa8b-4679-8ec6-85528a942d6f.png,1076,753,1198,881,122,128,red blood cell,15616,1.0491803278688525,0.953125
45941,/images/0d098413-6911-4535-b70a-3c3effd8cf49.png,437,1112,563,1244,126,132,red blood cell,16632,1.0476190476190477,0.9545454545454546
6678,/images/95fea6d8-413f-421e-b331-5d51c31df150.png,714,1346,849,1454,135,108,red blood cell,14580,0.8,1.25
22645,/images/4ab47131-c2ac-461f-b95c-ac19ce24edbd.png,613,1070,701,1176,88,106,red blood cell,9328,1.2045454545454546,0.8301886792452831
55190,/images/9c5f48c0-0544-4c0c-92b4-59b7d7b7814c.png,82,30,193,136,111,106,red blood cell,11766,0.954954954954955,1.0471698113207548
76621,/images/4184a235-d209-4151-86e9-6c77e7938dab.png,617,1340,706,1435,89,95,red blood cell,8455,1.0674157303370786,0.9368421052631579
75998,/images/034c8d57-04d5-4786-93a4-6ae8fde2c258.png,1062,882,1136,966,74,84,red blood cell,6216,1.135135135135135,0.8809523809523809
73068,/images/2bd26501-2fbc-4c1a-bef0-4ad57e02b4d0.png,566,912,650,1007,84,95,red blood cell,7980,1.130952380952381,0.8842105263157894
11311,/images/6303f964-98ef-47c6-bb2d-283aa393f918.png,155,498,288,631,133,133,red blood cell,17689,1.0,1.0
76379,/images/3dad6483-ac30-4d2b-b045-9f24fe6ff75e.png,577,951,685,1068,108,117,red blood cell,12636,1.0833333333333333,0.9230769230769231
37187,/images/befe6182-266b-4f8a-ac82-3a4154f05f60.png,372,607,489,735,117,128,red blood cell,14976,1.0940170940170941,0.9140625
74509,/images/cbb58718-6319-48db-b84b-78ac9b12ff89.png,449,988,542,1080,93,92,red blood cell,8556,0.989247311827957,1.0108695652173914
10773,/images/fac4b0e2-6b52-4c0e-b762-4fa65d552856.png,23,544,121,661,98,117,red blood cell,11466,1.1938775510204083,0.8376068376068376
8617,/images/a6aa3b72-2970-4c78-b655-ea8dfe6e018c.png,203,329,307,436,104,107,red blood cell,11128,1.0288461538461537,0.9719626168224299
714,/images/dcc1a193-7b74-44f8-ad8d-813751d8fa6b.png,830,481,949,599,119,118,red blood cell,14042,0.9915966386554622,1.0084745762711864
66888,/images/9acf303a-fcba-4e52-be3e-8d061aa5e72a.png,770,865,854,959,84,94,red blood cell,7896,1.119047619047619,0.8936170212765957
10922,/images/1380f9b4-bf54-4492-90c3-743c7aa8898b.png,407,662,506,776,99,114,red blood cell,11286,1.1515151515151516,0.868421052631579
65022,/images/ff3b9d4d-373c-48ef-a75a-d23e2c2ade87.png,463,339,560,437,97,98,red blood cell,9506,1.0103092783505154,0.9897959183673469
61793,/images/985627c9-7b85-40de-a106-eb9cc47b47cb.png,424,463,520,542,96,79,red blood cell,7584,0.8229166666666666,1.2151898734177216
13926,/images/de00f9a5-aa8b-4679-8ec6-85528a942d6f.png,588,498,696,615,108,117,red blood cell,12636,1.0833333333333333,0.9230769230769231
73562,/images/7624ac36-1cf9-42fb-844d-376078309553.png,1019,147,1132,248,113,101,red blood cell,11413,0.8938053097345132,1.118811881188119
33443,/images/244ac6fa-8a92-4214-9cf4-ae0811d9ec7e.png,530,1240,623,1332,93,92,red blood cell,8556,0.989247311827957,1.0108695652173914
69478,/images/664c570b-4822-413c-9724-11b1d91fac44.png,986,78,1073,170,87,92,red blood cell,8004,1.0574712643678161,0.9456521739130435
56541,/images/ac8df764-c8d8-4312-916d-70bfb37574b4.png,1035,160,1160,267,125,107,red blood cell,13375,0.856,1.1682242990654206
49721,/images/5e17f8e6-fd8d-426c-b444-1515d14f04b7.png,319,398,425,506,106,108,red blood cell,11448,1.0188679245283019,0.9814814814814815
26711,/images/2518f6e4-29cc-4ae4-a914-b215a4c56099.png,1065,287,1169,383,104,96,red blood cell,9984,0.9230769230769231,1.0833333333333333
56097,/images/ffb7be9a-65df-4f0b-99ae-cfd34e81cd34.png,77,999,202,1125,125,126,red blood cell,15750,1.008,0.9920634920634921
79166,/images/1c90231b-2830-42d9-884e-7301edb16933.png,258,441,342,527,84,86,red blood cell,7224,1.0238095238095237,0.9767441860465116
27789,/images/e3c1442a-717f-41dd-bf97-81e1233ac9fa.png,97,804,207,908,110,104,red blood cell,11440,0.9454545454545454,1.0576923076923077
23815,/images/eeb06e39-482b-443d-8cf6-b9b5c763df78.png,640,572,747,682,107,110,red blood cell,11770,1.02803738317757,0.9727272727272728
50544,/images/e98ea067-82b5-4a0d-87bf-b4bbdc10ddab.png,233,1385,330,1500,97,115,red blood cell,11155,1.1855670103092784,0.8434782608695652
4739,/images/3fa1a4e3-c80d-49da-8f7b-a1abb0424f48.png,779,475,904,606,125,131,red blood cell,16375,1.048,0.9541984732824428
71904,/images/61575482-91e1-4db9-83c7-687b7ddbbfc4.png,589,525,674,628,85,103,red blood cell,8755,1.2117647058823529,0.8252427184466019
34036,/images/1012abf2-cb05-4337-86c5-513ec4ca904d.png,1015,267,1125,386,110,119,red blood cell,13090,1.0818181818181818,0.9243697478991597
13409,/images/a7f1bbb1-6058-4642-bd66-cfb90dce762e.png,593,479,710,605,117,126,red blood cell,14742,1.0769230769230769,0.9285714285714286
14407,/images/3b13e20f-ec0d-44ec-b2f4-eaebfa09150e.png,197,663,320,775,123,112,red blood cell,13776,0.9105691056910569,1.0982142857142858
69645,/images/4a49841f-216c-4815-8140-b8762c4f6603.png,698,941,773,1024,75,83,red blood cell,6225,1.1066666666666667,0.9036144578313253
5309,/images/06df7bbe-60d4-4f7c-ba4a-5a42ac4be91b.png,853,1153,970,1279,117,126,red blood cell,14742,1.0769230769230769,0.9285714285714286
79119,/images/1c90231b-2830-42d9-884e-7301edb16933.png,940,905,1025,987,85,82,red blood cell,6970,0.9647058823529412,1.0365853658536586
20752,/images/eeac81a5-9202-4965-b7de-35b12910cdf6.png,589,26,699,119,110,93,red blood cell,10230,0.8454545454545455,1.1827956989247312
26368,/images/ef1419e0-3a3a-458a-b3b2-7efddac50404.png,515,241,630,353,115,112,red blood cell,12880,0.9739130434782609,1.0267857142857142
4827,/images/c6ab535c-30e5-4b6b-8273-1ec8d78cdd13.png,999,529,1102,653,103,124,red blood cell,12772,1.203883495145631,0.8306451612903226
67254,/images/5f491efd-a21c-4a80-aaba-70b8876238ac.png,912,1342,1011,1448,99,106,red blood cell,10494,1.0707070707070707,0.9339622641509434
49444,/images/f2574be3-81c6-4fc3-8a40-0230d1264f52.png,992,75,1082,182,90,107,red blood cell,9630,1.1888888888888889,0.8411214953271028
29468,/images/8cc6fe77-5f2f-4670-b4ac-1b49550241a8.png,395,1448,498,1554,103,106,red blood cell,10918,1.029126213592233,0.9716981132075472
26231,/images/7ba9db7e-9d3f-413c-b672-2bba5fb5b415.png,661,515,772,624,111,109,red blood cell,12099,0.9819819819819819,1.018348623853211
34752,/images/6294153c-6db3-4f2b-a8ff-9c087225e737.png,340,1034,449,1154,109,120,red blood cell,13080,1.1009174311926606,0.9083333333333333
78277,/images/adff6e1d-ba9d-4c7b-a8fe-1ec458eaeeb8.png,796,1425,890,1542,94,117,red blood cell,10998,1.2446808510638299,0.8034188034188035
21011,/images/666601e7-608d-4d19-999f-8fc6ab373a55.png,1067,1260,1180,1376,113,116,red blood cell,13108,1.0265486725663717,0.9741379310344828
13410,/images/a7f1bbb1-6058-4642-bd66-cfb90dce762e.png,682,616,774,723,92,107,red blood cell,9844,1.1630434782608696,0.8598130841121495
5606,/images/75c243e2-610d-4d5a-bc5a-4c53d99d9ae9.png,551,1392,673,1519,122,127,red blood cell,15494,1.040983606557377,0.9606299212598425
13321,/images/030f3421-ed3f-4bf1-8f27-4d02590bffbc.png,530,2,619,79,89,77,red blood cell,6853,0.8651685393258427,1.155844155844156
51533,/images/6afb3717-f197-4668-929a-4fab389ae6e8.png,971,657,1083,775,112,118,red blood cell,13216,1.0535714285714286,0.9491525423728814
37861,/images/56a57a8d-c9b9-432a-a3b0-32a09355806c.png,1066,832,1181,936,115,104,red blood cell,11960,0.9043478260869565,1.1057692307692308
52250,/images/4903d9c7-de88-426a-b42d-a7e797e5ebcd.png,392,1277,491,1375,99,98,red blood cell,9702,0.98989898989899,1.010204081632653
34180,/images/f1cda808-69a9-4d10-ba0a-6607c98e362d.png,878,506,991,623,113,117,red blood cell,13221,1.0353982300884956,0.9658119658119658
48450,/images/e13f2327-fbf4-4d84-a8c1-09cb1e449c8c.png,691,627,815,744,124,117,red blood cell,14508,0.9435483870967742,1.0598290598290598
6738,/images/672e4ecf-a56b-462e-b83b-76f4efaa6634.png,823,1220,946,1337,123,117,red blood cell,14391,0.9512195121951219,1.0512820512820513
10019,/images/b9ccf7ca-953f-4832-9575-5e70b2a8c224.png,676,603,766,708,90,105,red blood cell,9450,1.1666666666666667,0.8571428571428571
20816,/images/c2ec116f-f091-422c-926c-70b548a8f6ef.png,401,277,508,382,107,105,red blood cell,11235,0.9813084112149533,1.019047619047619
16556,/images/69565501-6e77-4f40-bd80-caa3dda34d8b.png,458,224,560,341,102,117,red blood cell,11934,1.1470588235294117,0.8717948717948718
29455,/images/8cc6fe77-5f2f-4670-b4ac-1b49550241a8.png,119,1417,235,1541,116,124,red blood cell,14384,1.0689655172413792,0.9354838709677419
48824,/images/fed6ba05-36a5-45dc-a4e1-9baa7de2c622.png,1,573,103,679,102,106,red blood cell,10812,1.0392156862745099,0.9622641509433962
39173,/images/2aeb7b85-7df9-4a63-8d37-2eecaaa190e7.png,41,385,148,483,107,98,red blood cell,10486,0.9158878504672897,1.0918367346938775
48233,/images/71204a6d-814e-44b6-9cee-7b979f478021.png,573,1016,687,1117,114,101,red blood cell,11514,0.8859649122807017,1.1287128712871286
79215,/images/eb0173a3-7e5e-4f53-8124-03d9d6317844.png,175,586,287,712,112,126,red blood cell,14112,1.125,0.8888888888888888
57314,/images/aaade430-4c49-4038-97b7-f8cdd937db57.png,472,709,567,804,95,95,red blood cell,9025,1.0,1.0
1168,/images/4411fea2-d785-4eeb-80c6-c739ab6114c4.png,1083,684,1189,778,106,94,red blood cell,9964,0.8867924528301887,1.127659574468085
28521,/images/dbdfad64-110c-421f-a1c7-f68fd9e82d67.png,1002,57,1118,158,116,101,red blood cell,11716,0.8706896551724138,1.1485148514851484
518,/images/67acd5bc-4658-4c6e-a9b9-cd8ea3a03418.png,574,1246,701,1374,127,128,red blood cell,16256,1.0078740157480315,0.9921875
44967,/images/83ec8923-6232-40d7-ba1f-a1b8bf7cb66c.png,265,1239,368,1328,103,89,red blood cell,9167,0.8640776699029126,1.1573033707865168
78794,/images/9174f910-3859-4839-8e30-2c3b25269322.png,86,774,202,875,116,101,red blood cell,11716,0.8706896551724138,1.1485148514851484
19372,/images/a302a6fa-f635-4ade-b72b-b6f3c2a34ec9.png,371,906,474,1017,103,111,red blood cell,11433,1.0776699029126213,0.9279279279279279
20189,/images/bb337c84-f727-42a5-9c3d-934323a16c6a.png,312,789,423,906,111,117,red blood cell,12987,1.054054054054054,0.9487179487179487
65119,/images/5e042380-6ef2-496f-8231-0ca550fbfa71.png,292,915,391,1005,99,90,red blood cell,8910,0.9090909090909091,1.1
49784,/images/5e17f8e6-fd8d-426c-b444-1515d14f04b7.png,389,1415,485,1524,96,109,red blood cell,10464,1.1354166666666667,0.8807339449541285
21065,/images/c680004e-6ee2-43d7-877c-edc9b5ebeecc.png,696,631,816,760,120,129,red blood cell,15480,1.075,0.9302325581395349
58886,/images/8a7deb24-d2b4-4acf-86c4-3aadd39157fa.png,867,1058,986,1173,119,115,red blood cell,13685,0.9663865546218487,1.0347826086956522
41157,/images/2240b991-48f6-4c59-9b62-5a8b5e541fae.png,366,487,467,593,101,106,red blood cell,10706,1.0495049504950495,0.9528301886792453
18995,/images/e9e78ff8-831b-46e9-9785-3eee9acbfcd8.png,0,1056,87,1147,87,91,red blood cell,7917,1.0459770114942528,0.9560439560439561
26484,/images/cdb086a8-2bf8-4436-b1ef-96cdd801f247.png,1029,85,1125,181,96,96,red blood cell,9216,1.0,1.0
7669,/images/9f959520-e15e-45c2-bc29-ef3c19154d1c.png,39,796,128,898,89,102,red blood cell,9078,1.146067415730337,0.8725490196078431
9308,/images/261562a8-ffd8-4e0e-919b-22e267000b74.png,471,527,577,646,106,119,red blood cell,12614,1.1226415094339623,0.8907563025210085
61387,/images/e16c0dab-780d-4035-872e-1bb91e49f9d2.png,4,752,109,866,105,114,red blood cell,11970,1.0857142857142856,0.9210526315789473
49419,/images/f2574be3-81c6-4fc3-8a40-0230d1264f52.png,335,1442,459,1556,124,114,red blood cell,14136,0.9193548387096774,1.087719298245614
13432,/images/370277f8-436b-4103-8210-b4feb5ab95ea.png,578,1151,667,1250,89,99,red blood cell,8811,1.1123595505617978,0.898989898989899
51720,/images/592c941a-aa54-4971-b499-dc47356f80a3.png,83,737,170,830,87,93,red blood cell,8091,1.0689655172413792,0.9354838709677419
4080,/images/e02edd82-c424-4dee-98a7-575640655d9b.png,569,1226,706,1337,137,111,red blood cell,15207,0.8102189781021898,1.2342342342342343
19564,/images/883d9731-a04d-4f84-83c9-d3bef954759d.png,812,442,935,562,123,120,red blood cell,14760,0.975609756097561,1.025
50556,/images/e98ea067-82b5-4a0d-87bf-b4bbdc10ddab.png,568,1369,679,1492,111,123,red blood cell,13653,1.1081081081081081,0.9024390243902439
72106,/images/64b0e49a-0e48-447d-8872-c1dd255e7a21.png,531,1011,632,1112,101,101,red blood cell,10201,1.0,1.0
67530,/images/45902b63-be9a-49ae-9ede-3a8015671bc4.png,376,356,479,456,103,100,red blood cell,10300,0.970873786407767,1.03
45766,/images/584d62ed-4329-45dd-94ce-e929d8b2bb74.png,281,1301,368,1397,87,96,red blood cell,8352,1.103448275862069,0.90625
67815,/images/04de3a31-fc09-40be-9c2c-9830c57f809d.png,1050,1174,1152,1271,102,97,red blood cell,9894,0.9509803921568627,1.0515463917525774
70333,/images/90246988-0d6d-4bf8-8a76-94107de4121e.png,864,1475,985,1599,121,124,red blood cell,15004,1.024793388429752,0.9758064516129032
63661,/images/d9c9479e-f1ea-4d6e-861f-843ff9a90d19.png,614,229,735,340,121,111,red blood cell,13431,0.9173553719008265,1.09009009009009
2150,/images/e94a811d-3145-4313-ba42-2d5ed283179f.png,594,760,689,855,95,95,red blood cell,9025,1.0,1.0
16893,/images/4823c1fe-a7f9-4b92-959f-0d9be09cd14b.png,907,709,997,805,90,96,red blood cell,8640,1.0666666666666667,0.9375
15541,/images/169d541c-daed-468e-8b41-0f1abccdf319.png,299,1296,434,1414,135,118,red blood cell,15930,0.8740740740740741,1.1440677966101696
36501,/images/bd856928-96ee-4fc4-a377-f2fc4e84448b.png,743,1088,862,1208,119,120,red blood cell,14280,1.0084033613445378,0.9916666666666667
19265,/images/b4d22412-a495-43a9-bec0-73a2322f8dad.png,988,1442,1089,1543,101,101,red blood cell,10201,1.0,1.0
38762,/images/b426ef1d-4a59-4f90-b593-50226af60a60.png,563,570,662,674,99,104,red blood cell,10296,1.0505050505050506,0.9519230769230769
69397,/images/fde0fd54-49cc-42e1-90c6-6b612cd062d8.png,518,70,618,183,100,113,red blood cell,11300,1.13,0.8849557522123894
61648,/images/a3c0a876-be12-4ede-8aed-18b32a64401b.png,56,90,159,190,103,100,red blood cell,10300,0.970873786407767,1.03
31110,/images/9c48fdf4-621d-4f40-bcd7-6a28cd530de7.png,128,854,242,978,114,124,red blood cell,14136,1.087719298245614,0.9193548387096774
3090,/images/14efbfc8-39f6-4599-9994-a8cc95605b9c.png,349,918,466,1034,117,116,red blood cell,13572,0.9914529914529915,1.0086206896551724
34090,/images/de5d19b7-e670-4ac7-843b-7ce7bcebdf45.png,41,1384,165,1491,124,107,red blood cell,13268,0.8629032258064516,1.158878504672897
5391,/images/716273ea-19c4-49af-8604-df587b295eca.png,328,598,454,699,126,101,red blood cell,12726,0.8015873015873016,1.2475247524752475
68100,/images/29d40b60-cde1-45b5-b403-692437a77ac1.png,9,887,112,981,103,94,red blood cell,9682,0.912621359223301,1.0957446808510638
30678,/images/f939782b-f5a2-40a3-9c22-6c6d7e18edc3.png,604,22,707,133,103,111,red blood cell,11433,1.0776699029126213,0.9279279279279279
72019,/images/6ad3efc9-4392-4cee-98a5-186564a96373.png,854,445,974,566,120,121,red blood cell,14520,1.0083333333333333,0.9917355371900827
53785,/images/76b24246-8571-4e7b-8815-b185414a2c51.png,225,1182,330,1296,105,114,red blood cell,11970,1.0857142857142856,0.9210526315789473
71819,/images/093a831a-bf71-4333-bc06-942ae70cb164.png,566,672,662,777,96,105,red blood cell,10080,1.09375,0.9142857142857143
11634,/images/37e072a6-000d-4773-8d9f-d66b60ace668.png,569,288,700,407,131,119,red blood cell,15589,0.9083969465648855,1.1008403361344539
44011,/images/de81bf7a-7a56-437f-a068-4d9c3e01134c.png,931,207,1063,331,132,124,red blood cell,16368,0.9393939393939394,1.064516129032258
5509,/images/eb6e8684-b84e-483d-b835-f59286d2516b.png,793,997,897,1122,104,125,red blood cell,13000,1.2019230769230769,0.832
19804,/images/d67fb447-4dd7-4a82-a305-2b70927b69bb.png,661,1459,765,1556,104,97,red blood cell,10088,0.9326923076923077,1.0721649484536082
73171,/images/85546330-4efd-43e2-87aa-d53a30220bfc.png,314,1144,422,1253,108,109,red blood cell,11772,1.0092592592592593,0.9908256880733946
11975,/images/ca16a5ad-b106-4e84-8a43-178710e854ba.png,831,944,925,1035,94,91,red blood cell,8554,0.9680851063829787,1.032967032967033
7784,/images/e726dac6-f962-449c-acff-4dd56847b685.png,40,1230,146,1359,106,129,red blood cell,13674,1.2169811320754718,0.8217054263565892
14107,/images/eaf4b781-b3aa-41ce-8c5e-287979b4e15a.png,357,331,443,430,86,99,red blood cell,8514,1.1511627906976745,0.8686868686868687
21366,/images/5077f87d-a19f-494c-b911-14ccb03bd230.png,365,1047,472,1154,107,107,red blood cell,11449,1.0,1.0
4324,/images/84041bf9-dace-4066-9fe0-52170d08f826.png,193,1275,293,1378,100,103,red blood cell,10300,1.03,0.970873786407767
60400,/images/8d5d5c22-2f75-4fe1-9ea3-03a3c7b92ea9.png,842,1214,972,1339,130,125,red blood cell,16250,0.9615384615384616,1.04
72670,/images/6ab870ba-b24b-49a9-9570-8eafe63aa74e.png,735,72,827,172,92,100,red blood cell,9200,1.0869565217391304,0.92
71536,/images/191071ab-6515-428c-9f05-8e4309542b75.png,606,94,701,183,95,89,red blood cell,8455,0.9368421052631579,1.0674157303370786
58790,/images/e4827c85-311a-4df1-89c2-99dad0c3558c.png,206,990,286,1074,80,84,red blood cell,6720,1.05,0.9523809523809523
57968,/images/7942691b-6376-4c75-ae8a-ddf65454dcb2.png,939,714,1065,824,126,110,red blood cell,13860,0.873015873015873,1.1454545454545455
36917,/images/b2e34f5f-904e-4473-9dc7-c6bc1ce12640.png,156,1235,273,1346,117,111,red blood cell,12987,0.9487179487179487,1.054054054054054
7776,/images/e726dac6-f962-449c-acff-4dd56847b685.png,186,354,288,462,102,108,red blood cell,11016,1.0588235294117647,0.9444444444444444
53414,/images/766d5547-8dd2-4c8d-b78e-3007f83932e8.png,928,189,1039,306,111,117,red blood cell,12987,1.054054054054054,0.9487179487179487
21451,/images/b701b5c5-b922-4315-b12a-aac4ec65ee8b.png,45,384,142,495,97,111,red blood cell,10767,1.1443298969072164,0.8738738738738738
74967,/images/b4c52960-bbee-439e-83dc-f89ddaade71b.png,502,261,618,368,116,107,red blood cell,12412,0.9224137931034483,1.0841121495327102
62978,/images/f234a2de-f3c8-4521-a306-8cfdf52dd597.png,1034,285,1132,400,98,115,red blood cell,11270,1.1734693877551021,0.8521739130434782
52119,/images/de6d3020-9347-473b-9146-8909627790f6.png,0,34,96,128,96,94,red blood cell,9024,0.9791666666666666,1.0212765957446808
47788,/images/5a105b89-c592-4d78-b208-7db6c6572752.png,604,488,730,598,126,110,red blood cell,13860,0.873015873015873,1.1454545454545455
41131,/images/2240b991-48f6-4c59-9b62-5a8b5e541fae.png,377,282,506,404,129,122,red blood cell,15738,0.9457364341085271,1.0573770491803278
26276,/images/52767904-4cdc-4821-ba68-8cd0c28f9023.png,499,877,633,1001,134,124,red blood cell,16616,0.9253731343283582,1.0806451612903225
71162,/images/4fac16e1-8e62-499b-a66b-c4c890372914.png,948,789,1073,910,125,121,red blood cell,15125,0.968,1.0330578512396693
2008,/images/bfefa21c-11e1-4dab-ac5d-8ff6f046d65f.png,788,1183,915,1305,127,122,red blood cell,15494,0.9606299212598425,1.040983606557377
1159,/images/4411fea2-d785-4eeb-80c6-c739ab6114c4.png,1066,1300,1182,1402,116,102,red blood cell,11832,0.8793103448275862,1.1372549019607843
25503,/images/f6ab936d-924b-4038-aa47-71b07c26b4e2.png,405,121,499,202,94,81,red blood cell,7614,0.8617021276595744,1.1604938271604939
24119,/images/505355c9-23bf-4f90-8ebc-6a7ef50964d0.png,664,31,774,145,110,114,red blood cell,12540,1.0363636363636364,0.9649122807017544
79198,/images/eb0173a3-7e5e-4f53-8124-03d9d6317844.png,674,1353,785,1466,111,113,red blood cell,12543,1.018018018018018,0.9823008849557522
28341,/images/34e024a5-5698-42d4-972f-fee234b4bd64.png,584,1484,697,1599,113,115,red blood cell,12995,1.0176991150442478,0.9826086956521739
47256,/images/58ced55c-bf0d-4204-b6b2-4f8992d92779.png,684,1253,786,1364,102,111,red blood cell,11322,1.088235294117647,0.918918918918919
53941,/images/540a5fee-175b-4b92-bf62-1ea9b59c86c6.png,1016,826,1132,935,116,109,red blood cell,12644,0.9396551724137931,1.0642201834862386
33609,/images/00c8364b-8c85-4502-bcfe-64736fe76815.png,247,163,365,263,118,100,red blood cell,11800,0.847457627118644,1.18
50698,/images/6b4c79f5-b194-4586-be9f-e339c5af4188.png,469,511,586,630,117,119,red blood cell,13923,1.017094017094017,0.9831932773109243
50648,/images/c956e531-6805-4fe1-b61c-8b96a9815a77.png,215,45,310,135,95,90,red blood cell,8550,0.9473684210526315,1.0555555555555556
40151,/images/b34e65f6-c32e-42f1-a437-4a037c75a231.png,358,1239,457,1350,99,111,red blood cell,10989,1.121212121212121,0.8918918918918919
61413,/images/e16c0dab-780d-4035-872e-1bb91e49f9d2.png,8,1379,117,1476,109,97,red blood cell,10573,0.8899082568807339,1.1237113402061856
40112,/images/6fd30823-3b77-40c9-ba5d-e1eda9660674.png,840,1171,962,1288,122,117,red blood cell,14274,0.9590163934426229,1.0427350427350428
45205,/images/24879caf-a327-464c-9cd9-e0f3d9161079.png,137,1211,255,1312,118,101,red blood cell,11918,0.8559322033898306,1.1683168316831682
48253,/images/71204a6d-814e-44b6-9cee-7b979f478021.png,419,911,521,1022,102,111,red blood cell,11322,1.088235294117647,0.918918918918919
24572,/images/c03d9b87-e19b-402b-ad86-b30d6e8aeb59.png,727,671,838,776,111,105,red blood cell,11655,0.9459459459459459,1.0571428571428572
68994,/images/b5246b58-6f40-4c9e-8024-f49b0ed6bdbd.png,11,406,120,520,109,114,red blood cell,12426,1.0458715596330275,0.956140350877193
21146,/images/fb05b297-180a-4171-b633-09d5616d7534.png,104,838,220,954,116,116,red blood cell,13456,1.0,1.0
69185,/images/f274b784-b995-4a7e-a2c2-6cc31c24c4b4.png,86,892,205,1010,119,118,red blood cell,14042,0.9915966386554622,1.0084745762711864
43655,/images/a4851ed0-1499-4eae-9157-dcd34773254f.png,267,1464,363,1566,96,102,red blood cell,9792,1.0625,0.9411764705882353
13898,/images/7d65d296-0f7b-41cc-9073-a547e24326c8.png,830,974,929,1095,99,121,red blood cell,11979,1.2222222222222223,0.8181818181818182
44172,/images/8b494b40-cab5-49d3-893d-c805000fbe88.png,228,1136,315,1223,87,87,red blood cell,7569,1.0,1.0
40543,/images/e3ade58d-086c-47fa-9120-76beacb45395.png,784,1363,890,1481,106,118,red blood cell,12508,1.1132075471698113,0.8983050847457628
18621,/images/c22f7031-9cf8-48ce-b03b-1b12d0db4951.png,903,212,999,309,96,97,red blood cell,9312,1.0104166666666667,0.9896907216494846
34251,/images/259da25f-40f3-4d37-bca9-a9c807af1547.png,719,1366,841,1492,122,126,red blood cell,15372,1.0327868852459017,0.9682539682539683
31759,/images/ab59c9e4-3e50-48b9-874d-060d317410cc.png,369,1053,484,1167,115,114,red blood cell,13110,0.991304347826087,1.0087719298245614
63038,/images/6afd8203-d61a-4e9b-a4cf-dcb53a16b57c.png,358,595,464,714,106,119,red blood cell,12614,1.1226415094339623,0.8907563025210085
64586,/images/6dfafdf1-f588-4e80-8cf8-0126e1bf7af9.png,978,58,1080,175,102,117,red blood cell,11934,1.1470588235294117,0.8717948717948718
77177,/images/fe691faa-3bc7-475e-b558-aa8fe7b795bc.png,657,989,761,1100,104,111,red blood cell,11544,1.0673076923076923,0.9369369369369369
46689,/images/da111ca5-520f-4ea8-97ad-ae5fce58ee91.png,546,407,664,508,118,101,red blood cell,11918,0.8559322033898306,1.1683168316831682
39182,/images/2aeb7b85-7df9-4a63-8d37-2eecaaa190e7.png,431,729,546,847,115,118,red blood cell,13570,1.0260869565217392,0.9745762711864406
16200,/images/acdc6e12-73d9-44ba-be8c-2a56aaffef4f.png,345,333,465,460,120,127,red blood cell,15240,1.0583333333333333,0.9448818897637795
27580,/images/715761a2-745e-4743-9849-956a034ad3c4.png,667,1115,775,1217,108,102,red blood cell,11016,0.9444444444444444,1.0588235294117647
29855,/images/9cdee92c-6267-4188-a41e-125bc0abb9ae.png,131,903,240,1006,109,103,red blood cell,11227,0.944954128440367,1.058252427184466
10141,/images/09ecf7be-28e2-4531-b9e2-07e01c44097d.png,43,1463,155,1573,112,110,red blood cell,12320,0.9821428571428571,1.018181818181818
10395,/images/46a2d369-4bea-4405-ac78-91bbe130b9a7.png,381,1007,488,1105,107,98,red blood cell,10486,0.9158878504672897,1.0918367346938775
25019,/images/ed0bee2f-05e0-4392-8357-19750cec577c.png,1024,601,1120,695,96,94,red blood cell,9024,0.9791666666666666,1.0212765957446808
43370,/images/aabca37c-f9ef-4415-aab6-3246caa348e9.png,977,388,1069,494,92,106,red blood cell,9752,1.1521739130434783,0.8679245283018868
12052,/images/b234b6ea-b54d-470c-8461-ba7f4a024796.png,910,663,1023,767,113,104,red blood cell,11752,0.9203539823008849,1.0865384615384615
40475,/images/db249e5a-4142-432c-8288-bacd10d7273d.png,894,545,995,652,101,107,red blood cell,10807,1.0594059405940595,0.9439252336448598
25267,/images/587e5464-d70b-4279-8562-010279f6efbd.png,596,440,705,573,109,133,red blood cell,14497,1.2201834862385321,0.8195488721804511
54274,/images/3b5a8060-dec6-4a83-b7f2-b604e4e69dfc.png,453,245,569,343,116,98,red blood cell,11368,0.8448275862068966,1.183673469387755
24135,/images/505355c9-23bf-4f90-8ebc-6a7ef50964d0.png,454,712,562,815,108,103,red blood cell,11124,0.9537037037037037,1.0485436893203883
68406,/images/040112be-3c8d-49aa-93f1-522f94a592ff.png,1101,1145,1188,1252,87,107,red blood cell,9309,1.2298850574712643,0.8130841121495327
36428,/images/cfe6086f-eb0b-4cb0-a430-8cd7de6556e2.png,274,1100,371,1211,97,111,red blood cell,10767,1.1443298969072164,0.8738738738738738
3364,/images/b1100ae1-0ac8-4fc2-b0ff-8819f7fbe724.png,845,165,957,265,112,100,red blood cell,11200,0.8928571428571429,1.12
11280,/images/6303f964-98ef-47c6-bb2d-283aa393f918.png,73,1353,176,1449,103,96,red blood cell,9888,0.9320388349514563,1.0729166666666667
500,/images/67acd5bc-4658-4c6e-a9b9-cd8ea3a03418.png,1018,971,1137,1080,119,109,red blood cell,12971,0.9159663865546218,1.091743119266055
64133,/images/0d3c2521-da55-4df5-bf06-56b3bd4fb2fc.png,994,87,1090,191,96,104,red blood cell,9984,1.0833333333333333,0.9230769230769231
14083,/images/eaf4b781-b3aa-41ce-8c5e-287979b4e15a.png,979,727,1076,835,97,108,red blood cell,10476,1.1134020618556701,0.8981481481481481
56665,/images/4adcaa26-aa1f-47b5-bdf0-18c9f814f576.png,776,170,888,286,112,116,red blood cell,12992,1.0357142857142858,0.9655172413793104
27360,/images/9f38055f-4fe6-47fd-a6dd-c0743db4eccf.png,98,1426,213,1527,115,101,red blood cell,11615,0.8782608695652174,1.1386138613861385
21558,/images/49efc89d-9cba-44f7-8257-7f911b73f68a.png,1046,836,1143,931,97,95,red blood cell,9215,0.979381443298969,1.0210526315789474
15997,/images/c7c1b873-0548-4a73-9618-f60912e164df.png,990,987,1095,1111,105,124,red blood cell,13020,1.180952380952381,0.8467741935483871
65975,/images/25c6cfb1-01d0-4864-87f9-02b7593683c7.png,794,655,889,759,95,104,red blood cell,9880,1.0947368421052632,0.9134615384615384
40118,/images/b34e65f6-c32e-42f1-a437-4a037c75a231.png,301,501,398,593,97,92,red blood cell,8924,0.9484536082474226,1.0543478260869565
3603,/images/8bd71314-e38a-4670-bb25-5cd6c9acb595.png,925,300,1041,418,116,118,red blood cell,13688,1.0172413793103448,0.9830508474576272
41397,/images/65e8b0cd-05d1-4c8d-8efd-24bf71df3167.png,784,409,917,542,133,133,red blood cell,17689,1.0,1.0
11568,/images/b4dc3088-3fe2-4688-be24-70664a64e022.png,140,1448,271,1568,131,120,red blood cell,15720,0.916030534351145,1.0916666666666666
33975,/images/701206c5-aaac-4b99-9cc0-4a6854359457.png,1010,715,1129,823,119,108,red blood cell,12852,0.907563025210084,1.1018518518518519
8382,/images/9a1cd456-310c-47b6-a1f8-0fbd8e33d1fd.png,388,594,490,717,102,123,red blood cell,12546,1.2058823529411764,0.8292682926829268
6030,/images/72732579-a812-4496-b2dd-ea1556924337.png,14,188,104,299,90,111,red blood cell,9990,1.2333333333333334,0.8108108108108109
50163,/images/4cccfcf0-cac9-46f0-870c-0eabfdc781ba.png,837,1289,939,1380,102,91,red blood cell,9282,0.8921568627450981,1.120879120879121
76127,/images/16244280-6c74-47d3-b544-9fd6831a6bf9.png,103,555,199,666,96,111,red blood cell,10656,1.15625,0.8648648648648649
24516,/images/109fbb82-bc3c-41ac-984d-e2da86202873.png,0,324,102,432,102,108,red blood cell,11016,1.0588235294117647,0.9444444444444444
54041,/images/d9345456-b76d-46cc-b81e-46d4a0a7b652.png,577,480,681,583,104,103,red blood cell,10712,0.9903846153846154,1.0097087378640777
10587,/images/20d4f65e-6c63-433a-935c-d568d577967b.png,791,779,889,871,98,92,red blood cell,9016,0.9387755102040817,1.065217391304348
36089,/images/cb2fac19-90b0-48b4-bdc5-7dbbd58756d1.png,196,323,312,450,116,127,red blood cell,14732,1.0948275862068966,0.9133858267716536
44294,/images/4257342d-6d77-4671-a84b-1f0c36ccb367.png,442,428,564,566,122,138,red blood cell,16836,1.1311475409836065,0.8840579710144928
14251,/images/6382976c-ee87-4916-b798-4ef1373b2df0.png,440,107,540,200,100,93,red blood cell,9300,0.93,1.075268817204301
3218,/images/96596a68-8c95-43f3-b74e-e9506c235144.png,328,704,430,801,102,97,red blood cell,9894,0.9509803921568627,1.0515463917525774
43933,/images/d7c7eb2c-2acd-4f86-8a5a-09ab3dd02d16.png,1019,759,1108,853,89,94,red blood cell,8366,1.0561797752808988,0.9468085106382979
64078,/images/0d3c2521-da55-4df5-bf06-56b3bd4fb2fc.png,275,1011,377,1106,102,95,red blood cell,9690,0.9313725490196079,1.0736842105263158
66641,/images/b88fe674-fb9a-41d4-b100-cb1c86440d44.png,10,1398,108,1489,98,91,red blood cell,8918,0.9285714285714286,1.0769230769230769
21481,/images/7625dfc4-858a-4c8e-907c-8943d665e9a7.png,723,370,817,458,94,88,red blood cell,8272,0.9361702127659575,1.0681818181818181
15032,/images/3003252a-2d2e-4687-ad30-9c38d68f1394.png,782,375,911,493,129,118,red blood cell,15222,0.9147286821705426,1.0932203389830508
62910,/images/4b346035-b8c0-46ca-8fdb-a01b1421ee4a.png,1037,123,1143,253,106,130,red blood cell,13780,1.2264150943396226,0.8153846153846154
51545,/images/6afb3717-f197-4668-929a-4fab389ae6e8.png,743,1255,835,1368,92,113,red blood cell,10396,1.2282608695652173,0.8141592920353983
23731,/images/79d7a014-21ff-40f1-9ac4-a69839390654.png,1108,1506,1196,1595,88,89,red blood cell,7832,1.0113636363636365,0.9887640449438202
29748,/images/7ef90770-6aeb-45eb-9744-49c5247dde30.png,54,1180,179,1307,125,127,red blood cell,15875,1.016,0.984251968503937
59120,/images/4736f545-1f1f-4d77-9241-d69cbf4dae35.png,112,527,221,654,109,127,red blood cell,13843,1.165137614678899,0.8582677165354331
12211,/images/313ed8d9-3c00-4415-9de0-0eda07c60ad9.png,882,537,999,659,117,122,red blood cell,14274,1.0427350427350428,0.9590163934426229
29077,/images/4c13e22e-dfd1-4fa1-b373-be9d0c272c0f.png,615,373,719,473,104,100,red blood cell,10400,0.9615384615384616,1.04
40487,/images/e3ade58d-086c-47fa-9120-76beacb45395.png,699,885,821,1004,122,119,red blood cell,14518,0.9754098360655737,1.0252100840336134
6209,/images/effd6334-516f-4d48-9f3c-5272a99780fb.png,127,244,257,360,130,116,red blood cell,15080,0.8923076923076924,1.1206896551724137
80099,/images/99e979d4-ee97-4d7f-9da6-00bead40db4d.png,944,763,1039,881,95,118,red blood cell,11210,1.2421052631578948,0.8050847457627118
27686,/images/18dbe7c4-89d2-42a6-a969-1e951ab313b1.png,1,216,113,328,112,112,red blood cell,12544,1.0,1.0
47621,/images/78ac1e98-7062-4e27-8d58-25c392cae889.png,1010,127,1118,247,108,120,red blood cell,12960,1.1111111111111112,0.9
68750,/images/eb5f4f2f-2275-4a80-84a5-78a1eaf4ce4d.png,646,982,769,1097,123,115,red blood cell,14145,0.9349593495934959,1.0695652173913044
49886,/images/5e17f8e6-fd8d-426c-b444-1515d14f04b7.png,96,1244,199,1358,103,114,red blood cell,11742,1.1067961165048543,0.9035087719298246
26053,/images/71925778-a26e-483e-a07c-f3aaf740122a.png,657,658,768,772,111,114,red blood cell,12654,1.027027027027027,0.9736842105263158
79004,/images/6144887d-a1c1-46db-91a1-f7ff5bf8c8a5.png,312,56,401,151,89,95,red blood cell,8455,1.0674157303370786,0.9368421052631579
35423,/images/002f20ad-2ace-499c-9335-c9080bc3e6b5.png,486,361,611,487,125,126,red blood cell,15750,1.008,0.9920634920634921
35333,/images/452482bc-24a3-413e-ba03-fad4c9d61f3c.png,401,1217,497,1317,96,100,red blood cell,9600,1.0416666666666667,0.96
68856,/images/aa3ad405-828e-4986-8251-20fd981f34d3.png,300,1410,390,1487,90,77,red blood cell,6930,0.8555555555555555,1.1688311688311688
34138,/images/de5d19b7-e670-4ac7-843b-7ce7bcebdf45.png,372,1467,468,1566,96,99,red blood cell,9504,1.03125,0.9696969696969697
17586,/images/e80bad38-66d0-473e-85dd-92142dba37e6.png,2,848,98,956,96,108,red blood cell,10368,1.125,0.8888888888888888
4703,/images/b91b1641-ee06-44d8-94cc-24cdb583cc37.png,392,890,507,1012,115,122,red blood cell,14030,1.0608695652173914,0.9426229508196722
20556,/images/cbde7f7e-2458-4dda-9db2-3d5ccf950ced.png,412,825,510,928,98,103,red blood cell,10094,1.0510204081632653,0.9514563106796117
19011,/images/e9e78ff8-831b-46e9-9785-3eee9acbfcd8.png,1083,357,1172,448,89,91,red blood cell,8099,1.0224719101123596,0.978021978021978
70131,/images/c742ee2c-6814-46cd-af56-ae87bb9972f4.png,887,730,992,839,105,109,red blood cell,11445,1.0380952380952382,0.963302752293578
59468,/images/a7c3c52f-3b40-4c92-a212-df9462cf25d8.png,91,612,208,717,117,105,red blood cell,12285,0.8974358974358975,1.1142857142857143
19146,/images/bb795ddf-ce72-42d5-9006-124db4d5cf1c.png,191,10,303,119,112,109,red blood cell,12208,0.9732142857142857,1.0275229357798166
10371,/images/46a2d369-4bea-4405-ac78-91bbe130b9a7.png,967,1060,1063,1163,96,103,red blood cell,9888,1.0729166666666667,0.9320388349514563
18557,/images/c22f7031-9cf8-48ce-b03b-1b12d0db4951.png,30,498,147,606,117,108,red blood cell,12636,0.9230769230769231,1.0833333333333333
54528,/images/db871d17-28fd-4ceb-b421-e4e4afa0a7a0.png,297,521,392,620,95,99,red blood cell,9405,1.0421052631578946,0.9595959595959596
40830,/images/bf20d04d-ff8a-4910-91d7-94054c267d1b.png,683,497,804,624,121,127,red blood cell,15367,1.0495867768595042,0.952755905511811
24288,/images/4d8a4ce8-0f9c-4f21-8844-4cf0e5514bbf.png,954,843,1060,958,106,115,red blood cell,12190,1.0849056603773586,0.9217391304347826
56762,/images/0dcbf2c9-f959-4703-a72b-f6a81e66c2ea.png,874,479,965,572,91,93,red blood cell,8463,1.021978021978022,0.978494623655914
29359,/images/3850f2a5-ab62-49d3-8135-68d60baa676b.png,446,298,560,417,114,119,red blood cell,13566,1.043859649122807,0.957983193277311
32784,/images/eef2ac0b-42de-4bc3-a3c3-d5fcd597fbe4.png,1099,1183,1197,1303,98,120,red blood cell,11760,1.2244897959183674,0.8166666666666667
14580,/images/b8410821-a42b-47d0-8bcf-c2fc82e4e2d5.png,438,564,559,683,121,119,red blood cell,14399,0.9834710743801653,1.0168067226890756
44087,/images/8b494b40-cab5-49d3-893d-c805000fbe88.png,949,846,1076,953,127,107,red blood cell,13589,0.84251968503937,1.1869158878504673
22023,/images/c5acd0ad-b0f2-478d-b0ad-5aa733aa7b32.png,54,1425,188,1543,134,118,red blood cell,15812,0.8805970149253731,1.1355932203389831
63804,/images/6013bff0-dc4b-4bde-9409-0f6139c3495c.png,60,1355,163,1465,103,110,red blood cell,11330,1.0679611650485437,0.9363636363636364
51866,/images/d67398c5-8b0e-463f-a04e-8583c820786c.png,558,626,674,728,116,102,red blood cell,11832,0.8793103448275862,1.1372549019607843
37931,/images/56a57a8d-c9b9-432a-a3b0-32a09355806c.png,0,612,120,720,120,108,red blood cell,12960,0.9,1.1111111111111112
15248,/images/dd7142e4-2d86-4170-a41f-e825743e8907.png,675,709,793,842,118,133,red blood cell,15694,1.1271186440677967,0.8872180451127819
76277,/images/1574565f-f45b-4160-947e-25ce1a81aaca.png,810,57,914,151,104,94,red blood cell,9776,0.9038461538461539,1.1063829787234043
20604,/images/0f2a6cda-afec-437b-8803-8d3176b072c1.png,168,1181,283,1297,115,116,red blood cell,13340,1.008695652173913,0.9913793103448276
3904,/images/65e865f3-acfb-4d01-a75f-ff5a535ffa6a.png,951,978,1056,1106,105,128,red blood cell,13440,1.2190476190476192,0.8203125
57723,/images/5c037ffc-f515-48b3-b231-c110fbd2b8ca.png,687,1332,803,1455,116,123,red blood cell,14268,1.0603448275862069,0.943089430894309
61630,/images/a3c0a876-be12-4ede-8aed-18b32a64401b.png,1062,987,1159,1084,97,97,red blood cell,9409,1.0,1.0
29972,/images/deeaa5b3-3895-4aec-a2ce-ed6404862cdf.png,359,985,472,1122,113,137,red blood cell,15481,1.2123893805309736,0.8248175182481752
76009,/images/4c7d2382-a962-4237-a053-955eea3decd8.png,953,262,1058,375,105,113,red blood cell,11865,1.0761904761904761,0.9292035398230089
17649,/images/70a95e58-ba60-4c1f-adcd-49c198dc2ba0.png,171,30,277,118,106,88,red blood cell,9328,0.8301886792452831,1.2045454545454546
11441,/images/dca685a8-a609-45d8-93d7-da1e4165b9bd.png,886,1040,997,1176,111,136,red blood cell,15096,1.2252252252252251,0.8161764705882353
55962,/images/afd39466-aafa-4d81-9520-483727418723.png,487,868,589,963,102,95,red blood cell,9690,0.9313725490196079,1.0736842105263158
25731,/images/1f8edb2a-40bc-4beb-aa6b-884d2473df0f.png,194,933,319,1060,125,127,red blood cell,15875,1.016,0.984251968503937
33551,/images/255d5f0c-87fc-4337-bb51-07c440df4f1b.png,329,105,447,224,118,119,red blood cell,14042,1.0084745762711864,0.9915966386554622
18042,/images/0f0c949e-018a-4f3f-ab02-3704f49c7754.png,248,577,361,673,113,96,red blood cell,10848,0.8495575221238938,1.1770833333333333
576,/images/065af549-320a-4862-b92a-8ef750d7b5fb.png,90,192,216,299,126,107,red blood cell,13482,0.8492063492063492,1.1775700934579438
75767,/images/f48bf825-13c4-42fc-8dd8-10cc4ae6b202.png,818,602,933,710,115,108,red blood cell,12420,0.9391304347826087,1.0648148148148149
64405,/images/0a7bfa8a-ee52-4f7a-b9c5-2919ecfa93ef.png,679,591,774,686,95,95,red blood cell,9025,1.0,1.0
36608,/images/21f001d6-f568-4ea4-82da-fab54c77c419.png,55,1125,164,1220,109,95,red blood cell,10355,0.8715596330275229,1.1473684210526316
9025,/images/ef815e3a-02a6-4cf8-9262-45bc74c50b00.png,17,1324,133,1443,116,119,red blood cell,13804,1.0258620689655173,0.9747899159663865
13257,/images/711f6b3f-cd63-46d1-834a-bc8e9aa9b43e.png,807,670,891,770,84,100,red blood cell,8400,1.1904761904761905,0.84
19367,/images/a302a6fa-f635-4ade-b72b-b6f3c2a34ec9.png,569,1468,657,1575,88,107,red blood cell,9416,1.2159090909090908,0.822429906542056
71628,/images/390ad256-e1ed-476a-9f14-2dc34e0da632.png,232,1389,341,1514,109,125,red blood cell,13625,1.146788990825688,0.872
22937,/images/ecd68ba2-48af-4866-826a-7cd1c147c055.png,775,855,883,981,108,126,red blood cell,13608,1.1666666666666667,0.8571428571428571
57115,/images/7d041c38-11f2-4186-8a24-29d7d0f5c3cf.png,190,584,298,689,108,105,red blood cell,11340,0.9722222222222222,1.0285714285714285
61088,/images/6e86206f-dafe-4c28-bacc-7b83b2d40f0c.png,558,939,649,1035,91,96,red blood cell,8736,1.054945054945055,0.9479166666666666
11410,/images/b5513d5b-46fc-4f44-a616-791087fbd608.png,477,402,599,526,122,124,red blood cell,15128,1.0163934426229508,0.9838709677419355
43433,/images/367663b2-5d09-4020-ab0a-c2200e7a1c8c.png,585,243,684,329,99,86,red blood cell,8514,0.8686868686868687,1.1511627906976745
58957,/images/a0eeeb10-d0cb-48d9-8c22-2c3a3c908d00.png,391,883,518,1014,127,131,red blood cell,16637,1.031496062992126,0.9694656488549618
45468,/images/e4eea7ea-8989-46a9-9c98-25a178146b28.png,528,644,622,743,94,99,red blood cell,9306,1.053191489361702,0.9494949494949495
71392,/images/bcb447c9-5d37-414f-a513-d7076b04a532.png,28,389,134,506,106,117,red blood cell,12402,1.1037735849056605,0.905982905982906
24002,/images/3d8fb5bf-3315-48fb-8ab1-802eafd550bc.png,898,642,1010,759,112,117,red blood cell,13104,1.0446428571428572,0.9572649572649573
78701,/images/76a8a5f5-1328-4539-a131-baf877f40cf3.png,12,195,150,318,138,123,red blood cell,16974,0.8913043478260869,1.1219512195121952
52800,/images/0a747cb3-c720-4572-a661-ab5670a5c42e.png,856,1057,983,1168,127,111,red blood cell,14097,0.8740157480314961,1.1441441441441442
14261,/images/6382976c-ee87-4916-b798-4ef1373b2df0.png,514,1102,633,1219,119,117,red blood cell,13923,0.9831932773109243,1.017094017094017
45896,/images/939ad732-d7c5-4339-b087-4335b49d6a3c.png,515,636,642,753,127,117,red blood cell,14859,0.9212598425196851,1.0854700854700854
51346,/images/b4f3b2a4-f4b9-48de-ac5d-0e681b77be27.png,1068,231,1172,327,104,96,red blood cell,9984,0.9230769230769231,1.0833333333333333
16696,/images/d6352a03-ef81-421d-915e-226499555d20.png,297,1357,425,1477,128,120,red blood cell,15360,0.9375,1.0666666666666667
44404,/images/edd3862f-04e1-49cf-97dd-ca566d17e71a.png,531,719,649,834,118,115,red blood cell,13570,0.9745762711864406,1.0260869565217392
56876,/images/a588091c-5e4c-4e61-914d-e96f3ee3e505.png,487,1233,597,1346,110,113,red blood cell,12430,1.0272727272727273,0.9734513274336283
34469,/images/b4bde4e8-f48b-4ae2-be01-86d8c91d0af9.png,816,745,925,863,109,118,red blood cell,12862,1.0825688073394495,0.923728813559322
54093,/images/d9345456-b76d-46cc-b81e-46d4a0a7b652.png,819,190,900,290,81,100,red blood cell,8100,1.2345679012345678,0.81
62036,/images/bdb5d571-27bc-4a42-ae45-aa5a9af40a81.png,686,1124,794,1224,108,100,red blood cell,10800,0.9259259259259259,1.08
7600,/images/21cc498b-8cb2-42ed-8f80-bfa27b86ef11.png,302,1326,421,1444,119,118,red blood cell,14042,0.9915966386554622,1.0084745762711864
44030,/images/de81bf7a-7a56-437f-a068-4d9c3e01134c.png,852,782,965,891,113,109,red blood cell,12317,0.9646017699115044,1.036697247706422
12245,/images/3b55c42f-ad59-422f-ba99-4f4f4ca9cb2e.png,172,458,282,567,110,109,red blood cell,11990,0.990909090909091,1.0091743119266054
7531,/images/071901eb-4c3f-404b-a747-3d0b9d0a5158.png,319,242,417,355,98,113,red blood cell,11074,1.153061224489796,0.8672566371681416
5669,/images/d3dcdf92-9328-4796-adf4-918646877ba1.png,366,171,505,297,139,126,red blood cell,17514,0.9064748201438849,1.1031746031746033
29684,/images/b85fc640-de49-4f7e-afc0-978ff020f2e2.png,166,102,284,247,118,145,red blood cell,17110,1.228813559322034,0.8137931034482758
77682,/images/07d15855-eb9b-46a9-b894-7cfe4d097826.png,1065,77,1158,160,93,83,red blood cell,7719,0.8924731182795699,1.1204819277108433
45053,/images/13bab3c3-3f79-44d9-a287-0ae6d71eff31.png,861,1052,968,1167,107,115,red blood cell,12305,1.074766355140187,0.9304347826086956
76421,/images/34df8890-272d-423a-ae78-ff8d068d3306.png,385,855,485,944,100,89,red blood cell,8900,0.89,1.1235955056179776
19144,/images/bb795ddf-ce72-42d5-9006-124db4d5cf1c.png,844,1238,958,1335,114,97,red blood cell,11058,0.8508771929824561,1.175257731958763
46666,/images/da111ca5-520f-4ea8-97ad-ae5fce58ee91.png,20,236,128,340,108,104,red blood cell,11232,0.9629629629629629,1.0384615384615385
47897,/images/ab27173b-6e30-4957-bd68-29194328fd39.png,248,162,352,269,104,107,red blood cell,11128,1.0288461538461537,0.9719626168224299
19874,/images/b318889c-3c60-477c-b8f6-d18cb01a59df.png,630,979,741,1079,111,100,red blood cell,11100,0.9009009009009009,1.11
74077,/images/fe436c09-b680-4f4c-8faf-aa10a55a335b.png,800,138,886,222,86,84,red blood cell,7224,0.9767441860465116,1.0238095238095237
43923,/images/d7c7eb2c-2acd-4f86-8a5a-09ab3dd02d16.png,1056,1481,1175,1599,119,118,red blood cell,14042,0.9915966386554622,1.0084745762711864
75175,/images/7fdc8be8-7579-4a5c-b369-8a07ee0a8b7d.png,303,756,383,846,80,90,red blood cell,7200,1.125,0.8888888888888888
41699,/images/67abb826-9b70-4459-8764-da76ecf35bfe.png,375,1290,502,1425,127,135,red blood cell,17145,1.062992125984252,0.9407407407407408
17773,/images/1863da5f-c595-4541-a8f4-21fe78678168.png,194,678,285,771,91,93,red blood cell,8463,1.021978021978022,0.978494623655914
35893,/images/33068c1a-48f7-470b-8e49-e2f0888042e9.png,865,947,974,1075,109,128,red blood cell,13952,1.1743119266055047,0.8515625
21565,/images/49efc89d-9cba-44f7-8257-7f911b73f68a.png,1088,503,1184,600,96,97,red blood cell,9312,1.0104166666666667,0.9896907216494846
69599,/images/4a49841f-216c-4815-8140-b8762c4f6603.png,326,1203,427,1304,101,101,red blood cell,10201,1.0,1.0
18878,/images/d1b48634-9ad5-46e8-b816-42d1d97c93cd.png,280,342,396,445,116,103,red blood cell,11948,0.8879310344827587,1.1262135922330097
66022,/images/25c6cfb1-01d0-4864-87f9-02b7593683c7.png,877,64,964,150,87,86,red blood cell,7482,0.9885057471264368,1.0116279069767442
50604,/images/c956e531-6805-4fe1-b61c-8b96a9815a77.png,158,110,262,217,104,107,red blood cell,11128,1.0288461538461537,0.9719626168224299
45450,/images/e4eea7ea-8989-46a9-9c98-25a178146b28.png,331,57,436,155,105,98,red blood cell,10290,0.9333333333333333,1.0714285714285714
72455,/images/a15e0fa8-2620-4f66-896e-175115c9dc3d.png,71,1356,199,1463,128,107,red blood cell,13696,0.8359375,1.1962616822429906
61408,/images/e16c0dab-780d-4035-872e-1bb91e49f9d2.png,281,513,377,630,96,117,red blood cell,11232,1.21875,0.8205128205128205
31265,/images/db7c5ec1-fefe-4e9d-83c1-da8fb982f1e2.png,432,520,551,650,119,130,red blood cell,15470,1.0924369747899159,0.9153846153846154
3972,/images/f09acb0c-b270-4e91-99f8-410adfa7f34a.png,931,23,1034,119,103,96,red blood cell,9888,0.9320388349514563,1.0729166666666667
8441,/images/ae779806-6d01-4dc6-89df-294c368db6bc.png,452,355,568,476,116,121,red blood cell,14036,1.043103448275862,0.9586776859504132
31493,/images/83ec1cb9-1714-4bf1-81f6-115fde84564d.png,473,103,585,218,112,115,red blood cell,12880,1.0267857142857142,0.9739130434782609
55686,/images/c32b8bb8-c89d-4ae9-9c77-5b9356ca35a1.png,843,386,950,498,107,112,red blood cell,11984,1.0467289719626167,0.9553571428571429
23064,/images/be5bb7d0-7c3f-4bb9-8bb4-f8bc8d875943.png,266,489,379,605,113,116,red blood cell,13108,1.0265486725663717,0.9741379310344828
57491,/images/00d04a90-80e5-4bce-9511-1b64eabb7a47.png,953,1361,1049,1449,96,88,red blood cell,8448,0.9166666666666666,1.0909090909090908
2514,/images/a23f5539-bfe6-4885-9a0e-dba972475ea9.png,296,115,416,224,120,109,red blood cell,13080,0.9083333333333333,1.1009174311926606
22470,/images/99d6a7e5-128e-4455-841d-8fbd1663905e.png,369,1084,484,1211,115,127,red blood cell,14605,1.1043478260869566,0.905511811023622
62918,/images/4b346035-b8c0-46ca-8fdb-a01b1421ee4a.png,118,87,231,217,113,130,red blood cell,14690,1.1504424778761062,0.8692307692307693
66204,/images/14005767-9296-4b48-8a9d-bbe9b2040005.png,979,389,1083,489,104,100,red blood cell,10400,0.9615384615384616,1.04
30582,/images/7d9c1422-6332-44e9-b134-3ac94f07b0f0.png,84,1463,180,1563,96,100,red blood cell,9600,1.0416666666666667,0.96
22145,/images/ca677c3c-083f-4d54-9dec-39f79f6a17d8.png,1050,1008,1164,1121,114,113,red blood cell,12882,0.9912280701754386,1.008849557522124
9195,/images/6e7ed596-1b76-4998-8147-a846d53d91c5.png,65,651,179,744,114,93,red blood cell,10602,0.8157894736842105,1.2258064516129032
59489,/images/a7c3c52f-3b40-4c92-a212-df9462cf25d8.png,199,741,295,853,96,112,red blood cell,10752,1.1666666666666667,0.8571428571428571
24876,/images/ed0bee2f-05e0-4392-8357-19750cec577c.png,637,336,736,450,99,114,red blood cell,11286,1.1515151515151516,0.868421052631579
17827,/images/1863da5f-c595-4541-a8f4-21fe78678168.png,112,80,222,191,110,111,red blood cell,12210,1.009090909090909,0.990990990990991
28575,/images/dbdfad64-110c-421f-a1c7-f68fd9e82d67.png,271,980,394,1081,123,101,red blood cell,12423,0.8211382113821138,1.2178217821782178
68345,/images/0f735cca-051c-4048-a1fa-cb36f389e12f.png,516,1483,626,1587,110,104,red blood cell,11440,0.9454545454545454,1.0576923076923077
10539,/images/46a2d369-4bea-4405-ac78-91bbe130b9a7.png,876,345,972,439,96,94,red blood cell,9024,0.9791666666666666,1.0212765957446808
34631,/images/a0eedcb9-b85c-4612-b945-7e8227f53c35.png,622,421,723,514,101,93,red blood cell,9393,0.9207920792079208,1.086021505376344
58128,/images/e9916e11-9be6-4dec-9df6-2e7d1a8e1735.png,604,1249,721,1361,117,112,red blood cell,13104,0.9572649572649573,1.0446428571428572
73806,/images/3eba916c-998b-40a7-993c-7ed916c2a04c.png,715,1482,815,1583,100,101,red blood cell,10100,1.01,0.9900990099009901
41599,/images/0fcd1ebe-ee4a-40a0-b787-29cee18bfa1b.png,301,1134,392,1218,91,84,red blood cell,7644,0.9230769230769231,1.0833333333333333
57747,/images/5c037ffc-f515-48b3-b231-c110fbd2b8ca.png,700,584,815,703,115,119,red blood cell,13685,1.0347826086956522,0.9663865546218487
62548,/images/9ecf2006-8d49-4ae8-a14b-ed8b3b14ee7c.png,961,1352,1058,1448,97,96,red blood cell,9312,0.9896907216494846,1.0104166666666667
69863,/images/9edba799-e169-46cd-b100-c9f8fc7a8c7d.png,146,618,255,733,109,115,red blood cell,12535,1.055045871559633,0.9478260869565217
15262,/images/dd7142e4-2d86-4170-a41f-e825743e8907.png,713,58,826,171,113,113,red blood cell,12769,1.0,1.0
71203,/images/4fac16e1-8e62-499b-a66b-c4c890372914.png,818,1095,926,1207,108,112,red blood cell,12096,1.037037037037037,0.9642857142857143
68519,/images/74261741-4d6e-4dba-8ad4-4fbdf919c30f.png,433,1398,509,1474,76,76,red blood cell,5776,1.0,1.0
12010,/images/ca16a5ad-b106-4e84-8a43-178710e854ba.png,868,569,1011,684,143,115,red blood cell,16445,0.8041958041958042,1.2434782608695651
48433,/images/0fa5b35d-6c44-4207-b6f8-d5b355086b5f.png,115,1316,244,1438,129,122,red blood cell,15738,0.9457364341085271,1.0573770491803278
36798,/images/aa2dfa24-2dc3-4279-a232-f84780ace190.png,963,197,1069,299,106,102,red blood cell,10812,0.9622641509433962,1.0392156862745099
13872,/images/7d65d296-0f7b-41cc-9073-a547e24326c8.png,252,153,377,269,125,116,red blood cell,14500,0.928,1.0775862068965518
12734,/images/b634137b-bc8b-4e88-b0e3-b536ad6e7e18.png,241,451,348,549,107,98,red blood cell,10486,0.9158878504672897,1.0918367346938775
27408,/images/9f38055f-4fe6-47fd-a6dd-c0743db4eccf.png,1104,14,1193,117,89,103,red blood cell,9167,1.1573033707865168,0.8640776699029126
35342,/images/452482bc-24a3-413e-ba03-fad4c9d61f3c.png,24,1402,124,1508,100,106,red blood cell,10600,1.06,0.9433962264150944
65266,/images/45ac9409-5537-44ed-90cd-5c8a1ae0e1e0.png,85,1392,176,1498,91,106,red blood cell,9646,1.164835164835165,0.8584905660377359
14865,/images/3090a362-1f3d-49e9-a76e-ce76ff9c2276.png,629,116,717,210,88,94,red blood cell,8272,1.0681818181818181,0.9361702127659575
63330,/images/9f4bc3b4-abb0-4bcb-baa8-ec9f25e2b9c6.png,749,755,862,867,113,112,red blood cell,12656,0.9911504424778761,1.0089285714285714
6779,/images/672e4ecf-a56b-462e-b83b-76f4efaa6634.png,199,245,310,360,111,115,red blood cell,12765,1.0360360360360361,0.9652173913043478
11731,/images/082e1f81-4f49-44ad-b5bb-9dfc155b2ed8.png,180,1463,284,1570,104,107,red blood cell,11128,1.0288461538461537,0.9719626168224299
4191,/images/ac3358f1-ef9a-4ccc-b66c-da5e47e352e0.png,725,960,834,1076,109,116,red blood cell,12644,1.0642201834862386,0.9396551724137931
31487,/images/83ec1cb9-1714-4bf1-81f6-115fde84564d.png,762,1352,892,1474,130,122,red blood cell,15860,0.9384615384615385,1.0655737704918034
1809,/images/5f783f43-0090-4f8a-bd75-9562f4aa2dd5.png,348,252,441,359,93,107,red blood cell,9951,1.1505376344086022,0.8691588785046729
28438,/images/c3042130-a6e2-458f-9fde-bb012f68f5f2.png,13,1271,136,1375,123,104,red blood cell,12792,0.8455284552845529,1.1826923076923077
21791,/images/f68ae8e9-e760-4106-88e0-4bdef2785f06.png,685,285,785,398,100,113,red blood cell,11300,1.13,0.8849557522123894
58230,/images/319c9c52-f316-49f3-baad-4444ab19f85b.png,537,735,643,841,106,106,red blood cell,11236,1.0,1.0
70224,/images/a5c3b3f8-7ceb-4573-a400-a76b9479af46.png,748,756,858,870,110,114,red blood cell,12540,1.0363636363636364,0.9649122807017544
59822,/images/acb16781-11ad-4327-874a-5c9c35dcb085.png,793,940,916,1064,123,124,red blood cell,15252,1.008130081300813,0.9919354838709677
26733,/images/2518f6e4-29cc-4ae4-a914-b215a4c56099.png,463,1131,551,1237,88,106,red blood cell,9328,1.2045454545454546,0.8301886792452831
46614,/images/da111ca5-520f-4ea8-97ad-ae5fce58ee91.png,1003,566,1108,662,105,96,red blood cell,10080,0.9142857142857143,1.09375
46906,/images/9e0e1928-d19a-4100-b093-0b962ac09e05.png,742,242,849,359,107,117,red blood cell,12519,1.0934579439252337,0.9145299145299145
51016,/images/cc275c45-7511-4070-84af-10b8ffebda53.png,76,1366,202,1503,126,137,red blood cell,17262,1.0873015873015872,0.9197080291970803
78362,/images/24115f58-a7d6-4022-a95a-86b515a78d3e.png,0,1286,105,1401,105,115,red blood cell,12075,1.0952380952380953,0.9130434782608695
77122,/images/dd6f047e-af73-43df-9c46-354534fc20e0.png,753,1478,847,1565,94,87,red blood cell,8178,0.925531914893617,1.0804597701149425
65684,/images/397f37bc-a3a4-4257-9430-c8fc5716f8b1.png,674,56,783,170,109,114,red blood cell,12426,1.0458715596330275,0.956140350877193
41973,/images/46a03374-64c7-49ac-81c9-c3d62542bbf3.png,863,627,966,719,103,92,red blood cell,9476,0.8932038834951457,1.1195652173913044
61476,/images/7e837856-3519-4dc0-b357-4cdcfd30b4eb.png,403,185,500,282,97,97,red blood cell,9409,1.0,1.0
25966,/images/e683144c-0465-43a2-86b1-3cf52599d5e0.png,659,1422,757,1521,98,99,red blood cell,9702,1.010204081632653,0.98989898989899
27881,/images/948c94ad-395c-41f4-9a68-8a1dcb76888c.png,98,1398,202,1494,104,96,red blood cell,9984,0.9230769230769231,1.0833333333333333
30965,/images/533c47c9-02a6-419b-961b-81797f022f6c.png,551,338,657,437,106,99,red blood cell,10494,0.9339622641509434,1.0707070707070707
68901,/images/6347dd6a-cfdf-4cb5-bc50-cff5403cfecb.png,603,341,728,474,125,133,red blood cell,16625,1.064,0.9398496240601504
61427,/images/e16c0dab-780d-4035-872e-1bb91e49f9d2.png,409,284,491,366,82,82,red blood cell,6724,1.0,1.0
53462,/images/766d5547-8dd2-4c8d-b78e-3007f83932e8.png,992,1509,1092,1600,100,91,red blood cell,9100,0.91,1.098901098901099
38383,/images/674b0fd3-f247-4b7f-97f7-3e6c57c9ba9e.png,463,212,564,317,101,105,red blood cell,10605,1.0396039603960396,0.9619047619047619
56515,/images/ac8df764-c8d8-4312-916d-70bfb37574b4.png,756,189,860,311,104,122,red blood cell,12688,1.1730769230769231,0.8524590163934426
59300,/images/03c8da48-04b9-4520-b674-44a0ecd35688.png,427,858,520,949,93,91,red blood cell,8463,0.978494623655914,1.021978021978022
13366,/images/a7f1bbb1-6058-4642-bd66-cfb90dce762e.png,503,1324,612,1447,109,123,red blood cell,13407,1.128440366972477,0.8861788617886179
3087,/images/14efbfc8-39f6-4599-9994-a8cc95605b9c.png,881,765,987,864,106,99,red blood cell,10494,0.9339622641509434,1.0707070707070707
6381,/images/f06ba705-5509-479b-8067-127ffb37c5b6.png,675,1441,795,1560,120,119,red blood cell,14280,0.9916666666666667,1.0084033613445378
3532,/images/25132962-ff5d-4737-995f-c54d8490539b.png,640,939,742,1045,102,106,red blood cell,10812,1.0392156862745099,0.9622641509433962
52009,/images/4f62b14e-c6f4-4155-8f50-881558f83fae.png,1088,830,1164,914,76,84,red blood cell,6384,1.105263157894737,0.9047619047619048
39785,/images/5c68070c-3391-4db6-8c01-94175105dbea.png,865,1395,992,1528,127,133,red blood cell,16891,1.047244094488189,0.9548872180451128
43478,/images/5a539312-6cfa-43e6-8d5d-db883f343ad9.png,938,437,1063,563,125,126,red blood cell,15750,1.008,0.9920634920634921
60056,/images/e63e1607-f344-43d6-a0d8-e10cf2e5054a.png,586,1195,695,1310,109,115,red blood cell,12535,1.055045871559633,0.9478260869565217
66659,/images/b88fe674-fb9a-41d4-b100-cb1c86440d44.png,878,1138,975,1240,97,102,red blood cell,9894,1.0515463917525774,0.9509803921568627
17589,/images/e80bad38-66d0-473e-85dd-92142dba37e6.png,298,460,416,579,118,119,red blood cell,14042,1.0084745762711864,0.9915966386554622
69882,/images/9edba799-e169-46cd-b100-c9f8fc7a8c7d.png,669,951,777,1050,108,99,red blood cell,10692,0.9166666666666666,1.0909090909090908
794,/images/27fab82c-5bf0-426f-aeb9-47da829b6629.png,700,372,802,472,102,100,red blood cell,10200,0.9803921568627451,1.02
4689,/images/b91b1641-ee06-44d8-94cc-24cdb583cc37.png,714,438,840,564,126,126,red blood cell,15876,1.0,1.0
33944,/images/1a332b2c-9d49-4ff2-810c-5633d2314527.png,937,1006,1040,1099,103,93,red blood cell,9579,0.9029126213592233,1.10752688172043
44984,/images/13bab3c3-3f79-44d9-a287-0ae6d71eff31.png,934,1343,1050,1449,116,106,red blood cell,12296,0.9137931034482759,1.0943396226415094
2234,/images/5bf91ff9-80df-49c0-9c3e-599357d95530.png,844,1375,956,1481,112,106,red blood cell,11872,0.9464285714285714,1.0566037735849056
4904,/images/61cd8c7d-394d-42d3-9ed4-e09559110bed.png,912,180,1046,307,134,127,red blood cell,17018,0.9477611940298507,1.0551181102362204
17774,/images/1863da5f-c595-4541-a8f4-21fe78678168.png,820,352,923,450,103,98,red blood cell,10094,0.9514563106796117,1.0510204081632653
52453,/images/a2a20600-f851-4db7-90f9-6f7be027c8b5.png,356,752,431,832,75,80,red blood cell,6000,1.0666666666666667,0.9375
36121,/images/cb2fac19-90b0-48b4-bdc5-7dbbd58756d1.png,770,482,892,601,122,119,red blood cell,14518,0.9754098360655737,1.0252100840336134
33368,/images/f632981c-1330-4078-8a12-691beb2dab02.png,409,1035,526,1155,117,120,red blood cell,14040,1.0256410256410255,0.975
72911,/images/a20d0b4b-6e2e-4507-bc22-f321dedc4ed9.png,1069,15,1171,122,102,107,red blood cell,10914,1.0490196078431373,0.9532710280373832
38602,/images/f8b14fc4-dd6b-4ad0-a96d-c62845f48681.png,648,1319,754,1434,106,115,red blood cell,12190,1.0849056603773586,0.9217391304347826
21632,/images/66183740-e1e5-43c9-8539-a87028bb3621.png,470,1192,595,1325,125,133,red blood cell,16625,1.064,0.9398496240601504
79147,/images/1c90231b-2830-42d9-884e-7301edb16933.png,1045,1166,1138,1245,93,79,red blood cell,7347,0.8494623655913979,1.1772151898734178
42664,/images/3abbc4d3-1d7e-40c9-9963-33732da7cc50.png,293,1388,408,1495,115,107,red blood cell,12305,0.9304347826086956,1.074766355140187
38555,/images/c3ae7090-fc68-41b4-85a1-8d9bce9825a7.png,1092,616,1196,724,104,108,red blood cell,11232,1.0384615384615385,0.9629629629629629
49155,/images/df3d98b9-3dd7-4107-8d4a-ae1b7f247793.png,517,135,615,222,98,87,red blood cell,8526,0.8877551020408163,1.1264367816091954
64427,/images/34a70114-d3e3-4351-b8db-f6caab17e743.png,260,16,360,112,100,96,red blood cell,9600,0.96,1.0416666666666667
45140,/images/2596eb32-1323-41e9-8c0f-64819abcfc73.png,807,1449,915,1563,108,114,red blood cell,12312,1.0555555555555556,0.9473684210526315
54156,/images/c415532c-4cce-4580-9fcd-623c172a1abd.png,698,1139,796,1253,98,114,red blood cell,11172,1.163265306122449,0.8596491228070176
28927,/images/b12ae3b1-613c-4c0e-9163-3c5cc314abf5.png,282,623,413,754,131,131,red blood cell,17161,1.0,1.0
22015,/images/c5acd0ad-b0f2-478d-b0ad-5aa733aa7b32.png,285,885,403,1014,118,129,red blood cell,15222,1.0932203389830508,0.9147286821705426
78415,/images/fe00fa09-d3c8-485b-9d0f-3cce556c9edd.png,347,898,447,986,100,88,red blood cell,8800,0.88,1.1363636363636365
4788,/images/3fa1a4e3-c80d-49da-8f7b-a1abb0424f48.png,235,493,363,619,128,126,red blood cell,16128,0.984375,1.0158730158730158
34094,/images/de5d19b7-e670-4ac7-843b-7ce7bcebdf45.png,877,858,999,967,122,109,red blood cell,13298,0.8934426229508197,1.1192660550458715
77303,/images/07a80340-f65e-4f58-9317-94bb6ebd5a28.png,236,849,320,930,84,81,red blood cell,6804,0.9642857142857143,1.037037037037037
58506,/images/5cac6ddf-c8c6-45de-bce0-a1db64b14fb5.png,790,1036,892,1146,102,110,red blood cell,11220,1.0784313725490196,0.9272727272727272
52743,/images/9dc6ed5d-6698-48cf-aab3-fd156673729c.png,128,1351,234,1482,106,131,red blood cell,13886,1.2358490566037736,0.8091603053435115
27918,/images/46f5bd4f-8bea-48d1-a1da-4dea28e3b814.png,993,701,1111,817,118,116,red blood cell,13688,0.9830508474576272,1.0172413793103448
69144,/images/de2b8835-552c-4f01-98b7-67bc4910062e.png,69,305,171,408,102,103,red blood cell,10506,1.0098039215686274,0.9902912621359223
45389,/images/e4eea7ea-8989-46a9-9c98-25a178146b28.png,884,603,990,713,106,110,red blood cell,11660,1.0377358490566038,0.9636363636363636
16807,/images/4823c1fe-a7f9-4b92-959f-0d9be09cd14b.png,1060,558,1161,666,101,108,red blood cell,10908,1.0693069306930694,0.9351851851851852
72324,/images/ee57e743-a876-4f69-9fe5-bf5d01b44689.png,836,967,949,1078,113,111,red blood cell,12543,0.9823008849557522,1.018018018018018
42351,/images/5c5b7965-1a44-44b8-aa43-660823e61821.png,199,85,295,177,96,92,red blood cell,8832,0.9583333333333334,1.0434782608695652
24209,/images/194aec70-41a5-4ac3-b22f-0b6eda91f730.png,48,287,138,379,90,92,red blood cell,8280,1.0222222222222221,0.9782608695652174
59806,/images/acb16781-11ad-4327-874a-5c9c35dcb085.png,733,207,853,307,120,100,red blood cell,12000,0.8333333333333334,1.2
70184,/images/b338766f-19b9-4874-bcc5-ae22b3c533e6.png,399,572,521,683,122,111,red blood cell,13542,0.9098360655737705,1.0990990990990992
72396,/images/a15e0fa8-2620-4f66-896e-175115c9dc3d.png,362,415,470,524,108,109,red blood cell,11772,1.0092592592592593,0.9908256880733946
14930,/images/5d1418d3-1559-4725-ad4a-9afb6eaecdfd.png,964,247,1055,339,91,92,red blood cell,8372,1.010989010989011,0.9891304347826086
4944,/images/755e5bf8-e8e1-492b-a32f-f7d87cccaa40.png,840,480,947,612,107,132,red blood cell,14124,1.233644859813084,0.8106060606060606
60464,/images/93b47b14-7f78-4b31-8897-d63a81fdab01.png,15,394,128,503,113,109,red blood cell,12317,0.9646017699115044,1.036697247706422
18964,/images/e9e78ff8-831b-46e9-9785-3eee9acbfcd8.png,263,434,356,521,93,87,red blood cell,8091,0.9354838709677419,1.0689655172413792
20513,/images/cbde7f7e-2458-4dda-9db2-3d5ccf950ced.png,462,345,575,447,113,102,red blood cell,11526,0.9026548672566371,1.107843137254902
61276,/images/b3058064-d817-47dd-a8c4-cdb1f62374f8.png,353,345,441,441,88,96,red blood cell,8448,1.0909090909090908,0.9166666666666666
23564,/images/177f883a-f0f1-4b8e-b598-2ca4bab27381.png,458,288,558,413,100,125,red blood cell,12500,1.25,0.8
14400,/images/f5eb7c5e-bd77-4638-ba9f-58d42f87476b.png,597,23,736,140,139,117,red blood cell,16263,0.841726618705036,1.188034188034188
62454,/images/7dfbfeaf-e3b1-4159-8dcd-d7f731280ac8.png,81,137,190,249,109,112,red blood cell,12208,1.0275229357798166,0.9732142857142857
46592,/images/edd09b2e-2673-4405-8ac0-e476e003e96a.png,427,1438,561,1576,134,138,red blood cell,18492,1.0298507462686568,0.9710144927536232
68616,/images/31653d0f-c4e6-4e12-8005-518c2de34687.png,229,950,327,1042,98,92,red blood cell,9016,0.9387755102040817,1.065217391304348
24328,/images/4d8a4ce8-0f9c-4f21-8844-4cf0e5514bbf.png,164,1083,258,1191,94,108,red blood cell,10152,1.148936170212766,0.8703703703703703
7024,/images/8be185e7-2a1a-441c-a5c7-b50a9eb926cb.png,56,1441,170,1558,114,117,red blood cell,13338,1.0263157894736843,0.9743589743589743
32656,/images/ed0d8763-e734-4506-b61b-53fc32a8d8c9.png,438,517,524,616,86,99,red blood cell,8514,1.1511627906976745,0.8686868686868687
31002,/images/b59dc3a0-3d54-4e3b-a485-33b3e43966de.png,650,24,777,147,127,123,red blood cell,15621,0.968503937007874,1.032520325203252
47327,/images/1dd3e6dd-343f-4cc9-b0ed-e4d27fb36f0a.png,460,398,569,510,109,112,red blood cell,12208,1.0275229357798166,0.9732142857142857
73518,/images/5f2b32bd-fdca-4d6f-b13a-ee9f83626c8d.png,959,938,1043,1013,84,75,red blood cell,6300,0.8928571428571429,1.12
40424,/images/db249e5a-4142-432c-8288-bacd10d7273d.png,445,220,543,319,98,99,red blood cell,9702,1.010204081632653,0.98989898989899
11468,/images/2f9f400d-2d67-4118-aaa1-9094bc4b0e47.png,584,646,727,776,143,130,red blood cell,18590,0.9090909090909091,1.1
11878,/images/3cdcb09b-6a8c-43ca-b1d0-c1a289202f65.png,678,862,779,963,101,101,red blood cell,10201,1.0,1.0
75571,/images/c35ee701-fde2-46b5-b178-1fe3f1ea7da2.png,445,694,561,812,116,118,red blood cell,13688,1.0172413793103448,0.9830508474576272
8688,/images/92e4fd7b-79ef-49c2-a52b-9ef13dd720ef.png,777,994,895,1112,118,118,red blood cell,13924,1.0,1.0
42525,/images/29648565-fe28-4517-ba72-68df0c82c9c5.png,815,997,911,1082,96,85,red blood cell,8160,0.8854166666666666,1.1294117647058823
66000,/images/25c6cfb1-01d0-4864-87f9-02b7593683c7.png,463,169,554,282,91,113,red blood cell,10283,1.2417582417582418,0.8053097345132744
18549,/images/c22f7031-9cf8-48ce-b03b-1b12d0db4951.png,1055,590,1160,688,105,98,red blood cell,10290,0.9333333333333333,1.0714285714285714
55327,/images/4fb83278-adc5-4424-9f45-b6d0db2955b6.png,911,1244,1032,1370,121,126,red blood cell,15246,1.0413223140495869,0.9603174603174603
5671,/images/d3dcdf92-9328-4796-adf4-918646877ba1.png,657,744,793,856,136,112,red blood cell,15232,0.8235294117647058,1.2142857142857142
50964,/images/ef8fcfa4-8466-4186-8c69-f5f4904eb489.png,731,132,857,247,126,115,red blood cell,14490,0.9126984126984127,1.0956521739130434
17463,/images/56077789-8580-41b4-89d6-deea227e5c60.png,79,1328,187,1431,108,103,red blood cell,11124,0.9537037037037037,1.0485436893203883
10688,/images/20d4f65e-6c63-433a-935c-d568d577967b.png,642,748,738,857,96,109,red blood cell,10464,1.1354166666666667,0.8807339449541285
4696,/images/b91b1641-ee06-44d8-94cc-24cdb583cc37.png,670,1430,781,1563,111,133,red blood cell,14763,1.1981981981981982,0.8345864661654135
61869,/images/f32b21ae-5ca7-490b-bc40-6db9396d933c.png,493,422,589,512,96,90,red blood cell,8640,0.9375,1.0666666666666667
48499,/images/9c4cb048-d64a-4b7f-84ff-ca28a8084fc7.png,214,443,345,566,131,123,red blood cell,16113,0.9389312977099237,1.065040650406504
35999,/images/5836500a-221e-40ca-a8be-caaa37f7d300.png,693,670,791,765,98,95,red blood cell,9310,0.9693877551020408,1.0315789473684212
30344,/images/4aad9589-6b32-4522-bcd7-ca04687a02ca.png,218,1259,316,1381,98,122,red blood cell,11956,1.2448979591836735,0.8032786885245902
73662,/images/a51d6c18-f9e8-4714-9dbb-38e1577445f2.png,1025,843,1120,927,95,84,red blood cell,7980,0.8842105263157894,1.130952380952381
77974,/images/c691c8ef-d3c7-47b6-a941-f6a1089f21a9.png,322,845,429,945,107,100,red blood cell,10700,0.9345794392523364,1.07
16624,/images/a27858ef-6533-413e-bc75-cc54690261a2.png,90,574,199,703,109,129,red blood cell,14061,1.18348623853211,0.8449612403100775
27741,/images/e3c1442a-717f-41dd-bf97-81e1233ac9fa.png,280,980,400,1085,120,105,red blood cell,12600,0.875,1.1428571428571428
39776,/images/5c68070c-3391-4db6-8c01-94175105dbea.png,482,795,597,927,115,132,red blood cell,15180,1.1478260869565218,0.8712121212121212
9710,/images/53afd70c-08a7-4b9a-b137-7003b2ecbeab.png,306,490,412,601,106,111,red blood cell,11766,1.0471698113207548,0.954954954954955
26716,/images/2518f6e4-29cc-4ae4-a914-b215a4c56099.png,144,1009,243,1121,99,112,red blood cell,11088,1.1313131313131313,0.8839285714285714
14141,/images/eaf4b781-b3aa-41ce-8c5e-287979b4e15a.png,501,1476,596,1557,95,81,red blood cell,7695,0.8526315789473684,1.1728395061728396
66466,/images/5f66d20c-fbfe-44ec-a01b-8a09da24807e.png,362,280,473,387,111,107,red blood cell,11877,0.963963963963964,1.0373831775700935
7794,/images/e726dac6-f962-449c-acff-4dd56847b685.png,142,1191,251,1293,109,102,red blood cell,11118,0.9357798165137615,1.0686274509803921
27742,/images/e3c1442a-717f-41dd-bf97-81e1233ac9fa.png,915,652,1011,757,96,105,red blood cell,10080,1.09375,0.9142857142857143
24416,/images/4d8a4ce8-0f9c-4f21-8844-4cf0e5514bbf.png,914,1348,1006,1440,92,92,red blood cell,8464,1.0,1.0
73306,/images/67a4fb91-6f38-4ca2-8f20-6b2f5f1b29a7.png,1090,1024,1191,1142,101,118,red blood cell,11918,1.1683168316831682,0.8559322033898306
59827,/images/acb16781-11ad-4327-874a-5c9c35dcb085.png,224,774,321,880,97,106,red blood cell,10282,1.092783505154639,0.9150943396226415
76987,/images/51e86aa9-caa0-4297-94e8-34a57d7f7e36.png,828,897,926,999,98,102,red blood cell,9996,1.0408163265306123,0.9607843137254902
46343,/images/fcc2b245-f47f-447f-8527-275b0005677c.png,745,1433,864,1559,119,126,red blood cell,14994,1.0588235294117647,0.9444444444444444
41595,/images/0fcd1ebe-ee4a-40a0-b787-29cee18bfa1b.png,1031,1259,1123,1339,92,80,red blood cell,7360,0.8695652173913043,1.15
49316,/images/99b13257-b9d9-422f-8262-802da0bdc510.png,7,878,145,1015,138,137,red blood cell,18906,0.9927536231884058,1.0072992700729928
51418,/images/b4f3b2a4-f4b9-48de-ac5d-0e681b77be27.png,907,176,1024,279,117,103,red blood cell,12051,0.8803418803418803,1.1359223300970873
46019,/images/72088c26-d2dd-4906-b791-b8947fc7fbe4.png,377,1383,476,1472,99,89,red blood cell,8811,0.898989898989899,1.1123595505617978
79459,/images/a2fc0093-8645-43c7-bdee-ec8ca9484815.png,179,793,278,891,99,98,red blood cell,9702,0.98989898989899,1.010204081632653
66413,/images/e5fd5949-4cd0-4cb6-837a-02c26a5eb87a.png,416,252,536,388,120,136,red blood cell,16320,1.1333333333333333,0.8823529411764706
22743,/images/8490c623-3d88-4532-baf5-0d266a45b16f.png,870,1209,985,1326,115,117,red blood cell,13455,1.017391304347826,0.9829059829059829
27158,/images/f232eec3-02c0-43f9-bf32-3e60245397e2.png,327,956,433,1062,106,106,red blood cell,11236,1.0,1.0
22536,/images/bfe65b11-8aff-46aa-908b-1e989d25fdc4.png,311,661,426,767,115,106,red blood cell,12190,0.9217391304347826,1.0849056603773586
59166,/images/4736f545-1f1f-4d77-9241-d69cbf4dae35.png,382,275,465,354,83,79,red blood cell,6557,0.9518072289156626,1.0506329113924051
76243,/images/90a82250-1f68-48c9-9af9-15f18bf8c974.png,645,1414,767,1518,122,104,red blood cell,12688,0.8524590163934426,1.1730769230769231
76025,/images/4c7d2382-a962-4237-a053-955eea3decd8.png,22,84,143,198,121,114,red blood cell,13794,0.9421487603305785,1.0614035087719298
72994,/images/2bd26501-2fbc-4c1a-bef0-4ad57e02b4d0.png,343,1411,437,1520,94,109,red blood cell,10246,1.1595744680851063,0.8623853211009175
32991,/images/d1924af6-7512-4ccc-9c6b-adbbaa8db41f.png,1072,1320,1172,1422,100,102,red blood cell,10200,1.02,0.9803921568627451
65509,/images/da49db57-0c2f-4213-b322-c88c19fb9296.png,615,1155,736,1272,121,117,red blood cell,14157,0.9669421487603306,1.0341880341880343
6635,/images/640c4a52-3742-4f57-aee3-9e3dc0887622.png,171,167,276,267,105,100,red blood cell,10500,0.9523809523809523,1.05
54294,/images/3b5a8060-dec6-4a83-b7f2-b604e4e69dfc.png,112,1026,199,1120,87,94,red blood cell,8178,1.0804597701149425,0.925531914893617
6543,/images/640c4a52-3742-4f57-aee3-9e3dc0887622.png,1044,597,1129,690,85,93,red blood cell,7905,1.0941176470588236,0.9139784946236559
4640,/images/9615ff33-b3fc-4d1e-9c05-0b8e3ef936df.png,207,1113,327,1228,120,115,red blood cell,13800,0.9583333333333334,1.0434782608695652
63028,/images/f234a2de-f3c8-4521-a306-8cfdf52dd597.png,306,143,394,229,88,86,red blood cell,7568,0.9772727272727273,1.0232558139534884
44614,/images/6388e241-09a2-4fbe-a712-07d8fe714c51.png,1054,847,1175,963,121,116,red blood cell,14036,0.9586776859504132,1.043103448275862
9799,/images/3859deaf-6ae1-49a3-9051-898d0f0d7de6.png,98,761,182,860,84,99,red blood cell,8316,1.1785714285714286,0.8484848484848485
36855,/images/3de03fa2-3ad3-43fc-8435-b2a80bdd7550.png,1031,107,1147,210,116,103,red blood cell,11948,0.8879310344827587,1.1262135922330097
77487,/images/a11ed7d0-12f6-468f-abad-5cba7d968123.png,6,646,110,747,104,101,red blood cell,10504,0.9711538461538461,1.0297029702970297
23680,/images/79d7a014-21ff-40f1-9ac4-a69839390654.png,823,130,918,226,95,96,red blood cell,9120,1.0105263157894737,0.9895833333333334
12732,/images/b634137b-bc8b-4e88-b0e3-b536ad6e7e18.png,190,950,293,1049,103,99,red blood cell,10197,0.9611650485436893,1.0404040404040404
51631,/images/d0347b49-8f98-4632-a384-1a4f57ac6374.png,174,897,277,1013,103,116,red blood cell,11948,1.1262135922330097,0.8879310344827587
42046,/images/46a03374-64c7-49ac-81c9-c3d62542bbf3.png,244,225,332,315,88,90,red blood cell,7920,1.0227272727272727,0.9777777777777777
30117,/images/81c3c8f0-d5a9-4dda-afd5-e86f6afd9424.png,888,1216,993,1339,105,123,red blood cell,12915,1.1714285714285715,0.8536585365853658
50033,/images/b1145408-feae-4637-b4cf-3e70b99cc62d.png,664,714,755,814,91,100,red blood cell,9100,1.098901098901099,0.91
17339,/images/3d302619-473d-4c5b-af43-8833ff94233f.png,1069,1356,1168,1450,99,94,red blood cell,9306,0.9494949494949495,1.053191489361702
2664,/images/a2ccbf70-e444-49a9-8b7e-9797a05220d8.png,69,621,189,752,120,131,red blood cell,15720,1.0916666666666666,0.916030534351145
60397,/images/8d5d5c22-2f75-4fe1-9ea3-03a3c7b92ea9.png,53,1111,182,1236,129,125,red blood cell,16125,0.9689922480620154,1.032
78957,/images/6144887d-a1c1-46db-91a1-f7ff5bf8c8a5.png,659,319,749,414,90,95,red blood cell,8550,1.0555555555555556,0.9473684210526315
42988,/images/ff37dd9b-2e3c-444d-9d29-6db186cfa2fb.png,121,846,241,985,120,139,red blood cell,16680,1.1583333333333334,0.8633093525179856
79952,/images/e640ae51-cbf1-4a84-b7cf-d38b17f59c2f.png,109,863,208,972,99,109,red blood cell,10791,1.101010101010101,0.908256880733945
79476,/images/a2fc0093-8645-43c7-bdee-ec8ca9484815.png,111,183,218,280,107,97,red blood cell,10379,0.9065420560747663,1.1030927835051547
10909,/images/1380f9b4-bf54-4492-90c3-743c7aa8898b.png,389,61,514,167,125,106,red blood cell,13250,0.848,1.179245283018868
65005,/images/ff3b9d4d-373c-48ef-a75a-d23e2c2ade87.png,233,610,329,711,96,101,red blood cell,9696,1.0520833333333333,0.9504950495049505
19544,/images/2c1eaf87-3fd3-4803-92b8-23bab40bf28c.png,872,1255,1008,1365,136,110,red blood cell,14960,0.8088235294117647,1.2363636363636363
40954,/images/bbe65c18-8a56-4dfe-875c-94e124a84125.png,834,33,947,155,113,122,red blood cell,13786,1.079646017699115,0.9262295081967213
21757,/images/f68ae8e9-e760-4106-88e0-4bdef2785f06.png,824,590,914,672,90,82,red blood cell,7380,0.9111111111111111,1.0975609756097562
10989,/images/c442e2d6-aaf9-417a-9905-4737a1115f33.png,689,648,811,769,122,121,red blood cell,14762,0.9918032786885246,1.0082644628099173
6580,/images/640c4a52-3742-4f57-aee3-9e3dc0887622.png,34,873,121,960,87,87,red blood cell,7569,1.0,1.0
70241,/images/a5c3b3f8-7ceb-4573-a400-a76b9479af46.png,454,635,568,743,114,108,red blood cell,12312,0.9473684210526315,1.0555555555555556
18177,/images/947348fe-4c70-468e-8009-3c14daeca69b.png,1015,279,1106,382,91,103,red blood cell,9373,1.1318681318681318,0.883495145631068
36373,/images/4a0a05e1-11ad-4bfc-bfa3-adf3b9bd0b56.png,290,1383,408,1518,118,135,red blood cell,15930,1.1440677966101696,0.8740740740740741
23195,/images/3dcd4f1b-ce43-4a34-b1ed-076bb42963b1.png,513,76,614,183,101,107,red blood cell,10807,1.0594059405940595,0.9439252336448598
14633,/images/c649e1cb-4029-4433-b231-d67d68f7391a.png,765,786,877,891,112,105,red blood cell,11760,0.9375,1.0666666666666667
4258,/images/882b91b7-5906-4091-bad4-688d4375eeb5.png,10,173,134,310,124,137,red blood cell,16988,1.1048387096774193,0.9051094890510949
68657,/images/31653d0f-c4e6-4e12-8005-518c2de34687.png,1100,985,1200,1093,100,108,red blood cell,10800,1.08,0.9259259259259259
37482,/images/c6530038-6d4e-49e1-8427-d1d3acc9fa21.png,363,1360,489,1483,126,123,red blood cell,15498,0.9761904761904762,1.024390243902439
62367,/images/9af1ee02-87fd-42bc-963e-fa9ac3eb45bb.png,305,1332,407,1422,102,90,red blood cell,9180,0.8823529411764706,1.1333333333333333
79628,/images/a4409217-be11-4478-90a5-b406057d154d.png,357,1416,456,1519,99,103,red blood cell,10197,1.0404040404040404,0.9611650485436893
51662,/images/592c941a-aa54-4971-b499-dc47356f80a3.png,216,407,312,522,96,115,red blood cell,11040,1.1979166666666667,0.8347826086956521
56918,/images/f28e6d66-af71-40c1-b30c-da71d7230a3f.png,67,718,170,836,103,118,red blood cell,12154,1.145631067961165,0.8728813559322034
53854,/images/f24c8fe0-a534-44cf-9995-b2b314d945ba.png,695,360,832,470,137,110,red blood cell,15070,0.8029197080291971,1.2454545454545454
40414,/images/db249e5a-4142-432c-8288-bacd10d7273d.png,963,704,1094,829,131,125,red blood cell,16375,0.9541984732824428,1.048
7788,/images/e726dac6-f962-449c-acff-4dd56847b685.png,845,267,959,380,114,113,red blood cell,12882,0.9912280701754386,1.008849557522124
35266,/images/a9159b11-ba49-4885-902e-00c8d5095b98.png,643,1,759,103,116,102,red blood cell,11832,0.8793103448275862,1.1372549019607843
22628,/images/406e05f0-4444-414c-bb40-f4cb08e75ac9.png,431,1184,564,1320,133,136,red blood cell,18088,1.0225563909774436,0.9779411764705882
64376,/images/0a7bfa8a-ee52-4f7a-b9c5-2919ecfa93ef.png,313,667,397,751,84,84,red blood cell,7056,1.0,1.0
42694,/images/3abbc4d3-1d7e-40c9-9963-33732da7cc50.png,584,1342,683,1423,99,81,red blood cell,8019,0.8181818181818182,1.2222222222222223
21746,/images/f68ae8e9-e760-4106-88e0-4bdef2785f06.png,293,941,412,1074,119,133,red blood cell,15827,1.1176470588235294,0.8947368421052632
50119,/images/e98baeb2-aa58-4cce-8c61-66685dd2b239.png,932,150,1041,246,109,96,red blood cell,10464,0.8807339449541285,1.1354166666666667
77637,/images/07d15855-eb9b-46a9-b894-7cfe4d097826.png,535,236,633,336,98,100,red blood cell,9800,1.0204081632653061,0.98
18137,/images/947348fe-4c70-468e-8009-3c14daeca69b.png,789,501,887,602,98,101,red blood cell,9898,1.030612244897959,0.9702970297029703
35040,/images/67582df6-bf13-4c83-a531-1214692b70de.png,355,222,466,341,111,119,red blood cell,13209,1.072072072072072,0.9327731092436975
33133,/images/6231d81d-9e84-4a5a-8cb8-47c6a37a0176.png,389,1236,476,1321,87,85,red blood cell,7395,0.9770114942528736,1.0235294117647058
36300,/images/81fed4a1-9d48-4938-90c9-c8bf3f5e6b1f.png,648,1444,761,1558,113,114,red blood cell,12882,1.008849557522124,0.9912280701754386
68609,/images/31653d0f-c4e6-4e12-8005-518c2de34687.png,296,1006,401,1116,105,110,red blood cell,11550,1.0476190476190477,0.9545454545454546
44508,/images/b6573be3-9e04-49c3-9f48-6a145d065363.png,659,934,774,1047,115,113,red blood cell,12995,0.9826086956521739,1.0176991150442478
34165,/images/f1cda808-69a9-4d10-ba0a-6607c98e362d.png,183,926,310,1049,127,123,red blood cell,15621,0.968503937007874,1.032520325203252
72013,/images/6ad3efc9-4392-4cee-98a5-186564a96373.png,826,912,934,1008,108,96,red blood cell,10368,0.8888888888888888,1.125
30238,/images/f81806a8-5883-446c-be78-f0145b12dbdd.png,757,297,882,431,125,134,red blood cell,16750,1.072,0.9328358208955224
60987,/images/5397d8e2-bb09-42e7-9861-65ffad0fe94e.png,679,477,819,602,140,125,red blood cell,17500,0.8928571428571429,1.12
55126,/images/29d4b75f-d400-4702-a9ac-e5a4ed1a1db1.png,253,928,355,1024,102,96,red blood cell,9792,0.9411764705882353,1.0625
54694,/images/6473ddb6-ad56-48a2-81e8-c7cb45f06825.png,460,511,552,609,92,98,red blood cell,9016,1.065217391304348,0.9387755102040817
76950,/images/25ddc1ca-d368-4fff-b1ad-1dbf1e7c97aa.png,918,954,1018,1067,100,113,red blood cell,11300,1.13,0.8849557522123894
20339,/images/98976666-9125-47fe-9601-43c41e58dfb4.png,1033,158,1137,257,104,99,red blood cell,10296,0.9519230769230769,1.0505050505050506
49294,/images/99b13257-b9d9-422f-8262-802da0bdc510.png,384,158,519,296,135,138,red blood cell,18630,1.0222222222222221,0.9782608695652174
69812,/images/2bd15b6e-fe2d-49f3-b394-940d024d1f91.png,967,1317,1064,1419,97,102,red blood cell,9894,1.0515463917525774,0.9509803921568627
79000,/images/6144887d-a1c1-46db-91a1-f7ff5bf8c8a5.png,693,518,798,613,105,95,red blood cell,9975,0.9047619047619048,1.105263157894737
66399,/images/e5fd5949-4cd0-4cb6-837a-02c26a5eb87a.png,1052,123,1176,233,124,110,red blood cell,13640,0.8870967741935484,1.1272727272727272
65145,/images/5e042380-6ef2-496f-8231-0ca550fbfa71.png,712,474,820,564,108,90,red blood cell,9720,0.8333333333333334,1.2
17907,/images/eb77e4a9-acb0-4d83-8055-2c5fcaa54b45.png,956,284,1049,382,93,98,red blood cell,9114,1.053763440860215,0.9489795918367347
50150,/images/4cccfcf0-cac9-46f0-870c-0eabfdc781ba.png,825,481,938,594,113,113,red blood cell,12769,1.0,1.0
45510,/images/94b5a9a1-1c88-4400-aca4-3d56f543fc4a.png,411,850,505,944,94,94,red blood cell,8836,1.0,1.0
3809,/images/3e764461-22ee-44d3-925d-cd658ff7d154.png,129,812,247,920,118,108,red blood cell,12744,0.9152542372881356,1.0925925925925926
478,/images/f65a1633-9935-4984-a285-a60d30aa1707.png,694,585,812,705,118,120,red blood cell,14160,1.0169491525423728,0.9833333333333333
46292,/images/e11515b4-9527-4c23-a0ba-43719bacca0d.png,553,60,681,185,128,125,red blood cell,16000,0.9765625,1.024
33389,/images/f632981c-1330-4078-8a12-691beb2dab02.png,461,1260,567,1383,106,123,red blood cell,13038,1.1603773584905661,0.8617886178861789
57260,/images/6d05ed67-43e2-43af-9d57-70c7a6eeef5e.png,324,362,442,462,118,100,red blood cell,11800,0.847457627118644,1.18
18541,/images/c22f7031-9cf8-48ce-b03b-1b12d0db4951.png,770,742,876,844,106,102,red blood cell,10812,0.9622641509433962,1.0392156862745099
69098,/images/de2b8835-552c-4f01-98b7-67bc4910062e.png,564,472,656,568,92,96,red blood cell,8832,1.0434782608695652,0.9583333333333334
43062,/images/340a1727-0df7-4e6f-9c0e-9c5deddbfca2.png,1054,744,1176,865,122,121,red blood cell,14762,0.9918032786885246,1.0082644628099173
53216,/images/d8f7e159-b7e3-49e4-86e8-aed8c5fbcd97.png,756,141,887,264,131,123,red blood cell,16113,0.9389312977099237,1.065040650406504
19671,/images/627d6331-7bb9-4d1a-b20d-e6541af4d0f9.png,296,511,402,615,106,104,red blood cell,11024,0.9811320754716981,1.0192307692307692
77252,/images/07a80340-f65e-4f58-9317-94bb6ebd5a28.png,740,517,830,616,90,99,red blood cell,8910,1.1,0.9090909090909091
43084,/images/340a1727-0df7-4e6f-9c0e-9c5deddbfca2.png,952,1325,1046,1430,94,105,red blood cell,9870,1.1170212765957446,0.8952380952380953
29750,/images/7ef90770-6aeb-45eb-9744-49c5247dde30.png,785,438,897,562,112,124,red blood cell,13888,1.1071428571428572,0.9032258064516129
70048,/images/b8339d7b-85ec-48d0-83e8-c8f831070459.png,496,461,603,568,107,107,red blood cell,11449,1.0,1.0
75863,/images/3006096f-ceeb-42be-b69e-785179d7438b.png,769,1013,877,1111,108,98,red blood cell,10584,0.9074074074074074,1.1020408163265305
63254,/images/d3283f5b-3b3a-40ea-800b-79960ca851cb.png,518,1107,633,1226,115,119,red blood cell,13685,1.0347826086956522,0.9663865546218487
38782,/images/b426ef1d-4a59-4f90-b593-50226af60a60.png,804,656,915,745,111,89,red blood cell,9879,0.8018018018018018,1.247191011235955
35783,/images/bb2042c5-35e1-43cc-8171-7de81b764361.png,775,452,866,548,91,96,red blood cell,8736,1.054945054945055,0.9479166666666666
54957,/images/f1872d08-f8a6-4b21-aa29-f56bbf607883.png,856,1461,956,1568,100,107,red blood cell,10700,1.07,0.9345794392523364
54139,/images/c415532c-4cce-4580-9fcd-623c172a1abd.png,749,813,848,908,99,95,red blood cell,9405,0.9595959595959596,1.0421052631578946
62216,/images/a72cd558-b7ac-4bf2-a344-2ce6c73a354e.png,357,1137,457,1253,100,116,red blood cell,11600,1.16,0.8620689655172413
1180,/images/4411fea2-d785-4eeb-80c6-c739ab6114c4.png,750,875,867,996,117,121,red blood cell,14157,1.0341880341880343,0.9669421487603306
78708,/images/76a8a5f5-1328-4539-a131-baf877f40cf3.png,1065,1163,1159,1254,94,91,red blood cell,8554,0.9680851063829787,1.032967032967033
31590,/images/0d7bf56f-3b5a-40bd-971c-2ca33dd89b2c.png,615,476,711,573,96,97,red blood cell,9312,1.0104166666666667,0.9896907216494846
76632,/images/4184a235-d209-4151-86e9-6c77e7938dab.png,1028,270,1127,381,99,111,red blood cell,10989,1.121212121212121,0.8918918918918919
40498,/images/e3ade58d-086c-47fa-9120-76beacb45395.png,868,199,990,308,122,109,red blood cell,13298,0.8934426229508197,1.1192660550458715
19484,/images/a85cd1ae-0c94-4387-8305-84ab8d96d137.png,173,426,288,541,115,115,red blood cell,13225,1.0,1.0
9571,/images/239f17eb-a2e2-47e9-82e3-fa0d9a70fb9f.png,641,258,764,381,123,123,red blood cell,15129,1.0,1.0
45242,/images/b7a0d235-2217-43b4-aeff-cde4ccaf6789.png,616,670,722,776,106,106,red blood cell,11236,1.0,1.0
16254,/images/acdc6e12-73d9-44ba-be8c-2a56aaffef4f.png,656,117,765,221,109,104,red blood cell,11336,0.9541284403669725,1.0480769230769231
17377,/images/04018590-4e66-4cb9-ad2d-83570f1b29ae.png,285,171,394,289,109,118,red blood cell,12862,1.0825688073394495,0.923728813559322
20943,/images/c2ec116f-f091-422c-926c-70b548a8f6ef.png,126,873,203,960,77,87,red blood cell,6699,1.12987012987013,0.8850574712643678
26110,/images/27388ff2-4000-4c9a-a2e3-addc448a5f92.png,125,894,233,992,108,98,red blood cell,10584,0.9074074074074074,1.1020408163265305
17010,/images/57e1879e-4294-45e7-9c1b-627e8cca0271.png,867,529,987,651,120,122,red blood cell,14640,1.0166666666666666,0.9836065573770492
56414,/images/c10b125d-10c2-474a-9c6a-5249935c638e.png,815,633,910,733,95,100,red blood cell,9500,1.0526315789473684,0.95
29701,/images/f25a2ac8-cb6e-4e05-a0cd-cc00ac47718a.png,925,840,1029,949,104,109,red blood cell,11336,1.0480769230769231,0.9541284403669725
48692,/images/03359d4d-69cb-4146-8286-ca7399366f97.png,90,667,200,797,110,130,red blood cell,14300,1.1818181818181819,0.8461538461538461
23415,/images/8757be1e-b832-407a-8e95-62abae485b24.png,571,1243,685,1358,114,115,red blood cell,13110,1.0087719298245614,0.991304347826087
25360,/images/c52f8cc8-afd7-441c-9f1f-18b6e16d79cf.png,377,1162,502,1288,125,126,red blood cell,15750,1.008,0.9920634920634921
1008,/images/63d36d2c-43a9-49ac-9504-028b4968c860.png,479,344,582,457,103,113,red blood cell,11639,1.0970873786407767,0.911504424778761
62370,/images/9af1ee02-87fd-42bc-963e-fa9ac3eb45bb.png,480,1176,586,1285,106,109,red blood cell,11554,1.028301886792453,0.9724770642201835
12600,/images/8e4bdd0d-1c72-4836-ae3e-05e2e50e4983.png,758,945,871,1043,113,98,red blood cell,11074,0.8672566371681416,1.153061224489796
2543,/images/a23f5539-bfe6-4885-9a0e-dba972475ea9.png,715,669,800,750,85,81,red blood cell,6885,0.9529411764705882,1.0493827160493827
5529,/images/eb6e8684-b84e-483d-b835-f59286d2516b.png,208,746,320,864,112,118,red blood cell,13216,1.0535714285714286,0.9491525423728814
58411,/images/7eae1169-e294-4594-8e03-1366d23ff2d1.png,772,904,891,1014,119,110,red blood cell,13090,0.9243697478991597,1.0818181818181818
34869,/images/a4fbb9f2-9b75-4fdc-877d-2feaafac25b3.png,507,1440,616,1544,109,104,red blood cell,11336,0.9541284403669725,1.0480769230769231
11625,/images/37e072a6-000d-4773-8d9f-d66b60ace668.png,185,1448,271,1550,86,102,red blood cell,8772,1.186046511627907,0.8431372549019608
72848,/images/31435107-c77d-42f8-a619-75cba6a5161b.png,325,125,427,240,102,115,red blood cell,11730,1.1274509803921569,0.8869565217391304
72085,/images/64b0e49a-0e48-447d-8872-c1dd255e7a21.png,876,1058,963,1157,87,99,red blood cell,8613,1.1379310344827587,0.8787878787878788
57689,/images/5c037ffc-f515-48b3-b231-c110fbd2b8ca.png,14,168,117,293,103,125,red blood cell,12875,1.2135922330097086,0.824
37876,/images/56a57a8d-c9b9-432a-a3b0-32a09355806c.png,968,105,1078,210,110,105,red blood cell,11550,0.9545454545454546,1.0476190476190477
34986,/images/2b369d75-9c55-43e0-b352-d981aea544e3.png,651,408,795,537,144,129,red blood cell,18576,0.8958333333333334,1.1162790697674418
38766,/images/b426ef1d-4a59-4f90-b593-50226af60a60.png,683,509,786,599,103,90,red blood cell,9270,0.8737864077669902,1.1444444444444444
78624,/images/3612aa3b-2906-44a6-9c80-6144511a35ce.png,159,772,264,875,105,103,red blood cell,10815,0.9809523809523809,1.0194174757281553
9265,/images/261562a8-ffd8-4e0e-919b-22e267000b74.png,884,524,985,640,101,116,red blood cell,11716,1.1485148514851484,0.8706896551724138
76572,/images/38c69905-8a4f-451a-8d0a-b855dc88dd16.png,615,473,695,548,80,75,red blood cell,6000,0.9375,1.0666666666666667
26806,/images/2518f6e4-29cc-4ae4-a914-b215a4c56099.png,900,219,1004,348,104,129,red blood cell,13416,1.2403846153846154,0.8062015503875969
66948,/images/9acf303a-fcba-4e52-be3e-8d061aa5e72a.png,2,219,105,316,103,97,red blood cell,9991,0.941747572815534,1.0618556701030928
48560,/images/f3d84be2-8af0-4d62-9f72-23d3dc08cbbe.png,1002,1114,1131,1243,129,129,red blood cell,16641,1.0,1.0
16107,/images/66557580-fd38-4d4b-80d8-88611ecc78c6.png,342,1135,459,1258,117,123,red blood cell,14391,1.0512820512820513,0.9512195121951219
28523,/images/dbdfad64-110c-421f-a1c7-f68fd9e82d67.png,887,556,1005,665,118,109,red blood cell,12862,0.923728813559322,1.0825688073394495
29194,/images/6274fe0d-0d71-40be-b61b-f0bd5b5df1e2.png,838,148,949,249,111,101,red blood cell,11211,0.9099099099099099,1.099009900990099
29377,/images/30167dc1-f739-4036-b5c4-5fad435c2c67.png,871,1125,988,1235,117,110,red blood cell,12870,0.9401709401709402,1.0636363636363637
62932,/images/4b346035-b8c0-46ca-8fdb-a01b1421ee4a.png,111,44,214,143,103,99,red blood cell,10197,0.9611650485436893,1.0404040404040404
72104,/images/64b0e49a-0e48-447d-8872-c1dd255e7a21.png,1021,307,1104,396,83,89,red blood cell,7387,1.072289156626506,0.9325842696629213
46598,/images/edd09b2e-2673-4405-8ac0-e476e003e96a.png,653,872,780,981,127,109,red blood cell,13843,0.8582677165354331,1.165137614678899
45002,/images/13bab3c3-3f79-44d9-a287-0ae6d71eff31.png,733,1106,868,1222,135,116,red blood cell,15660,0.8592592592592593,1.1637931034482758
8785,/images/ae17a099-18b5-4a42-a901-850ea056423e.png,734,148,847,265,113,117,red blood cell,13221,1.0353982300884956,0.9658119658119658
54048,/images/d9345456-b76d-46cc-b81e-46d4a0a7b652.png,39,58,145,172,106,114,red blood cell,12084,1.0754716981132075,0.9298245614035088
33561,/images/255d5f0c-87fc-4337-bb51-07c440df4f1b.png,196,910,310,1017,114,107,red blood cell,12198,0.9385964912280702,1.0654205607476634
21927,/images/d57b3894-c912-47e8-b00a-e1a2a7aba644.png,495,99,605,211,110,112,red blood cell,12320,1.018181818181818,0.9821428571428571
69187,/images/f274b784-b995-4a7e-a2c2-6cc31c24c4b4.png,290,164,389,271,99,107,red blood cell,10593,1.0808080808080809,0.9252336448598131
74699,/images/5ccca8ee-abea-458a-a891-bedd31c3ddc3.png,642,908,743,1011,101,103,red blood cell,10403,1.0198019801980198,0.9805825242718447
34913,/images/a4fbb9f2-9b75-4fdc-877d-2feaafac25b3.png,395,12,496,116,101,104,red blood cell,10504,1.0297029702970297,0.9711538461538461
45018,/images/13bab3c3-3f79-44d9-a287-0ae6d71eff31.png,997,818,1097,942,100,124,red blood cell,12400,1.24,0.8064516129032258
33352,/images/f632981c-1330-4078-8a12-691beb2dab02.png,371,1161,466,1265,95,104,red blood cell,9880,1.0947368421052632,0.9134615384615384
37508,/images/205306da-0ed8-475a-ace6-f2f81d4be88a.png,742,946,850,1048,108,102,red blood cell,11016,0.9444444444444444,1.0588235294117647
3946,/images/f09acb0c-b270-4e91-99f8-410adfa7f34a.png,641,1435,738,1542,97,107,red blood cell,10379,1.1030927835051547,0.9065420560747663
60331,/images/1c87b997-a8e6-48ca-bf40-19b9a7fd6a96.png,890,651,999,770,109,119,red blood cell,12971,1.091743119266055,0.9159663865546218
35609,/images/45f18ac0-f097-4b20-a99d-8837cf488822.png,92,594,198,712,106,118,red blood cell,12508,1.1132075471698113,0.8983050847457628
25925,/images/4811fdf2-d7e8-475e-a840-45dda5282bf3.png,210,447,353,567,143,120,red blood cell,17160,0.8391608391608392,1.1916666666666667
43793,/images/ef83ed4c-2724-4d5f-8abe-1a18d25cea35.png,797,794,923,911,126,117,red blood cell,14742,0.9285714285714286,1.0769230769230769
42462,/images/29648565-fe28-4517-ba72-68df0c82c9c5.png,17,455,138,569,121,114,red blood cell,13794,0.9421487603305785,1.0614035087719298
71174,/images/4fac16e1-8e62-499b-a66b-c4c890372914.png,354,848,470,963,116,115,red blood cell,13340,0.9913793103448276,1.008695652173913
1742,/images/5f783f43-0090-4f8a-bd75-9562f4aa2dd5.png,1051,726,1142,827,91,101,red blood cell,9191,1.10989010989011,0.900990099009901
36572,/images/21f001d6-f568-4ea4-82da-fab54c77c419.png,1081,320,1168,421,87,101,red blood cell,8787,1.160919540229885,0.8613861386138614
47048,/images/997eabd9-55bf-4683-83c4-4cee4673a4ef.png,265,801,388,924,123,123,red blood cell,15129,1.0,1.0
17280,/images/3d302619-473d-4c5b-af43-8833ff94233f.png,866,171,975,280,109,109,red blood cell,11881,1.0,1.0
15516,/images/79f63258-24ce-4e69-a5cb-8529635a89a9.png,638,1004,745,1126,107,122,red blood cell,13054,1.1401869158878504,0.8770491803278688
61988,/images/bdb5d571-27bc-4a42-ae45-aa5a9af40a81.png,146,343,256,470,110,127,red blood cell,13970,1.1545454545454545,0.8661417322834646
62943,/images/4b346035-b8c0-46ca-8fdb-a01b1421ee4a.png,756,313,860,421,104,108,red blood cell,11232,1.0384615384615385,0.9629629629629629
51368,/images/b4f3b2a4-f4b9-48de-ac5d-0e681b77be27.png,376,1274,498,1376,122,102,red blood cell,12444,0.8360655737704918,1.196078431372549
15156,/images/3a8f468f-f9de-46a8-a7c8-f2be239fa207.png,232,793,350,908,118,115,red blood cell,13570,0.9745762711864406,1.0260869565217392
45207,/images/24879caf-a327-464c-9cd9-e0f3d9161079.png,222,832,352,956,130,124,red blood cell,16120,0.9538461538461539,1.0483870967741935
1885,/images/02ea7aa8-c142-4a3d-939f-e77689741341.png,338,1097,447,1209,109,112,red blood cell,12208,1.0275229357798166,0.9732142857142857
19598,/images/883d9731-a04d-4f84-83c9-d3bef954759d.png,526,906,668,1028,142,122,red blood cell,17324,0.8591549295774648,1.1639344262295082
49913,/images/05804cf0-f854-4099-97c2-df287f7c8a8c.png,113,462,218,565,105,103,red blood cell,10815,0.9809523809523809,1.0194174757281553
56487,/images/7dcc84ce-e8b4-46c8-9506-7c8ebda5da2f.png,631,1023,746,1135,115,112,red blood cell,12880,0.9739130434782609,1.0267857142857142
20581,/images/0f2a6cda-afec-437b-8803-8d3176b072c1.png,63,819,190,942,127,123,red blood cell,15621,0.968503937007874,1.032520325203252
28126,/images/cd2774a0-dab2-4d68-aae9-7568b9f3d2a6.png,680,861,796,979,116,118,red blood cell,13688,1.0172413793103448,0.9830508474576272
13327,/images/a7f1bbb1-6058-4642-bd66-cfb90dce762e.png,941,833,1039,949,98,116,red blood cell,11368,1.183673469387755,0.8448275862068966
56455,/images/d75933ed-d26e-4d1f-bda3-96bc0d77fb36.png,600,564,709,670,109,106,red blood cell,11554,0.9724770642201835,1.028301886792453
38510,/images/aa4a023b-55bd-4259-b15d-7086a9b491e0.png,652,748,784,861,132,113,red blood cell,14916,0.8560606060606061,1.168141592920354
28487,/images/dc4270fb-e5c2-414f-96e9-6769ba1d77e4.png,273,249,382,348,109,99,red blood cell,10791,0.908256880733945,1.101010101010101
35506,/images/3722d213-f2a9-46d5-aa76-9183b443e455.png,30,371,148,487,118,116,red blood cell,13688,0.9830508474576272,1.0172413793103448
76877,/images/2165fe38-b474-467d-be11-d1d728085efd.png,386,116,498,213,112,97,red blood cell,10864,0.8660714285714286,1.1546391752577319
1490,/images/0ac747cd-ff32-49bf-bc1a-3e9b7702ce9c.png,97,10,201,111,104,101,red blood cell,10504,0.9711538461538461,1.0297029702970297
25928,/images/e683144c-0465-43a2-86b1-3cf52599d5e0.png,1019,762,1121,845,102,83,red blood cell,8466,0.8137254901960784,1.2289156626506024
57585,/images/8190ec37-9a5e-419f-89ed-fbfb079370db.png,633,703,722,801,89,98,red blood cell,8722,1.101123595505618,0.9081632653061225
50319,/images/3d32a988-449d-4d58-b71f-abbfdc3f2fbc.png,1033,51,1149,168,116,117,red blood cell,13572,1.0086206896551724,0.9914529914529915
78618,/images/3612aa3b-2906-44a6-9c80-6144511a35ce.png,356,1281,461,1389,105,108,red blood cell,11340,1.0285714285714285,0.9722222222222222
58954,/images/a0eeeb10-d0cb-48d9-8c22-2c3a3c908d00.png,562,1205,695,1338,133,133,red blood cell,17689,1.0,1.0
31939,/images/9eb66577-7857-43dc-a879-8f2c9d7f780f.png,261,1390,362,1502,101,112,red blood cell,11312,1.108910891089109,0.9017857142857143
45272,/images/9e793460-d94c-47ac-b3a7-0d6ad86357da.png,361,210,500,347,139,137,red blood cell,19043,0.9856115107913669,1.0145985401459854
51721,/images/592c941a-aa54-4971-b499-dc47356f80a3.png,384,431,465,514,81,83,red blood cell,6723,1.0246913580246915,0.9759036144578314
49655,/images/bd7937db-fca2-44d0-8538-460110210927.png,404,1289,501,1394,97,105,red blood cell,10185,1.0824742268041236,0.9238095238095239
16364,/images/69569ecf-cfa1-4ddd-9342-b22c23387fdb.png,404,648,525,771,121,123,red blood cell,14883,1.0165289256198347,0.983739837398374
32627,/images/ed0d8763-e734-4506-b61b-53fc32a8d8c9.png,263,420,379,529,116,109,red blood cell,12644,0.9396551724137931,1.0642201834862386
59159,/images/4736f545-1f1f-4d77-9241-d69cbf4dae35.png,588,761,689,845,101,84,red blood cell,8484,0.8316831683168316,1.2023809523809523
74798,/images/91e93160-eb8d-4de0-b6bc-b98ec33d1663.png,542,515,637,619,95,104,red blood cell,9880,1.0947368421052632,0.9134615384615384
38736,/images/b426ef1d-4a59-4f90-b593-50226af60a60.png,1015,789,1133,911,118,122,red blood cell,14396,1.0338983050847457,0.9672131147540983
55013,/images/7beee655-6156-43b8-b185-dbae0eaf7f45.png,691,1125,789,1214,98,89,red blood cell,8722,0.9081632653061225,1.101123595505618
74230,/images/4e43fc22-dc08-4cde-b3ce-ce8a4f377c47.png,371,115,460,213,89,98,red blood cell,8722,1.101123595505618,0.9081632653061225
49994,/images/b1145408-feae-4637-b4cf-3e70b99cc62d.png,127,534,230,648,103,114,red blood cell,11742,1.1067961165048543,0.9035087719298246
29765,/images/7ef90770-6aeb-45eb-9744-49c5247dde30.png,208,747,333,860,125,113,red blood cell,14125,0.904,1.1061946902654867
16496,/images/9e5437c6-b0d3-473b-b7c3-8f5afeb90c7a.png,360,96,511,225,151,129,red blood cell,19479,0.8543046357615894,1.1705426356589148
68868,/images/6347dd6a-cfdf-4cb5-bc50-cff5403cfecb.png,669,1043,787,1154,118,111,red blood cell,13098,0.940677966101695,1.063063063063063
42575,/images/184b376b-03cb-4c2d-af51-fc1a62196293.png,1019,848,1148,982,129,134,red blood cell,17286,1.0387596899224807,0.9626865671641791
13505,/images/370277f8-436b-4103-8210-b4feb5ab95ea.png,1042,156,1118,236,76,80,red blood cell,6080,1.0526315789473684,0.95
70694,/images/8ab5c462-045e-4b59-b53a-9b2bc3ed2487.png,904,23,1012,145,108,122,red blood cell,13176,1.1296296296296295,0.8852459016393442
72070,/images/64b0e49a-0e48-447d-8872-c1dd255e7a21.png,437,1304,550,1422,113,118,red blood cell,13334,1.0442477876106195,0.9576271186440678
2614,/images/a23f5539-bfe6-4885-9a0e-dba972475ea9.png,702,533,788,624,86,91,red blood cell,7826,1.058139534883721,0.945054945054945
29767,/images/7ef90770-6aeb-45eb-9744-49c5247dde30.png,809,837,927,938,118,101,red blood cell,11918,0.8559322033898306,1.1683168316831682
39420,/images/fbcb2ef0-3c97-4d7a-8b96-0147c73f3941.png,660,1507,759,1600,99,93,red blood cell,9207,0.9393939393939394,1.064516129032258
947,/images/a8cb75ba-3f2f-40d8-8bc7-c79ebd1b9603.png,709,274,811,367,102,93,red blood cell,9486,0.9117647058823529,1.096774193548387
24613,/images/c03d9b87-e19b-402b-ad86-b30d6e8aeb59.png,764,203,873,328,109,125,red blood cell,13625,1.146788990825688,0.872
2673,/images/a2ccbf70-e444-49a9-8b7e-9797a05220d8.png,796,10,907,116,111,106,red blood cell,11766,0.954954954954955,1.0471698113207548
60362,/images/1c87b997-a8e6-48ca-bf40-19b9a7fd6a96.png,874,1238,969,1351,95,113,red blood cell,10735,1.1894736842105262,0.8407079646017699
73542,/images/7624ac36-1cf9-42fb-844d-376078309553.png,938,1455,1047,1572,109,117,red blood cell,12753,1.073394495412844,0.9316239316239316
20809,/images/c2ec116f-f091-422c-926c-70b548a8f6ef.png,169,926,261,1033,92,107,red blood cell,9844,1.1630434782608696,0.8598130841121495
19143,/images/bb795ddf-ce72-42d5-9006-124db4d5cf1c.png,635,1139,725,1235,90,96,red blood cell,8640,1.0666666666666667,0.9375
30663,/images/f939782b-f5a2-40a3-9c22-6c6d7e18edc3.png,655,518,769,639,114,121,red blood cell,13794,1.0614035087719298,0.9421487603305785
57943,/images/09bcedaa-e007-4692-a13f-ab02c3f872c4.png,540,1409,644,1512,104,103,red blood cell,10712,0.9903846153846154,1.0097087378640777
55289,/images/4fb83278-adc5-4424-9f45-b6d0db2955b6.png,601,1200,721,1314,120,114,red blood cell,13680,0.95,1.0526315789473684
36548,/images/21f001d6-f568-4ea4-82da-fab54c77c419.png,894,1297,1000,1394,106,97,red blood cell,10282,0.9150943396226415,1.092783505154639
43028,/images/1345dc89-a3d9-4b71-8a75-b3bff01ba518.png,763,869,881,979,118,110,red blood cell,12980,0.9322033898305084,1.0727272727272728
55847,/images/1893e0c5-88e9-4644-bd59-3e47bc53a88c.png,261,947,366,1038,105,91,red blood cell,9555,0.8666666666666667,1.1538461538461537
35171,/images/bfc61c48-685d-470b-86b1-e4c7eb85c4fd.png,1075,247,1196,381,121,134,red blood cell,16214,1.1074380165289257,0.9029850746268657
29014,/images/4c13e22e-dfd1-4fa1-b373-be9d0c272c0f.png,635,170,743,272,108,102,red blood cell,11016,0.9444444444444444,1.0588235294117647
5437,/images/75579b27-8191-4044-859b-268be969c42b.png,950,438,1060,567,110,129,red blood cell,14190,1.1727272727272726,0.8527131782945736
52491,/images/d1144956-5a0c-4bd2-b67d-8498c82d6a12.png,820,356,916,457,96,101,red blood cell,9696,1.0520833333333333,0.9504950495049505
47989,/images/eba73bff-fbe1-436d-9a5f-0a61331a0ea2.png,531,946,623,1044,92,98,red blood cell,9016,1.065217391304348,0.9387755102040817
74106,/images/9fe8bdc8-847d-434e-93e5-ae14ff3b45e1.png,688,611,798,723,110,112,red blood cell,12320,1.018181818181818,0.9821428571428571
55638,/images/c32b8bb8-c89d-4ae9-9c77-5b9356ca35a1.png,623,92,745,220,122,128,red blood cell,15616,1.0491803278688525,0.953125
29107,/images/4c13e22e-dfd1-4fa1-b373-be9d0c272c0f.png,580,680,668,767,88,87,red blood cell,7656,0.9886363636363636,1.0114942528735633
9087,/images/21c2a8aa-407c-4569-8212-96fcafa84138.png,1066,1094,1182,1216,116,122,red blood cell,14152,1.0517241379310345,0.9508196721311475
3982,/images/f09acb0c-b270-4e91-99f8-410adfa7f34a.png,700,1042,791,1129,91,87,red blood cell,7917,0.9560439560439561,1.0459770114942528
45035,/images/13bab3c3-3f79-44d9-a287-0ae6d71eff31.png,957,1048,1063,1147,106,99,red blood cell,10494,0.9339622641509434,1.0707070707070707
46896,/images/9e0e1928-d19a-4100-b093-0b962ac09e05.png,32,1264,143,1371,111,107,red blood cell,11877,0.963963963963964,1.0373831775700935
16655,/images/bc377041-e098-45c4-9651-2b1ea90d1d7e.png,534,1201,651,1313,117,112,red blood cell,13104,0.9572649572649573,1.0446428571428572
14623,/images/c649e1cb-4029-4433-b231-d67d68f7391a.png,444,1048,587,1173,143,125,red blood cell,17875,0.8741258741258742,1.144
33575,/images/255d5f0c-87fc-4337-bb51-07c440df4f1b.png,730,652,853,772,123,120,red blood cell,14760,0.975609756097561,1.025
75777,/images/f48bf825-13c4-42fc-8dd8-10cc4ae6b202.png,88,561,179,648,91,87,red blood cell,7917,0.9560439560439561,1.0459770114942528
32116,/images/9258fe22-6406-4d00-b6f0-3f9492925405.png,8,537,122,660,114,123,red blood cell,14022,1.0789473684210527,0.926829268292683
34720,/images/6294153c-6db3-4f2b-a8ff-9c087225e737.png,92,999,192,1105,100,106,red blood cell,10600,1.06,0.9433962264150944
24708,/images/78a5d1c3-44dd-44bc-ad5b-5e25bdcc4fae.png,1036,366,1145,480,109,114,red blood cell,12426,1.0458715596330275,0.956140350877193
39,/images/8d02117d-6c71-4e47-b50a-6cc8d5eb1d55.png,332,1206,434,1306,102,100,red blood cell,10200,0.9803921568627451,1.02
70637,/images/7521ec48-57b5-48a8-a5d6-8280ad5da19c.png,329,467,435,585,106,118,red blood cell,12508,1.1132075471698113,0.8983050847457628
1896,/images/02ea7aa8-c142-4a3d-939f-e77689741341.png,1071,500,1192,613,121,113,red blood cell,13673,0.9338842975206612,1.0707964601769913
66494,/images/b87fb62d-2c36-4f68-aba9-37fcd7d46eef.png,334,36,436,138,102,102,red blood cell,10404,1.0,1.0
29919,/images/f2a8a483-b254-43aa-817f-7d525adb8911.png,565,1143,678,1244,113,101,red blood cell,11413,0.8938053097345132,1.118811881188119
13692,/images/0b04ec46-5119-4cda-8c35-c4e5b6f0eed0.png,399,1027,527,1142,128,115,red blood cell,14720,0.8984375,1.1130434782608696
19733,/images/627d6331-7bb9-4d1a-b20d-e6541af4d0f9.png,408,934,499,1047,91,113,red blood cell,10283,1.2417582417582418,0.8053097345132744
2981,/images/5a386082-397f-4524-a6f9-c2b8efe5014d.png,837,950,940,1067,103,117,red blood cell,12051,1.1359223300970873,0.8803418803418803
49437,/images/f2574be3-81c6-4fc3-8a40-0230d1264f52.png,146,208,237,310,91,102,red blood cell,9282,1.120879120879121,0.8921568627450981
58012,/images/a7c91b63-b97c-4f4b-8d34-7ad2b08d7a17.png,440,279,563,398,123,119,red blood cell,14637,0.967479674796748,1.0336134453781514
46416,/images/bbecf1a8-a728-4c83-87f8-4dfbac0a1e03.png,131,26,243,143,112,117,red blood cell,13104,1.0446428571428572,0.9572649572649573
71310,/images/bcb447c9-5d37-414f-a513-d7076b04a532.png,133,1080,233,1173,100,93,red blood cell,9300,0.93,1.075268817204301
68820,/images/aa3ad405-828e-4986-8251-20fd981f34d3.png,269,680,374,785,105,105,red blood cell,11025,1.0,1.0
27645,/images/a0785022-e82b-4878-b9d4-19cb7b75213f.png,713,1141,816,1248,103,107,red blood cell,11021,1.0388349514563107,0.9626168224299065
38437,/images/674b0fd3-f247-4b7f-97f7-3e6c57c9ba9e.png,268,1340,359,1442,91,102,red blood cell,9282,1.120879120879121,0.8921568627450981
12543,/images/8e4bdd0d-1c72-4836-ae3e-05e2e50e4983.png,251,1422,367,1549,116,127,red blood cell,14732,1.0948275862068966,0.9133858267716536
33248,/images/877d5e7f-19b6-40e7-81bd-c92f25e72503.png,875,994,995,1118,120,124,red blood cell,14880,1.0333333333333334,0.967741935483871
17881,/images/eb77e4a9-acb0-4d83-8055-2c5fcaa54b45.png,617,1170,715,1262,98,92,red blood cell,9016,0.9387755102040817,1.065217391304348
12142,/images/87d6343b-70dd-4cdd-939f-d3ac0ca2e700.png,252,834,360,945,108,111,red blood cell,11988,1.0277777777777777,0.972972972972973
50560,/images/e98ea067-82b5-4a0d-87bf-b4bbdc10ddab.png,1026,1164,1135,1282,109,118,red blood cell,12862,1.0825688073394495,0.923728813559322
49359,/images/28c96a4a-4549-4761-99e4-ace4ea7e7ac9.png,584,396,695,521,111,125,red blood cell,13875,1.1261261261261262,0.888
26474,/images/cdb086a8-2bf8-4436-b1ef-96cdd801f247.png,484,1477,589,1574,105,97,red blood cell,10185,0.9238095238095239,1.0824742268041236
18299,/images/9ca20b10-e2fd-4bd2-93ef-78298f763ed5.png,161,351,269,476,108,125,red blood cell,13500,1.1574074074074074,0.864
7042,/images/8be185e7-2a1a-441c-a5c7-b50a9eb926cb.png,147,161,250,273,103,112,red blood cell,11536,1.087378640776699,0.9196428571428571
52537,/images/d1144956-5a0c-4bd2-b67d-8498c82d6a12.png,251,646,351,756,100,110,red blood cell,11000,1.1,0.9090909090909091
8506,/images/dfc026a9-079f-4f45-8666-e0ccba5bb437.png,832,335,946,455,114,120,red blood cell,13680,1.0526315789473684,0.95
79999,/images/e640ae51-cbf1-4a84-b7cf-d38b17f59c2f.png,249,1489,336,1576,87,87,red blood cell,7569,1.0,1.0
8104,/images/694222bb-cddf-469a-9526-f873c6fba58e.png,1072,855,1172,937,100,82,red blood cell,8200,0.82,1.2195121951219512
22088,/images/ac4d6507-d710-497b-ad7c-e0dd75c1d06d.png,48,612,184,744,136,132,red blood cell,17952,0.9705882352941176,1.0303030303030303
47006,/images/9ebd623d-5534-4dd9-bff8-cdedf322db35.png,306,188,412,296,106,108,red blood cell,11448,1.0188679245283019,0.9814814814814815
3384,/images/fd1302e2-3cd2-4a1a-9c13-00f810a9c41b.png,950,1090,1042,1187,92,97,red blood cell,8924,1.0543478260869565,0.9484536082474226
11719,/images/082e1f81-4f49-44ad-b5bb-9dfc155b2ed8.png,135,83,246,180,111,97,red blood cell,10767,0.8738738738738738,1.1443298969072164
64499,/images/6ba5d0b8-cdc7-4266-9d78-db76faa312e9.png,658,1446,770,1540,112,94,red blood cell,10528,0.8392857142857143,1.1914893617021276
10556,/images/9fbf38ab-44b9-4096-a818-603017a4300e.png,629,7,771,138,142,131,red blood cell,18602,0.9225352112676056,1.083969465648855
65153,/images/5e042380-6ef2-496f-8231-0ca550fbfa71.png,569,5,653,91,84,86,red blood cell,7224,1.0238095238095237,0.9767441860465116
19849,/images/b318889c-3c60-477c-b8f6-d18cb01a59df.png,1095,292,1192,386,97,94,red blood cell,9118,0.9690721649484536,1.0319148936170213
45168,/images/2596eb32-1323-41e9-8c0f-64819abcfc73.png,24,1002,128,1120,104,118,red blood cell,12272,1.1346153846153846,0.8813559322033898
78215,/images/2bed2796-75a9-4d93-bb2d-e3ccbe1a5cbe.png,67,119,165,240,98,121,red blood cell,11858,1.2346938775510203,0.8099173553719008
74367,/images/06a3effb-996c-4767-afd2-6aa3b697cb4e.png,1054,703,1156,807,102,104,red blood cell,10608,1.0196078431372548,0.9807692307692307
71545,/images/b9c6db13-ca3a-4937-8ecf-e537047ed858.png,554,240,671,354,117,114,red blood cell,13338,0.9743589743589743,1.0263157894736843
37215,/images/71881a39-a30c-40c7-8c4a-9f64c93e79d9.png,180,869,295,997,115,128,red blood cell,14720,1.1130434782608696,0.8984375
15221,/images/3a8f468f-f9de-46a8-a7c8-f2be239fa207.png,421,590,500,676,79,86,red blood cell,6794,1.0886075949367089,0.9186046511627907
15455,/images/1b7f47fc-26cd-4273-b848-88a7cbfd9f85.png,278,124,381,245,103,121,red blood cell,12463,1.174757281553398,0.8512396694214877
33802,/images/cb08956d-dd6a-4e13-817b-40a0a93068f1.png,588,571,678,680,90,109,red blood cell,9810,1.211111111111111,0.8256880733944955
77334,/images/3ff98212-7c2a-46cd-afb7-34a2479bed07.png,810,362,905,455,95,93,red blood cell,8835,0.9789473684210527,1.021505376344086
1625,/images/7094c11a-1e62-4f98-894e-d17d138a88e9.png,881,902,1002,1020,121,118,red blood cell,14278,0.9752066115702479,1.0254237288135593
23425,/images/8757be1e-b832-407a-8e95-62abae485b24.png,524,864,609,948,85,84,red blood cell,7140,0.9882352941176471,1.0119047619047619
38080,/images/907650b5-edae-471d-bc54-a825be3d3fac.png,940,672,1051,794,111,122,red blood cell,13542,1.0990990990990992,0.9098360655737705
64764,/images/76021d69-8919-4688-95ef-7418eff620cc.png,297,1142,419,1286,122,144,red blood cell,17568,1.180327868852459,0.8472222222222222
42171,/images/04c07425-57c7-415c-a0bc-36857bbd4049.png,1072,1148,1191,1267,119,119,red blood cell,14161,1.0,1.0
52844,/images/58f7e1da-3478-48f4-958c-e9b1cb8696aa.png,1017,1265,1142,1382,125,117,red blood cell,14625,0.936,1.0683760683760684
11891,/images/2e8d6a43-0110-4bf4-8e70-20567e513b81.png,904,1328,1005,1430,101,102,red blood cell,10302,1.00990099009901,0.9901960784313726
58765,/images/e4827c85-311a-4df1-89c2-99dad0c3558c.png,679,128,769,219,90,91,red blood cell,8190,1.011111111111111,0.989010989010989
67998,/images/bcaefb02-682a-41b9-acc7-e6cc010f5b30.png,70,1464,160,1559,90,95,red blood cell,8550,1.0555555555555556,0.9473684210526315
2533,/images/a23f5539-bfe6-4885-9a0e-dba972475ea9.png,288,1502,393,1597,105,95,red blood cell,9975,0.9047619047619048,1.105263157894737
25827,/images/14b68d86-ac7f-419d-b4a5-6b0b1d9aaa18.png,1080,1466,1187,1587,107,121,red blood cell,12947,1.1308411214953271,0.8842975206611571
13981,/images/31af9c31-7868-44a6-8eb4-82ce118af425.png,904,226,1021,353,117,127,red blood cell,14859,1.0854700854700854,0.9212598425196851
53219,/images/d8f7e159-b7e3-49e4-86e8-aed8c5fbcd97.png,210,52,307,152,97,100,red blood cell,9700,1.0309278350515463,0.97
21924,/images/d57b3894-c912-47e8-b00a-e1a2a7aba644.png,633,41,751,158,118,117,red blood cell,13806,0.9915254237288136,1.0085470085470085
19345,/images/b4d22412-a495-43a9-bec0-73a2322f8dad.png,601,349,704,443,103,94,red blood cell,9682,0.912621359223301,1.0957446808510638
75866,/images/3006096f-ceeb-42be-b69e-785179d7438b.png,45,592,149,712,104,120,red blood cell,12480,1.1538461538461537,0.8666666666666667
27477,/images/f5869ba8-6253-426b-93f3-82af59a86144.png,333,19,438,132,105,113,red blood cell,11865,1.0761904761904761,0.9292035398230089
77222,/images/fe691faa-3bc7-475e-b558-aa8fe7b795bc.png,1087,689,1199,784,112,95,red blood cell,10640,0.8482142857142857,1.1789473684210525
23767,/images/6b2ff7ca-c5b3-415c-9481-7b14efc6d7ef.png,1053,1029,1171,1145,118,116,red blood cell,13688,0.9830508474576272,1.0172413793103448
18831,/images/d1b48634-9ad5-46e8-b816-42d1d97c93cd.png,157,160,270,265,113,105,red blood cell,11865,0.9292035398230089,1.0761904761904761
24898,/images/ed0bee2f-05e0-4392-8357-19750cec577c.png,266,839,388,944,122,105,red blood cell,12810,0.860655737704918,1.161904761904762
38064,/images/e3e9c2de-0a24-4c7e-8a69-3d3093d5bdab.png,811,236,907,347,96,111,red blood cell,10656,1.15625,0.8648648648648649
65928,/images/d7581cb0-7a12-471d-a3d8-68dcea362213.png,141,265,220,354,79,89,red blood cell,7031,1.1265822784810127,0.8876404494382022
16663,/images/bc377041-e098-45c4-9651-2b1ea90d1d7e.png,715,1192,848,1315,133,123,red blood cell,16359,0.924812030075188,1.08130081300813
59630,/images/a2754679-68b0-40f4-be01-bafad5ac1261.png,621,550,719,639,98,89,red blood cell,8722,0.9081632653061225,1.101123595505618
30163,/images/a1669b59-fe09-4fe6-ba9f-06bec6725502.png,392,756,496,867,104,111,red blood cell,11544,1.0673076923076923,0.9369369369369369
60029,/images/49288109-80e9-4ec8-96d1-26a0166b8883.png,342,42,439,154,97,112,red blood cell,10864,1.1546391752577319,0.8660714285714286
27517,/images/f5869ba8-6253-426b-93f3-82af59a86144.png,166,1436,265,1539,99,103,red blood cell,10197,1.0404040404040404,0.9611650485436893
10799,/images/2a02cec2-a09b-483a-ad38-14359a763fa4.png,769,965,888,1083,119,118,red blood cell,14042,0.9915966386554622,1.0084745762711864
63404,/images/289ef1b7-02d5-42e9-a401-687688181306.png,556,958,668,1064,112,106,red blood cell,11872,0.9464285714285714,1.0566037735849056
55739,/images/c32b8bb8-c89d-4ae9-9c77-5b9356ca35a1.png,1093,1493,1189,1582,96,89,red blood cell,8544,0.9270833333333334,1.0786516853932584
20974,/images/0403835d-43f4-4a97-abfc-b2ff915f6d7b.png,21,927,152,1060,131,133,red blood cell,17423,1.015267175572519,0.9849624060150376
62213,/images/a72cd558-b7ac-4bf2-a344-2ce6c73a354e.png,956,162,1042,267,86,105,red blood cell,9030,1.2209302325581395,0.819047619047619
69511,/images/664c570b-4822-413c-9724-11b1d91fac44.png,1100,417,1183,500,83,83,red blood cell,6889,1.0,1.0
12297,/images/3b55c42f-ad59-422f-ba99-4f4f4ca9cb2e.png,867,1218,969,1325,102,107,red blood cell,10914,1.0490196078431373,0.9532710280373832
62842,/images/4b346035-b8c0-46ca-8fdb-a01b1421ee4a.png,375,593,486,697,111,104,red blood cell,11544,0.9369369369369369,1.0673076923076923
66930,/images/9acf303a-fcba-4e52-be3e-8d061aa5e72a.png,954,1129,1049,1236,95,107,red blood cell,10165,1.1263157894736842,0.8878504672897196
53150,/images/801296d9-3403-426f-859e-5c532858e025.png,473,1100,587,1211,114,111,red blood cell,12654,0.9736842105263158,1.027027027027027
9599,/images/239f17eb-a2e2-47e9-82e3-fa0d9a70fb9f.png,113,281,229,423,116,142,red blood cell,16472,1.2241379310344827,0.8169014084507042
15298,/images/2d0f600d-f94e-4907-b712-52fb37d9ed52.png,372,860,487,979,115,119,red blood cell,13685,1.0347826086956522,0.9663865546218487
17634,/images/70a95e58-ba60-4c1f-adcd-49c198dc2ba0.png,54,33,166,139,112,106,red blood cell,11872,0.9464285714285714,1.0566037735849056
43490,/images/2d857091-efcd-41c0-ba3f-226de90445c4.png,437,1410,553,1514,116,104,red blood cell,12064,0.896551724137931,1.1153846153846154
27181,/images/f232eec3-02c0-43f9-bf32-3e60245397e2.png,856,1206,981,1321,125,115,red blood cell,14375,0.92,1.0869565217391304
58398,/images/7eae1169-e294-4594-8e03-1366d23ff2d1.png,680,534,779,631,99,97,red blood cell,9603,0.9797979797979798,1.0206185567010309
53034,/images/42e87148-a015-4148-923a-fb83016f64e7.png,1107,427,1199,527,92,100,red blood cell,9200,1.0869565217391304,0.92
61764,/images/985627c9-7b85-40de-a106-eb9cc47b47cb.png,669,79,755,163,86,84,red blood cell,7224,0.9767441860465116,1.0238095238095237
4864,/images/c6ab535c-30e5-4b6b-8273-1ec8d78cdd13.png,605,453,721,586,116,133,red blood cell,15428,1.146551724137931,0.8721804511278195
11944,/images/f8a8b148-60e4-4a5c-ae19-941b19ec0846.png,761,894,862,987,101,93,red blood cell,9393,0.9207920792079208,1.086021505376344
36500,/images/bd856928-96ee-4fc4-a377-f2fc4e84448b.png,898,733,1000,840,102,107,red blood cell,10914,1.0490196078431373,0.9532710280373832
68944,/images/bbaa004f-05dc-4cb8-8768-e148085bb0f9.png,937,1365,1058,1480,121,115,red blood cell,13915,0.9504132231404959,1.0521739130434782
14898,/images/3090a362-1f3d-49e9-a76e-ce76ff9c2276.png,347,1378,460,1476,113,98,red blood cell,11074,0.8672566371681416,1.153061224489796
20577,/images/0f2a6cda-afec-437b-8803-8d3176b072c1.png,58,943,184,1061,126,118,red blood cell,14868,0.9365079365079365,1.0677966101694916
18155,/images/947348fe-4c70-468e-8009-3c14daeca69b.png,455,464,574,578,119,114,red blood cell,13566,0.957983193277311,1.043859649122807
78102,/images/105af41b-13cc-4ad1-8a1f-8bc4d47cdd94.png,871,131,981,247,110,116,red blood cell,12760,1.0545454545454545,0.9482758620689655
14643,/images/9d155086-acf5-4c86-a9e1-94b587c46e87.png,868,162,978,269,110,107,red blood cell,11770,0.9727272727272728,1.02803738317757
9154,/images/d3ed519e-2152-4e30-838d-a3ea23be512f.png,475,1253,594,1376,119,123,red blood cell,14637,1.0336134453781514,0.967479674796748
25637,/images/770b8ca4-8377-479b-9ad5-5455ec3b44f8.png,634,1442,757,1561,123,119,red blood cell,14637,0.967479674796748,1.0336134453781514
72339,/images/ee57e743-a876-4f69-9fe5-bf5d01b44689.png,108,1037,224,1165,116,128,red blood cell,14848,1.103448275862069,0.90625
21443,/images/b701b5c5-b922-4315-b12a-aac4ec65ee8b.png,805,1311,916,1432,111,121,red blood cell,13431,1.09009009009009,0.9173553719008265
16155,/images/1e978dfa-d339-4025-809d-09cee76728ed.png,78,659,207,780,129,121,red blood cell,15609,0.937984496124031,1.0661157024793388
15783,/images/64113b22-03b1-4ab8-89ab-b2f32154fbbd.png,411,740,502,847,91,107,red blood cell,9737,1.1758241758241759,0.8504672897196262
70964,/images/deaa1931-5f97-45bf-8c00-be6ddeb37b9a.png,882,541,972,629,90,88,red blood cell,7920,0.9777777777777777,1.0227272727272727
64889,/images/dec61ae1-5037-4c3a-8952-15371becca7d.png,1033,1094,1144,1209,111,115,red blood cell,12765,1.0360360360360361,0.9652173913043478
65969,/images/25c6cfb1-01d0-4864-87f9-02b7593683c7.png,1067,761,1163,862,96,101,red blood cell,9696,1.0520833333333333,0.9504950495049505
441,/images/84c88143-940d-4b62-bbd2-7acc4cadcb6b.png,301,1398,418,1525,117,127,red blood cell,14859,1.0854700854700854,0.9212598425196851
29731,/images/f25a2ac8-cb6e-4e05-a0cd-cc00ac47718a.png,455,1263,552,1379,97,116,red blood cell,11252,1.1958762886597938,0.8362068965517241
2804,/images/e79bd81b-f878-4bee-9be2-d91a722c031e.png,142,81,236,162,94,81,red blood cell,7614,0.8617021276595744,1.1604938271604939
78852,/images/4d0a1598-e4dd-45c4-8a90-dd7c780fe1da.png,517,57,624,159,107,102,red blood cell,10914,0.9532710280373832,1.0490196078431373
50270,/images/3d32a988-449d-4d58-b71f-abbfdc3f2fbc.png,836,1357,933,1442,97,85,red blood cell,8245,0.8762886597938144,1.1411764705882352
54943,/images/f1872d08-f8a6-4b21-aa29-f56bbf607883.png,313,1225,403,1327,90,102,red blood cell,9180,1.1333333333333333,0.8823529411764706
44594,/images/6388e241-09a2-4fbe-a712-07d8fe714c51.png,227,862,350,986,123,124,red blood cell,15252,1.008130081300813,0.9919354838709677
65683,/images/397f37bc-a3a4-4257-9430-c8fc5716f8b1.png,573,63,671,184,98,121,red blood cell,11858,1.2346938775510203,0.8099173553719008
14732,/images/1fdf99d1-a494-4174-bcd7-efbe457ab899.png,378,554,497,685,119,131,red blood cell,15589,1.1008403361344539,0.9083969465648855
64789,/images/a74b6d6a-7e04-40ac-9292-d62f13f7ded3.png,497,900,607,1015,110,115,red blood cell,12650,1.0454545454545454,0.9565217391304348
50229,/images/3d32a988-449d-4d58-b71f-abbfdc3f2fbc.png,95,918,205,1020,110,102,red blood cell,11220,0.9272727272727272,1.0784313725490196
51506,/images/baa87bf8-786c-444c-81e8-9fa0a41d8149.png,303,1178,395,1284,92,106,red blood cell,9752,1.1521739130434783,0.8679245283018868
67991,/images/bcaefb02-682a-41b9-acc7-e6cc010f5b30.png,617,35,720,136,103,101,red blood cell,10403,0.9805825242718447,1.0198019801980198
61286,/images/b3058064-d817-47dd-a8c4-cdb1f62374f8.png,451,658,553,758,102,100,red blood cell,10200,0.9803921568627451,1.02
24677,/images/30948737-0d0d-4b68-b9ab-50577e0fe026.png,176,174,287,289,111,115,red blood cell,12765,1.0360360360360361,0.9652173913043478
57413,/images/00d04a90-80e5-4bce-9511-1b64eabb7a47.png,312,800,425,914,113,114,red blood cell,12882,1.008849557522124,0.9912280701754386
24116,/images/505355c9-23bf-4f90-8ebc-6a7ef50964d0.png,422,1425,547,1540,125,115,red blood cell,14375,0.92,1.0869565217391304
53706,/images/6f67a66b-56ec-4c36-ae7c-f250d3b86a23.png,370,1158,470,1247,100,89,red blood cell,8900,0.89,1.1235955056179776
63202,/images/f0804a5e-e7f5-4cf2-a5df-b65e66502bf1.png,426,1250,535,1365,109,115,red blood cell,12535,1.055045871559633,0.9478260869565217
69345,/images/2ac343e4-c889-47c1-8fe2-461b626def76.png,602,1241,717,1360,115,119,red blood cell,13685,1.0347826086956522,0.9663865546218487
52368,/images/a2a20600-f851-4db7-90f9-6f7be027c8b5.png,1045,614,1152,727,107,113,red blood cell,12091,1.0560747663551402,0.9469026548672567
8200,/images/6bb4892c-27a9-4642-aba1-4b73f38f757c.png,917,21,1028,132,111,111,red blood cell,12321,1.0,1.0
16570,/images/c7045ab6-230e-4c1e-a8e0-f624d41a00d9.png,624,933,736,1048,112,115,red blood cell,12880,1.0267857142857142,0.9739130434782609
17513,/images/56077789-8580-41b4-89d6-deea227e5c60.png,138,1445,233,1556,95,111,red blood cell,10545,1.168421052631579,0.8558558558558559
54521,/images/db871d17-28fd-4ceb-b421-e4e4afa0a7a0.png,306,249,417,354,111,105,red blood cell,11655,0.9459459459459459,1.0571428571428572
62893,/images/4b346035-b8c0-46ca-8fdb-a01b1421ee4a.png,111,188,211,290,100,102,red blood cell,10200,1.02,0.9803921568627451
56442,/images/d75933ed-d26e-4d1f-bda3-96bc0d77fb36.png,1074,913,1176,1026,102,113,red blood cell,11526,1.107843137254902,0.9026548672566371
13497,/images/370277f8-436b-4103-8210-b4feb5ab95ea.png,379,864,464,965,85,101,red blood cell,8585,1.188235294117647,0.8415841584158416
12592,/images/8e4bdd0d-1c72-4836-ae3e-05e2e50e4983.png,932,956,1045,1047,113,91,red blood cell,10283,0.8053097345132744,1.2417582417582418
24559,/images/c03d9b87-e19b-402b-ad86-b30d6e8aeb59.png,116,528,216,612,100,84,red blood cell,8400,0.84,1.1904761904761905
13987,/images/eaf4b781-b3aa-41ce-8c5e-287979b4e15a.png,235,297,338,402,103,105,red blood cell,10815,1.0194174757281553,0.9809523809523809
30093,/images/81c3c8f0-d5a9-4dda-afd5-e86f6afd9424.png,124,526,235,633,111,107,red blood cell,11877,0.963963963963964,1.0373831775700935
45103,/images/56fbae44-4677-47f8-9c3a-22dac043c115.png,815,1175,926,1281,111,106,red blood cell,11766,0.954954954954955,1.0471698113207548
29741,/images/f25a2ac8-cb6e-4e05-a0cd-cc00ac47718a.png,271,32,379,166,108,134,red blood cell,14472,1.2407407407407407,0.8059701492537313
30461,/images/5955289d-19e5-45ef-a012-c8ea08ef45e2.png,319,1289,439,1422,120,133,red blood cell,15960,1.1083333333333334,0.9022556390977443
42628,/images/184b376b-03cb-4c2d-af51-fc1a62196293.png,40,451,134,553,94,102,red blood cell,9588,1.0851063829787233,0.9215686274509803
49069,/images/df3d98b9-3dd7-4107-8d4a-ae1b7f247793.png,554,750,644,860,90,110,red blood cell,9900,1.2222222222222223,0.8181818181818182
24900,/images/ed0bee2f-05e0-4392-8357-19750cec577c.png,935,1079,1033,1175,98,96,red blood cell,9408,0.9795918367346939,1.0208333333333333
5935,/images/e0e6b676-c39c-4542-8adf-de257a8e92e2.png,361,200,498,327,137,127,red blood cell,17399,0.927007299270073,1.078740157480315
37121,/images/d6942996-5664-4370-ad87-2bdcbd49ac16.png,1020,314,1137,444,117,130,red blood cell,15210,1.1111111111111112,0.9
41984,/images/46a03374-64c7-49ac-81c9-c3d62542bbf3.png,228,167,327,268,99,101,red blood cell,9999,1.02020202020202,0.9801980198019802
43150,/images/c5db0fc0-b96c-496e-90b4-f9fb1b85b28e.png,311,1002,427,1101,116,99,red blood cell,11484,0.853448275862069,1.1717171717171717
76028,/images/4c7d2382-a962-4237-a053-955eea3decd8.png,799,312,896,408,97,96,red blood cell,9312,0.9896907216494846,1.0104166666666667
51011,/images/cc275c45-7511-4070-84af-10b8ffebda53.png,143,0,264,135,121,135,red blood cell,16335,1.115702479338843,0.8962962962962963
37288,/images/2fdbd9bc-bbaf-44c2-b40c-d193709639fa.png,226,1298,341,1430,115,132,red blood cell,15180,1.1478260869565218,0.8712121212121212
2639,/images/a2ccbf70-e444-49a9-8b7e-9797a05220d8.png,915,1072,1042,1183,127,111,red blood cell,14097,0.8740157480314961,1.1441441441441442
27268,/images/9f38055f-4fe6-47fd-a6dd-c0743db4eccf.png,710,16,829,130,119,114,red blood cell,13566,0.957983193277311,1.043859649122807
11402,/images/b5513d5b-46fc-4f44-a616-791087fbd608.png,167,728,276,857,109,129,red blood cell,14061,1.18348623853211,0.8449612403100775
31291,/images/31c749e8-18d1-4105-b7e6-8319cceddae0.png,288,1230,397,1334,109,104,red blood cell,11336,0.9541284403669725,1.0480769230769231
52625,/images/a6fe423a-5204-4378-bcfa-d6d298a3e9aa.png,127,600,238,720,111,120,red blood cell,13320,1.0810810810810811,0.925
54000,/images/5e4f7425-11e6-4f9e-be2d-5a27deb9d1b4.png,173,1066,284,1183,111,117,red blood cell,12987,1.054054054054054,0.9487179487179487
48087,/images/05717db9-f1ef-4101-a9f7-7a007e83b1c9.png,702,179,816,275,114,96,red blood cell,10944,0.8421052631578947,1.1875
12104,/images/984caf56-f400-4a29-be97-a4d6b9d1468d.png,1011,1260,1142,1384,131,124,red blood cell,16244,0.9465648854961832,1.0564516129032258
56308,/images/6b473806-e936-4b19-98cf-a2b94cac35ff.png,913,1442,1029,1548,116,106,red blood cell,12296,0.9137931034482759,1.0943396226415094
24593,/images/c03d9b87-e19b-402b-ad86-b30d6e8aeb59.png,165,755,259,851,94,96,red blood cell,9024,1.0212765957446808,0.9791666666666666
69803,/images/2bd15b6e-fe2d-49f3-b394-940d024d1f91.png,290,749,379,841,89,92,red blood cell,8188,1.0337078651685394,0.967391304347826
55976,/images/4c460388-e0c1-4970-8527-c9e5b42bea49.png,395,204,512,323,117,119,red blood cell,13923,1.017094017094017,0.9831932773109243
22116,/images/ca677c3c-083f-4d54-9dec-39f79f6a17d8.png,1020,746,1138,860,118,114,red blood cell,13452,0.9661016949152542,1.0350877192982457
60390,/images/1c87b997-a8e6-48ca-bf40-19b9a7fd6a96.png,71,750,172,841,101,91,red blood cell,9191,0.900990099009901,1.10989010989011
4479,/images/cf90d82f-2814-4fb7-a3ff-a86b7c5efca7.png,191,980,314,1112,123,132,red blood cell,16236,1.0731707317073171,0.9318181818181818
46369,/images/fcc2b245-f47f-447f-8527-275b0005677c.png,787,971,907,1099,120,128,red blood cell,15360,1.0666666666666667,0.9375
72507,/images/22516db4-8687-4051-90c4-2bb1ca3204a5.png,355,715,466,839,111,124,red blood cell,13764,1.117117117117117,0.8951612903225806
36195,/images/17c06a23-bb77-49cb-9ffb-fbfc75fcc715.png,178,112,283,221,105,109,red blood cell,11445,1.0380952380952382,0.963302752293578
58057,/images/a7c91b63-b97c-4f4b-8d34-7ad2b08d7a17.png,1042,1178,1135,1258,93,80,red blood cell,7440,0.8602150537634409,1.1625
55956,/images/afd39466-aafa-4d81-9520-483727418723.png,184,895,272,986,88,91,red blood cell,8008,1.0340909090909092,0.967032967032967
19977,/images/8e69098c-fae0-47a3-8833-c2bfdfb1a416.png,999,146,1107,261,108,115,red blood cell,12420,1.0648148148148149,0.9391304347826087
23726,/images/79d7a014-21ff-40f1-9ac4-a69839390654.png,487,770,594,864,107,94,red blood cell,10058,0.8785046728971962,1.1382978723404256
2152,/images/e94a811d-3145-4313-ba42-2d5ed283179f.png,1088,257,1191,354,103,97,red blood cell,9991,0.941747572815534,1.0618556701030928
8998,/images/ef815e3a-02a6-4cf8-9262-45bc74c50b00.png,293,918,399,1036,106,118,red blood cell,12508,1.1132075471698113,0.8983050847457628
41230,/images/eed298b3-35f2-4127-88ad-0c4a9062207b.png,1069,39,1165,129,96,90,red blood cell,8640,0.9375,1.0666666666666667
50046,/images/b1145408-feae-4637-b4cf-3e70b99cc62d.png,483,601,604,725,121,124,red blood cell,15004,1.024793388429752,0.9758064516129032
30366,/images/58d75854-be99-484e-89f0-4ab208fe07e0.png,1022,1292,1134,1411,112,119,red blood cell,13328,1.0625,0.9411764705882353
50405,/images/f01f6659-2114-4801-9d28-1f411432a589.png,784,1041,886,1146,102,105,red blood cell,10710,1.0294117647058822,0.9714285714285714
38987,/images/5939f341-a886-4f63-ae87-2219d000a1d4.png,322,1063,450,1189,128,126,red blood cell,16128,0.984375,1.0158730158730158
34518,/images/fa1f9f89-cecb-4972-842c-d14c632f89a9.png,254,237,365,350,111,113,red blood cell,12543,1.018018018018018,0.9823008849557522
20958,/images/d4fef0c5-6597-48b6-97e9-32ed504488e6.png,774,1206,924,1333,150,127,red blood cell,19050,0.8466666666666667,1.1811023622047243
37467,/images/c6530038-6d4e-49e1-8427-d1d3acc9fa21.png,246,501,357,614,111,113,red blood cell,12543,1.018018018018018,0.9823008849557522
65647,/images/397f37bc-a3a4-4257-9430-c8fc5716f8b1.png,207,17,324,141,117,124,red blood cell,14508,1.0598290598290598,0.9435483870967742
57309,/images/aaade430-4c49-4038-97b7-f8cdd937db57.png,696,504,790,615,94,111,red blood cell,10434,1.1808510638297873,0.8468468468468469
49090,/images/df3d98b9-3dd7-4107-8d4a-ae1b7f247793.png,969,218,1050,304,81,86,red blood cell,6966,1.0617283950617284,0.9418604651162791
3986,/images/f09acb0c-b270-4e91-99f8-410adfa7f34a.png,390,1071,485,1171,95,100,red blood cell,9500,1.0526315789473684,0.95
14454,/images/3b13e20f-ec0d-44ec-b2f4-eaebfa09150e.png,485,747,590,855,105,108,red blood cell,11340,1.0285714285714285,0.9722222222222222
70587,/images/8cca114a-ed05-4b87-95b7-fae02487f08c.png,302,2,412,96,110,94,red blood cell,10340,0.8545454545454545,1.1702127659574468
14048,/images/eaf4b781-b3aa-41ce-8c5e-287979b4e15a.png,325,388,423,476,98,88,red blood cell,8624,0.8979591836734694,1.1136363636363635
16937,/images/8eeb378e-90f0-47ea-ac1c-2a201eb8d090.png,829,1453,929,1543,100,90,red blood cell,9000,0.9,1.1111111111111112
59555,/images/6bfe6a90-8a69-4171-8e7f-42dc9417c6d9.png,1093,895,1188,989,95,94,red blood cell,8930,0.9894736842105263,1.0106382978723405
23990,/images/3d8fb5bf-3315-48fb-8ab1-802eafd550bc.png,203,155,321,268,118,113,red blood cell,13334,0.9576271186440678,1.0442477876106195
62627,/images/f7a4334a-4332-4de8-b39b-22da907976f2.png,325,825,422,913,97,88,red blood cell,8536,0.9072164948453608,1.1022727272727273
8697,/images/92e4fd7b-79ef-49c2-a52b-9ef13dd720ef.png,739,1221,838,1326,99,105,red blood cell,10395,1.0606060606060606,0.9428571428571428
79679,/images/a4409217-be11-4478-90a5-b406057d154d.png,9,170,112,285,103,115,red blood cell,11845,1.116504854368932,0.8956521739130435
65847,/images/daea4860-a296-4f6d-acef-996ab0882676.png,583,1088,672,1179,89,91,red blood cell,8099,1.0224719101123596,0.978021978021978
58223,/images/2f68686f-1fe8-46e7-ad92-a08e3523ea79.png,832,1183,914,1277,82,94,red blood cell,7708,1.146341463414634,0.8723404255319149
14906,/images/3090a362-1f3d-49e9-a76e-ce76ff9c2276.png,98,599,214,704,116,105,red blood cell,12180,0.9051724137931034,1.1047619047619048
7768,/images/e726dac6-f962-449c-acff-4dd56847b685.png,339,644,454,754,115,110,red blood cell,12650,0.9565217391304348,1.0454545454545454
49508,/images/9f33e0ea-065b-4703-9df9-15829b891860.png,623,1058,748,1173,125,115,red blood cell,14375,0.92,1.0869565217391304
7597,/images/21cc498b-8cb2-42ed-8f80-bfa27b86ef11.png,413,1125,547,1236,134,111,red blood cell,14874,0.8283582089552238,1.2072072072072073
58703,/images/e4827c85-311a-4df1-89c2-99dad0c3558c.png,458,373,568,479,110,106,red blood cell,11660,0.9636363636363636,1.0377358490566038
37728,/images/003a89b0-a095-417a-8dd6-f408339bbc68.png,927,844,1048,967,121,123,red blood cell,14883,1.0165289256198347,0.983739837398374
11569,/images/b4dc3088-3fe2-4688-be24-70664a64e022.png,738,1437,865,1569,127,132,red blood cell,16764,1.0393700787401574,0.9621212121212122
42553,/images/9a25f103-1683-47d1-8b07-ac20fe0b3ee9.png,285,596,388,702,103,106,red blood cell,10918,1.029126213592233,0.9716981132075472
78753,/images/dc6ac71b-2616-431e-bfd5-4c38139e4ddd.png,996,813,1103,930,107,117,red blood cell,12519,1.0934579439252337,0.9145299145299145
25383,/images/fbb1b44c-d75a-4550-a6c0-0eb62b96bfce.png,730,507,850,632,120,125,red blood cell,15000,1.0416666666666667,0.96
70905,/images/bf002a25-6535-4621-be19-56d468be5413.png,797,1376,880,1453,83,77,red blood cell,6391,0.927710843373494,1.077922077922078
69048,/images/b5246b58-6f40-4c9e-8024-f49b0ed6bdbd.png,541,421,650,535,109,114,red blood cell,12426,1.0458715596330275,0.956140350877193
20108,/images/81a2748d-51c9-4439-995d-f747871d6544.png,3,613,133,738,130,125,red blood cell,16250,0.9615384615384616,1.04
45031,/images/13bab3c3-3f79-44d9-a287-0ae6d71eff31.png,595,1206,702,1332,107,126,red blood cell,13482,1.1775700934579438,0.8492063492063492
56425,/images/d75933ed-d26e-4d1f-bda3-96bc0d77fb36.png,889,807,995,904,106,97,red blood cell,10282,0.9150943396226415,1.092783505154639
51204,/images/ad8731b7-0dae-4983-9dc6-dec31767d761.png,616,1303,725,1393,109,90,red blood cell,9810,0.8256880733944955,1.211111111111111
39271,/images/f7cced00-9b41-45ec-9fdf-fb9e1a74da90.png,60,841,170,960,110,119,red blood cell,13090,1.0818181818181818,0.9243697478991597
35413,/images/002f20ad-2ace-499c-9335-c9080bc3e6b5.png,192,457,309,573,117,116,red blood cell,13572,0.9914529914529915,1.0086206896551724
28022,/images/c4d34e35-4db2-41de-ba77-1a94aa9ef788.png,620,127,738,231,118,104,red blood cell,12272,0.8813559322033898,1.1346153846153846
29632,/images/42845335-4ab2-4963-806d-0985d1382a31.png,439,1221,546,1317,107,96,red blood cell,10272,0.897196261682243,1.1145833333333333
78733,/images/dc6ac71b-2616-431e-bfd5-4c38139e4ddd.png,886,222,991,342,105,120,red blood cell,12600,1.1428571428571428,0.875
50292,/images/3d32a988-449d-4d58-b71f-abbfdc3f2fbc.png,179,273,275,373,96,100,red blood cell,9600,1.0416666666666667,0.96
77568,/images/2d2e81f3-e329-4765-9ba1-2c95f12dc9f3.png,768,332,859,408,91,76,red blood cell,6916,0.8351648351648352,1.1973684210526316
39471,/images/5a631871-2fc7-4a68-9c39-f3b9a0bf4a04.png,611,521,712,622,101,101,red blood cell,10201,1.0,1.0
24501,/images/109fbb82-bc3c-41ac-984d-e2da86202873.png,795,933,904,1052,109,119,red blood cell,12971,1.091743119266055,0.9159663865546218
46252,/images/815bf40c-371a-4d34-aa41-c549c8221881.png,965,721,1089,851,124,130,red blood cell,16120,1.0483870967741935,0.9538461538461539
15990,/images/c7c1b873-0548-4a73-9618-f60912e164df.png,763,212,860,306,97,94,red blood cell,9118,0.9690721649484536,1.0319148936170213
4772,/images/3fa1a4e3-c80d-49da-8f7b-a1abb0424f48.png,956,1450,1058,1549,102,99,red blood cell,10098,0.9705882352941176,1.0303030303030303
35508,/images/3e33ee12-ef02-4287-8318-7ad3b284a617.png,958,531,1085,635,127,104,red blood cell,13208,0.8188976377952756,1.2211538461538463
29048,/images/4c13e22e-dfd1-4fa1-b373-be9d0c272c0f.png,877,162,983,256,106,94,red blood cell,9964,0.8867924528301887,1.127659574468085
78647,/images/fd1c4c7a-24bc-43f2-b84f-fee182207aee.png,67,719,177,836,110,117,red blood cell,12870,1.0636363636363637,0.9401709401709402
50038,/images/b1145408-feae-4637-b4cf-3e70b99cc62d.png,163,301,280,410,117,109,red blood cell,12753,0.9316239316239316,1.073394495412844
42743,/images/b8dd6125-5027-47e2-a283-14e199274c80.png,674,342,799,459,125,117,red blood cell,14625,0.936,1.0683760683760684
79904,/images/0b923ab7-ebff-4079-a4bb-af7da89f374e.png,831,381,948,495,117,114,red blood cell,13338,0.9743589743589743,1.0263157894736843
33415,/images/f632981c-1330-4078-8a12-691beb2dab02.png,813,466,915,563,102,97,red blood cell,9894,0.9509803921568627,1.0515463917525774
47370,/images/477e541c-0519-4542-9b13-8ee7922644d3.png,943,1063,1040,1171,97,108,red blood cell,10476,1.1134020618556701,0.8981481481481481
55418,/images/d67655e6-0a80-4a86-b552-1f5e85788377.png,372,1224,472,1332,100,108,red blood cell,10800,1.08,0.9259259259259259
57002,/images/9e82c996-2cfa-418d-9482-8ee23e9d0a5d.png,743,159,844,268,101,109,red blood cell,11009,1.0792079207920793,0.926605504587156
62673,/images/f7a4334a-4332-4de8-b39b-22da907976f2.png,181,1108,265,1188,84,80,red blood cell,6720,0.9523809523809523,1.05
11648,/images/0ed416f9-7c20-4829-9016-559e4009568e.png,537,994,643,1101,106,107,red blood cell,11342,1.009433962264151,0.9906542056074766
67404,/images/266180ed-77a3-4284-8292-50a49fc47fce.png,650,563,738,662,88,99,red blood cell,8712,1.125,0.8888888888888888
45689,/images/584d62ed-4329-45dd-94ce-e929d8b2bb74.png,1005,887,1100,981,95,94,red blood cell,8930,0.9894736842105263,1.0106382978723405
18342,/images/9ca20b10-e2fd-4bd2-93ef-78298f763ed5.png,982,224,1086,316,104,92,red blood cell,9568,0.8846153846153846,1.1304347826086956
16665,/images/bc377041-e098-45c4-9651-2b1ea90d1d7e.png,629,643,744,747,115,104,red blood cell,11960,0.9043478260869565,1.1057692307692308
34530,/images/fa1f9f89-cecb-4972-842c-d14c632f89a9.png,690,190,807,304,117,114,red blood cell,13338,0.9743589743589743,1.0263157894736843
75173,/images/7fdc8be8-7579-4a5c-b369-8a07ee0a8b7d.png,373,150,474,257,101,107,red blood cell,10807,1.0594059405940595,0.9439252336448598
63270,/images/d3283f5b-3b3a-40ea-800b-79960ca851cb.png,458,694,548,784,90,90,red blood cell,8100,1.0,1.0
3210,/images/c3215597-a032-46be-9058-d6de1e5191d7.png,295,1195,424,1325,129,130,red blood cell,16770,1.0077519379844961,0.9923076923076923
54800,/images/b6364a57-72a9-43f3-8d02-9f53a992dc95.png,516,51,613,145,97,94,red blood cell,9118,0.9690721649484536,1.0319148936170213
25286,/images/587e5464-d70b-4279-8562-010279f6efbd.png,160,1021,289,1134,129,113,red blood cell,14577,0.875968992248062,1.1415929203539823
2026,/images/bfefa21c-11e1-4dab-ac5d-8ff6f046d65f.png,381,1068,504,1190,123,122,red blood cell,15006,0.991869918699187,1.0081967213114753
26656,/images/16ec6e1f-5020-40b3-ba26-51c340d03ee7.png,191,925,306,1038,115,113,red blood cell,12995,0.9826086956521739,1.0176991150442478
38587,/images/f8b14fc4-dd6b-4ad0-a96d-c62845f48681.png,130,1280,244,1404,114,124,red blood cell,14136,1.087719298245614,0.9193548387096774
45164,/images/2596eb32-1323-41e9-8c0f-64819abcfc73.png,151,708,255,819,104,111,red blood cell,11544,1.0673076923076923,0.9369369369369369
75168,/images/7fdc8be8-7579-4a5c-b369-8a07ee0a8b7d.png,293,1288,366,1368,73,80,red blood cell,5840,1.095890410958904,0.9125
38436,/images/674b0fd3-f247-4b7f-97f7-3e6c57c9ba9e.png,57,1387,139,1479,82,92,red blood cell,7544,1.1219512195121952,0.8913043478260869
73308,/images/67a4fb91-6f38-4ca2-8f20-6b2f5f1b29a7.png,281,950,372,1049,91,99,red blood cell,9009,1.0879120879120878,0.9191919191919192
67239,/images/5f491efd-a21c-4a80-aaba-70b8876238ac.png,150,821,250,927,100,106,red blood cell,10600,1.06,0.9433962264150944
26921,/images/71bbdc58-11af-41f2-9a93-3fe9257c5cf3.png,412,1150,525,1251,113,101,red blood cell,11413,0.8938053097345132,1.118811881188119
49022,/images/df3d98b9-3dd7-4107-8d4a-ae1b7f247793.png,461,1181,571,1289,110,108,red blood cell,11880,0.9818181818181818,1.0185185185185186
24853,/images/93f7e207-0d8e-47f8-8258-09a0e03dbdd6.png,408,626,552,745,144,119,red blood cell,17136,0.8263888888888888,1.2100840336134453
22758,/images/8490c623-3d88-4532-baf5-0d266a45b16f.png,111,221,223,341,112,120,red blood cell,13440,1.0714285714285714,0.9333333333333333
26783,/images/2518f6e4-29cc-4ae4-a914-b215a4c56099.png,1092,873,1199,987,107,114,red blood cell,12198,1.0654205607476634,0.9385964912280702
43623,/images/a4851ed0-1499-4eae-9157-dcd34773254f.png,474,229,555,303,81,74,red blood cell,5994,0.9135802469135802,1.0945945945945945
78690,/images/76a8a5f5-1328-4539-a131-baf877f40cf3.png,187,884,301,997,114,113,red blood cell,12882,0.9912280701754386,1.008849557522124
39580,/images/5a631871-2fc7-4a68-9c39-f3b9a0bf4a04.png,717,573,834,693,117,120,red blood cell,14040,1.0256410256410255,0.975
34037,/images/1012abf2-cb05-4337-86c5-513ec4ca904d.png,927,1001,1042,1132,115,131,red blood cell,15065,1.1391304347826088,0.8778625954198473
14103,/images/eaf4b781-b3aa-41ce-8c5e-287979b4e15a.png,411,1314,501,1406,90,92,red blood cell,8280,1.0222222222222221,0.9782608695652174
74168,/images/4e43fc22-dc08-4cde-b3ce-ce8a4f377c47.png,321,413,422,529,101,116,red blood cell,11716,1.1485148514851484,0.8706896551724138
52855,/images/58f7e1da-3478-48f4-958c-e9b1cb8696aa.png,84,168,190,288,106,120,red blood cell,12720,1.1320754716981132,0.8833333333333333
46330,/images/e11515b4-9527-4c23-a0ba-43719bacca0d.png,854,150,981,272,127,122,red blood cell,15494,0.9606299212598425,1.040983606557377
46322,/images/e11515b4-9527-4c23-a0ba-43719bacca0d.png,431,1224,542,1335,111,111,red blood cell,12321,1.0,1.0
44237,/images/4257342d-6d77-4671-a84b-1f0c36ccb367.png,426,1184,540,1297,114,113,red blood cell,12882,0.9912280701754386,1.008849557522124
44105,/images/8b494b40-cab5-49d3-893d-c805000fbe88.png,505,301,597,404,92,103,red blood cell,9476,1.1195652173913044,0.8932038834951457
71479,/images/191071ab-6515-428c-9f05-8e4309542b75.png,826,814,927,928,101,114,red blood cell,11514,1.1287128712871286,0.8859649122807017
27393,/images/9f38055f-4fe6-47fd-a6dd-c0743db4eccf.png,462,196,569,292,107,96,red blood cell,10272,0.897196261682243,1.1145833333333333
27208,/images/bca27923-b270-45df-a0bf-3e1a7d135b2c.png,171,793,296,920,125,127,red blood cell,15875,1.016,0.984251968503937
40843,/images/bf20d04d-ff8a-4910-91d7-94054c267d1b.png,112,1111,224,1218,112,107,red blood cell,11984,0.9553571428571429,1.0467289719626167
30766,/images/8e0dfc1f-e3eb-4a3f-a1c4-249bdfbfaa27.png,508,1282,621,1401,113,119,red blood cell,13447,1.0530973451327434,0.9495798319327731
8325,/images/65e3d6a6-012c-4b40-9a42-83078eb85e31.png,320,14,412,116,92,102,red blood cell,9384,1.108695652173913,0.9019607843137255
20430,/images/781d4bea-c6a9-4b36-ae10-ba9e328c87fe.png,1094,1171,1199,1290,105,119,red blood cell,12495,1.1333333333333333,0.8823529411764706
2671,/images/a2ccbf70-e444-49a9-8b7e-9797a05220d8.png,311,826,435,935,124,109,red blood cell,13516,0.8790322580645161,1.1376146788990826
56667,/images/4adcaa26-aa1f-47b5-bdf0-18c9f814f576.png,1091,1036,1199,1154,108,118,red blood cell,12744,1.0925925925925926,0.9152542372881356
53561,/images/7c1cd7c7-7452-4428-a98e-dd7675c8ddea.png,202,226,302,338,100,112,red blood cell,11200,1.12,0.8928571428571429
57717,/images/5c037ffc-f515-48b3-b231-c110fbd2b8ca.png,452,1436,556,1538,104,102,red blood cell,10608,0.9807692307692307,1.0196078431372548
47858,/images/ab27173b-6e30-4957-bd68-29194328fd39.png,683,1214,811,1339,128,125,red blood cell,16000,0.9765625,1.024
55676,/images/c32b8bb8-c89d-4ae9-9c77-5b9356ca35a1.png,628,235,718,336,90,101,red blood cell,9090,1.1222222222222222,0.8910891089108911
62043,/images/bdb5d571-27bc-4a42-ae45-aa5a9af40a81.png,1020,482,1117,580,97,98,red blood cell,9506,1.0103092783505154,0.9897959183673469
58430,/images/7eae1169-e294-4594-8e03-1366d23ff2d1.png,182,928,291,1035,109,107,red blood cell,11663,0.981651376146789,1.0186915887850467
3601,/images/8bd71314-e38a-4670-bb25-5cd6c9acb595.png,656,1426,754,1538,98,112,red blood cell,10976,1.1428571428571428,0.875
48833,/images/fed6ba05-36a5-45dc-a4e1-9baa7de2c622.png,472,695,562,788,90,93,red blood cell,8370,1.0333333333333334,0.967741935483871
52431,/images/a2a20600-f851-4db7-90f9-6f7be027c8b5.png,240,1319,338,1421,98,102,red blood cell,9996,1.0408163265306123,0.9607843137254902
25528,/images/f6ab936d-924b-4038-aa47-71b07c26b4e2.png,399,362,512,478,113,116,red blood cell,13108,1.0265486725663717,0.9741379310344828
39114,/images/7bde7de1-889b-4218-b0e1-e2c04f6a7986.png,435,1304,554,1436,119,132,red blood cell,15708,1.1092436974789917,0.9015151515151515
54135,/images/c415532c-4cce-4580-9fcd-623c172a1abd.png,611,1360,717,1468,106,108,red blood cell,11448,1.0188679245283019,0.9814814814814815
27102,/images/f232eec3-02c0-43f9-bf32-3e60245397e2.png,112,123,217,246,105,123,red blood cell,12915,1.1714285714285715,0.8536585365853658
18514,/images/c22f7031-9cf8-48ce-b03b-1b12d0db4951.png,716,1069,829,1166,113,97,red blood cell,10961,0.8584070796460177,1.1649484536082475
69833,/images/2bd15b6e-fe2d-49f3-b394-940d024d1f91.png,36,1299,116,1385,80,86,red blood cell,6880,1.075,0.9302325581395349
11144,/images/6303f964-98ef-47c6-bb2d-283aa393f918.png,1048,1220,1145,1328,97,108,red blood cell,10476,1.1134020618556701,0.8981481481481481
36937,/images/b2e34f5f-904e-4473-9dc7-c6bc1ce12640.png,890,1461,974,1550,84,89,red blood cell,7476,1.0595238095238095,0.9438202247191011
79808,/images/fc15659f-6264-4dd5-ab17-43d89fb297b9.png,929,69,1051,186,122,117,red blood cell,14274,0.9590163934426229,1.0427350427350428
77940,/images/c691c8ef-d3c7-47b6-a941-f6a1089f21a9.png,64,1260,185,1385,121,125,red blood cell,15125,1.0330578512396693,0.968
71516,/images/191071ab-6515-428c-9f05-8e4309542b75.png,748,807,847,903,99,96,red blood cell,9504,0.9696969696969697,1.03125
12832,/images/b10ea12f-cd36-4f2c-994a-67d1665269ab.png,829,1218,939,1321,110,103,red blood cell,11330,0.9363636363636364,1.0679611650485437
7259,/images/89f10192-d3dd-4996-a571-4c851dbdc983.png,896,1241,992,1333,96,92,red blood cell,8832,0.9583333333333334,1.0434782608695652
52505,/images/d1144956-5a0c-4bd2-b67d-8498c82d6a12.png,978,71,1083,188,105,117,red blood cell,12285,1.1142857142857143,0.8974358974358975
35043,/images/67582df6-bf13-4c83-a531-1214692b70de.png,291,866,423,999,132,133,red blood cell,17556,1.0075757575757576,0.9924812030075187
8421,/images/ae779806-6d01-4dc6-89df-294c368db6bc.png,746,148,859,255,113,107,red blood cell,12091,0.9469026548672567,1.0560747663551402
26403,/images/d532e31c-10ce-4313-9a36-bd5e01230254.png,387,856,508,966,121,110,red blood cell,13310,0.9090909090909091,1.1
38313,/images/674b0fd3-f247-4b7f-97f7-3e6c57c9ba9e.png,455,1110,566,1215,111,105,red blood cell,11655,0.9459459459459459,1.0571428571428572
41193,/images/eed298b3-35f2-4127-88ad-0c4a9062207b.png,519,120,634,222,115,102,red blood cell,11730,0.8869565217391304,1.1274509803921569
36426,/images/cfe6086f-eb0b-4cb0-a430-8cd7de6556e2.png,65,704,183,811,118,107,red blood cell,12626,0.9067796610169492,1.102803738317757
60591,/images/724e0c34-32cd-41f1-ae37-586038bc67ab.png,96,517,184,617,88,100,red blood cell,8800,1.1363636363636365,0.88
495,/images/f65a1633-9935-4984-a285-a60d30aa1707.png,328,170,444,290,116,120,red blood cell,13920,1.0344827586206897,0.9666666666666667
32915,/images/e40000b4-1b26-42ce-909d-4715e04f0a6e.png,704,903,826,1022,122,119,red blood cell,14518,0.9754098360655737,1.0252100840336134
17697,/images/b5143aae-6e98-4dc6-b546-980cb472de67.png,946,372,1054,496,108,124,red blood cell,13392,1.1481481481481481,0.8709677419354839
57199,/images/ca5e6a15-ba65-48ea-8913-2d986e71bf3a.png,731,1183,842,1300,111,117,red blood cell,12987,1.054054054054054,0.9487179487179487
43195,/images/fe1ee954-ba71-47b3-954a-d20ab940cd7b.png,849,290,976,410,127,120,red blood cell,15240,0.9448818897637795,1.0583333333333333
6225,/images/effd6334-516f-4d48-9f3c-5272a99780fb.png,654,822,784,944,130,122,red blood cell,15860,0.9384615384615385,1.0655737704918034
7514,/images/071901eb-4c3f-404b-a747-3d0b9d0a5158.png,312,345,448,474,136,129,red blood cell,17544,0.9485294117647058,1.054263565891473
51549,/images/6afb3717-f197-4668-929a-4fab389ae6e8.png,197,1093,294,1188,97,95,red blood cell,9215,0.979381443298969,1.0210526315789474
73794,/images/3eba916c-998b-40a7-993c-7ed916c2a04c.png,558,1142,656,1243,98,101,red blood cell,9898,1.030612244897959,0.9702970297029703
22059,/images/6b8048ed-ebd7-4789-ba87-c1ba94801481.png,647,887,772,1014,125,127,red blood cell,15875,1.016,0.984251968503937
79992,/images/e640ae51-cbf1-4a84-b7cf-d38b17f59c2f.png,847,117,940,230,93,113,red blood cell,10509,1.2150537634408602,0.8230088495575221
38257,/images/b834cbf7-ff97-49d9-9561-566c9343735c.png,222,49,356,164,134,115,red blood cell,15410,0.8582089552238806,1.1652173913043478
46796,/images/63055d1b-5221-4c80-8b39-37ac069a1b5c.png,863,838,980,950,117,112,red blood cell,13104,0.9572649572649573,1.0446428571428572
7114,/images/64a678d4-9048-4491-90c7-1924f38be19a.png,988,1375,1105,1494,117,119,red blood cell,13923,1.017094017094017,0.9831932773109243
42543,/images/9a25f103-1683-47d1-8b07-ac20fe0b3ee9.png,458,490,579,608,121,118,red blood cell,14278,0.9752066115702479,1.0254237288135593
31850,/images/f62d4fb6-df7c-446c-94a8-d5aede0b1e0c.png,1030,174,1137,304,107,130,red blood cell,13910,1.2149532710280373,0.823076923076923
24546,/images/c03d9b87-e19b-402b-ad86-b30d6e8aeb59.png,60,449,160,539,100,90,red blood cell,9000,0.9,1.1111111111111112
11396,/images/2f6224be-50d0-4e85-94ef-88315df561b6.png,746,332,824,419,78,87,red blood cell,6786,1.1153846153846154,0.896551724137931
76267,/images/1574565f-f45b-4160-947e-25ce1a81aaca.png,639,212,750,320,111,108,red blood cell,11988,0.972972972972973,1.0277777777777777
63248,/images/d3283f5b-3b3a-40ea-800b-79960ca851cb.png,142,875,248,996,106,121,red blood cell,12826,1.1415094339622642,0.8760330578512396
8810,/images/ae17a099-18b5-4a42-a901-850ea056423e.png,666,953,772,1049,106,96,red blood cell,10176,0.9056603773584906,1.1041666666666667
10619,/images/20d4f65e-6c63-433a-935c-d568d577967b.png,932,459,1054,563,122,104,red blood cell,12688,0.8524590163934426,1.1730769230769231
4787,/images/3fa1a4e3-c80d-49da-8f7b-a1abb0424f48.png,600,454,714,580,114,126,red blood cell,14364,1.105263157894737,0.9047619047619048
41500,/images/2f3ebec8-ef64-420d-9aa0-c2fcadc27d74.png,1023,764,1150,892,127,128,red blood cell,16256,1.0078740157480315,0.9921875
33925,/images/1a332b2c-9d49-4ff2-810c-5633d2314527.png,309,78,403,178,94,100,red blood cell,9400,1.0638297872340425,0.94
12248,/images/3b55c42f-ad59-422f-ba99-4f4f4ca9cb2e.png,658,135,754,229,96,94,red blood cell,9024,0.9791666666666666,1.0212765957446808
65383,/images/24418314-f7a4-49fc-a03e-ec597ca6796e.png,539,1167,623,1256,84,89,red blood cell,7476,1.0595238095238095,0.9438202247191011
23077,/images/be5bb7d0-7c3f-4bb9-8bb4-f8bc8d875943.png,641,857,761,975,120,118,red blood cell,14160,0.9833333333333333,1.0169491525423728
64303,/images/0a7bfa8a-ee52-4f7a-b9c5-2919ecfa93ef.png,100,1026,204,1120,104,94,red blood cell,9776,0.9038461538461539,1.1063829787234043
71756,/images/093a831a-bf71-4333-bc06-942ae70cb164.png,1076,1195,1167,1304,91,109,red blood cell,9919,1.1978021978021978,0.8348623853211009
75020,/images/9147a21d-0de2-4c04-88da-b788311696ac.png,99,594,222,711,123,117,red blood cell,14391,0.9512195121951219,1.0512820512820513
14033,/images/eaf4b781-b3aa-41ce-8c5e-287979b4e15a.png,514,1289,613,1390,99,101,red blood cell,9999,1.02020202020202,0.9801980198019802
45421,/images/e4eea7ea-8989-46a9-9c98-25a178146b28.png,740,231,825,325,85,94,red blood cell,7990,1.1058823529411765,0.9042553191489362
51995,/images/4f62b14e-c6f4-4155-8f50-881558f83fae.png,60,910,129,983,69,73,red blood cell,5037,1.0579710144927537,0.9452054794520548
30292,/images/cecbf663-0751-4e7f-b298-770c88afc2c1.png,467,1195,572,1291,105,96,red blood cell,10080,0.9142857142857143,1.09375
16871,/images/4823c1fe-a7f9-4b92-959f-0d9be09cd14b.png,644,690,740,789,96,99,red blood cell,9504,1.03125,0.9696969696969697
15737,/images/64113b22-03b1-4ab8-89ab-b2f32154fbbd.png,792,910,912,1022,120,112,red blood cell,13440,0.9333333333333333,1.0714285714285714
44208,/images/8b494b40-cab5-49d3-893d-c805000fbe88.png,768,244,857,350,89,106,red blood cell,9434,1.1910112359550562,0.839622641509434
1882,/images/8855c685-5a8c-4967-a356-942ed89e3471.png,969,1333,1096,1450,127,117,red blood cell,14859,0.9212598425196851,1.0854700854700854
11530,/images/834a30bb-26bf-4e60-9ea1-3250b926892e.png,1027,33,1133,127,106,94,red blood cell,9964,0.8867924528301887,1.127659574468085
70538,/images/8cca114a-ed05-4b87-95b7-fae02487f08c.png,76,1472,162,1552,86,80,red blood cell,6880,0.9302325581395349,1.075
76724,/images/3317d733-ec0d-45e6-b631-40457392f343.png,820,738,921,836,101,98,red blood cell,9898,0.9702970297029703,1.030612244897959
10878,/images/b78b88f0-154a-4b54-8aaf-85d37a42a0f9.png,356,625,474,734,118,109,red blood cell,12862,0.923728813559322,1.0825688073394495
74314,/images/8939e14b-fcdf-48b1-acb9-6514a2fc2fc0.png,894,325,995,433,101,108,red blood cell,10908,1.0693069306930694,0.9351851851851852
53642,/images/7bcd3735-3134-46d1-8ca2-d4379f2d51c0.png,794,671,887,776,93,105,red blood cell,9765,1.1290322580645162,0.8857142857142857
58640,/images/a4d7a7e1-5ae1-486d-b6ee-c9af1476ccad.png,590,351,671,451,81,100,red blood cell,8100,1.2345679012345678,0.81
64173,/images/2a91387a-d30f-418d-ac3a-f7cfa6836261.png,288,865,407,987,119,122,red blood cell,14518,1.0252100840336134,0.9754098360655737
12594,/images/8e4bdd0d-1c72-4836-ae3e-05e2e50e4983.png,964,759,1065,878,101,119,red blood cell,12019,1.1782178217821782,0.8487394957983193
47687,/images/4b3a49bc-8536-4760-9553-440a6f64db37.png,228,907,321,1018,93,111,red blood cell,10323,1.1935483870967742,0.8378378378378378
69554,/images/4a49841f-216c-4815-8140-b8762c4f6603.png,590,960,703,1070,113,110,red blood cell,12430,0.9734513274336283,1.0272727272727273
5490,/images/eb6e8684-b84e-483d-b835-f59286d2516b.png,919,23,1022,132,103,109,red blood cell,11227,1.058252427184466,0.944954128440367
73231,/images/85546330-4efd-43e2-87aa-d53a30220bfc.png,385,421,456,499,71,78,red blood cell,5538,1.0985915492957747,0.9102564102564102
19668,/images/627d6331-7bb9-4d1a-b20d-e6541af4d0f9.png,329,1118,433,1222,104,104,red blood cell,10816,1.0,1.0
31875,/images/f62d4fb6-df7c-446c-94a8-d5aede0b1e0c.png,258,608,366,737,108,129,red blood cell,13932,1.1944444444444444,0.8372093023255814
27063,/images/ec301f62-1302-4407-96f9-fcfe45c150ae.png,276,115,386,217,110,102,red blood cell,11220,0.9272727272727272,1.0784313725490196
52911,/images/abb2f9d6-26fa-4328-983c-959ef6717c05.png,693,468,814,584,121,116,red blood cell,14036,0.9586776859504132,1.043103448275862
17618,/images/70a95e58-ba60-4c1f-adcd-49c198dc2ba0.png,818,261,912,358,94,97,red blood cell,9118,1.0319148936170213,0.9690721649484536
20154,/images/df49578a-60d4-4a3b-9ee0-79d9d59bc72a.png,902,1441,1022,1575,120,134,red blood cell,16080,1.1166666666666667,0.8955223880597015
14253,/images/6382976c-ee87-4916-b798-4ef1373b2df0.png,307,138,407,240,100,102,red blood cell,10200,1.02,0.9803921568627451
37370,/images/08f5a524-0554-49c2-83a8-ae9a6d51e8fd.png,400,374,509,480,109,106,red blood cell,11554,0.9724770642201835,1.028301886792453
72878,/images/31435107-c77d-42f8-a619-75cba6a5161b.png,6,560,94,657,88,97,red blood cell,8536,1.1022727272727273,0.9072164948453608
7735,/images/187f92b2-71ed-484a-9bd3-599ca0d2636f.png,202,862,290,963,88,101,red blood cell,8888,1.1477272727272727,0.8712871287128713
24661,/images/30948737-0d0d-4b68-b9ab-50577e0fe026.png,565,1384,674,1507,109,123,red blood cell,13407,1.128440366972477,0.8861788617886179
78930,/images/4d0a1598-e4dd-45c4-8a90-dd7c780fe1da.png,787,1496,887,1589,100,93,red blood cell,9300,0.93,1.075268817204301
43364,/images/36569710-a574-40be-ad42-897a6e74a128.png,682,1224,787,1345,105,121,red blood cell,12705,1.1523809523809523,0.8677685950413223
11478,/images/2f9f400d-2d67-4118-aaa1-9094bc4b0e47.png,165,296,266,404,101,108,red blood cell,10908,1.0693069306930694,0.9351851851851852
40559,/images/29861cf9-9a1e-4733-8309-4bd10706b4a3.png,825,243,952,362,127,119,red blood cell,15113,0.937007874015748,1.0672268907563025
42253,/images/ca734448-0d52-42fa-b41c-17b2939e58ae.png,659,780,781,910,122,130,red blood cell,15860,1.0655737704918034,0.9384615384615385
32759,/images/eef2ac0b-42de-4bc3-a3c3-d5fcd597fbe4.png,583,987,681,1085,98,98,red blood cell,9604,1.0,1.0
1006,/images/63d36d2c-43a9-49ac-9504-028b4968c860.png,1007,1159,1131,1273,124,114,red blood cell,14136,0.9193548387096774,1.087719298245614
60392,/images/8d5d5c22-2f75-4fe1-9ea3-03a3c7b92ea9.png,618,914,739,1031,121,117,red blood cell,14157,0.9669421487603306,1.0341880341880343
56642,/images/4adcaa26-aa1f-47b5-bdf0-18c9f814f576.png,486,430,599,561,113,131,red blood cell,14803,1.1592920353982301,0.8625954198473282
56142,/images/50d9fc90-8642-4bb6-91a7-0069a7e37392.png,933,659,1043,765,110,106,red blood cell,11660,0.9636363636363636,1.0377358490566038
43580,/images/e0ef520d-7b65-485d-9888-e6859f189f70.png,193,1081,316,1192,123,111,red blood cell,13653,0.9024390243902439,1.1081081081081081
30891,/images/fbc1f360-4382-48bb-a32e-3f5f2f9dbe57.png,887,1174,1000,1279,113,105,red blood cell,11865,0.9292035398230089,1.0761904761904761
63138,/images/d82c657e-5678-41da-9a6e-3ad29430b759.png,336,1191,426,1293,90,102,red blood cell,9180,1.1333333333333333,0.8823529411764706
74266,/images/8939e14b-fcdf-48b1-acb9-6514a2fc2fc0.png,319,1351,418,1451,99,100,red blood cell,9900,1.0101010101010102,0.99
32375,/images/a6526894-e290-482d-ac43-f1df34864817.png,37,11,165,122,128,111,red blood cell,14208,0.8671875,1.1531531531531531
52799,/images/0a747cb3-c720-4572-a661-ab5670a5c42e.png,758,1101,858,1222,100,121,red blood cell,12100,1.21,0.8264462809917356
5811,/images/143f5959-5b6d-4f95-bcee-9e110450fc22.png,903,1463,1019,1578,116,115,red blood cell,13340,0.9913793103448276,1.008695652173913
8453,/images/ae779806-6d01-4dc6-89df-294c368db6bc.png,438,322,543,426,105,104,red blood cell,10920,0.9904761904761905,1.0096153846153846
18443,/images/39cc33be-d752-40fe-b7a8-2e69a3517205.png,901,836,1038,956,137,120,red blood cell,16440,0.8759124087591241,1.1416666666666666
16177,/images/1e978dfa-d339-4025-809d-09cee76728ed.png,587,1048,711,1169,124,121,red blood cell,15004,0.9758064516129032,1.024793388429752
4636,/images/9615ff33-b3fc-4d1e-9c05-0b8e3ef936df.png,920,1489,1035,1599,115,110,red blood cell,12650,0.9565217391304348,1.0454545454545454
22230,/images/3d4d7ba7-6c7c-4ddd-b282-31fb5d80edb5.png,125,350,226,458,101,108,red blood cell,10908,1.0693069306930694,0.9351851851851852
45155,/images/2596eb32-1323-41e9-8c0f-64819abcfc73.png,812,632,933,747,121,115,red blood cell,13915,0.9504132231404959,1.0521739130434782
6687,/images/95fea6d8-413f-421e-b331-5d51c31df150.png,145,777,261,893,116,116,red blood cell,13456,1.0,1.0
53245,/images/d8f7e159-b7e3-49e4-86e8-aed8c5fbcd97.png,437,1387,535,1474,98,87,red blood cell,8526,0.8877551020408163,1.1264367816091954
23349,/images/a7688988-2bcc-4458-83d3-5e482da5f87b.png,646,824,750,934,104,110,red blood cell,11440,1.0576923076923077,0.9454545454545454
10686,/images/20d4f65e-6c63-433a-935c-d568d577967b.png,199,1467,286,1566,87,99,red blood cell,8613,1.1379310344827587,0.8787878787878788
72376,/images/a15e0fa8-2620-4f66-896e-175115c9dc3d.png,569,269,675,385,106,116,red blood cell,12296,1.0943396226415094,0.9137931034482759
11200,/images/6303f964-98ef-47c6-bb2d-283aa393f918.png,1014,1292,1132,1398,118,106,red blood cell,12508,0.8983050847457628,1.1132075471698113
42021,/images/46a03374-64c7-49ac-81c9-c3d62542bbf3.png,49,1405,144,1488,95,83,red blood cell,7885,0.8736842105263158,1.144578313253012
9045,/images/ef815e3a-02a6-4cf8-9262-45bc74c50b00.png,719,1433,824,1527,105,94,red blood cell,9870,0.8952380952380953,1.1170212765957446
428,/images/84c88143-940d-4b62-bbd2-7acc4cadcb6b.png,696,18,807,133,111,115,red blood cell,12765,1.0360360360360361,0.9652173913043478
26988,/images/1f337b61-1b0d-4539-91f9-73d4a0798a4a.png,922,1135,1036,1242,114,107,red blood cell,12198,0.9385964912280702,1.0654205607476634
37704,/images/003a89b0-a095-417a-8dd6-f408339bbc68.png,262,1031,385,1142,123,111,red blood cell,13653,0.9024390243902439,1.1081081081081081
9376,/images/e3a4b3e7-9500-4b6c-a402-b6d3f45e714b.png,263,12,387,133,124,121,red blood cell,15004,0.9758064516129032,1.024793388429752
61343,/images/e16c0dab-780d-4035-872e-1bb91e49f9d2.png,186,718,290,830,104,112,red blood cell,11648,1.0769230769230769,0.9285714285714286
64152,/images/0d3c2521-da55-4df5-bf06-56b3bd4fb2fc.png,439,343,524,447,85,104,red blood cell,8840,1.223529411764706,0.8173076923076923
43930,/images/d7c7eb2c-2acd-4f86-8a5a-09ab3dd02d16.png,287,1016,398,1123,111,107,red blood cell,11877,0.963963963963964,1.0373831775700935
35173,/images/bfc61c48-685d-470b-86b1-e4c7eb85c4fd.png,997,555,1120,694,123,139,red blood cell,17097,1.1300813008130082,0.8848920863309353
73964,/images/2ae3e6e6-7482-4ab8-ad73-b530b5c2ee3b.png,473,1372,544,1450,71,78,red blood cell,5538,1.0985915492957747,0.9102564102564102
28232,/images/036404d1-b9fc-497b-bbe1-f4d9c5ac3ce0.png,911,951,1020,1062,109,111,red blood cell,12099,1.018348623853211,0.9819819819819819
25385,/images/fbb1b44c-d75a-4550-a6c0-0eb62b96bfce.png,801,1011,920,1131,119,120,red blood cell,14280,1.0084033613445378,0.9916666666666667
9746,/images/3859deaf-6ae1-49a3-9051-898d0f0d7de6.png,868,1054,970,1166,102,112,red blood cell,11424,1.0980392156862746,0.9107142857142857
59000,/images/597bbff8-6592-41cf-8946-e59b0d1f289a.png,1059,1282,1163,1380,104,98,red blood cell,10192,0.9423076923076923,1.0612244897959184
80107,/images/99e979d4-ee97-4d7f-9da6-00bead40db4d.png,1026,929,1130,1036,104,107,red blood cell,11128,1.0288461538461537,0.9719626168224299
56268,/images/6b473806-e936-4b19-98cf-a2b94cac35ff.png,902,445,1016,563,114,118,red blood cell,13452,1.0350877192982457,0.9661016949152542
50327,/images/3d32a988-449d-4d58-b71f-abbfdc3f2fbc.png,27,49,116,142,89,93,red blood cell,8277,1.0449438202247192,0.956989247311828
25645,/images/770b8ca4-8377-479b-9ad5-5455ec3b44f8.png,872,972,989,1073,117,101,red blood cell,11817,0.8632478632478633,1.1584158415841583
68603,/images/31653d0f-c4e6-4e12-8005-518c2de34687.png,171,481,277,600,106,119,red blood cell,12614,1.1226415094339623,0.8907563025210085
74495,/images/cbb58718-6319-48db-b84b-78ac9b12ff89.png,872,1234,960,1331,88,97,red blood cell,8536,1.1022727272727273,0.9072164948453608
704,/images/e61e6af2-7f8b-47b0-bbe7-acb2ed0299ab.png,1050,1484,1153,1572,103,88,red blood cell,9064,0.8543689320388349,1.1704545454545454
31104,/images/9c48fdf4-621d-4f40-bcd7-6a28cd530de7.png,543,697,633,776,90,79,red blood cell,7110,0.8777777777777778,1.139240506329114
28696,/images/151f3af5-5e6e-4bcd-9389-4974fc68813e.png,990,1435,1089,1540,99,105,red blood cell,10395,1.0606060606060606,0.9428571428571428
37333,/images/4d88e2d2-5aad-410c-9bbc-702ee9496995.png,316,801,452,935,136,134,red blood cell,18224,0.9852941176470589,1.0149253731343284
16057,/images/7e25ced3-5caf-47f8-ad0c-42946bd4468b.png,21,1264,139,1360,118,96,red blood cell,11328,0.8135593220338984,1.2291666666666667
63186,/images/f0804a5e-e7f5-4cf2-a5df-b65e66502bf1.png,280,1148,374,1247,94,99,red blood cell,9306,1.053191489361702,0.9494949494949495
3299,/images/b901c906-91be-48c4-88ec-2c527544a258.png,246,425,366,524,120,99,red blood cell,11880,0.825,1.2121212121212122
72458,/images/a15e0fa8-2620-4f66-896e-175115c9dc3d.png,193,975,290,1074,97,99,red blood cell,9603,1.0206185567010309,0.9797979797979798
78014,/images/c691c8ef-d3c7-47b6-a941-f6a1089f21a9.png,630,347,705,435,75,88,red blood cell,6600,1.1733333333333333,0.8522727272727273
26215,/images/7ba9db7e-9d3f-413c-b672-2bba5fb5b415.png,148,1316,275,1430,127,114,red blood cell,14478,0.8976377952755905,1.1140350877192982
878,/images/dce55b59-c6c3-4693-aa75-6b348c8f52cd.png,221,241,314,345,93,104,red blood cell,9672,1.118279569892473,0.8942307692307693
54415,/images/22a464ef-c3da-4d56-b37e-e22e95d945e7.png,1006,257,1106,367,100,110,red blood cell,11000,1.1,0.9090909090909091
50454,/images/a2de1248-7bc0-44dc-b508-70a357eedd68.png,201,890,330,1015,129,125,red blood cell,16125,0.9689922480620154,1.032
73067,/images/2bd26501-2fbc-4c1a-bef0-4ad57e02b4d0.png,824,1093,918,1194,94,101,red blood cell,9494,1.074468085106383,0.9306930693069307
70507,/images/8cca114a-ed05-4b87-95b7-fae02487f08c.png,61,1348,174,1463,113,115,red blood cell,12995,1.0176991150442478,0.9826086956521739
75940,/images/034c8d57-04d5-4786-93a4-6ae8fde2c258.png,1031,474,1161,598,130,124,red blood cell,16120,0.9538461538461539,1.0483870967741935
51402,/images/b4f3b2a4-f4b9-48de-ac5d-0e681b77be27.png,477,216,572,308,95,92,red blood cell,8740,0.968421052631579,1.0326086956521738
77498,/images/2d2e81f3-e329-4765-9ba1-2c95f12dc9f3.png,988,926,1097,1028,109,102,red blood cell,11118,0.9357798165137615,1.0686274509803921
45628,/images/582e4b8b-404e-4b30-9df3-66f2afb3cdb3.png,616,1438,719,1542,103,104,red blood cell,10712,1.0097087378640777,0.9903846153846154
78290,/images/24115f58-a7d6-4022-a95a-86b515a78d3e.png,679,1463,791,1577,112,114,red blood cell,12768,1.0178571428571428,0.9824561403508771
3695,/images/dacf7e3f-1d8c-42a0-8539-3abe3971c956.png,55,180,171,301,116,121,red blood cell,14036,1.043103448275862,0.9586776859504132
45712,/images/584d62ed-4329-45dd-94ce-e929d8b2bb74.png,412,1374,500,1473,88,99,red blood cell,8712,1.125,0.8888888888888888
69260,/images/f274b784-b995-4a7e-a2c2-6cc31c24c4b4.png,408,53,505,168,97,115,red blood cell,11155,1.1855670103092784,0.8434782608695652
77942,/images/c691c8ef-d3c7-47b6-a941-f6a1089f21a9.png,851,326,969,447,118,121,red blood cell,14278,1.0254237288135593,0.9752066115702479
4564,/images/0f26699f-a776-4424-b092-27da9a1d12e2.png,334,825,416,914,82,89,red blood cell,7298,1.0853658536585367,0.9213483146067416
16609,/images/a27858ef-6533-413e-bc75-cc54690261a2.png,644,1462,741,1567,97,105,red blood cell,10185,1.0824742268041236,0.9238095238095239
14710,/images/1fdf99d1-a494-4174-bcd7-efbe457ab899.png,491,1133,598,1253,107,120,red blood cell,12840,1.1214953271028036,0.8916666666666667
64959,/images/dec61ae1-5037-4c3a-8952-15371becca7d.png,462,1498,544,1580,82,82,red blood cell,6724,1.0,1.0
1129,/images/edcb4d77-a4d3-465d-9b59-eb3087766b1c.png,800,1264,900,1375,100,111,red blood cell,11100,1.11,0.9009009009009009
26006,/images/612bdd3c-da43-4321-a76b-c73c614928d1.png,8,44,133,184,125,140,red blood cell,17500,1.12,0.8928571428571429
73951,/images/2ae3e6e6-7482-4ab8-ad73-b530b5c2ee3b.png,1054,1097,1150,1185,96,88,red blood cell,8448,0.9166666666666666,1.0909090909090908
15462,/images/1b7f47fc-26cd-4273-b848-88a7cbfd9f85.png,137,1003,246,1100,109,97,red blood cell,10573,0.8899082568807339,1.1237113402061856
44735,/images/ccb4b13d-ab20-4222-892f-5adf70249aaa.png,680,792,807,914,127,122,red blood cell,15494,0.9606299212598425,1.040983606557377
13324,/images/030f3421-ed3f-4bf1-8f27-4d02590bffbc.png,453,1208,553,1310,100,102,red blood cell,10200,1.02,0.9803921568627451
33805,/images/cb08956d-dd6a-4e13-817b-40a0a93068f1.png,531,501,629,605,98,104,red blood cell,10192,1.0612244897959184,0.9423076923076923
33365,/images/f632981c-1330-4078-8a12-691beb2dab02.png,325,310,447,426,122,116,red blood cell,14152,0.9508196721311475,1.0517241379310345
52576,/images/0546d843-d778-4aca-b8b5-bfe23d7c87da.png,510,1118,615,1227,105,109,red blood cell,11445,1.0380952380952382,0.963302752293578
30194,/images/a1669b59-fe09-4fe6-ba9f-06bec6725502.png,516,178,625,283,109,105,red blood cell,11445,0.963302752293578,1.0380952380952382
28865,/images/686ed568-d5f8-475e-81ad-edab9dd473a0.png,1086,972,1199,1106,113,134,red blood cell,15142,1.1858407079646018,0.8432835820895522
58601,/images/a4d7a7e1-5ae1-486d-b6ee-c9af1476ccad.png,735,915,856,1033,121,118,red blood cell,14278,0.9752066115702479,1.0254237288135593
72118,/images/64b0e49a-0e48-447d-8872-c1dd255e7a21.png,787,285,868,381,81,96,red blood cell,7776,1.1851851851851851,0.84375
32052,/images/b8a4d467-c40c-4ebf-91dd-1c19d0f2a7ae.png,202,573,314,682,112,109,red blood cell,12208,0.9732142857142857,1.0275229357798166
63012,/images/f234a2de-f3c8-4521-a306-8cfdf52dd597.png,118,134,204,222,86,88,red blood cell,7568,1.0232558139534884,0.9772727272727273
26271,/images/52767904-4cdc-4821-ba68-8cd0c28f9023.png,426,392,566,529,140,137,red blood cell,19180,0.9785714285714285,1.0218978102189782
43699,/images/ef83ed4c-2724-4d5f-8abe-1a18d25cea35.png,368,42,487,174,119,132,red blood cell,15708,1.1092436974789917,0.9015151515151515
1601,/images/7094c11a-1e62-4f98-894e-d17d138a88e9.png,323,306,445,413,122,107,red blood cell,13054,0.8770491803278688,1.1401869158878504
61165,/images/80da32ce-8c22-470e-9f35-558c5f7a5df9.png,220,961,315,1056,95,95,red blood cell,9025,1.0,1.0
4034,/images/a5e05ba8-0c19-41e3-92d5-10e42a03b85e.png,1019,502,1139,622,120,120,red blood cell,14400,1.0,1.0
58619,/images/a4d7a7e1-5ae1-486d-b6ee-c9af1476ccad.png,625,1256,725,1340,100,84,red blood cell,8400,0.84,1.1904761904761905
18697,/images/f6f8a69a-3fd2-4684-ac77-3e83ea0fb36d.png,97,1224,194,1328,97,104,red blood cell,10088,1.0721649484536082,0.9326923076923077
52041,/images/de6d3020-9347-473b-9146-8909627790f6.png,624,308,723,406,99,98,red blood cell,9702,0.98989898989899,1.010204081632653
14678,/images/4e2873dd-651e-4ecc-ac70-7335cf21a469.png,31,128,165,241,134,113,red blood cell,15142,0.8432835820895522,1.1858407079646018
65972,/images/25c6cfb1-01d0-4864-87f9-02b7593683c7.png,1028,735,1129,839,101,104,red blood cell,10504,1.0297029702970297,0.9711538461538461
31267,/images/db7c5ec1-fefe-4e9d-83c1-da8fb982f1e2.png,593,729,708,837,115,108,red blood cell,12420,0.9391304347826087,1.0648148148148149
74552,/images/bbedfcbe-9528-4ba9-9d86-4ebba7589ac5.png,854,705,971,821,117,116,red blood cell,13572,0.9914529914529915,1.0086206896551724
31984,/images/9eb66577-7857-43dc-a879-8f2c9d7f780f.png,662,1180,763,1287,101,107,red blood cell,10807,1.0594059405940595,0.9439252336448598
4412,/images/21ea4841-8998-4c04-b345-bc99cd8ecee6.png,851,629,963,746,112,117,red blood cell,13104,1.0446428571428572,0.9572649572649573
47674,/images/4b3a49bc-8536-4760-9553-440a6f64db37.png,938,1421,1045,1541,107,120,red blood cell,12840,1.1214953271028036,0.8916666666666667
46163,/images/d8632217-ec33-4d0a-98e6-427824c58869.png,1022,1330,1135,1441,113,111,red blood cell,12543,0.9823008849557522,1.018018018018018
59112,/images/5e2cea49-0823-49d1-83cf-8fd1559cdd93.png,118,771,215,882,97,111,red blood cell,10767,1.1443298969072164,0.8738738738738738
46042,/images/72088c26-d2dd-4906-b791-b8947fc7fbe4.png,146,984,242,1079,96,95,red blood cell,9120,0.9895833333333334,1.0105263157894737
19388,/images/5487faad-24a7-46b6-92d8-479d3a8d229f.png,560,944,662,1049,102,105,red blood cell,10710,1.0294117647058822,0.9714285714285714
70714,/images/8ab5c462-045e-4b59-b53a-9b2bc3ed2487.png,1078,889,1187,999,109,110,red blood cell,11990,1.0091743119266054,0.990909090909091
61594,/images/4a717a39-80f8-4b75-a25e-c46d65d7dcd5.png,665,1091,753,1180,88,89,red blood cell,7832,1.0113636363636365,0.9887640449438202
18607,/images/c22f7031-9cf8-48ce-b03b-1b12d0db4951.png,631,866,731,964,100,98,red blood cell,9800,0.98,1.0204081632653061
32321,/images/1c406ce1-023b-47fc-a2cd-5ea2e255de65.png,403,1460,514,1564,111,104,red blood cell,11544,0.9369369369369369,1.0673076923076923
29849,/images/9cdee92c-6267-4188-a41e-125bc0abb9ae.png,52,289,165,399,113,110,red blood cell,12430,0.9734513274336283,1.0272727272727273
15468,/images/1b7f47fc-26cd-4273-b848-88a7cbfd9f85.png,336,257,441,355,105,98,red blood cell,10290,0.9333333333333333,1.0714285714285714
23821,/images/eeb06e39-482b-443d-8cf6-b9b5c763df78.png,661,1325,782,1454,121,129,red blood cell,15609,1.0661157024793388,0.937984496124031
38438,/images/674b0fd3-f247-4b7f-97f7-3e6c57c9ba9e.png,352,1353,469,1463,117,110,red blood cell,12870,0.9401709401709402,1.0636363636363637
23278,/images/157ac97a-396e-4f6c-94c6-72a4d06ccc5f.png,970,1399,1095,1525,125,126,red blood cell,15750,1.008,0.9920634920634921
69436,/images/fde0fd54-49cc-42e1-90c6-6b612cd062d8.png,245,841,348,950,103,109,red blood cell,11227,1.058252427184466,0.944954128440367
25243,/images/90171428-f208-428a-b40e-f57ee3bea457.png,721,17,819,128,98,111,red blood cell,10878,1.1326530612244898,0.8828828828828829
50052,/images/b1145408-feae-4637-b4cf-3e70b99cc62d.png,402,395,517,512,115,117,red blood cell,13455,1.017391304347826,0.9829059829059829
52546,/images/d1144956-5a0c-4bd2-b67d-8498c82d6a12.png,916,430,1011,518,95,88,red blood cell,8360,0.9263157894736842,1.0795454545454546
45545,/images/e597f7ce-46c6-4dce-9063-50a2703fdd45.png,929,1309,1035,1411,106,102,red blood cell,10812,0.9622641509433962,1.0392156862745099
24034,/images/5107dcb7-164f-4e10-bbff-822b39b76efc.png,486,1289,607,1410,121,121,red blood cell,14641,1.0,1.0
10324,/images/f91670db-be74-474c-bd72-68120aed4756.png,385,295,487,390,102,95,red blood cell,9690,0.9313725490196079,1.0736842105263158
43400,/images/aabca37c-f9ef-4415-aab6-3246caa348e9.png,903,77,1010,185,107,108,red blood cell,11556,1.0093457943925233,0.9907407407407407
57440,/images/00d04a90-80e5-4bce-9511-1b64eabb7a47.png,260,47,364,150,104,103,red blood cell,10712,0.9903846153846154,1.0097087378640777
76373,/images/3dad6483-ac30-4d2b-b045-9f24fe6ff75e.png,902,890,1008,997,106,107,red blood cell,11342,1.009433962264151,0.9906542056074766
18509,/images/c22f7031-9cf8-48ce-b03b-1b12d0db4951.png,51,227,162,331,111,104,red blood cell,11544,0.9369369369369369,1.0673076923076923
49179,/images/a9daf82a-a46d-4296-bd72-2c374ed0a193.png,182,656,277,766,95,110,red blood cell,10450,1.1578947368421053,0.8636363636363636
24607,/images/c03d9b87-e19b-402b-ad86-b30d6e8aeb59.png,577,1050,682,1144,105,94,red blood cell,9870,0.8952380952380953,1.1170212765957446
9549,/images/a18f122f-3a3e-4478-8ac4-91b83e050e65.png,6,1097,123,1205,117,108,red blood cell,12636,0.9230769230769231,1.0833333333333333
21947,/images/d57b3894-c912-47e8-b00a-e1a2a7aba644.png,196,389,301,503,105,114,red blood cell,11970,1.0857142857142856,0.9210526315789473
42287,/images/ca734448-0d52-42fa-b41c-17b2939e58ae.png,388,839,501,964,113,125,red blood cell,14125,1.1061946902654867,0.904
25489,/images/f6ab936d-924b-4038-aa47-71b07c26b4e2.png,255,1003,368,1120,113,117,red blood cell,13221,1.0353982300884956,0.9658119658119658
66168,/images/14005767-9296-4b48-8a9d-bbe9b2040005.png,377,951,476,1043,99,92,red blood cell,9108,0.9292929292929293,1.076086956521739
40553,/images/e3ade58d-086c-47fa-9120-76beacb45395.png,428,670,531,773,103,103,red blood cell,10609,1.0,1.0
64407,/images/0a7bfa8a-ee52-4f7a-b9c5-2919ecfa93ef.png,791,193,903,288,112,95,red blood cell,10640,0.8482142857142857,1.1789473684210525
4831,/images/c6ab535c-30e5-4b6b-8273-1ec8d78cdd13.png,790,1001,909,1129,119,128,red blood cell,15232,1.0756302521008403,0.9296875
34211,/images/f1cda808-69a9-4d10-ba0a-6607c98e362d.png,351,997,462,1112,111,115,red blood cell,12765,1.0360360360360361,0.9652173913043478
79572,/images/161978c3-3a05-47a5-9fee-be7d25693eae.png,792,748,888,843,96,95,red blood cell,9120,0.9895833333333334,1.0105263157894737
31771,/images/ab59c9e4-3e50-48b9-874d-060d317410cc.png,1081,1132,1198,1247,117,115,red blood cell,13455,0.9829059829059829,1.017391304347826
15533,/images/169d541c-daed-468e-8b41-0f1abccdf319.png,916,1454,1008,1566,92,112,red blood cell,10304,1.2173913043478262,0.8214285714285714
63201,/images/f0804a5e-e7f5-4cf2-a5df-b65e66502bf1.png,583,1146,697,1265,114,119,red blood cell,13566,1.043859649122807,0.957983193277311
28776,/images/686ed568-d5f8-475e-81ad-edab9dd473a0.png,431,1289,565,1405,134,116,red blood cell,15544,0.8656716417910447,1.1551724137931034
25066,/images/b02f6804-1697-4a5e-9be7-61931903ab55.png,643,222,766,346,123,124,red blood cell,15252,1.008130081300813,0.9919354838709677
16585,/images/c7045ab6-230e-4c1e-a8e0-f624d41a00d9.png,871,981,974,1084,103,103,red blood cell,10609,1.0,1.0
57532,/images/00d04a90-80e5-4bce-9511-1b64eabb7a47.png,877,264,966,344,89,80,red blood cell,7120,0.898876404494382,1.1125
15317,/images/2d0f600d-f94e-4907-b712-52fb37d9ed52.png,580,56,685,156,105,100,red blood cell,10500,0.9523809523809523,1.05
28642,/images/861c3e06-aada-47a0-99ae-94fbc2772cc0.png,235,159,345,267,110,108,red blood cell,11880,0.9818181818181818,1.0185185185185186
52060,/images/de6d3020-9347-473b-9146-8909627790f6.png,931,561,1018,647,87,86,red blood cell,7482,0.9885057471264368,1.0116279069767442
58986,/images/a0eeeb10-d0cb-48d9-8c22-2c3a3c908d00.png,1024,1442,1128,1548,104,106,red blood cell,11024,1.0192307692307692,0.9811320754716981
23647,/images/79d7a014-21ff-40f1-9ac4-a69839390654.png,980,268,1080,360,100,92,red blood cell,9200,0.92,1.0869565217391304
22652,/images/4ab47131-c2ac-461f-b95c-ac19ce24edbd.png,675,167,772,274,97,107,red blood cell,10379,1.1030927835051547,0.9065420560747663
59888,/images/1519257c-e3e5-4474-908f-8665b3cf1258.png,892,178,980,279,88,101,red blood cell,8888,1.1477272727272727,0.8712871287128713
72215,/images/7d4d0646-26b5-46fa-ab25-452d986e887b.png,800,137,896,238,96,101,red blood cell,9696,1.0520833333333333,0.9504950495049505
8743,/images/29dc8176-dfe1-40e0-8247-2dc3c530057e.png,732,1318,842,1427,110,109,red blood cell,11990,0.990909090909091,1.0091743119266054
38789,/images/b426ef1d-4a59-4f90-b593-50226af60a60.png,674,152,758,256,84,104,red blood cell,8736,1.2380952380952381,0.8076923076923077
24928,/images/ed0bee2f-05e0-4392-8357-19750cec577c.png,267,386,354,479,87,93,red blood cell,8091,1.0689655172413792,0.9354838709677419
35761,/images/bb2042c5-35e1-43cc-8171-7de81b764361.png,828,626,938,730,110,104,red blood cell,11440,0.9454545454545454,1.0576923076923077
14518,/images/458cb2e9-5a7f-437c-ac5d-a56f98a3efdf.png,531,867,627,962,96,95,red blood cell,9120,0.9895833333333334,1.0105263157894737
67324,/images/49c4dbd3-6269-4d4c-9648-a2146c57bab1.png,962,309,1081,434,119,125,red blood cell,14875,1.050420168067227,0.952
33373,/images/f632981c-1330-4078-8a12-691beb2dab02.png,918,192,998,288,80,96,red blood cell,7680,1.2,0.8333333333333334
1920,/images/02ea7aa8-c142-4a3d-939f-e77689741341.png,455,804,576,947,121,143,red blood cell,17303,1.1818181818181819,0.8461538461538461
69649,/images/4a49841f-216c-4815-8140-b8762c4f6603.png,381,961,458,1033,77,72,red blood cell,5544,0.935064935064935,1.0694444444444444
40815,/images/252071ac-e9f2-41d2-abbb-87ef01b8a997.png,199,1177,286,1268,87,91,red blood cell,7917,1.0459770114942528,0.9560439560439561
21446,/images/b701b5c5-b922-4315-b12a-aac4ec65ee8b.png,86,490,190,597,104,107,red blood cell,11128,1.0288461538461537,0.9719626168224299
53202,/images/d8f7e159-b7e3-49e4-86e8-aed8c5fbcd97.png,201,1032,308,1149,107,117,red blood cell,12519,1.0934579439252337,0.9145299145299145
56066,/images/ffb7be9a-65df-4f0b-99ae-cfd34e81cd34.png,597,1245,690,1342,93,97,red blood cell,9021,1.043010752688172,0.9587628865979382
27223,/images/9f38055f-4fe6-47fd-a6dd-c0743db4eccf.png,6,784,116,905,110,121,red blood cell,13310,1.1,0.9090909090909091
2654,/images/a2ccbf70-e444-49a9-8b7e-9797a05220d8.png,165,425,273,537,108,112,red blood cell,12096,1.037037037037037,0.9642857142857143
31013,/images/b59dc3a0-3d54-4e3b-a485-33b3e43966de.png,145,46,264,152,119,106,red blood cell,12614,0.8907563025210085,1.1226415094339623
67425,/images/8e72e20e-e714-4db6-a1da-c05a409257d4.png,696,34,799,128,103,94,red blood cell,9682,0.912621359223301,1.0957446808510638
17673,/images/b5143aae-6e98-4dc6-b546-980cb472de67.png,93,1400,203,1502,110,102,red blood cell,11220,0.9272727272727272,1.0784313725490196
31203,/images/1976cd04-d24f-457c-b423-7e4cdb05de9e.png,114,540,217,667,103,127,red blood cell,13081,1.233009708737864,0.8110236220472441
54697,/images/6473ddb6-ad56-48a2-81e8-c7cb45f06825.png,716,1109,799,1202,83,93,red blood cell,7719,1.1204819277108433,0.8924731182795699
1354,/images/6d91d1f0-636b-4f5a-a526-7c17fc857190.png,105,375,187,462,82,87,red blood cell,7134,1.0609756097560976,0.9425287356321839
21765,/images/f68ae8e9-e760-4106-88e0-4bdef2785f06.png,50,325,179,456,129,131,red blood cell,16899,1.0155038759689923,0.9847328244274809
28549,/images/dbdfad64-110c-421f-a1c7-f68fd9e82d67.png,7,1444,125,1545,118,101,red blood cell,11918,0.8559322033898306,1.1683168316831682
22796,/images/8490c623-3d88-4532-baf5-0d266a45b16f.png,1015,628,1113,731,98,103,red blood cell,10094,1.0510204081632653,0.9514563106796117
72624,/images/a63ce82f-f3d1-4818-9035-d3d230e5f686.png,1064,512,1148,602,84,90,red blood cell,7560,1.0714285714285714,0.9333333333333333
46912,/images/9e0e1928-d19a-4100-b093-0b962ac09e05.png,744,1061,871,1177,127,116,red blood cell,14732,0.9133858267716536,1.0948275862068966
39621,/images/04d21589-b777-43c2-86b5-038cbf8c3a4e.png,1005,716,1111,831,106,115,red blood cell,12190,1.0849056603773586,0.9217391304347826
10829,/images/2a02cec2-a09b-483a-ad38-14359a763fa4.png,312,344,404,456,92,112,red blood cell,10304,1.2173913043478262,0.8214285714285714
61965,/images/c66a3e52-0f3f-4c81-bab9-0303499549f7.png,488,751,596,873,108,122,red blood cell,13176,1.1296296296296295,0.8852459016393442
63110,/images/d82c657e-5678-41da-9a6e-3ad29430b759.png,169,294,274,394,105,100,red blood cell,10500,0.9523809523809523,1.05
60652,/images/724e0c34-32cd-41f1-ae37-586038bc67ab.png,750,1159,832,1257,82,98,red blood cell,8036,1.1951219512195121,0.8367346938775511
41741,/images/32a1ea24-b6b7-4253-ad3e-bdf99c2c9b9d.png,1009,757,1125,873,116,116,red blood cell,13456,1.0,1.0
26983,/images/1f337b61-1b0d-4539-91f9-73d4a0798a4a.png,1062,900,1154,992,92,92,red blood cell,8464,1.0,1.0
72915,/images/a20d0b4b-6e2e-4507-bc22-f321dedc4ed9.png,1019,767,1128,872,109,105,red blood cell,11445,0.963302752293578,1.0380952380952382
78445,/images/fe00fa09-d3c8-485b-9d0f-3cce556c9edd.png,1058,1405,1164,1510,106,105,red blood cell,11130,0.9905660377358491,1.0095238095238095
40195,/images/ef1a9020-5e45-450d-a237-165114308592.png,839,1026,958,1159,119,133,red blood cell,15827,1.1176470588235294,0.8947368421052632
55039,/images/1f8f08ea-b5b3-4f68-94d4-3cc071b7dce8.png,400,731,520,828,120,97,red blood cell,11640,0.8083333333333333,1.2371134020618557
47555,/images/adff132d-3af0-4cef-942c-58fc09729bee.png,468,73,592,185,124,112,red blood cell,13888,0.9032258064516129,1.1071428571428572
41005,/images/8e078333-8fa0-45be-a46e-fa05708cb365.png,903,652,1029,778,126,126,red blood cell,15876,1.0,1.0
2405,/images/fe851c88-692d-4199-87e0-d19d9c4eb591.png,946,52,1038,158,92,106,red blood cell,9752,1.1521739130434783,0.8679245283018868
28071,/images/f1f9df6d-c4cb-4b42-9ca2-8fb47b1b0e91.png,369,1264,482,1378,113,114,red blood cell,12882,1.008849557522124,0.9912280701754386
18645,/images/c22f7031-9cf8-48ce-b03b-1b12d0db4951.png,66,1337,165,1428,99,91,red blood cell,9009,0.9191919191919192,1.0879120879120878
59043,/images/597bbff8-6592-41cf-8946-e59b0d1f289a.png,647,271,748,352,101,81,red blood cell,8181,0.801980198019802,1.2469135802469136
53657,/images/7bcd3735-3134-46d1-8ca2-d4379f2d51c0.png,723,170,819,288,96,118,red blood cell,11328,1.2291666666666667,0.8135593220338984
67037,/images/1fe1e118-adb8-4b10-a41e-1e5814e8f067.png,768,1048,886,1161,118,113,red blood cell,13334,0.9576271186440678,1.0442477876106195
18512,/images/c22f7031-9cf8-48ce-b03b-1b12d0db4951.png,1052,692,1158,802,106,110,red blood cell,11660,1.0377358490566038,0.9636363636363636
46695,/images/da111ca5-520f-4ea8-97ad-ae5fce58ee91.png,0,566,102,668,102,102,red blood cell,10404,1.0,1.0
67089,/images/4272cbd7-5b0a-4bf7-b690-dee1c128f07b.png,437,86,530,183,93,97,red blood cell,9021,1.043010752688172,0.9587628865979382
24114,/images/505355c9-23bf-4f90-8ebc-6a7ef50964d0.png,921,1465,1038,1579,117,114,red blood cell,13338,0.9743589743589743,1.0263157894736843
68596,/images/31653d0f-c4e6-4e12-8005-518c2de34687.png,614,649,731,787,117,138,red blood cell,16146,1.1794871794871795,0.8478260869565217
72895,/images/31435107-c77d-42f8-a619-75cba6a5161b.png,378,366,486,479,108,113,red blood cell,12204,1.0462962962962963,0.9557522123893806
59747,/images/f77d7469-d083-4c2d-a4ea-5a9ff162e3e2.png,80,287,190,399,110,112,red blood cell,12320,1.018181818181818,0.9821428571428571
61500,/images/7e837856-3519-4dc0-b357-4cdcfd30b4eb.png,703,1056,799,1140,96,84,red blood cell,8064,0.875,1.1428571428571428
16429,/images/e474a20b-2769-48f1-a520-4f6ef5a0dbf5.png,275,184,370,281,95,97,red blood cell,9215,1.0210526315789474,0.979381443298969
1622,/images/7094c11a-1e62-4f98-894e-d17d138a88e9.png,692,1258,822,1380,130,122,red blood cell,15860,0.9384615384615385,1.0655737704918034
47735,/images/afbb264e-ff60-443a-83f5-49d09be1b835.png,903,1064,1034,1171,131,107,red blood cell,14017,0.816793893129771,1.2242990654205608
38489,/images/aa4a023b-55bd-4259-b15d-7086a9b491e0.png,316,61,455,192,139,131,red blood cell,18209,0.9424460431654677,1.0610687022900764
4879,/images/61cd8c7d-394d-42d3-9ed4-e09559110bed.png,45,1378,151,1483,106,105,red blood cell,11130,0.9905660377358491,1.0095238095238095
46902,/images/9e0e1928-d19a-4100-b093-0b962ac09e05.png,798,558,886,657,88,99,red blood cell,8712,1.125,0.8888888888888888
69582,/images/4a49841f-216c-4815-8140-b8762c4f6603.png,539,976,654,1081,115,105,red blood cell,12075,0.9130434782608695,1.0952380952380953
39780,/images/5c68070c-3391-4db6-8c01-94175105dbea.png,288,715,400,829,112,114,red blood cell,12768,1.0178571428571428,0.9824561403508771
37449,/images/c6530038-6d4e-49e1-8427-d1d3acc9fa21.png,820,1109,917,1230,97,121,red blood cell,11737,1.2474226804123711,0.8016528925619835
38733,/images/b426ef1d-4a59-4f90-b593-50226af60a60.png,1030,1411,1151,1528,121,117,red blood cell,14157,0.9669421487603306,1.0341880341880343
59915,/images/1519257c-e3e5-4474-908f-8665b3cf1258.png,463,500,549,605,86,105,red blood cell,9030,1.2209302325581395,0.819047619047619
22699,/images/4ab47131-c2ac-461f-b95c-ac19ce24edbd.png,137,1473,226,1580,89,107,red blood cell,9523,1.202247191011236,0.8317757009345794
68117,/images/5dec94a3-e3ca-4a58-9702-88e5a83ef612.png,835,545,959,659,124,114,red blood cell,14136,0.9193548387096774,1.087719298245614
48337,/images/6fa2b30f-9b89-46ac-9b79-c0bc105d4271.png,1011,897,1109,998,98,101,red blood cell,9898,1.030612244897959,0.9702970297029703
63824,/images/6013bff0-dc4b-4bde-9409-0f6139c3495c.png,125,1249,213,1347,88,98,red blood cell,8624,1.1136363636363635,0.8979591836734694
38567,/images/c3ae7090-fc68-41b4-85a1-8d9bce9825a7.png,235,1402,337,1516,102,114,red blood cell,11628,1.1176470588235294,0.8947368421052632
54747,/images/10891eed-b0f2-4dd0-90cb-da185f6761b2.png,107,992,213,1101,106,109,red blood cell,11554,1.028301886792453,0.9724770642201835
12773,/images/b634137b-bc8b-4e88-b0e3-b536ad6e7e18.png,283,1020,402,1134,119,114,red blood cell,13566,0.957983193277311,1.043859649122807
3599,/images/25132962-ff5d-4737-995f-c54d8490539b.png,292,716,424,829,132,113,red blood cell,14916,0.8560606060606061,1.168141592920354
8677,/images/ea6b012a-3425-4bfc-a61d-88563aa2a264.png,283,420,384,522,101,102,red blood cell,10302,1.00990099009901,0.9901960784313726
41343,/images/a065c50b-341d-4803-b4b0-0fe8f04fdbb5.png,241,5,354,126,113,121,red blood cell,13673,1.0707964601769913,0.9338842975206612
47625,/images/78ac1e98-7062-4e27-8d58-25c392cae889.png,333,331,446,456,113,125,red blood cell,14125,1.1061946902654867,0.904
20196,/images/bb337c84-f727-42a5-9c3d-934323a16c6a.png,15,115,136,229,121,114,red blood cell,13794,0.9421487603305785,1.0614035087719298
66173,/images/14005767-9296-4b48-8a9d-bbe9b2040005.png,211,1458,324,1564,113,106,red blood cell,11978,0.9380530973451328,1.0660377358490567
28802,/images/686ed568-d5f8-475e-81ad-edab9dd473a0.png,725,18,820,124,95,106,red blood cell,10070,1.1157894736842104,0.8962264150943396
47399,/images/477e541c-0519-4542-9b13-8ee7922644d3.png,513,1476,605,1567,92,91,red blood cell,8372,0.9891304347826086,1.010989010989011
21116,/images/fb05b297-180a-4171-b633-09d5616d7534.png,798,894,900,1003,102,109,red blood cell,11118,1.0686274509803921,0.9357798165137615
38837,/images/d79b4e90-c45d-4f5d-a498-49c3e323c291.png,861,1377,964,1482,103,105,red blood cell,10815,1.0194174757281553,0.9809523809523809
68128,/images/5dec94a3-e3ca-4a58-9702-88e5a83ef612.png,578,102,696,213,118,111,red blood cell,13098,0.940677966101695,1.063063063063063
63765,/images/06401963-8b02-46c5-ab2a-3d70bd01623f.png,410,95,487,179,77,84,red blood cell,6468,1.0909090909090908,0.9166666666666666
66345,/images/fcdf6632-c03f-49a8-9fb3-42e87c99b9d0.png,646,1320,750,1426,104,106,red blood cell,11024,1.0192307692307692,0.9811320754716981
9131,/images/d3ed519e-2152-4e30-838d-a3ea23be512f.png,902,222,1027,329,125,107,red blood cell,13375,0.856,1.1682242990654206
14096,/images/eaf4b781-b3aa-41ce-8c5e-287979b4e15a.png,649,239,748,353,99,114,red blood cell,11286,1.1515151515151516,0.868421052631579
76849,/images/2165fe38-b474-467d-be11-d1d728085efd.png,166,661,261,767,95,106,red blood cell,10070,1.1157894736842104,0.8962264150943396
66727,/images/334bf865-e3fb-4200-bd53-d9ff5808ed9f.png,501,1217,603,1313,102,96,red blood cell,9792,0.9411764705882353,1.0625
512,/images/67acd5bc-4658-4c6e-a9b9-cd8ea3a03418.png,726,211,848,325,122,114,red blood cell,13908,0.9344262295081968,1.0701754385964912
261,/images/0dcca702-a4ef-4fb3-a940-9c0c140b21c7.png,373,476,496,604,123,128,red blood cell,15744,1.0406504065040652,0.9609375
4705,/images/b91b1641-ee06-44d8-94cc-24cdb583cc37.png,331,405,457,535,126,130,red blood cell,16380,1.0317460317460319,0.9692307692307692
56974,/images/a93c35ba-1690-4358-8837-669bcd850bb7.png,207,1357,317,1481,110,124,red blood cell,13640,1.1272727272727272,0.8870967741935484
34678,/images/8d989997-038c-4924-b2d3-d02629a7cdf5.png,145,161,258,279,113,118,red blood cell,13334,1.0442477876106195,0.9576271186440678
16862,/images/4823c1fe-a7f9-4b92-959f-0d9be09cd14b.png,960,1134,1051,1246,91,112,red blood cell,10192,1.2307692307692308,0.8125
60271,/images/7abc0d26-dd66-4ef4-8c4e-4a661e589a7f.png,125,280,246,381,121,101,red blood cell,12221,0.8347107438016529,1.198019801980198
61222,/images/0da07970-3146-479c-8a07-f61ed32814a9.png,359,1094,471,1207,112,113,red blood cell,12656,1.0089285714285714,0.9911504424778761
70897,/images/bf002a25-6535-4621-be19-56d468be5413.png,794,1133,877,1219,83,86,red blood cell,7138,1.036144578313253,0.9651162790697675
28613,/images/861c3e06-aada-47a0-99ae-94fbc2772cc0.png,717,1336,833,1464,116,128,red blood cell,14848,1.103448275862069,0.90625
30464,/images/5955289d-19e5-45ef-a012-c8ea08ef45e2.png,610,604,716,722,106,118,red blood cell,12508,1.1132075471698113,0.8983050847457628
62113,/images/f5c51193-8a27-4ef3-83ad-771395d63caf.png,679,651,794,764,115,113,red blood cell,12995,0.9826086956521739,1.0176991150442478
53175,/images/801296d9-3403-426f-859e-5c532858e025.png,991,535,1104,655,113,120,red blood cell,13560,1.0619469026548674,0.9416666666666667
47890,/images/ab27173b-6e30-4957-bd68-29194328fd39.png,420,1007,498,1089,78,82,red blood cell,6396,1.0512820512820513,0.9512195121951219
37129,/images/d6942996-5664-4370-ad87-2bdcbd49ac16.png,564,1012,684,1136,120,124,red blood cell,14880,1.0333333333333334,0.967741935483871
47579,/images/06cd484f-e864-4fee-8819-688b45eed98e.png,738,68,846,185,108,117,red blood cell,12636,1.0833333333333333,0.9230769230769231
73974,/images/99a21c5c-f5a7-4c07-9cb6-5dda2d388f48.png,775,541,907,662,132,121,red blood cell,15972,0.9166666666666666,1.0909090909090908
1843,/images/8855c685-5a8c-4967-a356-942ed89e3471.png,378,832,495,941,117,109,red blood cell,12753,0.9316239316239316,1.073394495412844
45852,/images/7db1373d-5bbf-47e6-ab40-30cba7678745.png,1066,181,1164,277,98,96,red blood cell,9408,0.9795918367346939,1.0208333333333333
12303,/images/3b55c42f-ad59-422f-ba99-4f4f4ca9cb2e.png,489,1412,592,1511,103,99,red blood cell,10197,0.9611650485436893,1.0404040404040404
12604,/images/0901f9d1-be4f-4c19-8e83-dd724dded9f5.png,899,673,998,770,99,97,red blood cell,9603,0.9797979797979798,1.0206185567010309
47658,/images/4b3a49bc-8536-4760-9553-440a6f64db37.png,617,618,736,730,119,112,red blood cell,13328,0.9411764705882353,1.0625
74144,/images/9fe8bdc8-847d-434e-93e5-ae14ff3b45e1.png,607,825,709,941,102,116,red blood cell,11832,1.1372549019607843,0.8793103448275862
54067,/images/d9345456-b76d-46cc-b81e-46d4a0a7b652.png,1070,813,1178,925,108,112,red blood cell,12096,1.037037037037037,0.9642857142857143
20820,/images/c2ec116f-f091-422c-926c-70b548a8f6ef.png,284,484,380,577,96,93,red blood cell,8928,0.96875,1.032258064516129
29379,/images/30167dc1-f739-4036-b5c4-5fad435c2c67.png,772,798,890,915,118,117,red blood cell,13806,0.9915254237288136,1.0085470085470085
52021,/images/6c3f81d7-5670-46bd-9eaa-9b426413abb7.png,964,1189,1090,1312,126,123,red blood cell,15498,0.9761904761904762,1.024390243902439
75971,/images/034c8d57-04d5-4786-93a4-6ae8fde2c258.png,130,1479,226,1567,96,88,red blood cell,8448,0.9166666666666666,1.0909090909090908
69694,/images/f0713bee-2a71-4ced-b953-4041ea99496a.png,341,11,442,119,101,108,red blood cell,10908,1.0693069306930694,0.9351851851851852
55341,/images/4fb83278-adc5-4424-9f45-b6d0db2955b6.png,347,1102,461,1210,114,108,red blood cell,12312,0.9473684210526315,1.0555555555555556
2978,/images/5a386082-397f-4524-a6f9-c2b8efe5014d.png,765,1305,889,1420,124,115,red blood cell,14260,0.9274193548387096,1.0782608695652174
74560,/images/bbedfcbe-9528-4ba9-9d86-4ebba7589ac5.png,409,853,516,964,107,111,red blood cell,11877,1.0373831775700935,0.963963963963964
31788,/images/63ed5931-d93e-4f9b-a6f3-152713cb560e.png,1023,1406,1142,1519,119,113,red blood cell,13447,0.9495798319327731,1.0530973451327434
65001,/images/ff3b9d4d-373c-48ef-a75a-d23e2c2ade87.png,280,730,383,830,103,100,red blood cell,10300,0.970873786407767,1.03
38091,/images/907650b5-edae-471d-bc54-a825be3d3fac.png,680,894,803,1003,123,109,red blood cell,13407,0.8861788617886179,1.128440366972477
30082,/images/81c3c8f0-d5a9-4dda-afd5-e86f6afd9424.png,978,1301,1070,1416,92,115,red blood cell,10580,1.25,0.8
56342,/images/4372709c-f356-4906-be17-415384d916e8.png,674,124,777,224,103,100,red blood cell,10300,0.970873786407767,1.03
6283,/images/f4a27dfd-4c52-459f-96b5-ee6b452a3395.png,736,661,870,800,134,139,red blood cell,18626,1.037313432835821,0.9640287769784173
64549,/images/6ba5d0b8-cdc7-4266-9d78-db76faa312e9.png,749,196,847,279,98,83,red blood cell,8134,0.8469387755102041,1.180722891566265
41095,/images/e871f52c-77a6-4813-80d4-95bd97985f1a.png,893,1320,999,1421,106,101,red blood cell,10706,0.9528301886792453,1.0495049504950495
26158,/images/04de27ff-0d36-4da3-a829-e93851d76981.png,169,1201,302,1318,133,117,red blood cell,15561,0.8796992481203008,1.1367521367521367
506,/images/67acd5bc-4658-4c6e-a9b9-cd8ea3a03418.png,668,994,805,1105,137,111,red blood cell,15207,0.8102189781021898,1.2342342342342343
73525,/images/7624ac36-1cf9-42fb-844d-376078309553.png,350,332,456,431,106,99,red blood cell,10494,0.9339622641509434,1.0707070707070707
30197,/images/a1669b59-fe09-4fe6-ba9f-06bec6725502.png,468,1175,601,1297,133,122,red blood cell,16226,0.9172932330827067,1.0901639344262295
11921,/images/2e8d6a43-0110-4bf4-8e70-20567e513b81.png,129,1449,234,1553,105,104,red blood cell,10920,0.9904761904761905,1.0096153846153846
60710,/images/45651e76-4bd0-45e5-895b-edec65f51987.png,316,1120,427,1222,111,102,red blood cell,11322,0.918918918918919,1.088235294117647
56805,/images/0dcbf2c9-f959-4703-a72b-f6a81e66c2ea.png,646,99,752,216,106,117,red blood cell,12402,1.1037735849056605,0.905982905982906
67180,/images/be6fe358-dee1-4dcf-9b0d-5d8612aba577.png,821,1312,914,1419,93,107,red blood cell,9951,1.1505376344086022,0.8691588785046729
68728,/images/dcf7a19a-ec3d-44ef-8d7c-33b1e91fb9af.png,760,520,867,627,107,107,red blood cell,11449,1.0,1.0
47861,/images/ab27173b-6e30-4957-bd68-29194328fd39.png,32,14,129,109,97,95,red blood cell,9215,0.979381443298969,1.0210526315789474
28218,/images/036404d1-b9fc-497b-bbe1-f4d9c5ac3ce0.png,832,96,949,218,117,122,red blood cell,14274,1.0427350427350428,0.9590163934426229
74276,/images/8939e14b-fcdf-48b1-acb9-6514a2fc2fc0.png,918,982,1016,1087,98,105,red blood cell,10290,1.0714285714285714,0.9333333333333333
14667,/images/9d155086-acf5-4c86-a9e1-94b587c46e87.png,867,30,999,139,132,109,red blood cell,14388,0.8257575757575758,1.2110091743119267
44511,/images/b6573be3-9e04-49c3-9f48-6a145d065363.png,790,1039,900,1149,110,110,red blood cell,12100,1.0,1.0
53725,/images/6f67a66b-56ec-4c36-ae7c-f250d3b86a23.png,546,716,648,817,102,101,red blood cell,10302,0.9901960784313726,1.00990099009901
65126,/images/5e042380-6ef2-496f-8231-0ca550fbfa71.png,93,109,188,222,95,113,red blood cell,10735,1.1894736842105262,0.8407079646017699
73954,/images/2ae3e6e6-7482-4ab8-ad73-b530b5c2ee3b.png,439,131,523,222,84,91,red blood cell,7644,1.0833333333333333,0.9230769230769231
26660,/images/c1423156-82b3-4dd3-8e74-08eb7ed8e1d6.png,250,126,372,248,122,122,red blood cell,14884,1.0,1.0
2464,/images/fe851c88-692d-4199-87e0-d19d9c4eb591.png,907,59,1013,167,106,108,red blood cell,11448,1.0188679245283019,0.9814814814814815
66498,/images/b87fb62d-2c36-4f68-aba9-37fcd7d46eef.png,121,1252,224,1354,103,102,red blood cell,10506,0.9902912621359223,1.0098039215686274
8269,/images/65e3d6a6-012c-4b40-9a42-83078eb85e31.png,901,360,1006,465,105,105,red blood cell,11025,1.0,1.0
51350,/images/b4f3b2a4-f4b9-48de-ac5d-0e681b77be27.png,455,1088,560,1195,105,107,red blood cell,11235,1.019047619047619,0.9813084112149533
63558,/images/de0321fa-6f7d-4dd1-b96b-186701c3b1d9.png,706,1099,829,1228,123,129,red blood cell,15867,1.048780487804878,0.9534883720930233
47680,/images/4b3a49bc-8536-4760-9553-440a6f64db37.png,724,9,826,130,102,121,red blood cell,12342,1.1862745098039216,0.8429752066115702
51828,/images/f07174a5-f799-4286-ac43-5b0f5c5777ac.png,772,254,850,344,78,90,red blood cell,7020,1.1538461538461537,0.8666666666666667
4099,/images/d3b79739-aea2-4804-8c7a-183b7ed07de3.png,990,1262,1104,1364,114,102,red blood cell,11628,0.8947368421052632,1.1176470588235294
71609,/images/390ad256-e1ed-476a-9f14-2dc34e0da632.png,534,149,662,282,128,133,red blood cell,17024,1.0390625,0.9624060150375939
60398,/images/8d5d5c22-2f75-4fe1-9ea3-03a3c7b92ea9.png,673,533,795,646,122,113,red blood cell,13786,0.9262295081967213,1.079646017699115
12295,/images/3b55c42f-ad59-422f-ba99-4f4f4ca9cb2e.png,674,1042,767,1134,93,92,red blood cell,8556,0.989247311827957,1.0108695652173914
1685,/images/5f783f43-0090-4f8a-bd75-9562f4aa2dd5.png,971,1080,1090,1201,119,121,red blood cell,14399,1.0168067226890756,0.9834710743801653
66314,/images/fcdf6632-c03f-49a8-9fb3-42e87c99b9d0.png,379,1095,481,1203,102,108,red blood cell,11016,1.0588235294117647,0.9444444444444444
14756,/images/1fdf99d1-a494-4174-bcd7-efbe457ab899.png,400,445,501,558,101,113,red blood cell,11413,1.118811881188119,0.8938053097345132
7805,/images/e726dac6-f962-449c-acff-4dd56847b685.png,87,758,203,870,116,112,red blood cell,12992,0.9655172413793104,1.0357142857142858
4858,/images/c6ab535c-30e5-4b6b-8273-1ec8d78cdd13.png,480,1368,609,1500,129,132,red blood cell,17028,1.0232558139534884,0.9772727272727273
50298,/images/3d32a988-449d-4d58-b71f-abbfdc3f2fbc.png,1096,1101,1187,1206,91,105,red blood cell,9555,1.1538461538461537,0.8666666666666667
70698,/images/8ab5c462-045e-4b59-b53a-9b2bc3ed2487.png,90,957,197,1070,107,113,red blood cell,12091,1.0560747663551402,0.9469026548672567
2063,/images/f3bd0fcc-647d-4ca0-8c43-a16bd6ea3878.png,586,1128,699,1257,113,129,red blood cell,14577,1.1415929203539823,0.875968992248062
69574,/images/4a49841f-216c-4815-8140-b8762c4f6603.png,398,723,503,827,105,104,red blood cell,10920,0.9904761904761905,1.0096153846153846
52501,/images/d1144956-5a0c-4bd2-b67d-8498c82d6a12.png,952,1235,1043,1326,91,91,red blood cell,8281,1.0,1.0
9333,/images/261562a8-ffd8-4e0e-919b-22e267000b74.png,773,887,880,999,107,112,red blood cell,11984,1.0467289719626167,0.9553571428571429
31964,/images/9eb66577-7857-43dc-a879-8f2c9d7f780f.png,757,41,854,143,97,102,red blood cell,9894,1.0515463917525774,0.9509803921568627
5581,/images/75c243e2-610d-4d5a-bc5a-4c53d99d9ae9.png,1073,671,1192,788,119,117,red blood cell,13923,0.9831932773109243,1.017094017094017
76916,/images/25ddc1ca-d368-4fff-b1ad-1dbf1e7c97aa.png,390,1121,504,1216,114,95,red blood cell,10830,0.8333333333333334,1.2
65871,/images/d7581cb0-7a12-471d-a3d8-68dcea362213.png,184,432,288,530,104,98,red blood cell,10192,0.9423076923076923,1.0612244897959184
78859,/images/4d0a1598-e4dd-45c4-8a90-dd7c780fe1da.png,132,917,221,1024,89,107,red blood cell,9523,1.202247191011236,0.8317757009345794
40215,/images/ef1a9020-5e45-450d-a237-165114308592.png,1030,1283,1151,1416,121,133,red blood cell,16093,1.0991735537190082,0.9097744360902256
28434,/images/c3042130-a6e2-458f-9fde-bb012f68f5f2.png,11,644,129,753,118,109,red blood cell,12862,0.923728813559322,1.0825688073394495
68098,/images/29d40b60-cde1-45b5-b403-692437a77ac1.png,63,1026,156,1137,93,111,red blood cell,10323,1.1935483870967742,0.8378378378378378
19527,/images/2c1eaf87-3fd3-4803-92b8-23bab40bf28c.png,630,835,741,956,111,121,red blood cell,13431,1.09009009009009,0.9173553719008265
72247,/images/7d4d0646-26b5-46fa-ab25-452d986e887b.png,1047,759,1147,858,100,99,red blood cell,9900,0.99,1.0101010101010102
9066,/images/21c2a8aa-407c-4569-8212-96fcafa84138.png,689,584,836,712,147,128,red blood cell,18816,0.8707482993197279,1.1484375
78356,/images/24115f58-a7d6-4022-a95a-86b515a78d3e.png,352,1465,453,1564,101,99,red blood cell,9999,0.9801980198019802,1.02020202020202
57120,/images/7d041c38-11f2-4186-8a24-29d7d0f5c3cf.png,124,57,248,166,124,109,red blood cell,13516,0.8790322580645161,1.1376146788990826
76448,/images/34df8890-272d-423a-ae78-ff8d068d3306.png,972,103,1076,216,104,113,red blood cell,11752,1.0865384615384615,0.9203539823008849
37069,/images/b2e34f5f-904e-4473-9dc7-c6bc1ce12640.png,41,34,130,126,89,92,red blood cell,8188,1.0337078651685394,0.967391304347826
33504,/images/795d0331-da56-4d45-a58a-54803408ffd9.png,494,246,606,365,112,119,red blood cell,13328,1.0625,0.9411764705882353
78214,/images/2bed2796-75a9-4d93-bb2d-e3ccbe1a5cbe.png,1015,1096,1115,1189,100,93,red blood cell,9300,0.93,1.075268817204301
64388,/images/0a7bfa8a-ee52-4f7a-b9c5-2919ecfa93ef.png,822,983,918,1084,96,101,red blood cell,9696,1.0520833333333333,0.9504950495049505
65671,/images/397f37bc-a3a4-4257-9430-c8fc5716f8b1.png,757,295,858,394,101,99,red blood cell,9999,0.9801980198019802,1.02020202020202
68809,/images/aa3ad405-828e-4986-8251-20fd981f34d3.png,16,936,125,1051,109,115,red blood cell,12535,1.055045871559633,0.9478260869565217
58829,/images/434523fd-d4d9-4961-a7c2-d71d6ae68e13.png,269,1070,371,1182,102,112,red blood cell,11424,1.0980392156862746,0.9107142857142857
65613,/images/01b38a56-13eb-447b-89ee-fc21cb40dcc1.png,950,1221,1052,1327,102,106,red blood cell,10812,1.0392156862745099,0.9622641509433962
59785,/images/f77d7469-d083-4c2d-a4ea-5a9ff162e3e2.png,306,625,421,736,115,111,red blood cell,12765,0.9652173913043478,1.0360360360360361
65397,/images/24418314-f7a4-49fc-a03e-ec597ca6796e.png,2,592,84,678,82,86,red blood cell,7052,1.048780487804878,0.9534883720930233
60020,/images/49288109-80e9-4ec8-96d1-26a0166b8883.png,470,626,576,729,106,103,red blood cell,10918,0.9716981132075472,1.029126213592233
62529,/images/7dfbfeaf-e3b1-4159-8dcd-d7f731280ac8.png,514,955,613,1039,99,84,red blood cell,8316,0.8484848484848485,1.1785714285714286
28952,/images/b12ae3b1-613c-4c0e-9163-3c5cc314abf5.png,842,65,941,183,99,118,red blood cell,11682,1.1919191919191918,0.8389830508474576
40124,/images/b34e65f6-c32e-42f1-a437-4a037c75a231.png,583,1031,694,1143,111,112,red blood cell,12432,1.009009009009009,0.9910714285714286
10177,/images/09ecf7be-28e2-4531-b9e2-07e01c44097d.png,721,245,824,331,103,86,red blood cell,8858,0.8349514563106796,1.197674418604651
53323,/images/d8f7e159-b7e3-49e4-86e8-aed8c5fbcd97.png,503,862,587,958,84,96,red blood cell,8064,1.1428571428571428,0.875
11552,/images/834a30bb-26bf-4e60-9ea1-3250b926892e.png,773,844,894,963,121,119,red blood cell,14399,0.9834710743801653,1.0168067226890756
76467,/images/34df8890-272d-423a-ae78-ff8d068d3306.png,408,26,500,123,92,97,red blood cell,8924,1.0543478260869565,0.9484536082474226
19278,/images/b4d22412-a495-43a9-bec0-73a2322f8dad.png,742,743,842,842,100,99,red blood cell,9900,0.99,1.0101010101010102
75620,/images/c35ee701-fde2-46b5-b178-1fe3f1ea7da2.png,716,1257,808,1363,92,106,red blood cell,9752,1.1521739130434783,0.8679245283018868
64105,/images/0d3c2521-da55-4df5-bf06-56b3bd4fb2fc.png,227,353,318,457,91,104,red blood cell,9464,1.1428571428571428,0.875
35790,/images/bb2042c5-35e1-43cc-8171-7de81b764361.png,2,830,116,934,114,104,red blood cell,11856,0.9122807017543859,1.0961538461538463
117,/images/10be6380-cbbb-4886-8b9e-ff56b1710576.png,598,849,684,945,86,96,red blood cell,8256,1.1162790697674418,0.8958333333333334
73337,/images/c890ee00-daa5-4b20-9cd5-930748ecc4e0.png,743,1077,854,1201,111,124,red blood cell,13764,1.117117117117117,0.8951612903225806
36042,/images/ca9626bc-21a4-46f4-ba94-e7ee7a4cf735.png,898,777,1021,899,123,122,red blood cell,15006,0.991869918699187,1.0081967213114753
43859,/images/679ae89f-4a02-4301-862e-1d844cc66cbf.png,368,1186,480,1315,112,129,red blood cell,14448,1.1517857142857142,0.8682170542635659
50188,/images/4cccfcf0-cac9-46f0-870c-0eabfdc781ba.png,988,693,1099,815,111,122,red blood cell,13542,1.0990990990990992,0.9098360655737705
13493,/images/370277f8-436b-4103-8210-b4feb5ab95ea.png,408,796,501,911,93,115,red blood cell,10695,1.2365591397849462,0.808695652173913
7368,/images/89f10192-d3dd-4996-a571-4c851dbdc983.png,391,62,485,149,94,87,red blood cell,8178,0.925531914893617,1.0804597701149425
51316,/images/216f9d43-6869-4ba1-9106-4f5ea6aac223.png,0,1340,99,1439,99,99,red blood cell,9801,1.0,1.0
28604,/images/861c3e06-aada-47a0-99ae-94fbc2772cc0.png,727,51,845,161,118,110,red blood cell,12980,0.9322033898305084,1.0727272727272728
27029,/images/ec301f62-1302-4407-96f9-fcfe45c150ae.png,313,971,450,1093,137,122,red blood cell,16714,0.8905109489051095,1.1229508196721312
54833,/images/b6364a57-72a9-43f3-8d02-9f53a992dc95.png,880,330,992,445,112,115,red blood cell,12880,1.0267857142857142,0.9739130434782609
38283,/images/b834cbf7-ff97-49d9-9561-566c9343735c.png,954,206,1067,327,113,121,red blood cell,13673,1.0707964601769913,0.9338842975206612
47470,/images/f7231477-f2c1-439a-9c8b-204de07686a4.png,997,574,1113,710,116,136,red blood cell,15776,1.1724137931034482,0.8529411764705882
64366,/images/0a7bfa8a-ee52-4f7a-b9c5-2919ecfa93ef.png,178,1365,284,1471,106,106,red blood cell,11236,1.0,1.0
76294,/images/1574565f-f45b-4160-947e-25ce1a81aaca.png,224,160,321,256,97,96,red blood cell,9312,0.9896907216494846,1.0104166666666667
8842,/images/91827f1a-9b04-4ef0-972c-12e90e60c516.png,224,275,353,405,129,130,red blood cell,16770,1.0077519379844961,0.9923076923076923
25415,/images/5f742392-278d-461c-a848-08def2c28878.png,1010,798,1127,909,117,111,red blood cell,12987,0.9487179487179487,1.054054054054054
10641,/images/20d4f65e-6c63-433a-935c-d568d577967b.png,976,1230,1070,1312,94,82,red blood cell,7708,0.8723404255319149,1.146341463414634
13250,/images/711f6b3f-cd63-46d1-834a-bc8e9aa9b43e.png,665,274,768,359,103,85,red blood cell,8755,0.8252427184466019,1.2117647058823529
64241,/images/2a91387a-d30f-418d-ac3a-f7cfa6836261.png,759,267,857,363,98,96,red blood cell,9408,0.9795918367346939,1.0208333333333333
25822,/images/14b68d86-ac7f-419d-b4a5-6b0b1d9aaa18.png,679,523,779,622,100,99,red blood cell,9900,0.99,1.0101010101010102
40557,/images/29861cf9-9a1e-4733-8309-4bd10706b4a3.png,602,344,725,460,123,116,red blood cell,14268,0.943089430894309,1.0603448275862069
12636,/images/0901f9d1-be4f-4c19-8e83-dd724dded9f5.png,505,906,612,1016,107,110,red blood cell,11770,1.02803738317757,0.9727272727272728
43778,/images/ef83ed4c-2724-4d5f-8abe-1a18d25cea35.png,478,96,603,201,125,105,red blood cell,13125,0.84,1.1904761904761905
60606,/images/724e0c34-32cd-41f1-ae37-586038bc67ab.png,620,321,722,415,102,94,red blood cell,9588,0.9215686274509803,1.0851063829787233
52028,/images/6c3f81d7-5670-46bd-9eaa-9b426413abb7.png,423,1337,540,1458,117,121,red blood cell,14157,1.0341880341880343,0.9669421487603306
42646,/images/3abbc4d3-1d7e-40c9-9963-33732da7cc50.png,974,540,1077,637,103,97,red blood cell,9991,0.941747572815534,1.0618556701030928
15188,/images/3a8f468f-f9de-46a8-a7c8-f2be239fa207.png,180,41,265,126,85,85,red blood cell,7225,1.0,1.0
53881,/images/540a5fee-175b-4b92-bf62-1ea9b59c86c6.png,280,1125,377,1234,97,109,red blood cell,10573,1.1237113402061856,0.8899082568807339
29269,/images/6274fe0d-0d71-40be-b61b-f0bd5b5df1e2.png,240,1292,318,1378,78,86,red blood cell,6708,1.1025641025641026,0.9069767441860465
5321,/images/06df7bbe-60d4-4f7c-ba4a-5a42ac4be91b.png,163,405,270,522,107,117,red blood cell,12519,1.0934579439252337,0.9145299145299145
25273,/images/587e5464-d70b-4279-8562-010279f6efbd.png,1009,426,1129,561,120,135,red blood cell,16200,1.125,0.8888888888888888
36810,/images/dfac6c92-8f0f-429a-8caf-9b7732bf78da.png,593,1319,697,1434,104,115,red blood cell,11960,1.1057692307692308,0.9043478260869565
7564,/images/071901eb-4c3f-404b-a747-3d0b9d0a5158.png,601,1440,700,1538,99,98,red blood cell,9702,0.98989898989899,1.010204081632653
66529,/images/b87fb62d-2c36-4f68-aba9-37fcd7d46eef.png,490,903,591,999,101,96,red blood cell,9696,0.9504950495049505,1.0520833333333333
56147,/images/50d9fc90-8642-4bb6-91a7-0069a7e37392.png,1002,410,1104,520,102,110,red blood cell,11220,1.0784313725490196,0.9272727272727272
75143,/images/7fdc8be8-7579-4a5c-b369-8a07ee0a8b7d.png,675,1053,780,1173,105,120,red blood cell,12600,1.1428571428571428,0.875
58925,/images/8a7deb24-d2b4-4acf-86c4-3aadd39157fa.png,135,461,251,595,116,134,red blood cell,15544,1.1551724137931034,0.8656716417910447
42272,/images/ca734448-0d52-42fa-b41c-17b2939e58ae.png,244,921,345,1038,101,117,red blood cell,11817,1.1584158415841583,0.8632478632478633
11201,/images/6303f964-98ef-47c6-bb2d-283aa393f918.png,852,592,955,690,103,98,red blood cell,10094,0.9514563106796117,1.0510204081632653
65443,/images/b523daee-317b-461d-bdc1-07b4add4d488.png,681,447,789,571,108,124,red blood cell,13392,1.1481481481481481,0.8709677419354839
62460,/images/7dfbfeaf-e3b1-4159-8dcd-d7f731280ac8.png,1071,417,1195,527,124,110,red blood cell,13640,0.8870967741935484,1.1272727272727272
48889,/images/fed6ba05-36a5-45dc-a4e1-9baa7de2c622.png,64,745,165,827,101,82,red blood cell,8282,0.8118811881188119,1.2317073170731707
16772,/images/4823c1fe-a7f9-4b92-959f-0d9be09cd14b.png,754,302,861,406,107,104,red blood cell,11128,0.9719626168224299,1.0288461538461537
69189,/images/f274b784-b995-4a7e-a2c2-6cc31c24c4b4.png,820,142,919,238,99,96,red blood cell,9504,0.9696969696969697,1.03125
9660,/images/d997337e-e4a8-4ef0-b8ba-975e6c43b62c.png,166,907,300,1041,134,134,red blood cell,17956,1.0,1.0
58878,/images/434523fd-d4d9-4961-a7c2-d71d6ae68e13.png,1017,200,1125,321,108,121,red blood cell,13068,1.1203703703703705,0.8925619834710744
55828,/images/68f34a9c-f73d-4238-8f55-4b05a8a2154c.png,647,1118,744,1234,97,116,red blood cell,11252,1.1958762886597938,0.8362068965517241
71613,/images/390ad256-e1ed-476a-9f14-2dc34e0da632.png,464,1110,571,1208,107,98,red blood cell,10486,0.9158878504672897,1.0918367346938775
31883,/images/f62d4fb6-df7c-446c-94a8-d5aede0b1e0c.png,746,438,898,560,152,122,red blood cell,18544,0.8026315789473685,1.2459016393442623
68411,/images/040112be-3c8d-49aa-93f1-522f94a592ff.png,94,1420,191,1514,97,94,red blood cell,9118,0.9690721649484536,1.0319148936170213
3244,/images/96596a68-8c95-43f3-b74e-e9506c235144.png,71,1394,177,1500,106,106,red blood cell,11236,1.0,1.0
77916,/images/464055b6-3351-4636-a919-8be9840fb850.png,958,774,1071,872,113,98,red blood cell,11074,0.8672566371681416,1.153061224489796
12125,/images/87d6343b-70dd-4cdd-939f-d3ac0ca2e700.png,120,96,235,216,115,120,red blood cell,13800,1.0434782608695652,0.9583333333333334
49296,/images/99b13257-b9d9-422f-8262-802da0bdc510.png,282,90,415,206,133,116,red blood cell,15428,0.8721804511278195,1.146551724137931
2376,/images/fe851c88-692d-4199-87e0-d19d9c4eb591.png,1102,946,1188,1031,86,85,red blood cell,7310,0.9883720930232558,1.011764705882353
22611,/images/406e05f0-4444-414c-bb40-f4cb08e75ac9.png,306,665,426,782,120,117,red blood cell,14040,0.975,1.0256410256410255
2252,/images/fe851c88-692d-4199-87e0-d19d9c4eb591.png,714,545,814,639,100,94,red blood cell,9400,0.94,1.0638297872340425
80062,/images/99e979d4-ee97-4d7f-9da6-00bead40db4d.png,100,11,209,115,109,104,red blood cell,11336,0.9541284403669725,1.0480769230769231
8341,/images/65e3d6a6-012c-4b40-9a42-83078eb85e31.png,533,592,640,679,107,87,red blood cell,9309,0.8130841121495327,1.2298850574712643
52630,/images/a6fe423a-5204-4378-bcfa-d6d298a3e9aa.png,1001,1463,1110,1579,109,116,red blood cell,12644,1.0642201834862386,0.9396551724137931
64815,/images/a74b6d6a-7e04-40ac-9292-d62f13f7ded3.png,264,1136,350,1228,86,92,red blood cell,7912,1.069767441860465,0.9347826086956522
3362,/images/b1100ae1-0ac8-4fc2-b0ff-8819f7fbe724.png,539,638,652,755,113,117,red blood cell,13221,1.0353982300884956,0.9658119658119658
32058,/images/b8a4d467-c40c-4ebf-91dd-1c19d0f2a7ae.png,12,943,102,1022,90,79,red blood cell,7110,0.8777777777777778,1.139240506329114
20839,/images/c2ec116f-f091-422c-926c-70b548a8f6ef.png,309,247,408,359,99,112,red blood cell,11088,1.1313131313131313,0.8839285714285714
64883,/images/dec61ae1-5037-4c3a-8952-15371becca7d.png,334,92,447,210,113,118,red blood cell,13334,1.0442477876106195,0.9576271186440678
22747,/images/8490c623-3d88-4532-baf5-0d266a45b16f.png,973,1003,1087,1144,114,141,red blood cell,16074,1.236842105263158,0.8085106382978723
73972,/images/99a21c5c-f5a7-4c07-9cb6-5dda2d388f48.png,503,993,599,1097,96,104,red blood cell,9984,1.0833333333333333,0.9230769230769231
28343,/images/34e024a5-5698-42d4-972f-fee234b4bd64.png,482,581,587,682,105,101,red blood cell,10605,0.9619047619047619,1.0396039603960396
62030,/images/bdb5d571-27bc-4a42-ae45-aa5a9af40a81.png,902,159,999,247,97,88,red blood cell,8536,0.9072164948453608,1.1022727272727273
10595,/images/20d4f65e-6c63-433a-935c-d568d577967b.png,336,594,439,707,103,113,red blood cell,11639,1.0970873786407767,0.911504424778761
41961,/images/46a03374-64c7-49ac-81c9-c3d62542bbf3.png,725,969,816,1076,91,107,red blood cell,9737,1.1758241758241759,0.8504672897196262
75970,/images/034c8d57-04d5-4786-93a4-6ae8fde2c258.png,729,772,818,862,89,90,red blood cell,8010,1.0112359550561798,0.9888888888888889
63575,/images/de0321fa-6f7d-4dd1-b96b-186701c3b1d9.png,510,358,624,469,114,111,red blood cell,12654,0.9736842105263158,1.027027027027027
20182,/images/bb337c84-f727-42a5-9c3d-934323a16c6a.png,623,279,741,415,118,136,red blood cell,16048,1.152542372881356,0.8676470588235294
71607,/images/390ad256-e1ed-476a-9f14-2dc34e0da632.png,138,817,240,919,102,102,red blood cell,10404,1.0,1.0
23840,/images/c17523c5-90a0-4a6b-9b33-2b4a6cf58d36.png,850,304,962,414,112,110,red blood cell,12320,0.9821428571428571,1.018181818181818
25596,/images/770b8ca4-8377-479b-9ad5-5455ec3b44f8.png,618,1328,739,1439,121,111,red blood cell,13431,0.9173553719008265,1.09009009009009
69723,/images/f0713bee-2a71-4ced-b953-4041ea99496a.png,890,861,973,958,83,97,red blood cell,8051,1.1686746987951808,0.8556701030927835
10329,/images/affa429c-0315-4c18-a002-13bb3ecab259.png,1029,75,1157,198,128,123,red blood cell,15744,0.9609375,1.0406504065040652
37002,/images/b2e34f5f-904e-4473-9dc7-c6bc1ce12640.png,933,1454,1029,1548,96,94,red blood cell,9024,0.9791666666666666,1.0212765957446808
38882,/images/d79b4e90-c45d-4f5d-a498-49c3e323c291.png,930,582,1037,689,107,107,red blood cell,11449,1.0,1.0
4657,/images/a2d07312-2f97-40d2-8b09-7f2aca7b16fb.png,239,45,360,164,121,119,red blood cell,14399,0.9834710743801653,1.0168067226890756
33781,/images/cb08956d-dd6a-4e13-817b-40a0a93068f1.png,70,1453,178,1560,108,107,red blood cell,11556,0.9907407407407407,1.0093457943925233
31613,/images/0d7bf56f-3b5a-40bd-971c-2ca33dd89b2c.png,479,267,569,379,90,112,red blood cell,10080,1.2444444444444445,0.8035714285714286
13612,/images/d47cd049-d78b-4ba3-a7d4-399be4dd1dde.png,564,1008,685,1131,121,123,red blood cell,14883,1.0165289256198347,0.983739837398374
13660,/images/1e86933d-6a5a-4a3c-a0f2-ca22afd767b3.png,808,29,926,135,118,106,red blood cell,12508,0.8983050847457628,1.1132075471698113
78033,/images/c691c8ef-d3c7-47b6-a941-f6a1089f21a9.png,596,970,669,1042,73,72,red blood cell,5256,0.9863013698630136,1.0138888888888888
25977,/images/e683144c-0465-43a2-86b1-3cf52599d5e0.png,560,545,682,659,122,114,red blood cell,13908,0.9344262295081968,1.0701754385964912
50314,/images/3d32a988-449d-4d58-b71f-abbfdc3f2fbc.png,740,1453,847,1550,107,97,red blood cell,10379,0.9065420560747663,1.1030927835051547
41547,/images/0fcd1ebe-ee4a-40a0-b787-29cee18bfa1b.png,52,286,139,366,87,80,red blood cell,6960,0.9195402298850575,1.0875
63761,/images/06401963-8b02-46c5-ab2a-3d70bd01623f.png,618,1032,722,1120,104,88,red blood cell,9152,0.8461538461538461,1.1818181818181819
56392,/images/c10b125d-10c2-474a-9c6a-5249935c638e.png,261,1279,347,1365,86,86,red blood cell,7396,1.0,1.0
21179,/images/fb05b297-180a-4171-b633-09d5616d7534.png,116,269,214,362,98,93,red blood cell,9114,0.9489795918367347,1.053763440860215
22374,/images/78c35732-7e31-4153-842e-55ab1cd656f6.png,806,295,903,398,97,103,red blood cell,9991,1.0618556701030928,0.941747572815534
3983,/images/f09acb0c-b270-4e91-99f8-410adfa7f34a.png,508,93,603,177,95,84,red blood cell,7980,0.8842105263157894,1.130952380952381
31301,/images/31c749e8-18d1-4105-b7e6-8319cceddae0.png,433,1000,544,1111,111,111,red blood cell,12321,1.0,1.0
19909,/images/0ca25c88-457f-4f03-bbc1-98fb6663f1d1.png,113,1166,228,1288,115,122,red blood cell,14030,1.0608695652173914,0.9426229508196722
21064,/images/c680004e-6ee2-43d7-877c-edc9b5ebeecc.png,161,1076,260,1183,99,107,red blood cell,10593,1.0808080808080809,0.9252336448598131
48590,/images/55836297-fc8e-4e00-9767-0d12b86e4604.png,338,1363,427,1457,89,94,red blood cell,8366,1.0561797752808988,0.9468085106382979
62637,/images/f7a4334a-4332-4de8-b39b-22da907976f2.png,32,462,120,541,88,79,red blood cell,6952,0.8977272727272727,1.1139240506329113
67407,/images/266180ed-77a3-4284-8292-50a49fc47fce.png,243,1037,345,1149,102,112,red blood cell,11424,1.0980392156862746,0.9107142857142857
75909,/images/3006096f-ceeb-42be-b69e-785179d7438b.png,985,515,1114,619,129,104,red blood cell,13416,0.8062015503875969,1.2403846153846154
79005,/images/6144887d-a1c1-46db-91a1-f7ff5bf8c8a5.png,824,1226,927,1323,103,97,red blood cell,9991,0.941747572815534,1.0618556701030928
20486,/images/b809b407-7b69-4334-873d-d6c49135f04a.png,666,9,784,117,118,108,red blood cell,12744,0.9152542372881356,1.0925925925925926
55335,/images/4fb83278-adc5-4424-9f45-b6d0db2955b6.png,634,868,733,974,99,106,red blood cell,10494,1.0707070707070707,0.9339622641509434
5805,/images/143f5959-5b6d-4f95-bcee-9e110450fc22.png,176,1224,282,1343,106,119,red blood cell,12614,1.1226415094339623,0.8907563025210085
22029,/images/c5acd0ad-b0f2-478d-b0ad-5aa733aa7b32.png,512,16,648,133,136,117,red blood cell,15912,0.8602941176470589,1.1623931623931625
19498,/images/a85cd1ae-0c94-4387-8305-84ab8d96d137.png,567,955,682,1052,115,97,red blood cell,11155,0.8434782608695652,1.1855670103092784
8085,/images/694222bb-cddf-469a-9526-f873c6fba58e.png,316,786,411,882,95,96,red blood cell,9120,1.0105263157894737,0.9895833333333334
49871,/images/5e17f8e6-fd8d-426c-b444-1515d14f04b7.png,795,1353,889,1463,94,110,red blood cell,10340,1.1702127659574468,0.8545454545454545
75650,/images/50d7c6c9-3230-48fe-947c-7dcfd0aad710.png,529,312,634,423,105,111,red blood cell,11655,1.0571428571428572,0.9459459459459459
65423,/images/b523daee-317b-461d-bdc1-07b4add4d488.png,1070,303,1160,401,90,98,red blood cell,8820,1.0888888888888888,0.9183673469387755
23427,/images/8757be1e-b832-407a-8e95-62abae485b24.png,535,1146,656,1257,121,111,red blood cell,13431,0.9173553719008265,1.09009009009009
37774,/images/fe0c5e48-f65e-488c-9c3c-1ea7c7835c0c.png,75,992,182,1101,107,109,red blood cell,11663,1.0186915887850467,0.981651376146789
40349,/images/eb86033f-4f1c-4e8c-ae84-e8e4c7e08626.png,1046,1245,1164,1346,118,101,red blood cell,11918,0.8559322033898306,1.1683168316831682
12736,/images/b634137b-bc8b-4e88-b0e3-b536ad6e7e18.png,565,1232,667,1340,102,108,red blood cell,11016,1.0588235294117647,0.9444444444444444
20092,/images/81a2748d-51c9-4439-995d-f747871d6544.png,961,832,1094,955,133,123,red blood cell,16359,0.924812030075188,1.08130081300813
35224,/images/a9159b11-ba49-4885-902e-00c8d5095b98.png,357,396,458,500,101,104,red blood cell,10504,1.0297029702970297,0.9711538461538461
5680,/images/d3dcdf92-9328-4796-adf4-918646877ba1.png,458,345,584,468,126,123,red blood cell,15498,0.9761904761904762,1.024390243902439
7900,/images/98c25ffe-c329-420a-bc22-b082f565eac9.png,165,315,280,457,115,142,red blood cell,16330,1.2347826086956522,0.8098591549295775
20894,/images/c2ec116f-f091-422c-926c-70b548a8f6ef.png,608,310,704,414,96,104,red blood cell,9984,1.0833333333333333,0.9230769230769231
32620,/images/ed0d8763-e734-4506-b61b-53fc32a8d8c9.png,843,1124,953,1249,110,125,red blood cell,13750,1.1363636363636365,0.88
63106,/images/d82c657e-5678-41da-9a6e-3ad29430b759.png,647,898,765,1014,118,116,red blood cell,13688,0.9830508474576272,1.0172413793103448
79400,/images/dcb21739-3c36-459d-b3cc-1be5871d6fe7.png,686,1226,785,1314,99,88,red blood cell,8712,0.8888888888888888,1.125
9843,/images/3859deaf-6ae1-49a3-9051-898d0f0d7de6.png,52,1003,139,1093,87,90,red blood cell,7830,1.0344827586206897,0.9666666666666667
63320,/images/43bc935a-f655-45e1-a64d-fcb8b78267a6.png,187,948,310,1050,123,102,red blood cell,12546,0.8292682926829268,1.2058823529411764
35000,/images/2b369d75-9c55-43e0-b352-d981aea544e3.png,196,667,317,786,121,119,red blood cell,14399,0.9834710743801653,1.0168067226890756
51765,/images/f07174a5-f799-4286-ac43-5b0f5c5777ac.png,491,347,593,440,102,93,red blood cell,9486,0.9117647058823529,1.096774193548387
61248,/images/b3058064-d817-47dd-a8c4-cdb1f62374f8.png,796,565,889,654,93,89,red blood cell,8277,0.956989247311828,1.0449438202247192
73589,/images/7624ac36-1cf9-42fb-844d-376078309553.png,208,14,302,123,94,109,red blood cell,10246,1.1595744680851063,0.8623853211009175
27758,/images/e3c1442a-717f-41dd-bf97-81e1233ac9fa.png,483,97,590,199,107,102,red blood cell,10914,0.9532710280373832,1.0490196078431373
46464,/images/bbecf1a8-a728-4c83-87f8-4dfbac0a1e03.png,708,1184,819,1288,111,104,red blood cell,11544,0.9369369369369369,1.0673076923076923
13980,/images/31af9c31-7868-44a6-8eb4-82ce118af425.png,235,862,369,997,134,135,red blood cell,18090,1.007462686567164,0.9925925925925926
33089,/images/6231d81d-9e84-4a5a-8cb8-47c6a37a0176.png,167,1044,249,1111,82,67,red blood cell,5494,0.8170731707317073,1.2238805970149254
37907,/images/56a57a8d-c9b9-432a-a3b0-32a09355806c.png,222,923,332,1035,110,112,red blood cell,12320,1.018181818181818,0.9821428571428571
6104,/images/c147584d-4c61-412a-bdaf-b02b22c18708.png,299,263,409,370,110,107,red blood cell,11770,0.9727272727272728,1.02803738317757
69298,/images/3f8c5ae1-b9fd-464b-8e91-98143ddd8d29.png,241,1286,349,1382,108,96,red blood cell,10368,0.8888888888888888,1.125
46681,/images/da111ca5-520f-4ea8-97ad-ae5fce58ee91.png,60,1077,166,1179,106,102,red blood cell,10812,0.9622641509433962,1.0392156862745099
51021,/images/cc275c45-7511-4070-84af-10b8ffebda53.png,519,119,619,228,100,109,red blood cell,10900,1.09,0.9174311926605505
59131,/images/4736f545-1f1f-4d77-9241-d69cbf4dae35.png,431,1004,544,1111,113,107,red blood cell,12091,0.9469026548672567,1.0560747663551402
8528,/images/dfc026a9-079f-4f45-8666-e0ccba5bb437.png,562,251,663,367,101,116,red blood cell,11716,1.1485148514851484,0.8706896551724138
49925,/images/05804cf0-f854-4099-97c2-df287f7c8a8c.png,904,1103,1018,1215,114,112,red blood cell,12768,0.9824561403508771,1.0178571428571428
64319,/images/0a7bfa8a-ee52-4f7a-b9c5-2919ecfa93ef.png,836,114,932,205,96,91,red blood cell,8736,0.9479166666666666,1.054945054945055
70998,/images/deaa1931-5f97-45bf-8c00-be6ddeb37b9a.png,676,987,781,1105,105,118,red blood cell,12390,1.1238095238095238,0.8898305084745762
51726,/images/592c941a-aa54-4971-b499-dc47356f80a3.png,421,1458,529,1556,108,98,red blood cell,10584,0.9074074074074074,1.1020408163265305
38006,/images/e3e9c2de-0a24-4c7e-8a69-3d3093d5bdab.png,433,467,535,568,102,101,red blood cell,10302,0.9901960784313726,1.00990099009901
8406,/images/ae779806-6d01-4dc6-89df-294c368db6bc.png,1018,346,1135,479,117,133,red blood cell,15561,1.1367521367521367,0.8796992481203008
53475,/images/43158031-a335-4533-9c20-48bebba90123.png,438,1421,543,1523,105,102,red blood cell,10710,0.9714285714285714,1.0294117647058822
72514,/images/22516db4-8687-4051-90c4-2bb1ca3204a5.png,648,342,747,453,99,111,red blood cell,10989,1.121212121212121,0.8918918918918919
76531,/images/38c69905-8a4f-451a-8d0a-b855dc88dd16.png,678,1077,784,1177,106,100,red blood cell,10600,0.9433962264150944,1.06
24577,/images/c03d9b87-e19b-402b-ad86-b30d6e8aeb59.png,261,115,391,229,130,114,red blood cell,14820,0.8769230769230769,1.1403508771929824
59318,/images/03c8da48-04b9-4520-b674-44a0ecd35688.png,909,646,995,741,86,95,red blood cell,8170,1.1046511627906976,0.9052631578947369
72710,/images/6ab870ba-b24b-49a9-9570-8eafe63aa74e.png,482,1366,582,1469,100,103,red blood cell,10300,1.03,0.970873786407767
6810,/images/e36cb882-c6d0-4467-812e-d18c169a9a47.png,1084,496,1188,588,104,92,red blood cell,9568,0.8846153846153846,1.1304347826086956
51536,/images/6afb3717-f197-4668-929a-4fab389ae6e8.png,262,398,365,519,103,121,red blood cell,12463,1.174757281553398,0.8512396694214877
50098,/images/e98baeb2-aa58-4cce-8c61-66685dd2b239.png,495,979,613,1106,118,127,red blood cell,14986,1.076271186440678,0.9291338582677166
32693,/images/0154dd8e-72f8-4d78-a4dd-93e139577bd1.png,809,79,931,177,122,98,red blood cell,11956,0.8032786885245902,1.2448979591836735
78907,/images/4d0a1598-e4dd-45c4-8a90-dd7c780fe1da.png,382,846,466,926,84,80,red blood cell,6720,0.9523809523809523,1.05
20896,/images/c2ec116f-f091-422c-926c-70b548a8f6ef.png,596,0,696,104,100,104,red blood cell,10400,1.04,0.9615384615384616
56008,/images/177a3141-fa93-426a-9b52-7da71547ce44.png,249,208,365,316,116,108,red blood cell,12528,0.9310344827586207,1.0740740740740742
58785,/images/e4827c85-311a-4df1-89c2-99dad0c3558c.png,238,891,320,986,82,95,red blood cell,7790,1.1585365853658536,0.8631578947368421
35132,/images/a6ba808f-ec60-42a5-ad91-7b32412ab708.png,165,1101,297,1220,132,119,red blood cell,15708,0.9015151515151515,1.1092436974789917
46569,/images/edd09b2e-2673-4405-8ac0-e476e003e96a.png,823,274,954,393,131,119,red blood cell,15589,0.9083969465648855,1.1008403361344539
21952,/images/d57b3894-c912-47e8-b00a-e1a2a7aba644.png,342,723,462,825,120,102,red blood cell,12240,0.85,1.1764705882352942
3414,/images/fd1302e2-3cd2-4a1a-9c13-00f810a9c41b.png,681,219,779,309,98,90,red blood cell,8820,0.9183673469387755,1.0888888888888888
74870,/images/81edcae1-65bf-4752-b0e4-494376b71e49.png,396,1086,485,1191,89,105,red blood cell,9345,1.1797752808988764,0.8476190476190476
59054,/images/5e2cea49-0823-49d1-83cf-8fd1559cdd93.png,540,1111,645,1216,105,105,red blood cell,11025,1.0,1.0
51278,/images/216f9d43-6869-4ba1-9106-4f5ea6aac223.png,167,19,277,126,110,107,red blood cell,11770,0.9727272727272728,1.02803738317757
79469,/images/a2fc0093-8645-43c7-bdee-ec8ca9484815.png,1067,457,1172,563,105,106,red blood cell,11130,1.0095238095238095,0.9905660377358491
32487,/images/d31dd2c0-ae8e-4499-86bb-7cabb6e438b9.png,797,97,929,223,132,126,red blood cell,16632,0.9545454545454546,1.0476190476190477
19715,/images/627d6331-7bb9-4d1a-b20d-e6541af4d0f9.png,644,627,745,732,101,105,red blood cell,10605,1.0396039603960396,0.9619047619047619
61411,/images/e16c0dab-780d-4035-872e-1bb91e49f9d2.png,191,603,300,710,109,107,red blood cell,11663,0.981651376146789,1.0186915887850467
75795,/images/f48bf825-13c4-42fc-8dd8-10cc4ae6b202.png,115,400,222,508,107,108,red blood cell,11556,1.0093457943925233,0.9907407407407407
42419,/images/1a27ebe9-93a1-4898-af69-f276057d4012.png,882,920,999,1034,117,114,red blood cell,13338,0.9743589743589743,1.0263157894736843
59286,/images/03c8da48-04b9-4520-b674-44a0ecd35688.png,188,922,292,1026,104,104,red blood cell,10816,1.0,1.0
18789,/images/cc882eae-a341-4783-bd19-8bdedf798538.png,746,484,851,585,105,101,red blood cell,10605,0.9619047619047619,1.0396039603960396
62915,/images/4b346035-b8c0-46ca-8fdb-a01b1421ee4a.png,268,331,354,434,86,103,red blood cell,8858,1.197674418604651,0.8349514563106796
51679,/images/592c941a-aa54-4971-b499-dc47356f80a3.png,931,464,1036,586,105,122,red blood cell,12810,1.161904761904762,0.860655737704918
56708,/images/89b3d781-2f81-4d23-bed4-84da064df7f3.png,859,1484,980,1591,121,107,red blood cell,12947,0.8842975206611571,1.1308411214953271
43635,/images/a4851ed0-1499-4eae-9157-dcd34773254f.png,121,884,241,1002,120,118,red blood cell,14160,0.9833333333333333,1.0169491525423728
74816,/images/91e93160-eb8d-4de0-b6bc-b98ec33d1663.png,69,1500,176,1599,107,99,red blood cell,10593,0.9252336448598131,1.0808080808080809
75315,/images/9ec1dcec-87c2-4aca-8e6b-0db3cd05509c.png,981,351,1089,450,108,99,red blood cell,10692,0.9166666666666666,1.0909090909090908
57160,/images/7c870293-2665-4a6b-a4fa-336959051dfc.png,254,849,349,962,95,113,red blood cell,10735,1.1894736842105262,0.8407079646017699
63200,/images/f0804a5e-e7f5-4cf2-a5df-b65e66502bf1.png,340,962,442,1057,102,95,red blood cell,9690,0.9313725490196079,1.0736842105263158
75276,/images/9ec1dcec-87c2-4aca-8e6b-0db3cd05509c.png,831,902,940,1011,109,109,red blood cell,11881,1.0,1.0
68499,/images/74261741-4d6e-4dba-8ad4-4fbdf919c30f.png,765,1130,864,1225,99,95,red blood cell,9405,0.9595959595959596,1.0421052631578946
35354,/images/452482bc-24a3-413e-ba03-fad4c9d61f3c.png,987,688,1086,798,99,110,red blood cell,10890,1.1111111111111112,0.9
29837,/images/9cdee92c-6267-4188-a41e-125bc0abb9ae.png,853,1066,962,1177,109,111,red blood cell,12099,1.018348623853211,0.9819819819819819
68204,/images/ff1b23d0-3cef-459b-b81f-39bfcdb6526f.png,486,421,583,518,97,97,red blood cell,9409,1.0,1.0
29930,/images/f2a8a483-b254-43aa-817f-7d525adb8911.png,562,7,695,136,133,129,red blood cell,17157,0.9699248120300752,1.0310077519379846
79168,/images/1c90231b-2830-42d9-884e-7301edb16933.png,200,217,288,305,88,88,red blood cell,7744,1.0,1.0
57827,/images/c9ad92d4-b408-4506-916e-def47b2e6ed0.png,743,1143,854,1252,111,109,red blood cell,12099,0.9819819819819819,1.018348623853211
43938,/images/d7c7eb2c-2acd-4f86-8a5a-09ab3dd02d16.png,7,645,133,764,126,119,red blood cell,14994,0.9444444444444444,1.0588235294117647
8529,/images/dfc026a9-079f-4f45-8666-e0ccba5bb437.png,117,1331,218,1444,101,113,red blood cell,11413,1.118811881188119,0.8938053097345132
71535,/images/191071ab-6515-428c-9f05-8e4309542b75.png,136,45,218,131,82,86,red blood cell,7052,1.048780487804878,0.9534883720930233
23672,/images/79d7a014-21ff-40f1-9ac4-a69839390654.png,809,1115,910,1211,101,96,red blood cell,9696,0.9504950495049505,1.0520833333333333
6623,/images/640c4a52-3742-4f57-aee3-9e3dc0887622.png,1026,699,1120,786,94,87,red blood cell,8178,0.925531914893617,1.0804597701149425
78318,/images/24115f58-a7d6-4022-a95a-86b515a78d3e.png,76,608,185,708,109,100,red blood cell,10900,0.9174311926605505,1.09
58171,/images/d615b706-8f50-4d96-8de5-6858897528d0.png,772,16,877,140,105,124,red blood cell,13020,1.180952380952381,0.8467741935483871
52604,/images/0546d843-d778-4aca-b8b5-bfe23d7c87da.png,597,1237,679,1326,82,89,red blood cell,7298,1.0853658536585367,0.9213483146067416
48758,/images/fed6ba05-36a5-45dc-a4e1-9baa7de2c622.png,982,1395,1094,1505,112,110,red blood cell,12320,0.9821428571428571,1.018181818181818
35592,/images/a1ff36df-71df-4e6e-a65f-ced9a2b381c3.png,344,1152,477,1269,133,117,red blood cell,15561,0.8796992481203008,1.1367521367521367
68244,/images/ff1b23d0-3cef-459b-b81f-39bfcdb6526f.png,902,995,1017,1118,115,123,red blood cell,14145,1.0695652173913044,0.9349593495934959
44036,/images/8b494b40-cab5-49d3-893d-c805000fbe88.png,741,766,854,872,113,106,red blood cell,11978,0.9380530973451328,1.0660377358490567
63613,/images/d9c9479e-f1ea-4d6e-861f-843ff9a90d19.png,645,1267,768,1391,123,124,red blood cell,15252,1.008130081300813,0.9919354838709677
11560,/images/834a30bb-26bf-4e60-9ea1-3250b926892e.png,921,1319,1046,1437,125,118,red blood cell,14750,0.944,1.0593220338983051
57679,/images/5c037ffc-f515-48b3-b231-c110fbd2b8ca.png,989,751,1107,877,118,126,red blood cell,14868,1.0677966101694916,0.9365079365079365
74703,/images/5ccca8ee-abea-458a-a891-bedd31c3ddc3.png,649,1041,765,1134,116,93,red blood cell,10788,0.8017241379310345,1.2473118279569892
67104,/images/4272cbd7-5b0a-4bf7-b690-dee1c128f07b.png,374,417,459,522,85,105,red blood cell,8925,1.2352941176470589,0.8095238095238095
40514,/images/e3ade58d-086c-47fa-9120-76beacb45395.png,1042,1347,1163,1466,121,119,red blood cell,14399,0.9834710743801653,1.0168067226890756
497,/images/f65a1633-9935-4984-a285-a60d30aa1707.png,896,1250,1028,1382,132,132,red blood cell,17424,1.0,1.0
25054,/images/ed0bee2f-05e0-4392-8357-19750cec577c.png,363,1511,453,1596,90,85,red blood cell,7650,0.9444444444444444,1.0588235294117647
54809,/images/b6364a57-72a9-43f3-8d02-9f53a992dc95.png,746,755,844,848,98,93,red blood cell,9114,0.9489795918367347,1.053763440860215
78899,/images/4d0a1598-e4dd-45c4-8a90-dd7c780fe1da.png,191,448,281,544,90,96,red blood cell,8640,1.0666666666666667,0.9375
52110,/images/de6d3020-9347-473b-9146-8909627790f6.png,166,492,254,577,88,85,red blood cell,7480,0.9659090909090909,1.035294117647059
28416,/images/a6d85204-24b8-4b23-a8b1-c3e8b93f9f22.png,445,1070,583,1203,138,133,red blood cell,18354,0.9637681159420289,1.037593984962406
79896,/images/a054a8e2-55f2-4508-97df-207f76b89be2.png,507,184,635,327,128,143,red blood cell,18304,1.1171875,0.8951048951048951
16486,/images/9e5437c6-b0d3-473b-b7c3-8f5afeb90c7a.png,310,893,418,1015,108,122,red blood cell,13176,1.1296296296296295,0.8852459016393442
1842,/images/8855c685-5a8c-4967-a356-942ed89e3471.png,220,883,341,1004,121,121,red blood cell,14641,1.0,1.0
16492,/images/9e5437c6-b0d3-473b-b7c3-8f5afeb90c7a.png,713,105,843,257,130,152,red blood cell,19760,1.1692307692307693,0.8552631578947368
14936,/images/5d1418d3-1559-4725-ad4a-9afb6eaecdfd.png,577,294,671,386,94,92,red blood cell,8648,0.9787234042553191,1.0217391304347827
65323,/images/24418314-f7a4-49fc-a03e-ec597ca6796e.png,812,582,905,678,93,96,red blood cell,8928,1.032258064516129,0.96875
6469,/images/640c4a52-3742-4f57-aee3-9e3dc0887622.png,483,463,579,555,96,92,red blood cell,8832,0.9583333333333334,1.0434782608695652
35464,/images/3722d213-f2a9-46d5-aa76-9183b443e455.png,803,1269,919,1389,116,120,red blood cell,13920,1.0344827586206897,0.9666666666666667
63675,/images/d9c9479e-f1ea-4d6e-861f-843ff9a90d19.png,27,1367,118,1449,91,82,red blood cell,7462,0.9010989010989011,1.1097560975609757
55789,/images/68f34a9c-f73d-4238-8f55-4b05a8a2154c.png,944,198,1034,293,90,95,red blood cell,8550,1.0555555555555556,0.9473684210526315
19175,/images/bb795ddf-ce72-42d5-9006-124db4d5cf1c.png,232,590,328,700,96,110,red blood cell,10560,1.1458333333333333,0.8727272727272727
8180,/images/694222bb-cddf-469a-9526-f873c6fba58e.png,932,57,1017,162,85,105,red blood cell,8925,1.2352941176470589,0.8095238095238095
1189,/images/5ff7c0c8-d208-4e7d-958d-ca3c2260ff39.png,850,1389,959,1525,109,136,red blood cell,14824,1.2477064220183487,0.8014705882352942
67296,/images/49c4dbd3-6269-4d4c-9648-a2146c57bab1.png,144,709,250,819,106,110,red blood cell,11660,1.0377358490566038,0.9636363636363636
9651,/images/d997337e-e4a8-4ef0-b8ba-975e6c43b62c.png,175,1077,307,1193,132,116,red blood cell,15312,0.8787878787878788,1.1379310344827587
22135,/images/ca677c3c-083f-4d54-9dec-39f79f6a17d8.png,811,632,926,738,115,106,red blood cell,12190,0.9217391304347826,1.0849056603773586
1487,/images/0ac747cd-ff32-49bf-bc1a-3e9b7702ce9c.png,787,690,905,809,118,119,red blood cell,14042,1.0084745762711864,0.9915966386554622
68209,/images/ff1b23d0-3cef-459b-b81f-39bfcdb6526f.png,833,577,928,682,95,105,red blood cell,9975,1.105263157894737,0.9047619047619048
73947,/images/2ae3e6e6-7482-4ab8-ad73-b530b5c2ee3b.png,604,316,693,400,89,84,red blood cell,7476,0.9438202247191011,1.0595238095238095
30490,/images/5955289d-19e5-45ef-a012-c8ea08ef45e2.png,11,412,139,535,128,123,red blood cell,15744,0.9609375,1.0406504065040652
43906,/images/d7c7eb2c-2acd-4f86-8a5a-09ab3dd02d16.png,710,1407,808,1514,98,107,red blood cell,10486,1.0918367346938775,0.9158878504672897
7509,/images/071901eb-4c3f-404b-a747-3d0b9d0a5158.png,991,1359,1115,1486,124,127,red blood cell,15748,1.0241935483870968,0.9763779527559056
17416,/images/f329e01b-fbd3-4fb5-9738-a7ff4c8622b8.png,918,693,1026,794,108,101,red blood cell,10908,0.9351851851851852,1.0693069306930694
6067,/images/c147584d-4c61-412a-bdaf-b02b22c18708.png,271,214,389,334,118,120,red blood cell,14160,1.0169491525423728,0.9833333333333333
9673,/images/53afd70c-08a7-4b9a-b137-7003b2ecbeab.png,590,1294,702,1408,112,114,red blood cell,12768,1.0178571428571428,0.9824561403508771
71840,/images/093a831a-bf71-4333-bc06-942ae70cb164.png,613,907,704,997,91,90,red blood cell,8190,0.989010989010989,1.011111111111111
15326,/images/2d0f600d-f94e-4907-b712-52fb37d9ed52.png,331,1266,424,1363,93,97,red blood cell,9021,1.043010752688172,0.9587628865979382
47795,/images/5a105b89-c592-4d78-b208-7db6c6572752.png,876,357,997,476,121,119,red blood cell,14399,0.9834710743801653,1.0168067226890756
5142,/images/a777e78c-ad1f-4380-9ab2-b4f9f32b2d78.png,226,856,325,950,99,94,red blood cell,9306,0.9494949494949495,1.053191489361702
546,/images/67acd5bc-4658-4c6e-a9b9-cd8ea3a03418.png,377,545,486,649,109,104,red blood cell,11336,0.9541284403669725,1.0480769230769231
41367,/images/a065c50b-341d-4803-b4b0-0fe8f04fdbb5.png,1011,1117,1101,1226,90,109,red blood cell,9810,1.211111111111111,0.8256880733944955
5178,/images/a777e78c-ad1f-4380-9ab2-b4f9f32b2d78.png,776,498,877,595,101,97,red blood cell,9797,0.9603960396039604,1.041237113402062
44819,/images/6795acae-e84d-4e97-b9a1-b4f4f0a72cfd.png,1027,669,1143,764,116,95,red blood cell,11020,0.8189655172413793,1.2210526315789474
15315,/images/2d0f600d-f94e-4907-b712-52fb37d9ed52.png,1072,218,1174,327,102,109,red blood cell,11118,1.0686274509803921,0.9357798165137615
62945,/images/4b346035-b8c0-46ca-8fdb-a01b1421ee4a.png,828,498,924,601,96,103,red blood cell,9888,1.0729166666666667,0.9320388349514563
37914,/images/56a57a8d-c9b9-432a-a3b0-32a09355806c.png,567,849,655,933,88,84,red blood cell,7392,0.9545454545454546,1.0476190476190477
3427,/images/fd1302e2-3cd2-4a1a-9c13-00f810a9c41b.png,473,229,588,351,115,122,red blood cell,14030,1.0608695652173914,0.9426229508196722
37366,/images/08f5a524-0554-49c2-83a8-ae9a6d51e8fd.png,674,526,774,618,100,92,red blood cell,9200,0.92,1.0869565217391304
64246,/images/83d4e1fe-da84-4175-a9e2-8efc18782dcf.png,863,191,974,298,111,107,red blood cell,11877,0.963963963963964,1.0373831775700935
31474,/images/6695a204-e39c-4418-b904-3f080fdbe7e8.png,454,1350,563,1454,109,104,red blood cell,11336,0.9541284403669725,1.0480769230769231
38492,/images/aa4a023b-55bd-4259-b15d-7086a9b491e0.png,221,331,332,450,111,119,red blood cell,13209,1.072072072072072,0.9327731092436975
20659,/images/d09eed76-e09b-4d90-b8f0-5a801beae41c.png,870,201,997,331,127,130,red blood cell,16510,1.0236220472440944,0.9769230769230769
65562,/images/01b38a56-13eb-447b-89ee-fc21cb40dcc1.png,169,1359,278,1483,109,124,red blood cell,13516,1.1376146788990826,0.8790322580645161
14728,/images/1fdf99d1-a494-4174-bcd7-efbe457ab899.png,92,538,201,643,109,105,red blood cell,11445,0.963302752293578,1.0380952380952382
69068,/images/de2b8835-552c-4f01-98b7-67bc4910062e.png,1044,563,1149,663,105,100,red blood cell,10500,0.9523809523809523,1.05
72826,/images/31435107-c77d-42f8-a619-75cba6a5161b.png,1026,598,1135,704,109,106,red blood cell,11554,0.9724770642201835,1.028301886792453
70948,/images/deaa1931-5f97-45bf-8c00-be6ddeb37b9a.png,518,634,642,738,124,104,red blood cell,12896,0.8387096774193549,1.1923076923076923
73493,/images/5f2b32bd-fdca-4d6f-b13a-ee9f83626c8d.png,900,1010,1001,1122,101,112,red blood cell,11312,1.108910891089109,0.9017857142857143
13758,/images/1b369bcf-ced4-4ae2-9196-2664bd2b1738.png,110,743,219,858,109,115,red blood cell,12535,1.055045871559633,0.9478260869565217
60443,/images/93b47b14-7f78-4b31-8897-d63a81fdab01.png,343,491,455,618,112,127,red blood cell,14224,1.1339285714285714,0.8818897637795275
40783,/images/252071ac-e9f2-41d2-abbb-87ef01b8a997.png,331,759,418,850,87,91,red blood cell,7917,1.0459770114942528,0.9560439560439561
15015,/images/3003252a-2d2e-4687-ad30-9c38d68f1394.png,1068,1292,1181,1405,113,113,red blood cell,12769,1.0,1.0
49900,/images/5e17f8e6-fd8d-426c-b444-1515d14f04b7.png,718,908,814,1015,96,107,red blood cell,10272,1.1145833333333333,0.897196261682243
39218,/images/2aeb7b85-7df9-4a63-8d37-2eecaaa190e7.png,541,1365,638,1476,97,111,red blood cell,10767,1.1443298969072164,0.8738738738738738
22763,/images/8490c623-3d88-4532-baf5-0d266a45b16f.png,191,1089,301,1187,110,98,red blood cell,10780,0.8909090909090909,1.1224489795918366
28551,/images/dbdfad64-110c-421f-a1c7-f68fd9e82d67.png,415,42,542,163,127,121,red blood cell,15367,0.952755905511811,1.0495867768595042
40714,/images/252071ac-e9f2-41d2-abbb-87ef01b8a997.png,412,1055,526,1150,114,95,red blood cell,10830,0.8333333333333334,1.2
20992,/images/666601e7-608d-4d19-999f-8fc6ab373a55.png,424,135,548,265,124,130,red blood cell,16120,1.0483870967741935,0.9538461538461539
27879,/images/948c94ad-395c-41f4-9a68-8a1dcb76888c.png,292,1235,401,1335,109,100,red blood cell,10900,0.9174311926605505,1.09
37988,/images/e3e9c2de-0a24-4c7e-8a69-3d3093d5bdab.png,229,542,333,645,104,103,red blood cell,10712,0.9903846153846154,1.0097087378640777
51328,/images/b4f3b2a4-f4b9-48de-ac5d-0e681b77be27.png,473,1219,573,1320,100,101,red blood cell,10100,1.01,0.9900990099009901
49117,/images/df3d98b9-3dd7-4107-8d4a-ae1b7f247793.png,215,526,311,610,96,84,red blood cell,8064,0.875,1.1428571428571428
55803,/images/68f34a9c-f73d-4238-8f55-4b05a8a2154c.png,672,696,762,792,90,96,red blood cell,8640,1.0666666666666667,0.9375
48594,/images/55836297-fc8e-4e00-9767-0d12b86e4604.png,711,942,826,1050,115,108,red blood cell,12420,0.9391304347826087,1.0648148148148149
9585,/images/239f17eb-a2e2-47e9-82e3-fa0d9a70fb9f.png,556,952,668,1061,112,109,red blood cell,12208,0.9732142857142857,1.0275229357798166
2875,/images/521a26aa-0a31-4c07-b4d0-fac08eb08344.png,419,572,532,699,113,127,red blood cell,14351,1.1238938053097345,0.889763779527559
38629,/images/3b601a1b-26d8-4873-afcf-fdd1b1e0010c.png,130,167,234,266,104,99,red blood cell,10296,0.9519230769230769,1.0505050505050506
26305,/images/d33bc9fc-3444-4f26-8082-307f9fccc52b.png,989,1419,1102,1529,113,110,red blood cell,12430,0.9734513274336283,1.0272727272727273
55007,/images/7beee655-6156-43b8-b185-dbae0eaf7f45.png,683,786,796,890,113,104,red blood cell,11752,0.9203539823008849,1.0865384615384615
11588,/images/b4dc3088-3fe2-4688-be24-70664a64e022.png,471,735,585,840,114,105,red blood cell,11970,0.9210526315789473,1.0857142857142856
14226,/images/c186dcd1-af61-455f-9619-1fdd8c881b06.png,1004,1435,1130,1547,126,112,red blood cell,14112,0.8888888888888888,1.125
36966,/images/b2e34f5f-904e-4473-9dc7-c6bc1ce12640.png,848,546,955,660,107,114,red blood cell,12198,1.0654205607476634,0.9385964912280702
20166,/images/df49578a-60d4-4a3b-9ee0-79d9d59bc72a.png,1081,1209,1200,1333,119,124,red blood cell,14756,1.0420168067226891,0.9596774193548387
50635,/images/c956e531-6805-4fe1-b61c-8b96a9815a77.png,1077,771,1188,888,111,117,red blood cell,12987,1.054054054054054,0.9487179487179487
68124,/images/5dec94a3-e3ca-4a58-9702-88e5a83ef612.png,556,820,659,927,103,107,red blood cell,11021,1.0388349514563107,0.9626168224299065
17500,/images/56077789-8580-41b4-89d6-deea227e5c60.png,696,108,823,226,127,118,red blood cell,14986,0.9291338582677166,1.076271186440678
1213,/images/5ff7c0c8-d208-4e7d-958d-ca3c2260ff39.png,585,1445,694,1571,109,126,red blood cell,13734,1.1559633027522935,0.8650793650793651
4973,/images/755e5bf8-e8e1-492b-a32f-f7d87cccaa40.png,995,1071,1080,1170,85,99,red blood cell,8415,1.1647058823529413,0.8585858585858586
18939,/images/e9e78ff8-831b-46e9-9785-3eee9acbfcd8.png,185,821,279,910,94,89,red blood cell,8366,0.9468085106382979,1.0561797752808988
31061,/images/9c48fdf4-621d-4f40-bcd7-6a28cd530de7.png,547,580,671,695,124,115,red blood cell,14260,0.9274193548387096,1.0782608695652174
79997,/images/e640ae51-cbf1-4a84-b7cf-d38b17f59c2f.png,495,1489,594,1581,99,92,red blood cell,9108,0.9292929292929293,1.076086956521739
49490,/images/9f33e0ea-065b-4703-9df9-15829b891860.png,587,1193,681,1282,94,89,red blood cell,8366,0.9468085106382979,1.0561797752808988
39180,/images/2aeb7b85-7df9-4a63-8d37-2eecaaa190e7.png,941,892,1037,991,96,99,red blood cell,9504,1.03125,0.9696969696969697
71429,/images/bcb447c9-5d37-414f-a513-d7076b04a532.png,361,953,469,1070,108,117,red blood cell,12636,1.0833333333333333,0.9230769230769231
9267,/images/261562a8-ffd8-4e0e-919b-22e267000b74.png,647,1045,729,1135,82,90,red blood cell,7380,1.0975609756097562,0.9111111111111111
10979,/images/c442e2d6-aaf9-417a-9905-4737a1115f33.png,299,716,400,840,101,124,red blood cell,12524,1.2277227722772277,0.8145161290322581
14715,/images/1fdf99d1-a494-4174-bcd7-efbe457ab899.png,837,1257,971,1398,134,141,red blood cell,18894,1.0522388059701493,0.950354609929078
58818,/images/434523fd-d4d9-4961-a7c2-d71d6ae68e13.png,828,692,925,790,97,98,red blood cell,9506,1.0103092783505154,0.9897959183673469
9186,/images/6e7ed596-1b76-4998-8147-a846d53d91c5.png,978,47,1094,174,116,127,red blood cell,14732,1.0948275862068966,0.9133858267716536
27045,/images/ec301f62-1302-4407-96f9-fcfe45c150ae.png,394,200,521,325,127,125,red blood cell,15875,0.984251968503937,1.016
32050,/images/b8a4d467-c40c-4ebf-91dd-1c19d0f2a7ae.png,505,90,603,197,98,107,red blood cell,10486,1.0918367346938775,0.9158878504672897
57516,/images/00d04a90-80e5-4bce-9511-1b64eabb7a47.png,219,1191,312,1279,93,88,red blood cell,8184,0.946236559139785,1.0568181818181819
66281,/images/e8058bed-c362-4e1c-85dc-62f80f32938f.png,1061,967,1166,1067,105,100,red blood cell,10500,0.9523809523809523,1.05
52659,/images/3f390b82-8859-4c27-bbfe-d1b242477f63.png,1022,1284,1128,1389,106,105,red blood cell,11130,0.9905660377358491,1.0095238095238095
58254,/images/319c9c52-f316-49f3-baad-4444ab19f85b.png,878,991,971,1072,93,81,red blood cell,7533,0.8709677419354839,1.1481481481481481
1861,/images/8855c685-5a8c-4967-a356-942ed89e3471.png,498,1000,618,1124,120,124,red blood cell,14880,1.0333333333333334,0.967741935483871
24205,/images/194aec70-41a5-4ac3-b22f-0b6eda91f730.png,92,386,201,497,109,111,red blood cell,12099,1.018348623853211,0.9819819819819819
36996,/images/b2e34f5f-904e-4473-9dc7-c6bc1ce12640.png,720,1092,816,1180,96,88,red blood cell,8448,0.9166666666666666,1.0909090909090908
11564,/images/b4dc3088-3fe2-4688-be24-70664a64e022.png,595,258,707,372,112,114,red blood cell,12768,1.0178571428571428,0.9824561403508771
7614,/images/21cc498b-8cb2-42ed-8f80-bfa27b86ef11.png,757,1165,876,1279,119,114,red blood cell,13566,0.957983193277311,1.043859649122807
16457,/images/e474a20b-2769-48f1-a520-4f6ef5a0dbf5.png,251,412,343,507,92,95,red blood cell,8740,1.0326086956521738,0.968421052631579
11516,/images/834a30bb-26bf-4e60-9ea1-3250b926892e.png,392,473,506,588,114,115,red blood cell,13110,1.0087719298245614,0.991304347826087
21480,/images/7625dfc4-858a-4c8e-907c-8943d665e9a7.png,62,699,158,802,96,103,red blood cell,9888,1.0729166666666667,0.9320388349514563
43140,/images/c5db0fc0-b96c-496e-90b4-f9fb1b85b28e.png,915,760,1032,867,117,107,red blood cell,12519,0.9145299145299145,1.0934579439252337
3970,/images/f09acb0c-b270-4e91-99f8-410adfa7f34a.png,284,695,392,793,108,98,red blood cell,10584,0.9074074074074074,1.1020408163265305
28867,/images/686ed568-d5f8-475e-81ad-edab9dd473a0.png,78,103,178,217,100,114,red blood cell,11400,1.14,0.8771929824561403
76776,/images/2165fe38-b474-467d-be11-d1d728085efd.png,886,73,992,193,106,120,red blood cell,12720,1.1320754716981132,0.8833333333333333
22661,/images/4ab47131-c2ac-461f-b95c-ac19ce24edbd.png,162,817,281,936,119,119,red blood cell,14161,1.0,1.0
12364,/images/3b55c42f-ad59-422f-ba99-4f4f4ca9cb2e.png,123,661,206,763,83,102,red blood cell,8466,1.2289156626506024,0.8137254901960784
63974,/images/5e974892-0ebe-4037-8427-ea8616d6d3b8.png,994,951,1093,1054,99,103,red blood cell,10197,1.0404040404040404,0.9611650485436893
10564,/images/9fbf38ab-44b9-4096-a818-603017a4300e.png,423,481,569,619,146,138,red blood cell,20148,0.9452054794520548,1.0579710144927537
33027,/images/6231d81d-9e84-4a5a-8cb8-47c6a37a0176.png,585,636,688,763,103,127,red blood cell,13081,1.233009708737864,0.8110236220472441
41548,/images/0fcd1ebe-ee4a-40a0-b787-29cee18bfa1b.png,454,111,568,225,114,114,red blood cell,12996,1.0,1.0
73304,/images/67a4fb91-6f38-4ca2-8f20-6b2f5f1b29a7.png,268,748,354,833,86,85,red blood cell,7310,0.9883720930232558,1.011764705882353
45383,/images/e4eea7ea-8989-46a9-9c98-25a178146b28.png,970,539,1076,639,106,100,red blood cell,10600,0.9433962264150944,1.06
51193,/images/ad8731b7-0dae-4983-9dc6-dec31767d761.png,197,1214,290,1305,93,91,red blood cell,8463,0.978494623655914,1.021978021978022
59092,/images/5e2cea49-0823-49d1-83cf-8fd1559cdd93.png,472,885,564,982,92,97,red blood cell,8924,1.0543478260869565,0.9484536082474226
59543,/images/6bfe6a90-8a69-4171-8e7f-42dc9417c6d9.png,959,723,1064,830,105,107,red blood cell,11235,1.019047619047619,0.9813084112149533
14137,/images/eaf4b781-b3aa-41ce-8c5e-287979b4e15a.png,974,775,1077,876,103,101,red blood cell,10403,0.9805825242718447,1.0198019801980198
36393,/images/4a0a05e1-11ad-4bfc-bfa3-adf3b9bd0b56.png,633,1480,759,1596,126,116,red blood cell,14616,0.9206349206349206,1.0862068965517242
79902,/images/0b923ab7-ebff-4079-a4bb-af7da89f374e.png,481,693,595,804,114,111,red blood cell,12654,0.9736842105263158,1.027027027027027
5362,/images/716273ea-19c4-49af-8604-df587b295eca.png,385,542,496,648,111,106,red blood cell,11766,0.954954954954955,1.0471698113207548
34145,/images/de5d19b7-e670-4ac7-843b-7ce7bcebdf45.png,180,1268,299,1371,119,103,red blood cell,12257,0.865546218487395,1.1553398058252426
31159,/images/1976cd04-d24f-457c-b423-7e4cdb05de9e.png,263,1037,391,1167,128,130,red blood cell,16640,1.015625,0.9846153846153847
75416,/images/468c261d-f5d8-423f-883e-48af2bbbc5d1.png,267,217,358,312,91,95,red blood cell,8645,1.043956043956044,0.9578947368421052
36909,/images/b2e34f5f-904e-4473-9dc7-c6bc1ce12640.png,507,1436,602,1533,95,97,red blood cell,9215,1.0210526315789474,0.979381443298969
24423,/images/4d8a4ce8-0f9c-4f21-8844-4cf0e5514bbf.png,617,1404,706,1495,89,91,red blood cell,8099,1.0224719101123596,0.978021978021978
41853,/images/c3b07675-9d02-477c-91fe-f0737867049b.png,226,570,341,692,115,122,red blood cell,14030,1.0608695652173914,0.9426229508196722
19579,/images/883d9731-a04d-4f84-83c9-d3bef954759d.png,978,1037,1096,1160,118,123,red blood cell,14514,1.0423728813559323,0.959349593495935
41378,/images/a065c50b-341d-4803-b4b0-0fe8f04fdbb5.png,1017,164,1112,266,95,102,red blood cell,9690,1.0736842105263158,0.9313725490196079
5024,/images/b7d0ae11-a393-4aec-8f68-6ba07147f78a.png,126,28,239,140,113,112,red blood cell,12656,0.9911504424778761,1.0089285714285714
23803,/images/eeb06e39-482b-443d-8cf6-b9b5c763df78.png,892,742,990,858,98,116,red blood cell,11368,1.183673469387755,0.8448275862068966
58498,/images/5cac6ddf-c8c6-45de-bce0-a1db64b14fb5.png,852,548,956,653,104,105,red blood cell,10920,1.0096153846153846,0.9904761904761905
4678,/images/a2d07312-2f97-40d2-8b09-7f2aca7b16fb.png,544,713,657,850,113,137,red blood cell,15481,1.2123893805309736,0.8248175182481752
75048,/images/073c10c9-5749-44b5-b08b-1be556a960f0.png,400,640,498,746,98,106,red blood cell,10388,1.0816326530612246,0.9245283018867925
17107,/images/dc3bdfe9-1565-4cda-9c4e-0979846dab60.png,334,616,423,719,89,103,red blood cell,9167,1.1573033707865168,0.8640776699029126
67373,/images/266180ed-77a3-4284-8292-50a49fc47fce.png,507,1275,630,1398,123,123,red blood cell,15129,1.0,1.0
436,/images/84c88143-940d-4b62-bbd2-7acc4cadcb6b.png,127,351,252,469,125,118,red blood cell,14750,0.944,1.0593220338983051
15023,/images/3003252a-2d2e-4687-ad30-9c38d68f1394.png,34,1128,153,1252,119,124,red blood cell,14756,1.0420168067226891,0.9596774193548387
7624,/images/21cc498b-8cb2-42ed-8f80-bfa27b86ef11.png,1,678,134,794,133,116,red blood cell,15428,0.8721804511278195,1.146551724137931
14412,/images/3b13e20f-ec0d-44ec-b2f4-eaebfa09150e.png,546,1137,661,1263,115,126,red blood cell,14490,1.0956521739130434,0.9126984126984127
63704,/images/06401963-8b02-46c5-ab2a-3d70bd01623f.png,374,1330,494,1447,120,117,red blood cell,14040,0.975,1.0256410256410255
51340,/images/b4f3b2a4-f4b9-48de-ac5d-0e681b77be27.png,680,868,779,972,99,104,red blood cell,10296,1.0505050505050506,0.9519230769230769
72789,/images/caeb2d62-1166-43f0-8eac-5b8fc48f02eb.png,25,173,99,256,74,83,red blood cell,6142,1.1216216216216217,0.891566265060241
57151,/images/7c870293-2665-4a6b-a4fa-336959051dfc.png,604,1141,708,1243,104,102,red blood cell,10608,0.9807692307692307,1.0196078431372548
2949,/images/00a02700-2ea2-4590-9e15-ffc9160fd3de.png,828,478,948,596,120,118,red blood cell,14160,0.9833333333333333,1.0169491525423728
22497,/images/dd60b6a7-c545-45b9-8250-d1633aa1ac75.png,84,1399,199,1515,115,116,red blood cell,13340,1.008695652173913,0.9913793103448276
1753,/images/5f783f43-0090-4f8a-bd75-9562f4aa2dd5.png,549,425,652,539,103,114,red blood cell,11742,1.1067961165048543,0.9035087719298246
61878,/images/f32b21ae-5ca7-490b-bc40-6db9396d933c.png,345,1270,456,1376,111,106,red blood cell,11766,0.954954954954955,1.0471698113207548
64138,/images/0d3c2521-da55-4df5-bf06-56b3bd4fb2fc.png,838,204,945,312,107,108,red blood cell,11556,1.0093457943925233,0.9907407407407407
76855,/images/2165fe38-b474-467d-be11-d1d728085efd.png,1010,946,1112,1054,102,108,red blood cell,11016,1.0588235294117647,0.9444444444444444
15687,/images/3892b776-f49a-4368-b0fa-7e855e76ccec.png,975,967,1089,1091,114,124,red blood cell,14136,1.087719298245614,0.9193548387096774
14801,/images/f8b6a868-60e9-4569-ae69-638a0c39834d.png,702,929,812,1049,110,120,red blood cell,13200,1.0909090909090908,0.9166666666666666
12675,/images/5a043d69-f435-46d4-8691-395c1602a76a.png,820,1053,935,1188,115,135,red blood cell,15525,1.173913043478261,0.8518518518518519
46764,/images/02fb5e19-6f94-4787-bb78-e550a29a3cbd.png,400,216,501,320,101,104,red blood cell,10504,1.0297029702970297,0.9711538461538461
27799,/images/e3c1442a-717f-41dd-bf97-81e1233ac9fa.png,118,1344,250,1454,132,110,red blood cell,14520,0.8333333333333334,1.2
23266,/images/157ac97a-396e-4f6c-94c6-72a4d06ccc5f.png,568,973,680,1086,112,113,red blood cell,12656,1.0089285714285714,0.9911504424778761
36516,/images/bd856928-96ee-4fc4-a377-f2fc4e84448b.png,894,975,1003,1088,109,113,red blood cell,12317,1.036697247706422,0.9646017699115044
64709,/images/76021d69-8919-4688-95ef-7418eff620cc.png,735,908,847,1012,112,104,red blood cell,11648,0.9285714285714286,1.0769230769230769
31784,/images/63ed5931-d93e-4f9b-a6f3-152713cb560e.png,361,842,472,956,111,114,red blood cell,12654,1.027027027027027,0.9736842105263158
16996,/images/57e1879e-4294-45e7-9c1b-627e8cca0271.png,568,1314,681,1422,113,108,red blood cell,12204,0.9557522123893806,1.0462962962962963
27147,/images/f232eec3-02c0-43f9-bf32-3e60245397e2.png,138,1373,254,1502,116,129,red blood cell,14964,1.1120689655172413,0.8992248062015504
25281,/images/587e5464-d70b-4279-8562-010279f6efbd.png,707,154,832,265,125,111,red blood cell,13875,0.888,1.1261261261261262
73228,/images/85546330-4efd-43e2-87aa-d53a30220bfc.png,1055,1093,1147,1191,92,98,red blood cell,9016,1.065217391304348,0.9387755102040817
7274,/images/89f10192-d3dd-4996-a571-4c851dbdc983.png,263,372,350,466,87,94,red blood cell,8178,1.0804597701149425,0.925531914893617
20404,/images/11e517bf-943b-4928-929a-e9f72c097880.png,0,1365,98,1477,98,112,red blood cell,10976,1.1428571428571428,0.875
3850,/images/3e764461-22ee-44d3-925d-cd658ff7d154.png,1022,1335,1129,1435,107,100,red blood cell,10700,0.9345794392523364,1.07
15679,/images/3892b776-f49a-4368-b0fa-7e855e76ccec.png,968,1310,1073,1419,105,109,red blood cell,11445,1.0380952380952382,0.963302752293578
23085,/images/be5bb7d0-7c3f-4bb9-8bb4-f8bc8d875943.png,12,879,141,987,129,108,red blood cell,13932,0.8372093023255814,1.1944444444444444
48781,/images/fed6ba05-36a5-45dc-a4e1-9baa7de2c622.png,804,910,898,1001,94,91,red blood cell,8554,0.9680851063829787,1.032967032967033
19682,/images/627d6331-7bb9-4d1a-b20d-e6541af4d0f9.png,295,1212,416,1332,121,120,red blood cell,14520,0.9917355371900827,1.0083333333333333
10323,/images/f91670db-be74-474c-bd72-68120aed4756.png,396,351,508,455,112,104,red blood cell,11648,0.9285714285714286,1.0769230769230769
57148,/images/7d041c38-11f2-4186-8a24-29d7d0f5c3cf.png,1022,845,1118,957,96,112,red blood cell,10752,1.1666666666666667,0.8571428571428571
71391,/images/bcb447c9-5d37-414f-a513-d7076b04a532.png,734,647,826,748,92,101,red blood cell,9292,1.0978260869565217,0.9108910891089109
55040,/images/1f8f08ea-b5b3-4f68-94d4-3cc071b7dce8.png,502,481,626,584,124,103,red blood cell,12772,0.8306451612903226,1.203883495145631
9809,/images/3859deaf-6ae1-49a3-9051-898d0f0d7de6.png,148,267,240,363,92,96,red blood cell,8832,1.0434782608695652,0.9583333333333334
34195,/images/f1cda808-69a9-4d10-ba0a-6607c98e362d.png,631,137,751,257,120,120,red blood cell,14400,1.0,1.0
50377,/images/3d32a988-449d-4d58-b71f-abbfdc3f2fbc.png,850,1143,944,1243,94,100,red blood cell,9400,1.0638297872340425,0.94
8532,/images/dfc026a9-079f-4f45-8666-e0ccba5bb437.png,1054,291,1150,405,96,114,red blood cell,10944,1.1875,0.8421052631578947
30991,/images/b59dc3a0-3d54-4e3b-a485-33b3e43966de.png,611,117,728,231,117,114,red blood cell,13338,0.9743589743589743,1.0263157894736843
41442,/images/c4494d4f-732f-431a-8a9d-62403f0b74fe.png,845,159,947,263,102,104,red blood cell,10608,1.0196078431372548,0.9807692307692307
34775,/images/4fc9a597-aaa8-43b0-ad1c-2eabbe442e84.png,465,109,565,223,100,114,red blood cell,11400,1.14,0.8771929824561403
29409,/images/b4e5e08d-6427-46f3-aca8-a4df165a151d.png,513,413,621,536,108,123,red blood cell,13284,1.1388888888888888,0.8780487804878049
21281,/images/fc8df086-39e0-43f8-b0c7-2d23a349539b.png,911,269,1041,382,130,113,red blood cell,14690,0.8692307692307693,1.1504424778761062
37739,/images/fe0c5e48-f65e-488c-9c3c-1ea7c7835c0c.png,255,380,364,492,109,112,red blood cell,12208,1.0275229357798166,0.9732142857142857
56789,/images/0dcbf2c9-f959-4703-a72b-f6a81e66c2ea.png,425,185,526,283,101,98,red blood cell,9898,0.9702970297029703,1.030612244897959
53734,/images/6f67a66b-56ec-4c36-ae7c-f250d3b86a23.png,97,772,185,862,88,90,red blood cell,7920,1.0227272727272727,0.9777777777777777
74312,/images/8939e14b-fcdf-48b1-acb9-6514a2fc2fc0.png,264,713,382,809,118,96,red blood cell,11328,0.8135593220338984,1.2291666666666667
12296,/images/3b55c42f-ad59-422f-ba99-4f4f4ca9cb2e.png,723,1134,823,1234,100,100,red blood cell,10000,1.0,1.0
35,/images/8d02117d-6c71-4e47-b50a-6cc8d5eb1d55.png,79,1467,175,1558,96,91,red blood cell,8736,0.9479166666666666,1.054945054945055
830,/images/27fab82c-5bf0-426f-aeb9-47da829b6629.png,363,1428,446,1529,83,101,red blood cell,8383,1.216867469879518,0.8217821782178217
19588,/images/883d9731-a04d-4f84-83c9-d3bef954759d.png,692,1068,802,1193,110,125,red blood cell,13750,1.1363636363636365,0.88
69825,/images/2bd15b6e-fe2d-49f3-b394-940d024d1f91.png,471,589,551,660,80,71,red blood cell,5680,0.8875,1.1267605633802817
63017,/images/f234a2de-f3c8-4521-a306-8cfdf52dd597.png,182,811,266,894,84,83,red blood cell,6972,0.9880952380952381,1.0120481927710843
29182,/images/6274fe0d-0d71-40be-b61b-f0bd5b5df1e2.png,1037,1187,1160,1286,123,99,red blood cell,12177,0.8048780487804879,1.2424242424242424
46162,/images/d8632217-ec33-4d0a-98e6-427824c58869.png,697,202,804,322,107,120,red blood cell,12840,1.1214953271028036,0.8916666666666667
33706,/images/441d7843-b20b-4c10-84e3-e6d32621e880.png,104,979,209,1084,105,105,red blood cell,11025,1.0,1.0
9606,/images/239f17eb-a2e2-47e9-82e3-fa0d9a70fb9f.png,121,1054,242,1156,121,102,red blood cell,12342,0.8429752066115702,1.1862745098039216
67368,/images/266180ed-77a3-4284-8292-50a49fc47fce.png,627,176,721,280,94,104,red blood cell,9776,1.1063829787234043,0.9038461538461539
37645,/images/205306da-0ed8-475a-ace6-f2f81d4be88a.png,1088,732,1173,800,85,68,red blood cell,5780,0.8,1.25
29520,/images/8cc6fe77-5f2f-4670-b4ac-1b49550241a8.png,788,1402,922,1536,134,134,red blood cell,17956,1.0,1.0
11858,/images/3cdcb09b-6a8c-43ca-b1d0-c1a289202f65.png,894,1262,992,1374,98,112,red blood cell,10976,1.1428571428571428,0.875
9803,/images/3859deaf-6ae1-49a3-9051-898d0f0d7de6.png,590,382,691,490,101,108,red blood cell,10908,1.0693069306930694,0.9351851851851852
30535,/images/7d9c1422-6332-44e9-b134-3ac94f07b0f0.png,286,29,406,141,120,112,red blood cell,13440,0.9333333333333333,1.0714285714285714
19190,/images/bb795ddf-ce72-42d5-9006-124db4d5cf1c.png,0,1274,118,1380,118,106,red blood cell,12508,0.8983050847457628,1.1132075471698113
29181,/images/6274fe0d-0d71-40be-b61b-f0bd5b5df1e2.png,806,627,893,734,87,107,red blood cell,9309,1.2298850574712643,0.8130841121495327
44646,/images/8002cb71-0f25-4fa4-a46f-b49e5aeded0c.png,740,1235,857,1356,117,121,red blood cell,14157,1.0341880341880343,0.9669421487603306
68598,/images/31653d0f-c4e6-4e12-8005-518c2de34687.png,948,1129,1036,1238,88,109,red blood cell,9592,1.2386363636363635,0.8073394495412844
12003,/images/ca16a5ad-b106-4e84-8a43-178710e854ba.png,65,40,181,163,116,123,red blood cell,14268,1.0603448275862069,0.943089430894309
27284,/images/9f38055f-4fe6-47fd-a6dd-c0743db4eccf.png,360,1162,482,1269,122,107,red blood cell,13054,0.8770491803278688,1.1401869158878504
32245,/images/f4722a74-35e7-42bd-8ef6-dfff04b9cd22.png,233,469,372,584,139,115,red blood cell,15985,0.8273381294964028,1.208695652173913
31177,/images/1976cd04-d24f-457c-b423-7e4cdb05de9e.png,42,204,149,325,107,121,red blood cell,12947,1.1308411214953271,0.8842975206611571
74465,/images/cbb58718-6319-48db-b84b-78ac9b12ff89.png,913,1341,1039,1454,126,113,red blood cell,14238,0.8968253968253969,1.1150442477876106
68392,/images/040112be-3c8d-49aa-93f1-522f94a592ff.png,822,1442,930,1545,108,103,red blood cell,11124,0.9537037037037037,1.0485436893203883
73560,/images/7624ac36-1cf9-42fb-844d-376078309553.png,81,242,197,353,116,111,red blood cell,12876,0.9568965517241379,1.045045045045045
36078,/images/ca9626bc-21a4-46f4-ba94-e7ee7a4cf735.png,41,186,156,295,115,109,red blood cell,12535,0.9478260869565217,1.055045871559633
53064,/images/69b5b3de-ec64-4e5d-bcc2-44f495e06e76.png,374,19,483,136,109,117,red blood cell,12753,1.073394495412844,0.9316239316239316
71992,/images/6ad3efc9-4392-4cee-98a5-186564a96373.png,119,44,218,144,99,100,red blood cell,9900,1.0101010101010102,0.99
40360,/images/db249e5a-4142-432c-8288-bacd10d7273d.png,819,860,931,978,112,118,red blood cell,13216,1.0535714285714286,0.9491525423728814
31566,/images/a0b277cb-20bc-4921-a6bd-5ccd5b91d14f.png,359,627,487,744,128,117,red blood cell,14976,0.9140625,1.0940170940170941
19228,/images/b4d22412-a495-43a9-bec0-73a2322f8dad.png,654,1260,764,1367,110,107,red blood cell,11770,0.9727272727272728,1.02803738317757
37555,/images/205306da-0ed8-475a-ace6-f2f81d4be88a.png,688,832,789,928,101,96,red blood cell,9696,0.9504950495049505,1.0520833333333333
38059,/images/e3e9c2de-0a24-4c7e-8a69-3d3093d5bdab.png,259,894,355,1004,96,110,red blood cell,10560,1.1458333333333333,0.8727272727272727
76688,/images/3317d733-ec0d-45e6-b631-40457392f343.png,553,1371,665,1479,112,108,red blood cell,12096,0.9642857142857143,1.037037037037037
31567,/images/a0b277cb-20bc-4921-a6bd-5ccd5b91d14f.png,304,62,428,185,124,123,red blood cell,15252,0.9919354838709677,1.008130081300813
68934,/images/bbaa004f-05dc-4cb8-8768-e148085bb0f9.png,921,1186,1033,1281,112,95,red blood cell,10640,0.8482142857142857,1.1789473684210525
44128,/images/8b494b40-cab5-49d3-893d-c805000fbe88.png,1045,1120,1149,1239,104,119,red blood cell,12376,1.1442307692307692,0.8739495798319328
49073,/images/df3d98b9-3dd7-4107-8d4a-ae1b7f247793.png,816,725,912,821,96,96,red blood cell,9216,1.0,1.0
40320,/images/eb86033f-4f1c-4e8c-ae84-e8e4c7e08626.png,942,243,1068,364,126,121,red blood cell,15246,0.9603174603174603,1.0413223140495869
63368,/images/9f4bc3b4-abb0-4bcb-baa8-ec9f25e2b9c6.png,452,226,543,330,91,104,red blood cell,9464,1.1428571428571428,0.875
68260,/images/a6391703-0820-4913-a7cd-e843ff0d84ba.png,48,1307,168,1423,120,116,red blood cell,13920,0.9666666666666667,1.0344827586206897
75395,/images/468c261d-f5d8-423f-883e-48af2bbbc5d1.png,395,430,510,548,115,118,red blood cell,13570,1.0260869565217392,0.9745762711864406
36197,/images/17c06a23-bb77-49cb-9ffb-fbfc75fcc715.png,6,101,102,210,96,109,red blood cell,10464,1.1354166666666667,0.8807339449541285
34490,/images/fa1f9f89-cecb-4972-842c-d14c632f89a9.png,1,1094,115,1207,114,113,red blood cell,12882,0.9912280701754386,1.008849557522124
74467,/images/cbb58718-6319-48db-b84b-78ac9b12ff89.png,868,1010,973,1115,105,105,red blood cell,11025,1.0,1.0
53938,/images/540a5fee-175b-4b92-bf62-1ea9b59c86c6.png,466,80,556,175,90,95,red blood cell,8550,1.0555555555555556,0.9473684210526315
9755,/images/3859deaf-6ae1-49a3-9051-898d0f0d7de6.png,479,439,578,537,99,98,red blood cell,9702,0.98989898989899,1.010204081632653
24284,/images/4d8a4ce8-0f9c-4f21-8844-4cf0e5514bbf.png,519,514,620,614,101,100,red blood cell,10100,0.9900990099009901,1.01
33968,/images/701206c5-aaac-4b99-9cc0-4a6854359457.png,580,902,707,1018,127,116,red blood cell,14732,0.9133858267716536,1.0948275862068966
46144,/images/72088c26-d2dd-4906-b791-b8947fc7fbe4.png,318,981,414,1081,96,100,red blood cell,9600,1.0416666666666667,0.96
24083,/images/505355c9-23bf-4f90-8ebc-6a7ef50964d0.png,326,1331,416,1425,90,94,red blood cell,8460,1.0444444444444445,0.9574468085106383
30002,/images/deeaa5b3-3895-4aec-a2ce-ed6404862cdf.png,705,852,825,966,120,114,red blood cell,13680,0.95,1.0526315789473684
74093,/images/fe436c09-b680-4f4c-8faf-aa10a55a335b.png,987,1039,1069,1120,82,81,red blood cell,6642,0.9878048780487805,1.0123456790123457
60161,/images/214f1d15-a081-476e-992d-6c3a77f03d59.png,391,1114,498,1224,107,110,red blood cell,11770,1.02803738317757,0.9727272727272728
6622,/images/640c4a52-3742-4f57-aee3-9e3dc0887622.png,994,567,1097,672,103,105,red blood cell,10815,1.0194174757281553,0.9809523809523809
74390,/images/06a3effb-996c-4767-afd2-6aa3b697cb4e.png,200,1376,295,1486,95,110,red blood cell,10450,1.1578947368421053,0.8636363636363636
22104,/images/ac4d6507-d710-497b-ad7c-e0dd75c1d06d.png,195,75,317,190,122,115,red blood cell,14030,0.9426229508196722,1.0608695652173914
18937,/images/e9e78ff8-831b-46e9-9785-3eee9acbfcd8.png,341,862,448,974,107,112,red blood cell,11984,1.0467289719626167,0.9553571428571429
14893,/images/3090a362-1f3d-49e9-a76e-ce76ff9c2276.png,635,1076,732,1192,97,116,red blood cell,11252,1.1958762886597938,0.8362068965517241
28602,/images/861c3e06-aada-47a0-99ae-94fbc2772cc0.png,450,565,560,675,110,110,red blood cell,12100,1.0,1.0
56626,/images/4adcaa26-aa1f-47b5-bdf0-18c9f814f576.png,574,1212,688,1325,114,113,red blood cell,12882,0.9912280701754386,1.008849557522124
10449,/images/46a2d369-4bea-4405-ac78-91bbe130b9a7.png,574,412,661,503,87,91,red blood cell,7917,1.0459770114942528,0.9560439560439561
30896,/images/fbc1f360-4382-48bb-a32e-3f5f2f9dbe57.png,882,1101,990,1207,108,106,red blood cell,11448,0.9814814814814815,1.0188679245283019
37974,/images/56a57a8d-c9b9-432a-a3b0-32a09355806c.png,272,695,372,789,100,94,red blood cell,9400,0.94,1.0638297872340425
46253,/images/815bf40c-371a-4d34-aa41-c549c8221881.png,0,132,108,252,108,120,red blood cell,12960,1.1111111111111112,0.9
65643,/images/397f37bc-a3a4-4257-9430-c8fc5716f8b1.png,800,550,911,659,111,109,red blood cell,12099,0.9819819819819819,1.018348623853211
1831,/images/5f783f43-0090-4f8a-bd75-9562f4aa2dd5.png,459,1413,569,1525,110,112,red blood cell,12320,1.018181818181818,0.9821428571428571
36890,/images/b2e34f5f-904e-4473-9dc7-c6bc1ce12640.png,73,882,167,983,94,101,red blood cell,9494,1.074468085106383,0.9306930693069307
16013,/images/7e25ced3-5caf-47f8-ad0c-42946bd4468b.png,731,112,850,229,119,117,red blood cell,13923,0.9831932773109243,1.017094017094017
26708,/images/2518f6e4-29cc-4ae4-a914-b215a4c56099.png,446,1254,548,1354,102,100,red blood cell,10200,0.9803921568627451,1.02
51855,/images/d67398c5-8b0e-463f-a04e-8583c820786c.png,78,1086,186,1186,108,100,red blood cell,10800,0.9259259259259259,1.08
55481,/images/43072c64-4c08-47cd-ae8a-b74d31f80008.png,617,412,724,516,107,104,red blood cell,11128,0.9719626168224299,1.0288461538461537
8969,/images/ef815e3a-02a6-4cf8-9262-45bc74c50b00.png,577,1408,696,1528,119,120,red blood cell,14280,1.0084033613445378,0.9916666666666667
40308,/images/eb86033f-4f1c-4e8c-ae84-e8e4c7e08626.png,49,468,149,584,100,116,red blood cell,11600,1.16,0.8620689655172413
39278,/images/697bdbc0-6e31-4e48-ac74-ba4ab5760d32.png,361,1434,457,1530,96,96,red blood cell,9216,1.0,1.0
44724,/images/ccb4b13d-ab20-4222-892f-5adf70249aaa.png,999,922,1126,1059,127,137,red blood cell,17399,1.078740157480315,0.927007299270073
4467,/images/cf90d82f-2814-4fb7-a3ff-a86b7c5efca7.png,1008,329,1119,459,111,130,red blood cell,14430,1.1711711711711712,0.8538461538461538
58146,/images/d615b706-8f50-4d96-8de5-6858897528d0.png,864,785,985,909,121,124,red blood cell,15004,1.024793388429752,0.9758064516129032
29591,/images/42845335-4ab2-4963-806d-0985d1382a31.png,983,983,1097,1091,114,108,red blood cell,12312,0.9473684210526315,1.0555555555555556
15898,/images/c7c1b873-0548-4a73-9618-f60912e164df.png,463,1144,566,1235,103,91,red blood cell,9373,0.883495145631068,1.1318681318681318
77870,/images/464055b6-3351-4636-a919-8be9840fb850.png,908,401,1022,512,114,111,red blood cell,12654,0.9736842105263158,1.027027027027027
61875,/images/f32b21ae-5ca7-490b-bc40-6db9396d933c.png,407,1476,505,1588,98,112,red blood cell,10976,1.1428571428571428,0.875
57274,/images/6d05ed67-43e2-43af-9d57-70c7a6eeef5e.png,628,776,746,895,118,119,red blood cell,14042,1.0084745762711864,0.9915966386554622
38304,/images/674b0fd3-f247-4b7f-97f7-3e6c57c9ba9e.png,580,75,668,174,88,99,red blood cell,8712,1.125,0.8888888888888888
4350,/images/84041bf9-dace-4066-9fe0-52170d08f826.png,540,875,637,984,97,109,red blood cell,10573,1.1237113402061856,0.8899082568807339
36082,/images/ca9626bc-21a4-46f4-ba94-e7ee7a4cf735.png,672,331,787,448,115,117,red blood cell,13455,1.017391304347826,0.9829059829059829
1913,/images/02ea7aa8-c142-4a3d-939f-e77689741341.png,823,663,952,773,129,110,red blood cell,14190,0.8527131782945736,1.1727272727272726
52010,/images/4f62b14e-c6f4-4155-8f50-881558f83fae.png,664,953,748,1037,84,84,red blood cell,7056,1.0,1.0
7787,/images/e726dac6-f962-449c-acff-4dd56847b685.png,419,569,520,671,101,102,red blood cell,10302,1.00990099009901,0.9901960784313726
34424,/images/b4bde4e8-f48b-4ae2-be01-86d8c91d0af9.png,86,1060,179,1148,93,88,red blood cell,8184,0.946236559139785,1.0568181818181819
25778,/images/1f8edb2a-40bc-4beb-aa6b-884d2473df0f.png,597,962,714,1081,117,119,red blood cell,13923,1.017094017094017,0.9831932773109243
1226,/images/5ff7c0c8-d208-4e7d-958d-ca3c2260ff39.png,22,131,148,245,126,114,red blood cell,14364,0.9047619047619048,1.105263157894737
5844,/images/143f5959-5b6d-4f95-bcee-9e110450fc22.png,55,2,171,96,116,94,red blood cell,10904,0.8103448275862069,1.2340425531914894
5124,/images/a777e78c-ad1f-4380-9ab2-b4f9f32b2d78.png,615,799,714,913,99,114,red blood cell,11286,1.1515151515151516,0.868421052631579
54670,/images/6473ddb6-ad56-48a2-81e8-c7cb45f06825.png,50,991,135,1071,85,80,red blood cell,6800,0.9411764705882353,1.0625
28530,/images/dbdfad64-110c-421f-a1c7-f68fd9e82d67.png,207,1365,325,1471,118,106,red blood cell,12508,0.8983050847457628,1.1132075471698113
15160,/images/3a8f468f-f9de-46a8-a7c8-f2be239fa207.png,944,1063,1056,1167,112,104,red blood cell,11648,0.9285714285714286,1.0769230769230769
16274,/images/d5009906-bce1-4353-90b4-f4c79362f4cf.png,711,513,823,630,112,117,red blood cell,13104,1.0446428571428572,0.9572649572649573
42855,/images/7029feb3-9ffe-46e4-9883-6a9df84f7b62.png,433,517,530,598,97,81,red blood cell,7857,0.8350515463917526,1.1975308641975309
24095,/images/505355c9-23bf-4f90-8ebc-6a7ef50964d0.png,104,291,206,389,102,98,red blood cell,9996,0.9607843137254902,1.0408163265306123
22383,/images/78c35732-7e31-4153-842e-55ab1cd656f6.png,381,664,492,768,111,104,red blood cell,11544,0.9369369369369369,1.0673076923076923
14892,/images/3090a362-1f3d-49e9-a76e-ce76ff9c2276.png,402,505,500,605,98,100,red blood cell,9800,1.0204081632653061,0.98
17545,/images/e80bad38-66d0-473e-85dd-92142dba37e6.png,836,1271,936,1381,100,110,red blood cell,11000,1.1,0.9090909090909091
1112,/images/edcb4d77-a4d3-465d-9b59-eb3087766b1c.png,192,978,300,1078,108,100,red blood cell,10800,0.9259259259259259,1.08
13147,/images/711f6b3f-cd63-46d1-834a-bc8e9aa9b43e.png,575,755,678,857,103,102,red blood cell,10506,0.9902912621359223,1.0098039215686274
1726,/images/5f783f43-0090-4f8a-bd75-9562f4aa2dd5.png,658,306,752,411,94,105,red blood cell,9870,1.1170212765957446,0.8952380952380953
9588,/images/239f17eb-a2e2-47e9-82e3-fa0d9a70fb9f.png,243,1,375,120,132,119,red blood cell,15708,0.9015151515151515,1.1092436974789917
22514,/images/bfe65b11-8aff-46aa-908b-1e989d25fdc4.png,849,183,952,279,103,96,red blood cell,9888,0.9320388349514563,1.0729166666666667
8613,/images/a6aa3b72-2970-4c78-b655-ea8dfe6e018c.png,244,245,333,348,89,103,red blood cell,9167,1.1573033707865168,0.8640776699029126
19145,/images/bb795ddf-ce72-42d5-9006-124db4d5cf1c.png,1063,1260,1164,1356,101,96,red blood cell,9696,0.9504950495049505,1.0520833333333333
45666,/images/584d62ed-4329-45dd-94ce-e929d8b2bb74.png,859,1027,948,1125,89,98,red blood cell,8722,1.101123595505618,0.9081632653061225
7762,/images/e726dac6-f962-449c-acff-4dd56847b685.png,285,557,385,677,100,120,red blood cell,12000,1.2,0.8333333333333334
6772,/images/672e4ecf-a56b-462e-b83b-76f4efaa6634.png,1067,1499,1169,1589,102,90,red blood cell,9180,0.8823529411764706,1.1333333333333333
31856,/images/f62d4fb6-df7c-446c-94a8-d5aede0b1e0c.png,1094,1161,1199,1284,105,123,red blood cell,12915,1.1714285714285715,0.8536585365853658
73176,/images/85546330-4efd-43e2-87aa-d53a30220bfc.png,642,589,737,692,95,103,red blood cell,9785,1.0842105263157895,0.9223300970873787
78780,/images/9174f910-3859-4839-8e30-2c3b25269322.png,714,1194,824,1297,110,103,red blood cell,11330,0.9363636363636364,1.0679611650485437
68878,/images/6347dd6a-cfdf-4cb5-bc50-cff5403cfecb.png,310,984,414,1086,104,102,red blood cell,10608,0.9807692307692307,1.0196078431372548
67126,/images/4272cbd7-5b0a-4bf7-b690-dee1c128f07b.png,527,563,613,645,86,82,red blood cell,7052,0.9534883720930233,1.048780487804878
22777,/images/8490c623-3d88-4532-baf5-0d266a45b16f.png,367,1211,463,1307,96,96,red blood cell,9216,1.0,1.0
46370,/images/fcc2b245-f47f-447f-8527-275b0005677c.png,188,761,300,883,112,122,red blood cell,13664,1.0892857142857142,0.9180327868852459
66394,/images/e5fd5949-4cd0-4cb6-837a-02c26a5eb87a.png,183,379,297,506,114,127,red blood cell,14478,1.1140350877192982,0.8976377952755905
76697,/images/3317d733-ec0d-45e6-b631-40457392f343.png,693,185,791,274,98,89,red blood cell,8722,0.9081632653061225,1.101123595505618
38812,/images/d0d3ae45-b434-4869-a518-427320ebe62d.png,779,737,897,853,118,116,red blood cell,13688,0.9830508474576272,1.0172413793103448
54890,/images/8f84a2c9-ca38-4405-a488-12fcd101278b.png,741,250,858,373,117,123,red blood cell,14391,1.0512820512820513,0.9512195121951219
23231,/images/3dcd4f1b-ce43-4a34-b1ed-076bb42963b1.png,890,597,992,697,102,100,red blood cell,10200,0.9803921568627451,1.02
27853,/images/948c94ad-395c-41f4-9a68-8a1dcb76888c.png,887,50,985,146,98,96,red blood cell,9408,0.9795918367346939,1.0208333333333333
2862,/images/521a26aa-0a31-4c07-b4d0-fac08eb08344.png,747,627,865,769,118,142,red blood cell,16756,1.2033898305084745,0.8309859154929577
11043,/images/85a4d82e-cfb7-4983-b272-626c9e8c7583.png,171,1288,285,1404,114,116,red blood cell,13224,1.0175438596491229,0.9827586206896551
56568,/images/a824b499-3736-4581-bbdc-be1b3b4cf756.png,334,735,431,833,97,98,red blood cell,9506,1.0103092783505154,0.9897959183673469
16099,/images/66557580-fd38-4d4b-80d8-88611ecc78c6.png,566,1445,688,1579,122,134,red blood cell,16348,1.098360655737705,0.9104477611940298
59386,/images/565513be-2c20-4ee3-94f3-093869515d3d.png,351,925,433,1015,82,90,red blood cell,7380,1.0975609756097562,0.9111111111111111
24934,/images/ed0bee2f-05e0-4392-8357-19750cec577c.png,1094,820,1188,906,94,86,red blood cell,8084,0.9148936170212766,1.0930232558139534
23200,/images/3dcd4f1b-ce43-4a34-b1ed-076bb42963b1.png,762,640,868,757,106,117,red blood cell,12402,1.1037735849056605,0.905982905982906
13042,/images/555c6ea2-c76c-4e71-af57-855d940c2b37.png,923,859,1033,992,110,133,red blood cell,14630,1.209090909090909,0.8270676691729323
44534,/images/419309ef-da3f-4424-93cf-01ff4c52b017.png,348,867,452,971,104,104,red blood cell,10816,1.0,1.0
77166,/images/fe691faa-3bc7-475e-b558-aa8fe7b795bc.png,669,594,772,704,103,110,red blood cell,11330,1.0679611650485437,0.9363636363636364
16714,/images/d6352a03-ef81-421d-915e-226499555d20.png,735,638,856,745,121,107,red blood cell,12947,0.8842975206611571,1.1308411214953271
6863,/images/b21f6c6e-4b45-407a-b4c7-034a115f3ee4.png,400,931,512,1048,112,117,red blood cell,13104,1.0446428571428572,0.9572649572649573
61416,/images/e16c0dab-780d-4035-872e-1bb91e49f9d2.png,808,278,907,392,99,114,red blood cell,11286,1.1515151515151516,0.868421052631579
44513,/images/b6573be3-9e04-49c3-9f48-6a145d065363.png,856,799,958,919,102,120,red blood cell,12240,1.1764705882352942,0.85
67860,/images/41ebf9a1-24dc-454e-8bf8-508218f5ee57.png,595,788,692,882,97,94,red blood cell,9118,0.9690721649484536,1.0319148936170213
38544,/images/c3ae7090-fc68-41b4-85a1-8d9bce9825a7.png,616,824,741,935,125,111,red blood cell,13875,0.888,1.1261261261261262
56420,/images/d75933ed-d26e-4d1f-bda3-96bc0d77fb36.png,826,1146,944,1252,118,106,red blood cell,12508,0.8983050847457628,1.1132075471698113
40646,/images/252071ac-e9f2-41d2-abbb-87ef01b8a997.png,197,71,295,187,98,116,red blood cell,11368,1.183673469387755,0.8448275862068966
66270,/images/e8058bed-c362-4e1c-85dc-62f80f32938f.png,990,885,1108,995,118,110,red blood cell,12980,0.9322033898305084,1.0727272727272728
10520,/images/46a2d369-4bea-4405-ac78-91bbe130b9a7.png,75,1200,181,1303,106,103,red blood cell,10918,0.9716981132075472,1.029126213592233
21793,/images/f68ae8e9-e760-4106-88e0-4bdef2785f06.png,24,86,135,190,111,104,red blood cell,11544,0.9369369369369369,1.0673076923076923
72002,/images/6ad3efc9-4392-4cee-98a5-186564a96373.png,746,935,865,1055,119,120,red blood cell,14280,1.0084033613445378,0.9916666666666667
43376,/images/aabca37c-f9ef-4415-aab6-3246caa348e9.png,973,717,1098,826,125,109,red blood cell,13625,0.872,1.146788990825688
31963,/images/9eb66577-7857-43dc-a879-8f2c9d7f780f.png,776,791,877,905,101,114,red blood cell,11514,1.1287128712871286,0.8859649122807017
33643,/images/84ee2ea3-9edd-4672-a1b3-f09c607d833a.png,333,256,428,353,95,97,red blood cell,9215,1.0210526315789474,0.979381443298969
27308,/images/9f38055f-4fe6-47fd-a6dd-c0743db4eccf.png,974,964,1072,1086,98,122,red blood cell,11956,1.2448979591836735,0.8032786885245902
58001,/images/7942691b-6376-4c75-ae8a-ddf65454dcb2.png,1085,626,1199,739,114,113,red blood cell,12882,0.9912280701754386,1.008849557522124
57884,/images/f4c2b43f-a2e7-4746-8034-0b34aebba8ee.png,280,1488,385,1597,105,109,red blood cell,11445,1.0380952380952382,0.963302752293578
63984,/images/5e974892-0ebe-4037-8427-ea8616d6d3b8.png,208,284,300,384,92,100,red blood cell,9200,1.0869565217391304,0.92
25809,/images/14b68d86-ac7f-419d-b4a5-6b0b1d9aaa18.png,535,306,652,427,117,121,red blood cell,14157,1.0341880341880343,0.9669421487603306
14742,/images/1fdf99d1-a494-4174-bcd7-efbe457ab899.png,143,950,264,1064,121,114,red blood cell,13794,0.9421487603305785,1.0614035087719298
5156,/images/a777e78c-ad1f-4380-9ab2-b4f9f32b2d78.png,419,489,522,589,103,100,red blood cell,10300,0.970873786407767,1.03
24262,/images/bb3ae957-0f6d-4615-bfe5-24fbca50b459.png,984,295,1098,421,114,126,red blood cell,14364,1.105263157894737,0.9047619047619048
30377,/images/58d75854-be99-484e-89f0-4ab208fe07e0.png,767,950,863,1058,96,108,red blood cell,10368,1.125,0.8888888888888888
77181,/images/fe691faa-3bc7-475e-b558-aa8fe7b795bc.png,758,25,859,135,101,110,red blood cell,11110,1.0891089108910892,0.9181818181818182
25472,/images/5f742392-278d-461c-a848-08def2c28878.png,274,956,374,1067,100,111,red blood cell,11100,1.11,0.9009009009009009
60347,/images/1c87b997-a8e6-48ca-bf40-19b9a7fd6a96.png,1096,39,1191,141,95,102,red blood cell,9690,1.0736842105263158,0.9313725490196079
72333,/images/ee57e743-a876-4f69-9fe5-bf5d01b44689.png,807,796,901,878,94,82,red blood cell,7708,0.8723404255319149,1.146341463414634
47848,/images/5a105b89-c592-4d78-b208-7db6c6572752.png,144,1364,252,1467,108,103,red blood cell,11124,0.9537037037037037,1.0485436893203883
67959,/images/bcaefb02-682a-41b9-acc7-e6cc010f5b30.png,404,121,479,196,75,75,red blood cell,5625,1.0,1.0
73908,/images/2ae3e6e6-7482-4ab8-ad73-b530b5c2ee3b.png,362,1158,458,1260,96,102,red blood cell,9792,1.0625,0.9411764705882353
79619,/images/a4409217-be11-4478-90a5-b406057d154d.png,147,1194,241,1293,94,99,red blood cell,9306,1.053191489361702,0.9494949494949495
32081,/images/b8a4d467-c40c-4ebf-91dd-1c19d0f2a7ae.png,186,622,295,732,109,110,red blood cell,11990,1.0091743119266054,0.990909090909091
77823,/images/6bc7b53c-5a98-48ef-a9de-59a476707ea4.png,420,492,533,612,113,120,red blood cell,13560,1.0619469026548674,0.9416666666666667
47707,/images/afbb264e-ff60-443a-83f5-49d09be1b835.png,393,1391,512,1509,119,118,red blood cell,14042,0.9915966386554622,1.0084745762711864
74001,/images/99a21c5c-f5a7-4c07-9cb6-5dda2d388f48.png,996,434,1098,542,102,108,red blood cell,11016,1.0588235294117647,0.9444444444444444
75022,/images/9147a21d-0de2-4c04-88da-b788311696ac.png,907,745,1012,864,105,119,red blood cell,12495,1.1333333333333333,0.8823529411764706
10037,/images/26799d2b-a289-4eff-9218-0aad77e05e41.png,859,1098,986,1224,127,126,red blood cell,16002,0.9921259842519685,1.007936507936508
17450,/images/56077789-8580-41b4-89d6-deea227e5c60.png,199,1320,330,1439,131,119,red blood cell,15589,0.9083969465648855,1.1008403361344539
14572,/images/458cb2e9-5a7f-437c-ac5d-a56f98a3efdf.png,1026,1500,1140,1599,114,99,red blood cell,11286,0.868421052631579,1.1515151515151516
73271,/images/67a4fb91-6f38-4ca2-8f20-6b2f5f1b29a7.png,675,871,782,973,107,102,red blood cell,10914,0.9532710280373832,1.0490196078431373
22869,/images/be779f52-0bfa-4c01-a16f-b7f0bc92ed7c.png,399,212,519,341,120,129,red blood cell,15480,1.075,0.9302325581395349
10044,/images/26799d2b-a289-4eff-9218-0aad77e05e41.png,239,595,337,692,98,97,red blood cell,9506,0.9897959183673469,1.0103092783505154
59660,/images/a2754679-68b0-40f4-be01-bafad5ac1261.png,911,1071,1005,1160,94,89,red blood cell,8366,0.9468085106382979,1.0561797752808988
41789,/images/28bd16ba-2bcf-46af-b889-41b78d2a50c0.png,863,774,980,882,117,108,red blood cell,12636,0.9230769230769231,1.0833333333333333
32771,/images/eef2ac0b-42de-4bc3-a3c3-d5fcd597fbe4.png,853,952,973,1064,120,112,red blood cell,13440,0.9333333333333333,1.0714285714285714
20311,/images/98976666-9125-47fe-9601-43c41e58dfb4.png,1002,153,1110,264,108,111,red blood cell,11988,1.0277777777777777,0.972972972972973
58762,/images/e4827c85-311a-4df1-89c2-99dad0c3558c.png,141,256,222,339,81,83,red blood cell,6723,1.0246913580246915,0.9759036144578314
31372,/images/04fb49a2-07b8-4cdf-b6f7-df5c3688e5f8.png,136,1357,239,1468,103,111,red blood cell,11433,1.0776699029126213,0.9279279279279279
54584,/images/59dc7da9-35d1-421e-a61b-1e9637bfbfa1.png,766,111,873,223,107,112,red blood cell,11984,1.0467289719626167,0.9553571428571429
17446,/images/56077789-8580-41b4-89d6-deea227e5c60.png,149,829,265,963,116,134,red blood cell,15544,1.1551724137931034,0.8656716417910447
38431,/images/674b0fd3-f247-4b7f-97f7-3e6c57c9ba9e.png,978,1438,1108,1563,130,125,red blood cell,16250,0.9615384615384616,1.04
8573,/images/a6aa3b72-2970-4c78-b655-ea8dfe6e018c.png,297,359,393,470,96,111,red blood cell,10656,1.15625,0.8648648648648649
53239,/images/d8f7e159-b7e3-49e4-86e8-aed8c5fbcd97.png,127,606,218,693,91,87,red blood cell,7917,0.9560439560439561,1.0459770114942528
30266,/images/cecbf663-0751-4e7f-b298-770c88afc2c1.png,1072,66,1177,176,105,110,red blood cell,11550,1.0476190476190477,0.9545454545454546
67301,/images/49c4dbd3-6269-4d4c-9648-a2146c57bab1.png,870,657,974,755,104,98,red blood cell,10192,0.9423076923076923,1.0612244897959184
9142,/images/d3ed519e-2152-4e30-838d-a3ea23be512f.png,227,535,343,673,116,138,red blood cell,16008,1.1896551724137931,0.8405797101449275
61738,/images/985627c9-7b85-40de-a106-eb9cc47b47cb.png,370,290,476,410,106,120,red blood cell,12720,1.1320754716981132,0.8833333333333333
41381,/images/a065c50b-341d-4803-b4b0-0fe8f04fdbb5.png,32,911,134,1004,102,93,red blood cell,9486,0.9117647058823529,1.096774193548387
52897,/images/abb2f9d6-26fa-4328-983c-959ef6717c05.png,665,244,757,339,92,95,red blood cell,8740,1.0326086956521738,0.968421052631579
22816,/images/72105bb0-8e39-48be-b7f7-5b32f047b99e.png,615,441,739,551,124,110,red blood cell,13640,0.8870967741935484,1.1272727272727272
45049,/images/13bab3c3-3f79-44d9-a287-0ae6d71eff31.png,697,628,815,736,118,108,red blood cell,12744,0.9152542372881356,1.0925925925925926
60569,/images/58065a0c-d4c5-40fd-bcdc-037f61788482.png,738,249,827,355,89,106,red blood cell,9434,1.1910112359550562,0.839622641509434
56,/images/8d02117d-6c71-4e47-b50a-6cc8d5eb1d55.png,104,404,210,501,106,97,red blood cell,10282,0.9150943396226415,1.092783505154639
49598,/images/bd7937db-fca2-44d0-8538-460110210927.png,924,253,1031,366,107,113,red blood cell,12091,1.0560747663551402,0.9469026548672567
24078,/images/505355c9-23bf-4f90-8ebc-6a7ef50964d0.png,966,360,1058,448,92,88,red blood cell,8096,0.9565217391304348,1.0454545454545454
51065,/images/93f40356-5676-45d3-8e83-8028708c93ba.png,82,644,193,773,111,129,red blood cell,14319,1.162162162162162,0.8604651162790697
4508,/images/0f26699f-a776-4424-b092-27da9a1d12e2.png,659,1446,770,1558,111,112,red blood cell,12432,1.009009009009009,0.9910714285714286
38958,/images/5939f341-a886-4f63-ae87-2219d000a1d4.png,605,776,717,897,112,121,red blood cell,13552,1.0803571428571428,0.9256198347107438
19965,/images/8e69098c-fae0-47a3-8833-c2bfdfb1a416.png,723,972,849,1098,126,126,red blood cell,15876,1.0,1.0
53852,/images/f24c8fe0-a534-44cf-9995-b2b314d945ba.png,802,1358,922,1471,120,113,red blood cell,13560,0.9416666666666667,1.0619469026548674
45279,/images/9e793460-d94c-47ac-b3a7-0d6ad86357da.png,362,475,485,601,123,126,red blood cell,15498,1.024390243902439,0.9761904761904762
73577,/images/7624ac36-1cf9-42fb-844d-376078309553.png,1066,1304,1163,1413,97,109,red blood cell,10573,1.1237113402061856,0.8899082568807339
29542,/images/8cc6fe77-5f2f-4670-b4ac-1b49550241a8.png,510,698,621,820,111,122,red blood cell,13542,1.0990990990990992,0.9098360655737705
42453,/images/29648565-fe28-4517-ba72-68df0c82c9c5.png,56,1140,184,1255,128,115,red blood cell,14720,0.8984375,1.1130434782608696
61324,/images/e16c0dab-780d-4035-872e-1bb91e49f9d2.png,514,322,624,426,110,104,red blood cell,11440,0.9454545454545454,1.0576923076923077
51129,/images/d64cd75a-df26-44d5-ac25-69061a4e4d57.png,1010,290,1102,400,92,110,red blood cell,10120,1.1956521739130435,0.8363636363636363
50606,/images/c956e531-6805-4fe1-b61c-8b96a9815a77.png,244,895,361,1014,117,119,red blood cell,13923,1.017094017094017,0.9831932773109243
32293,/images/1c406ce1-023b-47fc-a2cd-5ea2e255de65.png,525,637,644,763,119,126,red blood cell,14994,1.0588235294117647,0.9444444444444444
48077,/images/1d4f06e1-9c9b-487e-84cd-e7e50cc754da.png,186,568,301,684,115,116,red blood cell,13340,1.008695652173913,0.9913793103448276
7802,/images/e726dac6-f962-449c-acff-4dd56847b685.png,242,1203,363,1319,121,116,red blood cell,14036,0.9586776859504132,1.043103448275862
60477,/images/93b47b14-7f78-4b31-8897-d63a81fdab01.png,1065,355,1182,488,117,133,red blood cell,15561,1.1367521367521367,0.8796992481203008
28133,/images/cd2774a0-dab2-4d68-aae9-7568b9f3d2a6.png,947,17,1050,135,103,118,red blood cell,12154,1.145631067961165,0.8728813559322034
40819,/images/252071ac-e9f2-41d2-abbb-87ef01b8a997.png,89,796,178,885,89,89,red blood cell,7921,1.0,1.0
37407,/images/08f5a524-0554-49c2-83a8-ae9a6d51e8fd.png,460,479,558,575,98,96,red blood cell,9408,0.9795918367346939,1.0208333333333333
63541,/images/44b4a765-104e-4182-8871-e933c83c91ef.png,723,529,818,620,95,91,red blood cell,8645,0.9578947368421052,1.043956043956044
1222,/images/5ff7c0c8-d208-4e7d-958d-ca3c2260ff39.png,678,1038,797,1162,119,124,red blood cell,14756,1.0420168067226891,0.9596774193548387
49612,/images/bd7937db-fca2-44d0-8538-460110210927.png,224,504,340,630,116,126,red blood cell,14616,1.0862068965517242,0.9206349206349206
55884,/images/afd39466-aafa-4d81-9520-483727418723.png,490,1284,601,1393,111,109,red blood cell,12099,0.9819819819819819,1.018348623853211
8122,/images/694222bb-cddf-469a-9526-f873c6fba58e.png,165,1118,267,1216,102,98,red blood cell,9996,0.9607843137254902,1.0408163265306123
46186,/images/d8632217-ec33-4d0a-98e6-427824c58869.png,719,730,828,842,109,112,red blood cell,12208,1.0275229357798166,0.9732142857142857
40126,/images/b34e65f6-c32e-42f1-a437-4a037c75a231.png,566,199,660,293,94,94,red blood cell,8836,1.0,1.0
76490,/images/34df8890-272d-423a-ae78-ff8d068d3306.png,840,558,936,672,96,114,red blood cell,10944,1.1875,0.8421052631578947
71197,/images/4fac16e1-8e62-499b-a66b-c4c890372914.png,371,1323,503,1466,132,143,red blood cell,18876,1.0833333333333333,0.9230769230769231
20022,/images/ebfd9f67-138e-49f0-9cef-a0352069eedb.png,220,1258,325,1367,105,109,red blood cell,11445,1.0380952380952382,0.963302752293578
62863,/images/4b346035-b8c0-46ca-8fdb-a01b1421ee4a.png,79,1161,189,1264,110,103,red blood cell,11330,0.9363636363636364,1.0679611650485437
333,/images/0dcca702-a4ef-4fb3-a940-9c0c140b21c7.png,963,603,1069,710,106,107,red blood cell,11342,1.009433962264151,0.9906542056074766
40532,/images/e3ade58d-086c-47fa-9120-76beacb45395.png,579,320,705,438,126,118,red blood cell,14868,0.9365079365079365,1.0677966101694916
73591,/images/a51d6c18-f9e8-4714-9dbb-38e1577445f2.png,214,1058,318,1170,104,112,red blood cell,11648,1.0769230769230769,0.9285714285714286
5922,/images/a30da226-b452-408a-a556-bfae4d521464.png,791,687,893,782,102,95,red blood cell,9690,0.9313725490196079,1.0736842105263158
35556,/images/3e33ee12-ef02-4287-8318-7ad3b284a617.png,505,697,644,827,139,130,red blood cell,18070,0.935251798561151,1.0692307692307692
74316,/images/8939e14b-fcdf-48b1-acb9-6514a2fc2fc0.png,508,1316,596,1405,88,89,red blood cell,7832,1.0113636363636365,0.9887640449438202
32760,/images/eef2ac0b-42de-4bc3-a3c3-d5fcd597fbe4.png,137,541,225,641,88,100,red blood cell,8800,1.1363636363636365,0.88
621,/images/065af549-320a-4862-b92a-8ef750d7b5fb.png,49,51,169,179,120,128,red blood cell,15360,1.0666666666666667,0.9375
55552,/images/a27b451d-44a6-4740-861a-9e7e99915563.png,736,28,831,123,95,95,red blood cell,9025,1.0,1.0
13233,/images/711f6b3f-cd63-46d1-834a-bc8e9aa9b43e.png,939,452,1033,567,94,115,red blood cell,10810,1.2234042553191489,0.8173913043478261
17877,/images/eb77e4a9-acb0-4d83-8055-2c5fcaa54b45.png,417,39,517,145,100,106,red blood cell,10600,1.06,0.9433962264150944
47952,/images/ab27173b-6e30-4957-bd68-29194328fd39.png,143,0,238,104,95,104,red blood cell,9880,1.0947368421052632,0.9134615384615384
43679,/images/a4851ed0-1499-4eae-9157-dcd34773254f.png,1012,91,1099,177,87,86,red blood cell,7482,0.9885057471264368,1.0116279069767442
7162,/images/56551792-4aa1-4301-9f8f-8bfebcd20050.png,32,44,161,170,129,126,red blood cell,16254,0.9767441860465116,1.0238095238095237
63418,/images/289ef1b7-02d5-42e9-a401-687688181306.png,234,1484,320,1581,86,97,red blood cell,8342,1.127906976744186,0.8865979381443299
12207,/images/313ed8d9-3c00-4415-9de0-0eda07c60ad9.png,248,349,370,466,122,117,red blood cell,14274,0.9590163934426229,1.0427350427350428
42969,/images/ff37dd9b-2e3c-444d-9d29-6db186cfa2fb.png,959,241,1074,359,115,118,red blood cell,13570,1.0260869565217392,0.9745762711864406
26952,/images/1f337b61-1b0d-4539-91f9-73d4a0798a4a.png,33,1292,127,1390,94,98,red blood cell,9212,1.0425531914893618,0.9591836734693877
76720,/images/3317d733-ec0d-45e6-b631-40457392f343.png,276,382,362,459,86,77,red blood cell,6622,0.8953488372093024,1.1168831168831168
398,/images/84c88143-940d-4b62-bbd2-7acc4cadcb6b.png,955,97,1073,218,118,121,red blood cell,14278,1.0254237288135593,0.9752066115702479
7122,/images/64a678d4-9048-4491-90c7-1924f38be19a.png,861,1386,977,1490,116,104,red blood cell,12064,0.896551724137931,1.1153846153846154
38117,/images/33bdb7b5-ad5b-4a73-bbc2-3350f8c2ac0c.png,991,1044,1095,1154,104,110,red blood cell,11440,1.0576923076923077,0.9454545454545454
30120,/images/81c3c8f0-d5a9-4dda-afd5-e86f6afd9424.png,300,939,412,1058,112,119,red blood cell,13328,1.0625,0.9411764705882353
42346,/images/5c5b7965-1a44-44b8-aa43-660823e61821.png,75,1029,193,1149,118,120,red blood cell,14160,1.0169491525423728,0.9833333333333333
11760,/images/082e1f81-4f49-44ad-b5bb-9dfc155b2ed8.png,576,646,678,757,102,111,red blood cell,11322,1.088235294117647,0.918918918918919
32382,/images/a6526894-e290-482d-ac43-f1df34864817.png,680,1017,791,1127,111,110,red blood cell,12210,0.990990990990991,1.009090909090909
8653,/images/ea6b012a-3425-4bfc-a61d-88563aa2a264.png,578,59,715,172,137,113,red blood cell,15481,0.8248175182481752,1.2123893805309736
30860,/images/fbc1f360-4382-48bb-a32e-3f5f2f9dbe57.png,931,777,1050,903,119,126,red blood cell,14994,1.0588235294117647,0.9444444444444444
45540,/images/e597f7ce-46c6-4dce-9063-50a2703fdd45.png,850,1067,945,1172,95,105,red blood cell,9975,1.105263157894737,0.9047619047619048
29351,/images/3850f2a5-ab62-49d3-8135-68d60baa676b.png,294,177,415,298,121,121,red blood cell,14641,1.0,1.0
62937,/images/4b346035-b8c0-46ca-8fdb-a01b1421ee4a.png,496,772,601,876,105,104,red blood cell,10920,0.9904761904761905,1.0096153846153846
20668,/images/e6d7c5e1-43fc-4712-86d5-aa70252b978f.png,1016,629,1127,747,111,118,red blood cell,13098,1.063063063063063,0.940677966101695
50762,/images/db0a1123-0b35-48d7-8337-3b1ebd6af0cc.png,243,221,362,338,119,117,red blood cell,13923,0.9831932773109243,1.017094017094017
6151,/images/cbec07ed-69d3-40e7-8b04-b3bd6680885b.png,1020,1456,1159,1573,139,117,red blood cell,16263,0.841726618705036,1.188034188034188
25661,/images/770b8ca4-8377-479b-9ad5-5455ec3b44f8.png,722,1426,849,1548,127,122,red blood cell,15494,0.9606299212598425,1.040983606557377
65555,/images/01b38a56-13eb-447b-89ee-fc21cb40dcc1.png,892,1098,983,1193,91,95,red blood cell,8645,1.043956043956044,0.9578947368421052
783,/images/27fab82c-5bf0-426f-aeb9-47da829b6629.png,487,460,601,580,114,120,red blood cell,13680,1.0526315789473684,0.95
53880,/images/540a5fee-175b-4b92-bf62-1ea9b59c86c6.png,576,921,692,1040,116,119,red blood cell,13804,1.0258620689655173,0.9747899159663865
42145,/images/c63f190a-e860-44fc-a2db-7980e1c80519.png,935,1404,1049,1515,114,111,red blood cell,12654,0.9736842105263158,1.027027027027027
8093,/images/694222bb-cddf-469a-9526-f873c6fba58e.png,873,296,985,400,112,104,red blood cell,11648,0.9285714285714286,1.0769230769230769
7656,/images/21cc498b-8cb2-42ed-8f80-bfa27b86ef11.png,1088,1206,1200,1319,112,113,red blood cell,12656,1.0089285714285714,0.9911504424778761
73326,/images/c890ee00-daa5-4b20-9cd5-930748ecc4e0.png,210,769,313,870,103,101,red blood cell,10403,0.9805825242718447,1.0198019801980198
70956,/images/deaa1931-5f97-45bf-8c00-be6ddeb37b9a.png,64,1255,174,1360,110,105,red blood cell,11550,0.9545454545454546,1.0476190476190477
27615,/images/715761a2-745e-4743-9849-956a034ad3c4.png,86,577,194,681,108,104,red blood cell,11232,0.9629629629629629,1.0384615384615385
13154,/images/711f6b3f-cd63-46d1-834a-bc8e9aa9b43e.png,420,1096,519,1191,99,95,red blood cell,9405,0.9595959595959596,1.0421052631578946
14584,/images/b8410821-a42b-47d0-8bcf-c2fc82e4e2d5.png,848,850,963,956,115,106,red blood cell,12190,0.9217391304347826,1.0849056603773586
41110,/images/2240b991-48f6-4c59-9b62-5a8b5e541fae.png,750,1136,852,1240,102,104,red blood cell,10608,1.0196078431372548,0.9807692307692307
1390,/images/6d91d1f0-636b-4f5a-a526-7c17fc857190.png,1104,1340,1198,1436,94,96,red blood cell,9024,1.0212765957446808,0.9791666666666666
74172,/images/4e43fc22-dc08-4cde-b3ce-ce8a4f377c47.png,313,1438,409,1552,96,114,red blood cell,10944,1.1875,0.8421052631578947
74257,/images/4e43fc22-dc08-4cde-b3ce-ce8a4f377c47.png,519,938,598,1024,79,86,red blood cell,6794,1.0886075949367089,0.9186046511627907
36942,/images/b2e34f5f-904e-4473-9dc7-c6bc1ce12640.png,186,669,282,770,96,101,red blood cell,9696,1.0520833333333333,0.9504950495049505
24199,/images/194aec70-41a5-4ac3-b22f-0b6eda91f730.png,636,282,737,407,101,125,red blood cell,12625,1.2376237623762376,0.808
66392,/images/e5fd5949-4cd0-4cb6-837a-02c26a5eb87a.png,931,1290,1022,1395,91,105,red blood cell,9555,1.1538461538461537,0.8666666666666667
65496,/images/da49db57-0c2f-4213-b322-c88c19fb9296.png,972,1216,1074,1334,102,118,red blood cell,12036,1.1568627450980393,0.864406779661017
77064,/images/637957ef-df75-4a7b-86d5-9f6e9c042ca2.png,1038,1170,1134,1286,96,116,red blood cell,11136,1.2083333333333333,0.8275862068965517
72713,/images/6ab870ba-b24b-49a9-9570-8eafe63aa74e.png,632,2,712,101,80,99,red blood cell,7920,1.2375,0.8080808080808081
34839,/images/4fc9a597-aaa8-43b0-ad1c-2eabbe442e84.png,70,91,184,195,114,104,red blood cell,11856,0.9122807017543859,1.0961538461538463
13553,/images/370277f8-436b-4103-8210-b4feb5ab95ea.png,681,1399,804,1508,123,109,red blood cell,13407,0.8861788617886179,1.128440366972477
5696,/images/d3dcdf92-9328-4796-adf4-918646877ba1.png,804,644,924,761,120,117,red blood cell,14040,0.975,1.0256410256410255
62710,/images/9e1b0217-0926-4fd1-bb9e-a815c05deb59.png,578,647,682,737,104,90,red blood cell,9360,0.8653846153846154,1.1555555555555554
57105,/images/7d041c38-11f2-4186-8a24-29d7d0f5c3cf.png,437,1385,546,1480,109,95,red blood cell,10355,0.8715596330275229,1.1473684210526316
28950,/images/b12ae3b1-613c-4c0e-9163-3c5cc314abf5.png,298,124,420,243,122,119,red blood cell,14518,0.9754098360655737,1.0252100840336134
78805,/images/9174f910-3859-4839-8e30-2c3b25269322.png,490,558,599,652,109,94,red blood cell,10246,0.8623853211009175,1.1595744680851063
64093,/images/0d3c2521-da55-4df5-bf06-56b3bd4fb2fc.png,293,1463,389,1574,96,111,red blood cell,10656,1.15625,0.8648648648648649
50339,/images/3d32a988-449d-4d58-b71f-abbfdc3f2fbc.png,724,432,805,516,81,84,red blood cell,6804,1.037037037037037,0.9642857142857143
63020,/images/f234a2de-f3c8-4521-a306-8cfdf52dd597.png,1005,1182,1085,1268,80,86,red blood cell,6880,1.075,0.9302325581395349
28034,/images/c4d34e35-4db2-41de-ba77-1a94aa9ef788.png,998,325,1100,452,102,127,red blood cell,12954,1.2450980392156863,0.8031496062992126
31953,/images/9eb66577-7857-43dc-a879-8f2c9d7f780f.png,190,834,300,939,110,105,red blood cell,11550,0.9545454545454546,1.0476190476190477
62302,/images/e0ff3476-226f-4125-b182-8e524d5503dd.png,524,607,641,711,117,104,red blood cell,12168,0.8888888888888888,1.125
43700,/images/ef83ed4c-2724-4d5f-8abe-1a18d25cea35.png,248,366,373,489,125,123,red blood cell,15375,0.984,1.016260162601626
71224,/images/86495bbf-687b-429c-b9d3-6c2681ade7e2.png,303,374,418,488,115,114,red blood cell,13110,0.991304347826087,1.0087719298245614
26836,/images/2518f6e4-29cc-4ae4-a914-b215a4c56099.png,39,1070,142,1154,103,84,red blood cell,8652,0.8155339805825242,1.2261904761904763
57834,/images/c9ad92d4-b408-4506-916e-def47b2e6ed0.png,5,507,121,618,116,111,red blood cell,12876,0.9568965517241379,1.045045045045045
76203,/images/07a96126-482e-4beb-b42a-0cb59e505372.png,270,736,380,840,110,104,red blood cell,11440,0.9454545454545454,1.0576923076923077
75587,/images/c35ee701-fde2-46b5-b178-1fe3f1ea7da2.png,316,797,434,913,118,116,red blood cell,13688,0.9830508474576272,1.0172413793103448
46643,/images/da111ca5-520f-4ea8-97ad-ae5fce58ee91.png,887,1479,989,1575,102,96,red blood cell,9792,0.9411764705882353,1.0625
27857,/images/948c94ad-395c-41f4-9a68-8a1dcb76888c.png,712,227,818,315,106,88,red blood cell,9328,0.8301886792452831,1.2045454545454546
47538,/images/adff132d-3af0-4cef-942c-58fc09729bee.png,449,1364,559,1491,110,127,red blood cell,13970,1.1545454545454545,0.8661417322834646
16540,/images/69565501-6e77-4f40-bd80-caa3dda34d8b.png,12,1282,126,1387,114,105,red blood cell,11970,0.9210526315789473,1.0857142857142856
59049,/images/5e2cea49-0823-49d1-83cf-8fd1559cdd93.png,867,387,975,497,108,110,red blood cell,11880,1.0185185185185186,0.9818181818181818
20691,/images/e6d7c5e1-43fc-4712-86d5-aa70252b978f.png,621,347,740,474,119,127,red blood cell,15113,1.0672268907563025,0.937007874015748
39586,/images/04d21589-b777-43c2-86b5-038cbf8c3a4e.png,482,138,584,238,102,100,red blood cell,10200,0.9803921568627451,1.02
76074,/images/4c7d2382-a962-4237-a053-955eea3decd8.png,1032,815,1119,898,87,83,red blood cell,7221,0.9540229885057471,1.0481927710843373
22984,/images/b687c30d-cf15-445c-b3f6-5aca86584708.png,946,614,1060,754,114,140,red blood cell,15960,1.2280701754385965,0.8142857142857143
69818,/images/2bd15b6e-fe2d-49f3-b394-940d024d1f91.png,593,265,686,348,93,83,red blood cell,7719,0.8924731182795699,1.1204819277108433
53068,/images/69b5b3de-ec64-4e5d-bcc2-44f495e06e76.png,932,1180,1034,1297,102,117,red blood cell,11934,1.1470588235294117,0.8717948717948718
22508,/images/bfe65b11-8aff-46aa-908b-1e989d25fdc4.png,751,1176,868,1296,117,120,red blood cell,14040,1.0256410256410255,0.975
48795,/images/fed6ba05-36a5-45dc-a4e1-9baa7de2c622.png,760,494,871,592,111,98,red blood cell,10878,0.8828828828828829,1.1326530612244898
70590,/images/4ce5a070-9ede-4bb1-9ca2-1bae5746776b.png,338,128,453,238,115,110,red blood cell,12650,0.9565217391304348,1.0454545454545454
69104,/images/de2b8835-552c-4f01-98b7-67bc4910062e.png,261,26,353,121,92,95,red blood cell,8740,1.0326086956521738,0.968421052631579
36115,/images/cb2fac19-90b0-48b4-bdc5-7dbbd58756d1.png,569,1352,709,1464,140,112,red blood cell,15680,0.8,1.25
3748,/images/dacf7e3f-1d8c-42a0-8539-3abe3971c956.png,784,1214,902,1322,118,108,red blood cell,12744,0.9152542372881356,1.0925925925925926
51709,/images/592c941a-aa54-4971-b499-dc47356f80a3.png,868,306,965,390,97,84,red blood cell,8148,0.865979381443299,1.1547619047619047
11611,/images/b4dc3088-3fe2-4688-be24-70664a64e022.png,944,998,1073,1130,129,132,red blood cell,17028,1.0232558139534884,0.9772727272727273
43855,/images/c84edeb4-311c-4e82-88f9-ae0505b3ad13.png,777,1331,869,1425,92,94,red blood cell,8648,1.0217391304347827,0.9787234042553191
59584,/images/faead1c7-bb2c-4adf-bfce-9ff36cd2cf6a.png,719,433,822,559,103,126,red blood cell,12978,1.2233009708737863,0.8174603174603174
25498,/images/f6ab936d-924b-4038-aa47-71b07c26b4e2.png,364,260,490,373,126,113,red blood cell,14238,0.8968253968253969,1.1150442477876106
52820,/images/0a747cb3-c720-4572-a661-ab5670a5c42e.png,1022,283,1138,413,116,130,red blood cell,15080,1.1206896551724137,0.8923076923076924
74674,/images/5ccca8ee-abea-458a-a891-bedd31c3ddc3.png,529,1197,631,1303,102,106,red blood cell,10812,1.0392156862745099,0.9622641509433962
14957,/images/5d1418d3-1559-4725-ad4a-9afb6eaecdfd.png,660,1172,765,1285,105,113,red blood cell,11865,1.0761904761904761,0.9292035398230089
53297,/images/d8f7e159-b7e3-49e4-86e8-aed8c5fbcd97.png,283,1065,396,1177,113,112,red blood cell,12656,0.9911504424778761,1.0089285714285714
6208,/images/effd6334-516f-4d48-9f3c-5272a99780fb.png,214,622,341,757,127,135,red blood cell,17145,1.062992125984252,0.9407407407407408
34700,/images/8d989997-038c-4924-b2d3-d02629a7cdf5.png,1034,269,1159,389,125,120,red blood cell,15000,0.96,1.0416666666666667
35400,/images/002f20ad-2ace-499c-9335-c9080bc3e6b5.png,395,48,529,174,134,126,red blood cell,16884,0.9402985074626866,1.0634920634920635
6558,/images/640c4a52-3742-4f57-aee3-9e3dc0887622.png,461,719,553,807,92,88,red blood cell,8096,0.9565217391304348,1.0454545454545454
64566,/images/6ba5d0b8-cdc7-4266-9d78-db76faa312e9.png,206,956,288,1040,82,84,red blood cell,6888,1.024390243902439,0.9761904761904762
63018,/images/f234a2de-f3c8-4521-a306-8cfdf52dd597.png,1056,1392,1146,1482,90,90,red blood cell,8100,1.0,1.0
5830,/images/143f5959-5b6d-4f95-bcee-9e110450fc22.png,292,1304,408,1422,116,118,red blood cell,13688,1.0172413793103448,0.9830508474576272
4836,/images/c6ab535c-30e5-4b6b-8273-1ec8d78cdd13.png,847,1449,970,1560,123,111,red blood cell,13653,0.9024390243902439,1.1081081081081081
16819,/images/4823c1fe-a7f9-4b92-959f-0d9be09cd14b.png,972,171,1063,265,91,94,red blood cell,8554,1.032967032967033,0.9680851063829787
79413,/images/dcb21739-3c36-459d-b3cc-1be5871d6fe7.png,893,249,981,342,88,93,red blood cell,8184,1.0568181818181819,0.946236559139785
26818,/images/2518f6e4-29cc-4ae4-a914-b215a4c56099.png,1047,455,1151,548,104,93,red blood cell,9672,0.8942307692307693,1.118279569892473
34696,/images/8d989997-038c-4924-b2d3-d02629a7cdf5.png,82,680,210,791,128,111,red blood cell,14208,0.8671875,1.1531531531531531
2648,/images/a2ccbf70-e444-49a9-8b7e-9797a05220d8.png,974,186,1081,306,107,120,red blood cell,12840,1.1214953271028036,0.8916666666666667
67847,/images/04de3a31-fc09-40be-9c2c-9830c57f809d.png,1,1093,113,1196,112,103,red blood cell,11536,0.9196428571428571,1.087378640776699
13671,/images/1e86933d-6a5a-4a3c-a0f2-ca22afd767b3.png,98,385,212,500,114,115,red blood cell,13110,1.0087719298245614,0.991304347826087
51438,/images/b4f3b2a4-f4b9-48de-ac5d-0e681b77be27.png,2,1266,103,1369,101,103,red blood cell,10403,1.0198019801980198,0.9805825242718447
57800,/images/c9ad92d4-b408-4506-916e-def47b2e6ed0.png,1063,879,1188,1000,125,121,red blood cell,15125,0.968,1.0330578512396693
31598,/images/0d7bf56f-3b5a-40bd-971c-2ca33dd89b2c.png,685,434,787,533,102,99,red blood cell,10098,0.9705882352941176,1.0303030303030303
4556,/images/0f26699f-a776-4424-b092-27da9a1d12e2.png,892,770,1000,882,108,112,red blood cell,12096,1.037037037037037,0.9642857142857143
70336,/images/90246988-0d6d-4bf8-8a76-94107de4121e.png,852,684,943,775,91,91,red blood cell,8281,1.0,1.0
27271,/images/9f38055f-4fe6-47fd-a6dd-c0743db4eccf.png,686,643,800,745,114,102,red blood cell,11628,0.8947368421052632,1.1176470588235294
62140,/images/a63fa2c7-3ec8-4bb7-bde6-a39e09d2f806.png,1020,405,1145,522,125,117,red blood cell,14625,0.936,1.0683760683760684
49470,/images/f2574be3-81c6-4fc3-8a40-0230d1264f52.png,490,473,605,584,115,111,red blood cell,12765,0.9652173913043478,1.0360360360360361
26629,/images/16ec6e1f-5020-40b3-ba26-51c340d03ee7.png,766,732,896,863,130,131,red blood cell,17030,1.0076923076923077,0.9923664122137404
68710,/images/dcf7a19a-ec3d-44ef-8d7c-33b1e91fb9af.png,1028,297,1150,427,122,130,red blood cell,15860,1.0655737704918034,0.9384615384615385
58959,/images/a0eeeb10-d0cb-48d9-8c22-2c3a3c908d00.png,119,1417,248,1545,129,128,red blood cell,16512,0.9922480620155039,1.0078125
10020,/images/b9ccf7ca-953f-4832-9575-5e70b2a8c224.png,11,1089,107,1196,96,107,red blood cell,10272,1.1145833333333333,0.897196261682243
72361,/images/ee57e743-a876-4f69-9fe5-bf5d01b44689.png,674,1508,750,1598,76,90,red blood cell,6840,1.1842105263157894,0.8444444444444444
71247,/images/86495bbf-687b-429c-b9d3-6c2681ade7e2.png,354,9,455,116,101,107,red blood cell,10807,1.0594059405940595,0.9439252336448598
23603,/images/79d7a014-21ff-40f1-9ac4-a69839390654.png,807,929,900,1027,93,98,red blood cell,9114,1.053763440860215,0.9489795918367347
2646,/images/a2ccbf70-e444-49a9-8b7e-9797a05220d8.png,655,1225,786,1352,131,127,red blood cell,16637,0.9694656488549618,1.031496062992126
58704,/images/e4827c85-311a-4df1-89c2-99dad0c3558c.png,125,1392,222,1506,97,114,red blood cell,11058,1.175257731958763,0.8508771929824561
49192,/images/a9daf82a-a46d-4296-bd72-2c374ed0a193.png,438,573,549,704,111,131,red blood cell,14541,1.1801801801801801,0.8473282442748091
14723,/images/1fdf99d1-a494-4174-bcd7-efbe457ab899.png,102,635,204,733,102,98,red blood cell,9996,0.9607843137254902,1.0408163265306123
71099,/images/2dbf6f69-e020-4948-9e49-4b33edb7cebd.png,93,775,188,880,95,105,red blood cell,9975,1.105263157894737,0.9047619047619048
2457,/images/fe851c88-692d-4199-87e0-d19d9c4eb591.png,555,926,645,1031,90,105,red blood cell,9450,1.1666666666666667,0.8571428571428571
61823,/images/5f300fd1-7eec-41ac-bbd1-0f4a943c757c.png,813,699,922,806,109,107,red blood cell,11663,0.981651376146789,1.0186915887850467
55578,/images/a27b451d-44a6-4740-861a-9e7e99915563.png,320,550,434,673,114,123,red blood cell,14022,1.0789473684210527,0.926829268292683
41694,/images/67abb826-9b70-4459-8764-da76ecf35bfe.png,340,1009,463,1144,123,135,red blood cell,16605,1.0975609756097562,0.9111111111111111
4504,/images/0f26699f-a776-4424-b092-27da9a1d12e2.png,265,193,369,299,104,106,red blood cell,11024,1.0192307692307692,0.9811320754716981
19514,/images/a85cd1ae-0c94-4387-8305-84ab8d96d137.png,1062,326,1187,455,125,129,red blood cell,16125,1.032,0.9689922480620154
9187,/images/6e7ed596-1b76-4998-8147-a846d53d91c5.png,538,507,662,626,124,119,red blood cell,14756,0.9596774193548387,1.0420168067226891
1750,/images/5f783f43-0090-4f8a-bd75-9562f4aa2dd5.png,617,345,724,448,107,103,red blood cell,11021,0.9626168224299065,1.0388349514563107
76477,/images/34df8890-272d-423a-ae78-ff8d068d3306.png,160,186,267,283,107,97,red blood cell,10379,0.9065420560747663,1.1030927835051547
15452,/images/1b7f47fc-26cd-4273-b848-88a7cbfd9f85.png,309,270,421,386,112,116,red blood cell,12992,1.0357142857142858,0.9655172413793104
14283,/images/6382976c-ee87-4916-b798-4ef1373b2df0.png,42,838,149,940,107,102,red blood cell,10914,0.9532710280373832,1.0490196078431373
18223,/images/947348fe-4c70-468e-8009-3c14daeca69b.png,507,953,613,1056,106,103,red blood cell,10918,0.9716981132075472,1.029126213592233
14562,/images/458cb2e9-5a7f-437c-ac5d-a56f98a3efdf.png,94,1266,186,1366,92,100,red blood cell,9200,1.0869565217391304,0.92
37377,/images/08f5a524-0554-49c2-83a8-ae9a6d51e8fd.png,926,991,1031,1083,105,92,red blood cell,9660,0.8761904761904762,1.141304347826087
68305,/images/0f735cca-051c-4048-a1fa-cb36f389e12f.png,126,958,230,1073,104,115,red blood cell,11960,1.1057692307692308,0.9043478260869565
38154,/images/33bdb7b5-ad5b-4a73-bbc2-3350f8c2ac0c.png,868,187,972,315,104,128,red blood cell,13312,1.2307692307692308,0.8125
8882,/images/29539cb0-1c52-46b2-9302-552f8349dc71.png,384,588,509,695,125,107,red blood cell,13375,0.856,1.1682242990654206
78745,/images/dc6ac71b-2616-431e-bfd5-4c38139e4ddd.png,172,223,276,324,104,101,red blood cell,10504,0.9711538461538461,1.0297029702970297
26331,/images/580210c2-a8ed-4720-b71c-a77945968abc.png,207,439,328,557,121,118,red blood cell,14278,0.9752066115702479,1.0254237288135593
27887,/images/948c94ad-395c-41f4-9a68-8a1dcb76888c.png,771,1179,868,1273,97,94,red blood cell,9118,0.9690721649484536,1.0319148936170213
75034,/images/9147a21d-0de2-4c04-88da-b788311696ac.png,100,418,234,529,134,111,red blood cell,14874,0.8283582089552238,1.2072072072072073
23496,/images/6fb707b1-5c07-479f-8385-5404bf5747b0.png,805,617,932,744,127,127,red blood cell,16129,1.0,1.0
35019,/images/2b369d75-9c55-43e0-b352-d981aea544e3.png,855,378,962,488,107,110,red blood cell,11770,1.02803738317757,0.9727272727272728
4761,/images/3fa1a4e3-c80d-49da-8f7b-a1abb0424f48.png,599,665,697,772,98,107,red blood cell,10486,1.0918367346938775,0.9158878504672897
17799,/images/1863da5f-c595-4541-a8f4-21fe78678168.png,468,985,569,1083,101,98,red blood cell,9898,0.9702970297029703,1.030612244897959
18079,/images/947348fe-4c70-468e-8009-3c14daeca69b.png,566,443,680,562,114,119,red blood cell,13566,1.043859649122807,0.957983193277311
14117,/images/eaf4b781-b3aa-41ce-8c5e-287979b4e15a.png,1109,484,1198,580,89,96,red blood cell,8544,1.0786516853932584,0.9270833333333334
1495,/images/0ac747cd-ff32-49bf-bc1a-3e9b7702ce9c.png,70,909,184,1031,114,122,red blood cell,13908,1.0701754385964912,0.9344262295081968
14682,/images/4e2873dd-651e-4ecc-ac70-7335cf21a469.png,795,470,914,574,119,104,red blood cell,12376,0.8739495798319328,1.1442307692307692
60562,/images/58065a0c-d4c5-40fd-bcdc-037f61788482.png,90,1172,199,1286,109,114,red blood cell,12426,1.0458715596330275,0.956140350877193
37395,/images/08f5a524-0554-49c2-83a8-ae9a6d51e8fd.png,699,369,809,488,110,119,red blood cell,13090,1.0818181818181818,0.9243697478991597
79537,/images/161978c3-3a05-47a5-9fee-be7d25693eae.png,166,1188,267,1290,101,102,red blood cell,10302,1.00990099009901,0.9901960784313726
68802,/images/aa3ad405-828e-4986-8251-20fd981f34d3.png,559,1363,652,1466,93,103,red blood cell,9579,1.10752688172043,0.9029126213592233
66310,/images/fcdf6632-c03f-49a8-9fb3-42e87c99b9d0.png,602,977,702,1072,100,95,red blood cell,9500,0.95,1.0526315789473684
45317,/images/e4eea7ea-8989-46a9-9c98-25a178146b28.png,548,1095,657,1198,109,103,red blood cell,11227,0.944954128440367,1.058252427184466
79177,/images/1c90231b-2830-42d9-884e-7301edb16933.png,585,948,669,1024,84,76,red blood cell,6384,0.9047619047619048,1.105263157894737
2717,/images/a89cace5-c818-4f23-a432-052b3433b81e.png,1021,1103,1137,1226,116,123,red blood cell,14268,1.0603448275862069,0.943089430894309
49094,/images/df3d98b9-3dd7-4107-8d4a-ae1b7f247793.png,78,178,185,270,107,92,red blood cell,9844,0.8598130841121495,1.1630434782608696
66068,/images/c8af0297-ce1f-40ea-bf44-9256dcdae4e9.png,314,807,423,925,109,118,red blood cell,12862,1.0825688073394495,0.923728813559322
77769,/images/4849866a-73a2-4fcf-a407-2d0a25a09a89.png,39,1469,133,1551,94,82,red blood cell,7708,0.8723404255319149,1.146341463414634
40747,/images/252071ac-e9f2-41d2-abbb-87ef01b8a997.png,786,1173,901,1271,115,98,red blood cell,11270,0.8521739130434782,1.1734693877551021
19196,/images/064b84fe-bd21-4c27-b682-0a832272eac4.png,725,7,841,109,116,102,red blood cell,11832,0.8793103448275862,1.1372549019607843
4766,/images/3fa1a4e3-c80d-49da-8f7b-a1abb0424f48.png,159,1108,265,1215,106,107,red blood cell,11342,1.009433962264151,0.9906542056074766
28054,/images/f1f9df6d-c4cb-4b42-9ca2-8fb47b1b0e91.png,1007,323,1117,430,110,107,red blood cell,11770,0.9727272727272728,1.02803738317757
26470,/images/cdb086a8-2bf8-4436-b1ef-96cdd801f247.png,813,448,920,554,107,106,red blood cell,11342,0.9906542056074766,1.009433962264151
56395,/images/c10b125d-10c2-474a-9c6a-5249935c638e.png,391,260,503,369,112,109,red blood cell,12208,0.9732142857142857,1.0275229357798166
34958,/images/2b369d75-9c55-43e0-b352-d981aea544e3.png,627,1456,756,1581,129,125,red blood cell,16125,0.9689922480620154,1.032
61994,/images/bdb5d571-27bc-4a42-ae45-aa5a9af40a81.png,583,1151,681,1247,98,96,red blood cell,9408,0.9795918367346939,1.0208333333333333
7615,/images/21cc498b-8cb2-42ed-8f80-bfa27b86ef11.png,372,178,485,303,113,125,red blood cell,14125,1.1061946902654867,0.904
54993,/images/7beee655-6156-43b8-b185-dbae0eaf7f45.png,571,178,686,289,115,111,red blood cell,12765,0.9652173913043478,1.0360360360360361
45682,/images/584d62ed-4329-45dd-94ce-e929d8b2bb74.png,760,1110,866,1229,106,119,red blood cell,12614,1.1226415094339623,0.8907563025210085
28958,/images/b12ae3b1-613c-4c0e-9163-3c5cc314abf5.png,418,613,520,734,102,121,red blood cell,12342,1.1862745098039216,0.8429752066115702
65085,/images/5e042380-6ef2-496f-8231-0ca550fbfa71.png,1036,1449,1129,1553,93,104,red blood cell,9672,1.118279569892473,0.8942307692307693
16878,/images/4823c1fe-a7f9-4b92-959f-0d9be09cd14b.png,642,94,745,183,103,89,red blood cell,9167,0.8640776699029126,1.1573033707865168
67211,/images/5f491efd-a21c-4a80-aaba-70b8876238ac.png,354,724,447,826,93,102,red blood cell,9486,1.096774193548387,0.9117647058823529
44560,/images/419309ef-da3f-4424-93cf-01ff4c52b017.png,842,74,943,182,101,108,red blood cell,10908,1.0693069306930694,0.9351851851851852
4292,/images/882b91b7-5906-4091-bad4-688d4375eeb5.png,673,323,776,425,103,102,red blood cell,10506,0.9902912621359223,1.0098039215686274
7380,/images/89f10192-d3dd-4996-a571-4c851dbdc983.png,588,277,681,391,93,114,red blood cell,10602,1.2258064516129032,0.8157894736842105
14507,/images/458cb2e9-5a7f-437c-ac5d-a56f98a3efdf.png,216,290,324,385,108,95,red blood cell,10260,0.8796296296296297,1.1368421052631579
2361,/images/fe851c88-692d-4199-87e0-d19d9c4eb591.png,745,289,843,380,98,91,red blood cell,8918,0.9285714285714286,1.0769230769230769
15926,/images/c7c1b873-0548-4a73-9618-f60912e164df.png,618,301,708,392,90,91,red blood cell,8190,1.011111111111111,0.989010989010989
30205,/images/a1669b59-fe09-4fe6-ba9f-06bec6725502.png,424,902,524,1022,100,120,red blood cell,12000,1.2,0.8333333333333334
22805,/images/8490c623-3d88-4532-baf5-0d266a45b16f.png,405,1313,504,1426,99,113,red blood cell,11187,1.1414141414141414,0.8761061946902655
5040,/images/b7d0ae11-a393-4aec-8f68-6ba07147f78a.png,321,569,441,687,120,118,red blood cell,14160,0.9833333333333333,1.0169491525423728
24382,/images/4d8a4ce8-0f9c-4f21-8844-4cf0e5514bbf.png,153,66,251,167,98,101,red blood cell,9898,1.030612244897959,0.9702970297029703
71089,/images/2dbf6f69-e020-4948-9e49-4b33edb7cebd.png,930,390,1047,503,117,113,red blood cell,13221,0.9658119658119658,1.0353982300884956
79691,/images/03b9d6ad-39ca-4097-a98b-77f02b3c00a7.png,857,1163,969,1272,112,109,red blood cell,12208,0.9732142857142857,1.0275229357798166
3845,/images/3e764461-22ee-44d3-925d-cd658ff7d154.png,415,672,501,768,86,96,red blood cell,8256,1.1162790697674418,0.8958333333333334
22708,/images/4ab47131-c2ac-461f-b95c-ac19ce24edbd.png,848,475,962,588,114,113,red blood cell,12882,0.9912280701754386,1.008849557522124
6882,/images/b21f6c6e-4b45-407a-b4c7-034a115f3ee4.png,475,877,573,975,98,98,red blood cell,9604,1.0,1.0
42893,/images/a7b6894d-eeea-4ed5-bc0e-785d6c6da8df.png,972,312,1095,440,123,128,red blood cell,15744,1.0406504065040652,0.9609375
38944,/images/5939f341-a886-4f63-ae87-2219d000a1d4.png,429,1480,552,1593,123,113,red blood cell,13899,0.9186991869918699,1.0884955752212389
62046,/images/bdb5d571-27bc-4a42-ae45-aa5a9af40a81.png,186,1362,295,1466,109,104,red blood cell,11336,0.9541284403669725,1.0480769230769231
23035,/images/0d095f3a-9243-472b-90b4-0ce8309e778c.png,894,27,1004,150,110,123,red blood cell,13530,1.1181818181818182,0.8943089430894309
42609,/images/184b376b-03cb-4c2d-af51-fc1a62196293.png,884,562,1000,681,116,119,red blood cell,13804,1.0258620689655173,0.9747899159663865
70255,/images/a5c3b3f8-7ceb-4573-a400-a76b9479af46.png,165,248,291,368,126,120,red blood cell,15120,0.9523809523809523,1.05
2346,/images/fe851c88-692d-4199-87e0-d19d9c4eb591.png,1008,304,1095,405,87,101,red blood cell,8787,1.160919540229885,0.8613861386138614
47551,/images/adff132d-3af0-4cef-942c-58fc09729bee.png,156,1008,251,1110,95,102,red blood cell,9690,1.0736842105263158,0.9313725490196079
56572,/images/a824b499-3736-4581-bbdc-be1b3b4cf756.png,194,139,322,269,128,130,red blood cell,16640,1.015625,0.9846153846153847
79418,/images/dcb21739-3c36-459d-b3cc-1be5871d6fe7.png,32,400,120,490,88,90,red blood cell,7920,1.0227272727272727,0.9777777777777777
51212,/images/ad8731b7-0dae-4983-9dc6-dec31767d761.png,335,1095,433,1185,98,90,red blood cell,8820,0.9183673469387755,1.0888888888888888
62598,/images/f7a4334a-4332-4de8-b39b-22da907976f2.png,1023,877,1112,976,89,99,red blood cell,8811,1.1123595505617978,0.898989898989899
14352,/images/f5eb7c5e-bd77-4638-ba9f-58d42f87476b.png,952,773,1052,876,100,103,red blood cell,10300,1.03,0.970873786407767
62626,/images/f7a4334a-4332-4de8-b39b-22da907976f2.png,808,1020,921,1137,113,117,red blood cell,13221,1.0353982300884956,0.9658119658119658
14621,/images/c649e1cb-4029-4433-b231-d67d68f7391a.png,88,1078,212,1208,124,130,red blood cell,16120,1.0483870967741935,0.9538461538461539
74081,/images/fe436c09-b680-4f4c-8faf-aa10a55a335b.png,0,688,97,806,97,118,red blood cell,11446,1.2164948453608246,0.8220338983050848
20362,/images/11e517bf-943b-4928-929a-e9f72c097880.png,892,999,988,1109,96,110,red blood cell,10560,1.1458333333333333,0.8727272727272727
57774,/images/5c037ffc-f515-48b3-b231-c110fbd2b8ca.png,453,368,562,457,109,89,red blood cell,9701,0.8165137614678899,1.2247191011235956
19741,/images/68e69cfb-1a07-48d2-8abe-46b46fe264ed.png,5,706,100,798,95,92,red blood cell,8740,0.968421052631579,1.0326086956521738
34079,/images/de5d19b7-e670-4ac7-843b-7ce7bcebdf45.png,735,689,843,793,108,104,red blood cell,11232,0.9629629629629629,1.0384615384615385
30263,/images/cecbf663-0751-4e7f-b298-770c88afc2c1.png,59,1405,167,1516,108,111,red blood cell,11988,1.0277777777777777,0.972972972972973
60202,/images/214f1d15-a081-476e-992d-6c3a77f03d59.png,812,946,910,1039,98,93,red blood cell,9114,0.9489795918367347,1.053763440860215
70889,/images/bf002a25-6535-4621-be19-56d468be5413.png,546,1376,653,1462,107,86,red blood cell,9202,0.8037383177570093,1.244186046511628
44716,/images/ccb4b13d-ab20-4222-892f-5adf70249aaa.png,275,649,394,786,119,137,red blood cell,16303,1.1512605042016806,0.8686131386861314
77081,/images/a0e2ef53-d39b-40cf-b8b6-4b148ac339ec.png,186,304,310,420,124,116,red blood cell,14384,0.9354838709677419,1.0689655172413792
41879,/images/783ae4ad-6a35-4b3c-b19f-754974b67b2d.png,32,882,140,976,108,94,red blood cell,10152,0.8703703703703703,1.148936170212766
34900,/images/a4fbb9f2-9b75-4fdc-877d-2feaafac25b3.png,810,133,914,239,104,106,red blood cell,11024,1.0192307692307692,0.9811320754716981
4433,/images/21ea4841-8998-4c04-b345-bc99cd8ecee6.png,66,1352,178,1461,112,109,red blood cell,12208,0.9732142857142857,1.0275229357798166
70097,/images/c742ee2c-6814-46cd-af56-ae87bb9972f4.png,1066,1078,1162,1176,96,98,red blood cell,9408,1.0208333333333333,0.9795918367346939
27839,/images/db3f4098-02e4-45a3-a7af-5dda37ac1526.png,615,1077,727,1191,112,114,red blood cell,12768,1.0178571428571428,0.9824561403508771
45394,/images/e4eea7ea-8989-46a9-9c98-25a178146b28.png,479,1452,587,1556,108,104,red blood cell,11232,0.9629629629629629,1.0384615384615385
52636,/images/a6fe423a-5204-4378-bcfa-d6d298a3e9aa.png,722,792,846,930,124,138,red blood cell,17112,1.1129032258064515,0.8985507246376812
54401,/images/22a464ef-c3da-4d56-b37e-e22e95d945e7.png,839,29,922,129,83,100,red blood cell,8300,1.2048192771084338,0.83
62723,/images/9e1b0217-0926-4fd1-bb9e-a815c05deb59.png,587,1105,674,1198,87,93,red blood cell,8091,1.0689655172413792,0.9354838709677419
45037,/images/13bab3c3-3f79-44d9-a287-0ae6d71eff31.png,813,579,928,717,115,138,red blood cell,15870,1.2,0.8333333333333334
32675,/images/0154dd8e-72f8-4d78-a4dd-93e139577bd1.png,918,758,1034,870,116,112,red blood cell,12992,0.9655172413793104,1.0357142857142858
17054,/images/57e1879e-4294-45e7-9c1b-627e8cca0271.png,715,951,805,1063,90,112,red blood cell,10080,1.2444444444444445,0.8035714285714286
44218,/images/8b494b40-cab5-49d3-893d-c805000fbe88.png,910,809,1006,916,96,107,red blood cell,10272,1.1145833333333333,0.897196261682243
75172,/images/7fdc8be8-7579-4a5c-b369-8a07ee0a8b7d.png,587,1140,680,1222,93,82,red blood cell,7626,0.8817204301075269,1.1341463414634145
24764,/images/530761d4-1931-44cd-b220-d60db0e228f9.png,914,1065,1029,1180,115,115,red blood cell,13225,1.0,1.0
58583,/images/7fd2d254-b062-4f3d-8970-687e73c5a00a.png,931,558,1050,693,119,135,red blood cell,16065,1.134453781512605,0.8814814814814815
55026,/images/1f8f08ea-b5b3-4f68-94d4-3cc071b7dce8.png,144,445,246,541,102,96,red blood cell,9792,0.9411764705882353,1.0625
17415,/images/f329e01b-fbd3-4fb5-9738-a7ff4c8622b8.png,701,1232,811,1333,110,101,red blood cell,11110,0.9181818181818182,1.0891089108910892
24261,/images/bb3ae957-0f6d-4615-bfe5-24fbca50b459.png,671,943,788,1061,117,118,red blood cell,13806,1.0085470085470085,0.9915254237288136
75106,/images/073c10c9-5749-44b5-b08b-1be556a960f0.png,839,854,952,986,113,132,red blood cell,14916,1.168141592920354,0.8560606060606061
15639,/images/84d7545e-c3a8-4b1f-9a39-36aab78c8699.png,39,217,152,337,113,120,red blood cell,13560,1.0619469026548674,0.9416666666666667
32560,/images/3f26fbbc-deb1-494f-b71c-c7cb3d4819fb.png,748,1019,876,1153,128,134,red blood cell,17152,1.046875,0.9552238805970149
37827,/images/56a57a8d-c9b9-432a-a3b0-32a09355806c.png,13,940,115,1037,102,97,red blood cell,9894,0.9509803921568627,1.0515463917525774
17011,/images/57e1879e-4294-45e7-9c1b-627e8cca0271.png,526,1037,642,1158,116,121,red blood cell,14036,1.043103448275862,0.9586776859504132
66814,/images/9106a6bb-1352-411f-ac26-0d6fe48c16a8.png,582,624,706,739,124,115,red blood cell,14260,0.9274193548387096,1.0782608695652174
27471,/images/f5869ba8-6253-426b-93f3-82af59a86144.png,687,581,792,698,105,117,red blood cell,12285,1.1142857142857143,0.8974358974358975
4850,/images/c6ab535c-30e5-4b6b-8273-1ec8d78cdd13.png,569,950,688,1067,119,117,red blood cell,13923,0.9831932773109243,1.017094017094017
33499,/images/795d0331-da56-4d45-a58a-54803408ffd9.png,610,1012,719,1129,109,117,red blood cell,12753,1.073394495412844,0.9316239316239316
46200,/images/d8632217-ec33-4d0a-98e6-427824c58869.png,289,250,386,361,97,111,red blood cell,10767,1.1443298969072164,0.8738738738738738
4246,/images/ac3358f1-ef9a-4ccc-b66c-da5e47e352e0.png,699,1371,811,1488,112,117,red blood cell,13104,1.0446428571428572,0.9572649572649573
3859,/images/73dd09d3-2bff-4b5e-b996-9da0b8b54a8f.png,827,794,949,909,122,115,red blood cell,14030,0.9426229508196722,1.0608695652173914
10531,/images/46a2d369-4bea-4405-ac78-91bbe130b9a7.png,679,782,782,885,103,103,red blood cell,10609,1.0,1.0
962,/images/a8cb75ba-3f2f-40d8-8bc7-c79ebd1b9603.png,258,1055,372,1161,114,106,red blood cell,12084,0.9298245614035088,1.0754716981132075
71753,/images/093a831a-bf71-4333-bc06-942ae70cb164.png,803,576,907,678,104,102,red blood cell,10608,0.9807692307692307,1.0196078431372548
64052,/images/03cbfcf2-8da6-462c-b30d-16d63357371f.png,596,235,717,360,121,125,red blood cell,15125,1.0330578512396693,0.968
4529,/images/0f26699f-a776-4424-b092-27da9a1d12e2.png,866,362,962,466,96,104,red blood cell,9984,1.0833333333333333,0.9230769230769231
77236,/images/07a80340-f65e-4f58-9317-94bb6ebd5a28.png,397,1379,504,1504,107,125,red blood cell,13375,1.1682242990654206,0.856
58630,/images/a4d7a7e1-5ae1-486d-b6ee-c9af1476ccad.png,5,774,101,881,96,107,red blood cell,10272,1.1145833333333333,0.897196261682243
41559,/images/0fcd1ebe-ee4a-40a0-b787-29cee18bfa1b.png,554,1361,657,1463,103,102,red blood cell,10506,0.9902912621359223,1.0098039215686274
73100,/images/f39e2289-fedd-4d12-9e64-ffdafb89247e.png,725,133,822,241,97,108,red blood cell,10476,1.1134020618556701,0.8981481481481481
72668,/images/6ab870ba-b24b-49a9-9570-8eafe63aa74e.png,854,770,941,851,87,81,red blood cell,7047,0.9310344827586207,1.0740740740740742
20545,/images/cbde7f7e-2458-4dda-9db2-3d5ccf950ced.png,343,382,464,487,121,105,red blood cell,12705,0.8677685950413223,1.1523809523809523
71947,/images/61575482-91e1-4db9-83c7-687b7ddbbfc4.png,1053,464,1132,544,79,80,red blood cell,6320,1.0126582278481013,0.9875
47251,/images/58ced55c-bf0d-4204-b6b2-4f8992d92779.png,548,682,659,791,111,109,red blood cell,12099,0.9819819819819819,1.018348623853211
73933,/images/2ae3e6e6-7482-4ab8-ad73-b530b5c2ee3b.png,13,619,96,701,83,82,red blood cell,6806,0.9879518072289156,1.0121951219512195
12054,/images/b234b6ea-b54d-470c-8461-ba7f4a024796.png,691,573,797,691,106,118,red blood cell,12508,1.1132075471698113,0.8983050847457628
21357,/images/5077f87d-a19f-494c-b911-14ccb03bd230.png,163,1092,277,1201,114,109,red blood cell,12426,0.956140350877193,1.0458715596330275
30025,/images/deeaa5b3-3895-4aec-a2ce-ed6404862cdf.png,126,501,236,613,110,112,red blood cell,12320,1.018181818181818,0.9821428571428571
68407,/images/040112be-3c8d-49aa-93f1-522f94a592ff.png,359,780,466,884,107,104,red blood cell,11128,0.9719626168224299,1.0288461538461537
3515,/images/ad36bd67-594b-4f63-93e3-886af0bc618e.png,621,1330,733,1461,112,131,red blood cell,14672,1.1696428571428572,0.8549618320610687
9925,/images/b4261fa5-876d-48ea-b6da-ec7ca5b48fe2.png,88,1145,219,1259,131,114,red blood cell,14934,0.8702290076335878,1.1491228070175439
66050,/images/c8af0297-ce1f-40ea-bf44-9256dcdae4e9.png,743,1026,836,1123,93,97,red blood cell,9021,1.043010752688172,0.9587628865979382
69580,/images/4a49841f-216c-4815-8140-b8762c4f6603.png,215,694,313,790,98,96,red blood cell,9408,0.9795918367346939,1.0208333333333333
33145,/images/6231d81d-9e84-4a5a-8cb8-47c6a37a0176.png,580,446,665,548,85,102,red blood cell,8670,1.2,0.8333333333333334
302,/images/0dcca702-a4ef-4fb3-a940-9c0c140b21c7.png,1075,37,1181,124,106,87,red blood cell,9222,0.8207547169811321,1.2183908045977012
34451,/images/b4bde4e8-f48b-4ae2-be01-86d8c91d0af9.png,668,1295,778,1404,110,109,red blood cell,11990,0.990909090909091,1.0091743119266054
31166,/images/1976cd04-d24f-457c-b423-7e4cdb05de9e.png,314,417,445,554,131,137,red blood cell,17947,1.0458015267175573,0.9562043795620438
87,/images/10be6380-cbbb-4886-8b9e-ff56b1710576.png,374,1041,480,1131,106,90,red blood cell,9540,0.8490566037735849,1.1777777777777778
17225,/images/471f75c6-bd5d-4c20-bcc1-258e836f4d69.png,245,295,354,389,109,94,red blood cell,10246,0.8623853211009175,1.1595744680851063
9896,/images/b4261fa5-876d-48ea-b6da-ec7ca5b48fe2.png,834,270,945,382,111,112,red blood cell,12432,1.009009009009009,0.9910714285714286
56527,/images/ac8df764-c8d8-4312-916d-70bfb37574b4.png,145,1454,266,1571,121,117,red blood cell,14157,0.9669421487603306,1.0341880341880343
34744,/images/6294153c-6db3-4f2b-a8ff-9c087225e737.png,864,1276,981,1393,117,117,red blood cell,13689,1.0,1.0
53629,/images/7bcd3735-3134-46d1-8ca2-d4379f2d51c0.png,504,815,604,920,100,105,red blood cell,10500,1.05,0.9523809523809523
3026,/images/5a386082-397f-4524-a6f9-c2b8efe5014d.png,770,673,881,804,111,131,red blood cell,14541,1.1801801801801801,0.8473282442748091
62204,/images/a72cd558-b7ac-4bf2-a344-2ce6c73a354e.png,262,836,346,929,84,93,red blood cell,7812,1.1071428571428572,0.9032258064516129
26009,/images/612bdd3c-da43-4321-a76b-c73c614928d1.png,1097,507,1194,626,97,119,red blood cell,11543,1.2268041237113403,0.8151260504201681
13395,/images/a7f1bbb1-6058-4642-bd66-cfb90dce762e.png,1052,439,1164,551,112,112,red blood cell,12544,1.0,1.0
58066,/images/a7c91b63-b97c-4f4b-8d34-7ad2b08d7a17.png,345,1356,437,1451,92,95,red blood cell,8740,1.0326086956521738,0.968421052631579
61795,/images/985627c9-7b85-40de-a106-eb9cc47b47cb.png,97,1232,218,1335,121,103,red blood cell,12463,0.8512396694214877,1.174757281553398
8749,/images/29dc8176-dfe1-40e0-8247-2dc3c530057e.png,1078,798,1194,911,116,113,red blood cell,13108,0.9741379310344828,1.0265486725663717
2685,/images/a89cace5-c818-4f23-a432-052b3433b81e.png,622,523,746,643,124,120,red blood cell,14880,0.967741935483871,1.0333333333333334
34481,/images/fa1f9f89-cecb-4972-842c-d14c632f89a9.png,905,622,1026,748,121,126,red blood cell,15246,1.0413223140495869,0.9603174603174603
75359,/images/468c261d-f5d8-423f-883e-48af2bbbc5d1.png,175,687,284,812,109,125,red blood cell,13625,1.146788990825688,0.872
7616,/images/21cc498b-8cb2-42ed-8f80-bfa27b86ef11.png,745,753,874,900,129,147,red blood cell,18963,1.1395348837209303,0.8775510204081632
61686,/images/a3c0a876-be12-4ede-8aed-18b32a64401b.png,950,1368,1033,1450,83,82,red blood cell,6806,0.9879518072289156,1.0121951219512195
66463,/images/5f66d20c-fbfe-44ec-a01b-8a09da24807e.png,904,101,986,195,82,94,red blood cell,7708,1.146341463414634,0.8723404255319149
35969,/images/5836500a-221e-40ca-a8be-caaa37f7d300.png,130,793,235,895,105,102,red blood cell,10710,0.9714285714285714,1.0294117647058822
14622,/images/c649e1cb-4029-4433-b231-d67d68f7391a.png,710,1247,836,1380,126,133,red blood cell,16758,1.0555555555555556,0.9473684210526315
33029,/images/6231d81d-9e84-4a5a-8cb8-47c6a37a0176.png,361,1333,452,1432,91,99,red blood cell,9009,1.0879120879120878,0.9191919191919192
77274,/images/07a80340-f65e-4f58-9317-94bb6ebd5a28.png,938,669,1036,766,98,97,red blood cell,9506,0.9897959183673469,1.0103092783505154
52745,/images/9dc6ed5d-6698-48cf-aab3-fd156673729c.png,661,341,772,449,111,108,red blood cell,11988,0.972972972972973,1.0277777777777777
37046,/images/b2e34f5f-904e-4473-9dc7-c6bc1ce12640.png,1088,1170,1191,1271,103,101,red blood cell,10403,0.9805825242718447,1.0198019801980198
10005,/images/b9ccf7ca-953f-4832-9575-5e70b2a8c224.png,462,1057,556,1166,94,109,red blood cell,10246,1.1595744680851063,0.8623853211009175
62997,/images/f234a2de-f3c8-4521-a306-8cfdf52dd597.png,574,832,659,913,85,81,red blood cell,6885,0.9529411764705882,1.0493827160493827
10163,/images/09ecf7be-28e2-4531-b9e2-07e01c44097d.png,778,1467,886,1559,108,92,red blood cell,9936,0.8518518518518519,1.173913043478261
57779,/images/5c037ffc-f515-48b3-b231-c110fbd2b8ca.png,866,828,965,944,99,116,red blood cell,11484,1.1717171717171717,0.853448275862069
66376,/images/e5fd5949-4cd0-4cb6-837a-02c26a5eb87a.png,199,594,312,710,113,116,red blood cell,13108,1.0265486725663717,0.9741379310344828
69046,/images/b5246b58-6f40-4c9e-8024-f49b0ed6bdbd.png,198,758,290,851,92,93,red blood cell,8556,1.0108695652173914,0.989247311827957
79823,/images/fc15659f-6264-4dd5-ab17-43d89fb297b9.png,357,548,472,660,115,112,red blood cell,12880,0.9739130434782609,1.0267857142857142
44239,/images/4257342d-6d77-4671-a84b-1f0c36ccb367.png,1046,1002,1158,1112,112,110,red blood cell,12320,0.9821428571428571,1.018181818181818
65914,/images/d7581cb0-7a12-471d-a3d8-68dcea362213.png,352,793,455,898,103,105,red blood cell,10815,1.0194174757281553,0.9809523809523809
70130,/images/c742ee2c-6814-46cd-af56-ae87bb9972f4.png,891,589,984,676,93,87,red blood cell,8091,0.9354838709677419,1.0689655172413792
42314,/images/5c5b7965-1a44-44b8-aa43-660823e61821.png,513,253,625,373,112,120,red blood cell,13440,1.0714285714285714,0.9333333333333333
68072,/images/29d40b60-cde1-45b5-b403-692437a77ac1.png,660,336,786,461,126,125,red blood cell,15750,0.9920634920634921,1.008
61872,/images/f32b21ae-5ca7-490b-bc40-6db9396d933c.png,217,1265,318,1373,101,108,red blood cell,10908,1.0693069306930694,0.9351851851851852
54864,/images/b6364a57-72a9-43f3-8d02-9f53a992dc95.png,1116,998,1194,1088,78,90,red blood cell,7020,1.1538461538461537,0.8666666666666667
48187,/images/913099c5-8085-4908-bf4b-1f098bbfcf66.png,180,1299,297,1418,117,119,red blood cell,13923,1.017094017094017,0.9831932773109243
33000,/images/6231d81d-9e84-4a5a-8cb8-47c6a37a0176.png,1037,773,1154,875,117,102,red blood cell,11934,0.8717948717948718,1.1470588235294117
51609,/images/d0347b49-8f98-4632-a384-1a4f57ac6374.png,921,741,1039,846,118,105,red blood cell,12390,0.8898305084745762,1.1238095238095238
58649,/images/a4d7a7e1-5ae1-486d-b6ee-c9af1476ccad.png,845,467,933,555,88,88,red blood cell,7744,1.0,1.0
6690,/images/95fea6d8-413f-421e-b331-5d51c31df150.png,323,433,428,533,105,100,red blood cell,10500,0.9523809523809523,1.05
56357,/images/4372709c-f356-4906-be17-415384d916e8.png,480,540,591,649,111,109,red blood cell,12099,0.9819819819819819,1.018348623853211
56966,/images/a93c35ba-1690-4358-8837-669bcd850bb7.png,9,447,114,533,105,86,red blood cell,9030,0.819047619047619,1.2209302325581395
75213,/images/61dfc937-a428-44b4-94fb-d682bdb8dff0.png,843,1307,953,1414,110,107,red blood cell,11770,0.9727272727272728,1.02803738317757
67391,/images/266180ed-77a3-4284-8292-50a49fc47fce.png,193,202,318,307,125,105,red blood cell,13125,0.84,1.1904761904761905
72742,/images/caeb2d62-1166-43f0-8eac-5b8fc48f02eb.png,578,1470,709,1578,131,108,red blood cell,14148,0.8244274809160306,1.212962962962963
27815,/images/e3c1442a-717f-41dd-bf97-81e1233ac9fa.png,496,289,593,404,97,115,red blood cell,11155,1.1855670103092784,0.8434782608695652
36982,/images/b2e34f5f-904e-4473-9dc7-c6bc1ce12640.png,293,363,377,462,84,99,red blood cell,8316,1.1785714285714286,0.8484848484848485
6508,/images/640c4a52-3742-4f57-aee3-9e3dc0887622.png,367,724,462,834,95,110,red blood cell,10450,1.1578947368421053,0.8636363636363636
18025,/images/0f0c949e-018a-4f3f-ab02-3704f49c7754.png,435,1406,543,1508,108,102,red blood cell,11016,0.9444444444444444,1.0588235294117647
71943,/images/61575482-91e1-4db9-83c7-687b7ddbbfc4.png,496,600,593,690,97,90,red blood cell,8730,0.9278350515463918,1.0777777777777777
66595,/images/087f2c9c-188d-43cc-a94c-0eb8f10ac092.png,848,331,949,435,101,104,red blood cell,10504,1.0297029702970297,0.9711538461538461
70880,/images/bf002a25-6535-4621-be19-56d468be5413.png,994,352,1091,462,97,110,red blood cell,10670,1.134020618556701,0.8818181818181818
22669,/images/4ab47131-c2ac-461f-b95c-ac19ce24edbd.png,738,954,862,1070,124,116,red blood cell,14384,0.9354838709677419,1.0689655172413792
31902,/images/f62d4fb6-df7c-446c-94a8-d5aede0b1e0c.png,8,124,122,244,114,120,red blood cell,13680,1.0526315789473684,0.95
38068,/images/e3e9c2de-0a24-4c7e-8a69-3d3093d5bdab.png,397,230,500,327,103,97,red blood cell,9991,0.941747572815534,1.0618556701030928
64059,/images/03cbfcf2-8da6-462c-b30d-16d63357371f.png,157,938,247,1034,90,96,red blood cell,8640,1.0666666666666667,0.9375
63796,/images/6013bff0-dc4b-4bde-9409-0f6139c3495c.png,711,1059,827,1179,116,120,red blood cell,13920,1.0344827586206897,0.9666666666666667
26415,/images/d532e31c-10ce-4313-9a36-bd5e01230254.png,537,1367,654,1485,117,118,red blood cell,13806,1.0085470085470085,0.9915254237288136
9349,/images/261562a8-ffd8-4e0e-919b-22e267000b74.png,348,1321,464,1428,116,107,red blood cell,12412,0.9224137931034483,1.0841121495327102
30557,/images/7d9c1422-6332-44e9-b134-3ac94f07b0f0.png,750,1190,857,1301,107,111,red blood cell,11877,1.0373831775700935,0.963963963963964
56564,/images/ac8df764-c8d8-4312-916d-70bfb37574b4.png,2,321,114,430,112,109,red blood cell,12208,0.9732142857142857,1.0275229357798166
26675,/images/c1423156-82b3-4dd3-8e74-08eb7ed8e1d6.png,675,1400,801,1525,126,125,red blood cell,15750,0.9920634920634921,1.008
67882,/images/41ebf9a1-24dc-454e-8bf8-508218f5ee57.png,323,1206,414,1314,91,108,red blood cell,9828,1.1868131868131868,0.8425925925925926
9523,/images/a18f122f-3a3e-4478-8ac4-91b83e050e65.png,129,541,259,658,130,117,red blood cell,15210,0.9,1.1111111111111112
35195,/images/a9159b11-ba49-4885-902e-00c8d5095b98.png,137,47,231,145,94,98,red blood cell,9212,1.0425531914893618,0.9591836734693877
11342,/images/2f6224be-50d0-4e85-94ef-88315df561b6.png,703,1201,816,1311,113,110,red blood cell,12430,0.9734513274336283,1.0272727272727273
79959,/images/e640ae51-cbf1-4a84-b7cf-d38b17f59c2f.png,227,147,344,259,117,112,red blood cell,13104,0.9572649572649573,1.0446428571428572
79909,/images/0b923ab7-ebff-4079-a4bb-af7da89f374e.png,1003,625,1113,728,110,103,red blood cell,11330,0.9363636363636364,1.0679611650485437
27653,/images/18dbe7c4-89d2-42a6-a969-1e951ab313b1.png,773,40,865,131,92,91,red blood cell,8372,0.9891304347826086,1.010989010989011
35473,/images/3722d213-f2a9-46d5-aa76-9183b443e455.png,346,574,464,698,118,124,red blood cell,14632,1.0508474576271187,0.9516129032258065
65591,/images/01b38a56-13eb-447b-89ee-fc21cb40dcc1.png,100,661,205,771,105,110,red blood cell,11550,1.0476190476190477,0.9545454545454546
35297,/images/516bf1d5-5d00-4985-926c-3993e9bc3ff5.png,72,1252,183,1368,111,116,red blood cell,12876,1.045045045045045,0.9568965517241379
45992,/images/72088c26-d2dd-4906-b791-b8947fc7fbe4.png,869,300,971,393,102,93,red blood cell,9486,0.9117647058823529,1.096774193548387
18807,/images/cc882eae-a341-4783-bd19-8bdedf798538.png,965,780,1064,869,99,89,red blood cell,8811,0.898989898989899,1.1123595505617978
58281,/images/319c9c52-f316-49f3-baad-4444ab19f85b.png,1001,828,1120,939,119,111,red blood cell,13209,0.9327731092436975,1.072072072072072
59026,/images/597bbff8-6592-41cf-8946-e59b0d1f289a.png,978,560,1090,664,112,104,red blood cell,11648,0.9285714285714286,1.0769230769230769
11526,/images/834a30bb-26bf-4e60-9ea1-3250b926892e.png,658,79,771,188,113,109,red blood cell,12317,0.9646017699115044,1.036697247706422
50272,/images/3d32a988-449d-4d58-b71f-abbfdc3f2fbc.png,390,531,494,630,104,99,red blood cell,10296,0.9519230769230769,1.0505050505050506
68762,/images/eb5f4f2f-2275-4a80-84a5-78a1eaf4ce4d.png,172,772,287,898,115,126,red blood cell,14490,1.0956521739130434,0.9126984126984127
3554,/images/25132962-ff5d-4737-995f-c54d8490539b.png,742,512,848,627,106,115,red blood cell,12190,1.0849056603773586,0.9217391304347826
17453,/images/56077789-8580-41b4-89d6-deea227e5c60.png,289,587,404,706,115,119,red blood cell,13685,1.0347826086956522,0.9663865546218487
27239,/images/9f38055f-4fe6-47fd-a6dd-c0743db4eccf.png,267,825,375,948,108,123,red blood cell,13284,1.1388888888888888,0.8780487804878049
67492,/images/75660b56-51c2-45a9-9c15-e18d12a3af8c.png,333,1395,451,1496,118,101,red blood cell,11918,0.8559322033898306,1.1683168316831682
61240,/images/b3058064-d817-47dd-a8c4-cdb1f62374f8.png,1044,836,1133,931,89,95,red blood cell,8455,1.0674157303370786,0.9368421052631579
63225,/images/d3283f5b-3b3a-40ea-800b-79960ca851cb.png,126,53,244,161,118,108,red blood cell,12744,0.9152542372881356,1.0925925925925926
13437,/images/370277f8-436b-4103-8210-b4feb5ab95ea.png,1063,798,1144,895,81,97,red blood cell,7857,1.1975308641975309,0.8350515463917526
78685,/images/76a8a5f5-1328-4539-a131-baf877f40cf3.png,208,1409,323,1526,115,117,red blood cell,13455,1.017391304347826,0.9829059829059829
2704,/images/a89cace5-c818-4f23-a432-052b3433b81e.png,996,1234,1080,1327,84,93,red blood cell,7812,1.1071428571428572,0.9032258064516129
43629,/images/a4851ed0-1499-4eae-9157-dcd34773254f.png,243,820,356,928,113,108,red blood cell,12204,0.9557522123893806,1.0462962962962963
45538,/images/e597f7ce-46c6-4dce-9063-50a2703fdd45.png,504,689,600,789,96,100,red blood cell,9600,1.0416666666666667,0.96
19230,/images/b4d22412-a495-43a9-bec0-73a2322f8dad.png,646,796,746,900,100,104,red blood cell,10400,1.04,0.9615384615384616
9305,/images/261562a8-ffd8-4e0e-919b-22e267000b74.png,242,334,347,436,105,102,red blood cell,10710,0.9714285714285714,1.0294117647058822
40638,/images/252071ac-e9f2-41d2-abbb-87ef01b8a997.png,149,999,242,1111,93,112,red blood cell,10416,1.2043010752688172,0.8303571428571429
36846,/images/3de03fa2-3ad3-43fc-8435-b2a80bdd7550.png,683,622,800,742,117,120,red blood cell,14040,1.0256410256410255,0.975
66357,/images/fcdf6632-c03f-49a8-9fb3-42e87c99b9d0.png,479,759,583,859,104,100,red blood cell,10400,0.9615384615384616,1.04
52256,/images/4903d9c7-de88-426a-b42d-a7e797e5ebcd.png,629,1343,727,1437,98,94,red blood cell,9212,0.9591836734693877,1.0425531914893618
49160,/images/df3d98b9-3dd7-4107-8d4a-ae1b7f247793.png,537,544,622,631,85,87,red blood cell,7395,1.0235294117647058,0.9770114942528736
36947,/images/b2e34f5f-904e-4473-9dc7-c6bc1ce12640.png,19,436,135,540,116,104,red blood cell,12064,0.896551724137931,1.1153846153846154
16473,/images/9e5437c6-b0d3-473b-b7c3-8f5afeb90c7a.png,30,735,144,864,114,129,red blood cell,14706,1.131578947368421,0.8837209302325582
75878,/images/3006096f-ceeb-42be-b69e-785179d7438b.png,115,1233,214,1344,99,111,red blood cell,10989,1.121212121212121,0.8918918918918919
9949,/images/b9ccf7ca-953f-4832-9575-5e70b2a8c224.png,70,379,184,505,114,126,red blood cell,14364,1.105263157894737,0.9047619047619048
20760,/images/eeac81a5-9202-4965-b7de-35b12910cdf6.png,939,1094,1053,1206,114,112,red blood cell,12768,0.9824561403508771,1.0178571428571428
23973,/images/3d8fb5bf-3315-48fb-8ab1-802eafd550bc.png,131,1155,253,1266,122,111,red blood cell,13542,0.9098360655737705,1.0990990990990992
12499,/images/8e4bdd0d-1c72-4836-ae3e-05e2e50e4983.png,319,996,448,1111,129,115,red blood cell,14835,0.8914728682170543,1.1217391304347826
51544,/images/6afb3717-f197-4668-929a-4fab389ae6e8.png,821,703,919,807,98,104,red blood cell,10192,1.0612244897959184,0.9423076923076923
47189,/images/3d1b889e-bb4a-4ee6-b899-974ee7d956a7.png,33,715,151,829,118,114,red blood cell,13452,0.9661016949152542,1.0350877192982457
32661,/images/0154dd8e-72f8-4d78-a4dd-93e139577bd1.png,231,970,355,1085,124,115,red blood cell,14260,0.9274193548387096,1.0782608695652174
68631,/images/31653d0f-c4e6-4e12-8005-518c2de34687.png,544,824,630,918,86,94,red blood cell,8084,1.0930232558139534,0.9148936170212766
60370,/images/1c87b997-a8e6-48ca-bf40-19b9a7fd6a96.png,678,192,777,277,99,85,red blood cell,8415,0.8585858585858586,1.1647058823529413
26416,/images/d532e31c-10ce-4313-9a36-bd5e01230254.png,1052,953,1160,1066,108,113,red blood cell,12204,1.0462962962962963,0.9557522123893806
6683,/images/95fea6d8-413f-421e-b331-5d51c31df150.png,493,767,602,868,109,101,red blood cell,11009,0.926605504587156,1.0792079207920793
67080,/images/4272cbd7-5b0a-4bf7-b690-dee1c128f07b.png,1045,1348,1172,1470,127,122,red blood cell,15494,0.9606299212598425,1.040983606557377
75409,/images/468c261d-f5d8-423f-883e-48af2bbbc5d1.png,626,283,738,393,112,110,red blood cell,12320,0.9821428571428571,1.018181818181818
17748,/images/b5143aae-6e98-4dc6-b546-980cb472de67.png,192,564,274,665,82,101,red blood cell,8282,1.2317073170731707,0.8118811881188119
67716,/images/2b128a1a-95ed-408b-b9f8-8795cc814d80.png,143,135,234,245,91,110,red blood cell,10010,1.2087912087912087,0.8272727272727273
39816,/images/5c68070c-3391-4db6-8c01-94175105dbea.png,166,59,280,168,114,109,red blood cell,12426,0.956140350877193,1.0458715596330275
37429,/images/08f5a524-0554-49c2-83a8-ae9a6d51e8fd.png,1095,372,1183,462,88,90,red blood cell,7920,1.0227272727272727,0.9777777777777777
50099,/images/e98baeb2-aa58-4cce-8c61-66685dd2b239.png,662,1271,794,1396,132,125,red blood cell,16500,0.946969696969697,1.056
28313,/images/34e024a5-5698-42d4-972f-fee234b4bd64.png,896,595,1004,709,108,114,red blood cell,12312,1.0555555555555556,0.9473684210526315
5252,/images/729733ff-a349-4a96-b636-ccabe7d7e167.png,528,333,637,452,109,119,red blood cell,12971,1.091743119266055,0.9159663865546218
6989,/images/c776eb78-3323-4571-b39f-7ffc73ae63ce.png,727,1445,832,1546,105,101,red blood cell,10605,0.9619047619047619,1.0396039603960396
5659,/images/d3dcdf92-9328-4796-adf4-918646877ba1.png,383,559,481,650,98,91,red blood cell,8918,0.9285714285714286,1.0769230769230769
20445,/images/781d4bea-c6a9-4b36-ae10-ba9e328c87fe.png,9,680,134,820,125,140,red blood cell,17500,1.12,0.8928571428571429
38523,/images/c3ae7090-fc68-41b4-85a1-8d9bce9825a7.png,1059,149,1175,284,116,135,red blood cell,15660,1.1637931034482758,0.8592592592592593
33132,/images/6231d81d-9e84-4a5a-8cb8-47c6a37a0176.png,356,1276,446,1362,90,86,red blood cell,7740,0.9555555555555556,1.0465116279069768
38101,/images/907650b5-edae-471d-bc54-a825be3d3fac.png,775,798,904,936,129,138,red blood cell,17802,1.069767441860465,0.9347826086956522
12738,/images/b634137b-bc8b-4e88-b0e3-b536ad6e7e18.png,996,1086,1116,1194,120,108,red blood cell,12960,0.9,1.1111111111111112
62340,/images/e0ff3476-226f-4125-b182-8e524d5503dd.png,373,609,476,710,103,101,red blood cell,10403,0.9805825242718447,1.0198019801980198
35685,/images/4063945d-03fc-4ce3-a04c-17435dce8f91.png,1065,763,1175,877,110,114,red blood cell,12540,1.0363636363636364,0.9649122807017544
26216,/images/7ba9db7e-9d3f-413c-b672-2bba5fb5b415.png,539,29,655,143,116,114,red blood cell,13224,0.9827586206896551,1.0175438596491229
44274,/images/4257342d-6d77-4671-a84b-1f0c36ccb367.png,67,57,178,190,111,133,red blood cell,14763,1.1981981981981982,0.8345864661654135
60889,/images/11b72c7b-5c52-44b7-adb7-21eacc25e441.png,838,1221,920,1303,82,82,red blood cell,6724,1.0,1.0
20188,/images/bb337c84-f727-42a5-9c3d-934323a16c6a.png,675,913,795,1041,120,128,red blood cell,15360,1.0666666666666667,0.9375
28395,/images/a6d85204-24b8-4b23-a8b1-c3e8b93f9f22.png,480,1415,598,1530,118,115,red blood cell,13570,0.9745762711864406,1.0260869565217392
41661,/images/0fcd1ebe-ee4a-40a0-b787-29cee18bfa1b.png,462,939,571,1031,109,92,red blood cell,10028,0.8440366972477065,1.184782608695652
64503,/images/6ba5d0b8-cdc7-4266-9d78-db76faa312e9.png,871,1004,964,1096,93,92,red blood cell,8556,0.989247311827957,1.0108695652173914
46188,/images/d8632217-ec33-4d0a-98e6-427824c58869.png,850,1459,956,1562,106,103,red blood cell,10918,0.9716981132075472,1.029126213592233
59260,/images/03c8da48-04b9-4520-b674-44a0ecd35688.png,716,692,818,797,102,105,red blood cell,10710,1.0294117647058822,0.9714285714285714
75652,/images/50d7c6c9-3230-48fe-947c-7dcfd0aad710.png,965,1001,1055,1100,90,99,red blood cell,8910,1.1,0.9090909090909091
51432,/images/b4f3b2a4-f4b9-48de-ac5d-0e681b77be27.png,489,708,585,811,96,103,red blood cell,9888,1.0729166666666667,0.9320388349514563
8675,/images/ea6b012a-3425-4bfc-a61d-88563aa2a264.png,283,1342,379,1454,96,112,red blood cell,10752,1.1666666666666667,0.8571428571428571
63730,/images/06401963-8b02-46c5-ab2a-3d70bd01623f.png,263,632,353,716,90,84,red blood cell,7560,0.9333333333333333,1.0714285714285714
23324,/images/e5731221-814c-4894-a44e-e46b71460fa4.png,858,612,967,739,109,127,red blood cell,13843,1.165137614678899,0.8582677165354331
35849,/images/027ab174-e47a-44f8-b85b-372449eeb7d8.png,662,511,783,624,121,113,red blood cell,13673,0.9338842975206612,1.0707964601769913
31094,/images/9c48fdf4-621d-4f40-bcd7-6a28cd530de7.png,293,738,374,811,81,73,red blood cell,5913,0.9012345679012346,1.1095890410958904
73672,/images/a51d6c18-f9e8-4714-9dbb-38e1577445f2.png,236,781,316,871,80,90,red blood cell,7200,1.125,0.8888888888888888
66865,/images/9acf303a-fcba-4e52-be3e-8d061aa5e72a.png,1002,557,1104,651,102,94,red blood cell,9588,0.9215686274509803,1.0851063829787233
47213,/images/58ced55c-bf0d-4204-b6b2-4f8992d92779.png,648,344,766,456,118,112,red blood cell,13216,0.9491525423728814,1.0535714285714286
3096,/images/14efbfc8-39f6-4599-9994-a8cc95605b9c.png,964,864,1099,994,135,130,red blood cell,17550,0.9629629629629629,1.0384615384615385
4459,/images/cf90d82f-2814-4fb7-a3ff-a86b7c5efca7.png,356,1412,483,1544,127,132,red blood cell,16764,1.0393700787401574,0.9621212121212122
19519,/images/a85cd1ae-0c94-4387-8305-84ab8d96d137.png,737,290,845,394,108,104,red blood cell,11232,0.9629629629629629,1.0384615384615385
18050,/images/0f0c949e-018a-4f3f-ab02-3704f49c7754.png,581,512,682,621,101,109,red blood cell,11009,1.0792079207920793,0.926605504587156
13979,/images/31af9c31-7868-44a6-8eb4-82ce118af425.png,797,1153,926,1269,129,116,red blood cell,14964,0.8992248062015504,1.1120689655172413
44450,/images/edd3862f-04e1-49cf-97dd-ca566d17e71a.png,920,614,1042,749,122,135,red blood cell,16470,1.1065573770491803,0.9037037037037037
3590,/images/25132962-ff5d-4737-995f-c54d8490539b.png,992,808,1089,913,97,105,red blood cell,10185,1.0824742268041236,0.9238095238095239
40397,/images/db249e5a-4142-432c-8288-bacd10d7273d.png,889,647,986,768,97,121,red blood cell,11737,1.2474226804123711,0.8016528925619835
58639,/images/a4d7a7e1-5ae1-486d-b6ee-c9af1476ccad.png,82,1,180,108,98,107,red blood cell,10486,1.0918367346938775,0.9158878504672897
30262,/images/cecbf663-0751-4e7f-b298-770c88afc2c1.png,36,196,130,295,94,99,red blood cell,9306,1.053191489361702,0.9494949494949495
74828,/images/81edcae1-65bf-4752-b0e4-494376b71e49.png,962,811,1059,919,97,108,red blood cell,10476,1.1134020618556701,0.8981481481481481
25506,/images/f6ab936d-924b-4038-aa47-71b07c26b4e2.png,1000,1312,1111,1429,111,117,red blood cell,12987,1.054054054054054,0.9487179487179487
8079,/images/694222bb-cddf-469a-9526-f873c6fba58e.png,236,878,323,977,87,99,red blood cell,8613,1.1379310344827587,0.8787878787878788
9867,/images/3859deaf-6ae1-49a3-9051-898d0f0d7de6.png,1070,1019,1161,1118,91,99,red blood cell,9009,1.0879120879120878,0.9191919191919192
29039,/images/4c13e22e-dfd1-4fa1-b373-be9d0c272c0f.png,334,983,432,1077,98,94,red blood cell,9212,0.9591836734693877,1.0425531914893618
68544,/images/32700bc7-7a86-49d3-aded-ccaaed4ddc5c.png,857,381,975,499,118,118,red blood cell,13924,1.0,1.0
32,/images/8d02117d-6c71-4e47-b50a-6cc8d5eb1d55.png,1025,1139,1136,1272,111,133,red blood cell,14763,1.1981981981981982,0.8345864661654135
79417,/images/dcb21739-3c36-459d-b3cc-1be5871d6fe7.png,52,99,151,197,99,98,red blood cell,9702,0.98989898989899,1.010204081632653
28715,/images/151f3af5-5e6e-4bcd-9389-4974fc68813e.png,884,1466,984,1553,100,87,red blood cell,8700,0.87,1.1494252873563218
20517,/images/cbde7f7e-2458-4dda-9db2-3d5ccf950ced.png,44,871,162,984,118,113,red blood cell,13334,0.9576271186440678,1.0442477876106195
42710,/images/3abbc4d3-1d7e-40c9-9963-33732da7cc50.png,969,1477,1068,1582,99,105,red blood cell,10395,1.0606060606060606,0.9428571428571428
68619,/images/31653d0f-c4e6-4e12-8005-518c2de34687.png,572,1213,675,1312,103,99,red blood cell,10197,0.9611650485436893,1.0404040404040404
54341,/images/19370afd-f897-47d8-bfae-c0d257bbf795.png,985,1089,1112,1205,127,116,red blood cell,14732,0.9133858267716536,1.0948275862068966
35988,/images/5836500a-221e-40ca-a8be-caaa37f7d300.png,676,1473,782,1587,106,114,red blood cell,12084,1.0754716981132075,0.9298245614035088
10255,/images/e3ea07d7-884a-412e-874a-40fd6b856736.png,273,1168,376,1281,103,113,red blood cell,11639,1.0970873786407767,0.911504424778761
43241,/images/fe1ee954-ba71-47b3-954a-d20ab940cd7b.png,1081,1002,1198,1127,117,125,red blood cell,14625,1.0683760683760684,0.936
30746,/images/8e0dfc1f-e3eb-4a3f-a1c4-249bdfbfaa27.png,142,163,251,299,109,136,red blood cell,14824,1.2477064220183487,0.8014705882352942
40769,/images/252071ac-e9f2-41d2-abbb-87ef01b8a997.png,1012,169,1104,263,92,94,red blood cell,8648,1.0217391304347827,0.9787234042553191
75876,/images/3006096f-ceeb-42be-b69e-785179d7438b.png,93,885,202,985,109,100,red blood cell,10900,0.9174311926605505,1.09
29330,/images/3850f2a5-ab62-49d3-8135-68d60baa676b.png,1004,637,1129,742,125,105,red blood cell,13125,0.84,1.1904761904761905
47345,/images/477e541c-0519-4542-9b13-8ee7922644d3.png,965,958,1073,1057,108,99,red blood cell,10692,0.9166666666666666,1.0909090909090908
34726,/images/6294153c-6db3-4f2b-a8ff-9c087225e737.png,428,421,548,536,120,115,red blood cell,13800,0.9583333333333334,1.0434782608695652
59326,/images/03c8da48-04b9-4520-b674-44a0ecd35688.png,571,437,662,544,91,107,red blood cell,9737,1.1758241758241759,0.8504672897196262
6731,/images/672e4ecf-a56b-462e-b83b-76f4efaa6634.png,440,656,546,773,106,117,red blood cell,12402,1.1037735849056605,0.905982905982906
64471,/images/34a70114-d3e3-4351-b8db-f6caab17e743.png,181,1073,275,1158,94,85,red blood cell,7990,0.9042553191489362,1.1058823529411765
29144,/images/cfab01d3-0616-4efb-9290-11f0fd8bf5a3.png,1042,1458,1152,1563,110,105,red blood cell,11550,0.9545454545454546,1.0476190476190477
7503,/images/071901eb-4c3f-404b-a747-3d0b9d0a5158.png,631,106,757,229,126,123,red blood cell,15498,0.9761904761904762,1.024390243902439
51951,/images/4f62b14e-c6f4-4155-8f50-881558f83fae.png,785,622,888,714,103,92,red blood cell,9476,0.8932038834951457,1.1195652173913044
29418,/images/b4e5e08d-6427-46f3-aca8-a4df165a151d.png,925,1469,1011,1571,86,102,red blood cell,8772,1.186046511627907,0.8431372549019608
18139,/images/947348fe-4c70-468e-8009-3c14daeca69b.png,46,474,142,564,96,90,red blood cell,8640,0.9375,1.0666666666666667
27979,/images/c4d34e35-4db2-41de-ba77-1a94aa9ef788.png,663,1438,798,1553,135,115,red blood cell,15525,0.8518518518518519,1.173913043478261
5514,/images/eb6e8684-b84e-483d-b835-f59286d2516b.png,849,576,960,694,111,118,red blood cell,13098,1.063063063063063,0.940677966101695
11962,/images/f8a8b148-60e4-4a5c-ae19-941b19ec0846.png,18,39,135,134,117,95,red blood cell,11115,0.811965811965812,1.231578947368421
24218,/images/194aec70-41a5-4ac3-b22f-0b6eda91f730.png,366,547,465,661,99,114,red blood cell,11286,1.1515151515151516,0.868421052631579
31270,/images/db7c5ec1-fefe-4e9d-83c1-da8fb982f1e2.png,879,15,1004,116,125,101,red blood cell,12625,0.808,1.2376237623762376
30156,/images/a1669b59-fe09-4fe6-ba9f-06bec6725502.png,317,392,431,502,114,110,red blood cell,12540,0.9649122807017544,1.0363636363636364
53836,/images/f24c8fe0-a534-44cf-9995-b2b314d945ba.png,600,571,710,687,110,116,red blood cell,12760,1.0545454545454545,0.9482758620689655
67383,/images/266180ed-77a3-4284-8292-50a49fc47fce.png,799,148,905,251,106,103,red blood cell,10918,0.9716981132075472,1.029126213592233
1097,/images/edcb4d77-a4d3-465d-9b59-eb3087766b1c.png,592,932,698,1034,106,102,red blood cell,10812,0.9622641509433962,1.0392156862745099
37551,/images/205306da-0ed8-475a-ace6-f2f81d4be88a.png,285,827,386,924,101,97,red blood cell,9797,0.9603960396039604,1.041237113402062
6992,/images/c776eb78-3323-4571-b39f-7ffc73ae63ce.png,824,683,939,792,115,109,red blood cell,12535,0.9478260869565217,1.055045871559633
37959,/images/56a57a8d-c9b9-432a-a3b0-32a09355806c.png,908,133,1015,226,107,93,red blood cell,9951,0.8691588785046729,1.1505376344086022
51813,/images/f07174a5-f799-4286-ac43-5b0f5c5777ac.png,794,1483,877,1578,83,95,red blood cell,7885,1.144578313253012,0.8736842105263158
60351,/images/1c87b997-a8e6-48ca-bf40-19b9a7fd6a96.png,135,422,263,525,128,103,red blood cell,13184,0.8046875,1.2427184466019416
70600,/images/4ce5a070-9ede-4bb1-9ca2-1bae5746776b.png,400,891,515,1014,115,123,red blood cell,14145,1.0695652173913044,0.9349593495934959
38557,/images/c3ae7090-fc68-41b4-85a1-8d9bce9825a7.png,1004,767,1100,884,96,117,red blood cell,11232,1.21875,0.8205128205128205
45786,/images/584d62ed-4329-45dd-94ce-e929d8b2bb74.png,36,1243,139,1355,103,112,red blood cell,11536,1.087378640776699,0.9196428571428571
56930,/images/a93c35ba-1690-4358-8837-669bcd850bb7.png,202,133,304,223,102,90,red blood cell,9180,0.8823529411764706,1.1333333333333333
12503,/images/8e4bdd0d-1c72-4836-ae3e-05e2e50e4983.png,836,422,941,521,105,99,red blood cell,10395,0.9428571428571428,1.0606060606060606
78717,/images/76a8a5f5-1328-4539-a131-baf877f40cf3.png,101,962,198,1069,97,107,red blood cell,10379,1.1030927835051547,0.9065420560747663
63924,/images/5e974892-0ebe-4037-8427-ea8616d6d3b8.png,564,2,678,103,114,101,red blood cell,11514,0.8859649122807017,1.1287128712871286
66960,/images/9acf303a-fcba-4e52-be3e-8d061aa5e72a.png,1084,847,1174,951,90,104,red blood cell,9360,1.1555555555555554,0.8653846153846154
47979,/images/eba73bff-fbe1-436d-9a5f-0a61331a0ea2.png,973,856,1093,970,120,114,red blood cell,13680,0.95,1.0526315789473684
32300,/images/1c406ce1-023b-47fc-a2cd-5ea2e255de65.png,712,354,836,477,124,123,red blood cell,15252,0.9919354838709677,1.008130081300813
67523,/images/45902b63-be9a-49ae-9ede-3a8015671bc4.png,70,33,176,138,106,105,red blood cell,11130,0.9905660377358491,1.0095238095238095
5820,/images/143f5959-5b6d-4f95-bcee-9e110450fc22.png,334,1043,450,1160,116,117,red blood cell,13572,1.0086206896551724,0.9914529914529915
35422,/images/002f20ad-2ace-499c-9335-c9080bc3e6b5.png,288,1195,392,1310,104,115,red blood cell,11960,1.1057692307692308,0.9043478260869565
67575,/images/59542a24-b409-4c95-8608-d9691a741526.png,998,804,1093,902,95,98,red blood cell,9310,1.0315789473684212,0.9693877551020408
5107,/images/a777e78c-ad1f-4380-9ab2-b4f9f32b2d78.png,968,36,1088,162,120,126,red blood cell,15120,1.05,0.9523809523809523
14601,/images/c649e1cb-4029-4433-b231-d67d68f7391a.png,249,138,357,265,108,127,red blood cell,13716,1.1759259259259258,0.8503937007874016
59870,/images/1519257c-e3e5-4474-908f-8665b3cf1258.png,514,1203,622,1319,108,116,red blood cell,12528,1.0740740740740742,0.9310344827586207
20765,/images/eeac81a5-9202-4965-b7de-35b12910cdf6.png,0,1409,121,1531,121,122,red blood cell,14762,1.0082644628099173,0.9918032786885246
44951,/images/83ec8923-6232-40d7-ba1f-a1b8bf7cb66c.png,862,1508,949,1598,87,90,red blood cell,7830,1.0344827586206897,0.9666666666666667
78252,/images/adff6e1d-ba9d-4c7b-a8fe-1ec458eaeeb8.png,582,439,691,566,109,127,red blood cell,13843,1.165137614678899,0.8582677165354331
78640,/images/3612aa3b-2906-44a6-9c80-6144511a35ce.png,171,1216,292,1327,121,111,red blood cell,13431,0.9173553719008265,1.09009009009009
39300,/images/697bdbc0-6e31-4e48-ac74-ba4ab5760d32.png,382,43,496,153,114,110,red blood cell,12540,0.9649122807017544,1.0363636363636364
28118,/images/cd2774a0-dab2-4d68-aae9-7568b9f3d2a6.png,1064,657,1176,770,112,113,red blood cell,12656,1.0089285714285714,0.9911504424778761
43617,/images/a4851ed0-1499-4eae-9157-dcd34773254f.png,834,597,928,699,94,102,red blood cell,9588,1.0851063829787233,0.9215686274509803
27028,/images/ec301f62-1302-4407-96f9-fcfe45c150ae.png,146,1010,260,1141,114,131,red blood cell,14934,1.1491228070175439,0.8702290076335878
56608,/images/a824b499-3736-4581-bbdc-be1b3b4cf756.png,471,1479,582,1591,111,112,red blood cell,12432,1.009009009009009,0.9910714285714286
48803,/images/fed6ba05-36a5-45dc-a4e1-9baa7de2c622.png,166,111,272,213,106,102,red blood cell,10812,0.9622641509433962,1.0392156862745099
41502,/images/2f3ebec8-ef64-420d-9aa0-c2fcadc27d74.png,244,901,361,1029,117,128,red blood cell,14976,1.0940170940170941,0.9140625
36532,/images/bd856928-96ee-4fc4-a377-f2fc4e84448b.png,1064,1432,1184,1536,120,104,red blood cell,12480,0.8666666666666667,1.1538461538461537
72819,/images/31435107-c77d-42f8-a619-75cba6a5161b.png,119,286,227,401,108,115,red blood cell,12420,1.0648148148148149,0.9391304347826087
35264,/images/a9159b11-ba49-4885-902e-00c8d5095b98.png,565,817,665,911,100,94,red blood cell,9400,0.94,1.0638297872340425
73041,/images/2bd26501-2fbc-4c1a-bef0-4ad57e02b4d0.png,318,879,401,960,83,81,red blood cell,6723,0.9759036144578314,1.0246913580246915
66925,/images/9acf303a-fcba-4e52-be3e-8d061aa5e72a.png,651,570,735,660,84,90,red blood cell,7560,1.0714285714285714,0.9333333333333333
34970,/images/2b369d75-9c55-43e0-b352-d981aea544e3.png,547,327,662,423,115,96,red blood cell,11040,0.8347826086956521,1.1979166666666667
50785,/images/db0a1123-0b35-48d7-8337-3b1ebd6af0cc.png,875,1271,979,1388,104,117,red blood cell,12168,1.125,0.8888888888888888
74607,/images/bbedfcbe-9528-4ba9-9d86-4ebba7589ac5.png,1002,433,1086,511,84,78,red blood cell,6552,0.9285714285714286,1.0769230769230769
36305,/images/81fed4a1-9d48-4938-90c9-c8bf3f5e6b1f.png,965,448,1087,577,122,129,red blood cell,15738,1.0573770491803278,0.9457364341085271
63518,/images/44b4a765-104e-4182-8871-e933c83c91ef.png,375,107,477,213,102,106,red blood cell,10812,1.0392156862745099,0.9622641509433962
49926,/images/05804cf0-f854-4099-97c2-df287f7c8a8c.png,565,72,686,182,121,110,red blood cell,13310,0.9090909090909091,1.1
70317,/images/90246988-0d6d-4bf8-8a76-94107de4121e.png,441,1284,529,1369,88,85,red blood cell,7480,0.9659090909090909,1.035294117647059
76492,/images/34df8890-272d-423a-ae78-ff8d068d3306.png,260,357,351,438,91,81,red blood cell,7371,0.8901098901098901,1.123456790123457
30201,/images/a1669b59-fe09-4fe6-ba9f-06bec6725502.png,205,388,320,514,115,126,red blood cell,14490,1.0956521739130434,0.9126984126984127
36057,/images/ca9626bc-21a4-46f4-ba94-e7ee7a4cf735.png,217,190,340,313,123,123,red blood cell,15129,1.0,1.0
74192,/images/4e43fc22-dc08-4cde-b3ce-ce8a4f377c47.png,79,503,179,602,100,99,red blood cell,9900,0.99,1.0101010101010102
75240,/images/61dfc937-a428-44b4-94fb-d682bdb8dff0.png,313,172,408,263,95,91,red blood cell,8645,0.9578947368421052,1.043956043956044
19130,/images/2196389c-45ec-46b5-bc6c-1f4a33df7f7c.png,451,925,569,1038,118,113,red blood cell,13334,0.9576271186440678,1.0442477876106195
6915,/images/b21f6c6e-4b45-407a-b4c7-034a115f3ee4.png,130,408,208,486,78,78,red blood cell,6084,1.0,1.0
53948,/images/540a5fee-175b-4b92-bf62-1ea9b59c86c6.png,409,333,508,433,99,100,red blood cell,9900,1.0101010101010102,0.99
6646,/images/95fea6d8-413f-421e-b331-5d51c31df150.png,472,1031,575,1133,103,102,red blood cell,10506,0.9902912621359223,1.0098039215686274
4571,/images/0f26699f-a776-4424-b092-27da9a1d12e2.png,715,1013,809,1106,94,93,red blood cell,8742,0.9893617021276596,1.010752688172043
74698,/images/5ccca8ee-abea-458a-a891-bedd31c3ddc3.png,551,771,655,881,104,110,red blood cell,11440,1.0576923076923077,0.9454545454545454
8765,/images/29dc8176-dfe1-40e0-8247-2dc3c530057e.png,563,969,697,1095,134,126,red blood cell,16884,0.9402985074626866,1.0634920634920635
53321,/images/d8f7e159-b7e3-49e4-86e8-aed8c5fbcd97.png,425,535,519,636,94,101,red blood cell,9494,1.074468085106383,0.9306930693069307
77919,/images/464055b6-3351-4636-a919-8be9840fb850.png,199,1272,290,1369,91,97,red blood cell,8827,1.065934065934066,0.9381443298969072
41669,/images/0fcd1ebe-ee4a-40a0-b787-29cee18bfa1b.png,757,1413,839,1488,82,75,red blood cell,6150,0.9146341463414634,1.0933333333333333
52803,/images/0a747cb3-c720-4572-a661-ab5670a5c42e.png,132,1230,239,1331,107,101,red blood cell,10807,0.9439252336448598,1.0594059405940595
55999,/images/4c460388-e0c1-4970-8527-c9e5b42bea49.png,920,0,1030,104,110,104,red blood cell,11440,0.9454545454545454,1.0576923076923077
54535,/images/db871d17-28fd-4ceb-b421-e4e4afa0a7a0.png,293,138,420,261,127,123,red blood cell,15621,0.968503937007874,1.032520325203252
15256,/images/dd7142e4-2d86-4170-a41f-e825743e8907.png,813,462,933,573,120,111,red blood cell,13320,0.925,1.0810810810810811
78720,/images/76a8a5f5-1328-4539-a131-baf877f40cf3.png,878,1164,994,1269,116,105,red blood cell,12180,0.9051724137931034,1.1047619047619048
72130,/images/64b0e49a-0e48-447d-8872-c1dd255e7a21.png,1032,150,1129,271,97,121,red blood cell,11737,1.2474226804123711,0.8016528925619835
10949,/images/c442e2d6-aaf9-417a-9905-4737a1115f33.png,15,1408,121,1523,106,115,red blood cell,12190,1.0849056603773586,0.9217391304347826
48834,/images/fed6ba05-36a5-45dc-a4e1-9baa7de2c622.png,354,937,444,1029,90,92,red blood cell,8280,1.0222222222222221,0.9782608695652174
15824,/images/c7c1b873-0548-4a73-9618-f60912e164df.png,368,1197,476,1296,108,99,red blood cell,10692,0.9166666666666666,1.0909090909090908
57814,/images/c9ad92d4-b408-4506-916e-def47b2e6ed0.png,836,239,944,351,108,112,red blood cell,12096,1.037037037037037,0.9642857142857143
49541,/images/9f33e0ea-065b-4703-9df9-15829b891860.png,356,243,468,363,112,120,red blood cell,13440,1.0714285714285714,0.9333333333333333
43992,/images/de81bf7a-7a56-437f-a068-4d9c3e01134c.png,459,893,574,996,115,103,red blood cell,11845,0.8956521739130435,1.116504854368932
59744,/images/f77d7469-d083-4c2d-a4ea-5a9ff162e3e2.png,746,612,844,720,98,108,red blood cell,10584,1.1020408163265305,0.9074074074074074
44696,/images/867f30da-2568-4480-9968-cece78c61c64.png,311,931,406,1035,95,104,red blood cell,9880,1.0947368421052632,0.9134615384615384
74121,/images/9fe8bdc8-847d-434e-93e5-ae14ff3b45e1.png,312,1325,417,1449,105,124,red blood cell,13020,1.180952380952381,0.8467741935483871
32270,/images/f4722a74-35e7-42bd-8ef6-dfff04b9cd22.png,969,561,1085,665,116,104,red blood cell,12064,0.896551724137931,1.1153846153846154
70043,/images/b8339d7b-85ec-48d0-83e8-c8f831070459.png,509,1410,627,1527,118,117,red blood cell,13806,0.9915254237288136,1.0085470085470085
19353,/images/a302a6fa-f635-4ade-b72b-b6f3c2a34ec9.png,316,159,412,267,96,108,red blood cell,10368,1.125,0.8888888888888888
75645,/images/50d7c6c9-3230-48fe-947c-7dcfd0aad710.png,975,587,1093,699,118,112,red blood cell,13216,0.9491525423728814,1.0535714285714286
37272,/images/2fdbd9bc-bbaf-44c2-b40c-d193709639fa.png,441,823,566,950,125,127,red blood cell,15875,1.016,0.984251968503937
62383,/images/9af1ee02-87fd-42bc-963e-fa9ac3eb45bb.png,1005,1092,1108,1192,103,100,red blood cell,10300,0.970873786407767,1.03
14686,/images/4e2873dd-651e-4ecc-ac70-7335cf21a469.png,755,578,879,698,124,120,red blood cell,14880,0.967741935483871,1.0333333333333334
75962,/images/034c8d57-04d5-4786-93a4-6ae8fde2c258.png,219,584,308,693,89,109,red blood cell,9701,1.2247191011235956,0.8165137614678899
76736,/images/3317d733-ec0d-45e6-b631-40457392f343.png,333,1494,441,1599,108,105,red blood cell,11340,0.9722222222222222,1.0285714285714285
50895,/images/0906111b-bac7-4541-a6dc-da435c0724a8.png,192,645,301,758,109,113,red blood cell,12317,1.036697247706422,0.9646017699115044
41209,/images/eed298b3-35f2-4127-88ad-0c4a9062207b.png,207,152,308,249,101,97,red blood cell,9797,0.9603960396039604,1.041237113402062
78676,/images/fd1c4c7a-24bc-43f2-b84f-fee182207aee.png,372,809,479,922,107,113,red blood cell,12091,1.0560747663551402,0.9469026548672567
69591,/images/4a49841f-216c-4815-8140-b8762c4f6603.png,989,1312,1101,1428,112,116,red blood cell,12992,1.0357142857142858,0.9655172413793104
28273,/images/036404d1-b9fc-497b-bbe1-f4d9c5ac3ce0.png,150,859,242,968,92,109,red blood cell,10028,1.184782608695652,0.8440366972477065
11742,/images/082e1f81-4f49-44ad-b5bb-9dfc155b2ed8.png,449,1322,543,1420,94,98,red blood cell,9212,1.0425531914893618,0.9591836734693877
27685,/images/18dbe7c4-89d2-42a6-a969-1e951ab313b1.png,193,24,298,138,105,114,red blood cell,11970,1.0857142857142856,0.9210526315789473
8790,/images/ae17a099-18b5-4a42-a901-850ea056423e.png,308,197,406,303,98,106,red blood cell,10388,1.0816326530612246,0.9245283018867925
68358,/images/040112be-3c8d-49aa-93f1-522f94a592ff.png,276,1153,399,1270,123,117,red blood cell,14391,0.9512195121951219,1.0512820512820513
77373,/images/3ff98212-7c2a-46cd-afb7-34a2479bed07.png,1051,74,1144,162,93,88,red blood cell,8184,0.946236559139785,1.0568181818181819
48972,/images/5dec0204-af81-44ef-a942-8a173669c123.png,1091,1033,1196,1131,105,98,red blood cell,10290,0.9333333333333333,1.0714285714285714
76911,/images/25ddc1ca-d368-4fff-b1ad-1dbf1e7c97aa.png,453,771,569,888,116,117,red blood cell,13572,1.0086206896551724,0.9914529914529915
15327,/images/2d0f600d-f94e-4907-b712-52fb37d9ed52.png,244,877,349,971,105,94,red blood cell,9870,0.8952380952380953,1.1170212765957446
67216,/images/5f491efd-a21c-4a80-aaba-70b8876238ac.png,312,817,396,907,84,90,red blood cell,7560,1.0714285714285714,0.9333333333333333
74906,/images/dd090806-e4ac-4a78-b2ee-55a30626369c.png,777,452,881,547,104,95,red blood cell,9880,0.9134615384615384,1.0947368421052632
48172,/images/913099c5-8085-4908-bf4b-1f098bbfcf66.png,776,1435,906,1576,130,141,red blood cell,18330,1.0846153846153845,0.9219858156028369
63469,/images/b9d65ef3-1adc-4479-abee-2e422f5a613a.png,1045,1296,1142,1401,97,105,red blood cell,10185,1.0824742268041236,0.9238095238095239
67282,/images/5f491efd-a21c-4a80-aaba-70b8876238ac.png,424,1430,507,1527,83,97,red blood cell,8051,1.1686746987951808,0.8556701030927835
3802,/images/3e764461-22ee-44d3-925d-cd658ff7d154.png,504,567,613,683,109,116,red blood cell,12644,1.0642201834862386,0.9396551724137931
76623,/images/4184a235-d209-4151-86e9-6c77e7938dab.png,918,193,1020,298,102,105,red blood cell,10710,1.0294117647058822,0.9714285714285714
77761,/images/4849866a-73a2-4fcf-a407-2d0a25a09a89.png,309,522,397,610,88,88,red blood cell,7744,1.0,1.0
60276,/images/7abc0d26-dd66-4ef4-8c4e-4a661e589a7f.png,90,1261,198,1374,108,113,red blood cell,12204,1.0462962962962963,0.9557522123893806
76204,/images/07a96126-482e-4beb-b42a-0cb59e505372.png,854,1464,985,1592,131,128,red blood cell,16768,0.9770992366412213,1.0234375
13826,/images/345cb914-7583-49df-96e3-3cf19c2ba8f1.png,433,1025,547,1146,114,121,red blood cell,13794,1.0614035087719298,0.9421487603305785
47685,/images/4b3a49bc-8536-4760-9553-440a6f64db37.png,886,256,1005,384,119,128,red blood cell,15232,1.0756302521008403,0.9296875
58978,/images/a0eeeb10-d0cb-48d9-8c22-2c3a3c908d00.png,289,938,385,1035,96,97,red blood cell,9312,1.0104166666666667,0.9896907216494846
20514,/images/cbde7f7e-2458-4dda-9db2-3d5ccf950ced.png,252,128,380,250,128,122,red blood cell,15616,0.953125,1.0491803278688525
4413,/images/21ea4841-8998-4c04-b345-bc99cd8ecee6.png,558,1231,670,1368,112,137,red blood cell,15344,1.2232142857142858,0.8175182481751825
58531,/images/5cac6ddf-c8c6-45de-bce0-a1db64b14fb5.png,670,512,768,597,98,85,red blood cell,8330,0.8673469387755102,1.1529411764705881
66723,/images/334bf865-e3fb-4200-bd53-d9ff5808ed9f.png,1077,533,1177,630,100,97,red blood cell,9700,0.97,1.0309278350515463
23178,/images/c94a5851-b846-4fde-8c89-05bec3a8ac53.png,727,881,847,1005,120,124,red blood cell,14880,1.0333333333333334,0.967741935483871
16951,/images/8eeb378e-90f0-47ea-ac1c-2a201eb8d090.png,921,182,1020,275,99,93,red blood cell,9207,0.9393939393939394,1.064516129032258
37830,/images/56a57a8d-c9b9-432a-a3b0-32a09355806c.png,36,1046,140,1146,104,100,red blood cell,10400,0.9615384615384616,1.04
57669,/images/5c037ffc-f515-48b3-b231-c110fbd2b8ca.png,669,444,775,571,106,127,red blood cell,13462,1.1981132075471699,0.8346456692913385
76879,/images/2165fe38-b474-467d-be11-d1d728085efd.png,489,220,590,320,101,100,red blood cell,10100,0.9900990099009901,1.01
74856,/images/81edcae1-65bf-4752-b0e4-494376b71e49.png,860,174,950,276,90,102,red blood cell,9180,1.1333333333333333,0.8823529411764706
53328,/images/d8f7e159-b7e3-49e4-86e8-aed8c5fbcd97.png,505,338,594,430,89,92,red blood cell,8188,1.0337078651685394,0.967391304347826
71451,/images/bcb447c9-5d37-414f-a513-d7076b04a532.png,718,688,811,793,93,105,red blood cell,9765,1.1290322580645162,0.8857142857142857
776,/images/27fab82c-5bf0-426f-aeb9-47da829b6629.png,786,562,896,675,110,113,red blood cell,12430,1.0272727272727273,0.9734513274336283
32813,/images/67f5ca94-d84e-490e-bf0d-4ffba7bdbe30.png,269,1449,391,1578,122,129,red blood cell,15738,1.0573770491803278,0.9457364341085271
4245,/images/ac3358f1-ef9a-4ccc-b66c-da5e47e352e0.png,1006,633,1109,747,103,114,red blood cell,11742,1.1067961165048543,0.9035087719298246
13039,/images/555c6ea2-c76c-4e71-af57-855d940c2b37.png,313,508,445,625,132,117,red blood cell,15444,0.8863636363636364,1.1282051282051282
41533,/images/0fcd1ebe-ee4a-40a0-b787-29cee18bfa1b.png,178,449,293,568,115,119,red blood cell,13685,1.0347826086956522,0.9663865546218487
78000,/images/c691c8ef-d3c7-47b6-a941-f6a1089f21a9.png,240,536,334,625,94,89,red blood cell,8366,0.9468085106382979,1.0561797752808988
15114,/images/3a8f468f-f9de-46a8-a7c8-f2be239fa207.png,411,273,502,368,91,95,red blood cell,8645,1.043956043956044,0.9578947368421052
94,/images/10be6380-cbbb-4886-8b9e-ff56b1710576.png,439,254,550,383,111,129,red blood cell,14319,1.162162162162162,0.8604651162790697
48681,/images/03359d4d-69cb-4146-8286-ca7399366f97.png,897,504,1012,628,115,124,red blood cell,14260,1.0782608695652174,0.9274193548387096
72764,/images/caeb2d62-1166-43f0-8eac-5b8fc48f02eb.png,228,1031,328,1151,100,120,red blood cell,12000,1.2,0.8333333333333334
76946,/images/25ddc1ca-d368-4fff-b1ad-1dbf1e7c97aa.png,668,606,793,725,125,119,red blood cell,14875,0.952,1.050420168067227
50700,/images/6b4c79f5-b194-4586-be9f-e339c5af4188.png,926,193,1044,313,118,120,red blood cell,14160,1.0169491525423728,0.9833333333333333
62965,/images/f234a2de-f3c8-4521-a306-8cfdf52dd597.png,441,86,538,170,97,84,red blood cell,8148,0.865979381443299,1.1547619047619047
30537,/images/7d9c1422-6332-44e9-b134-3ac94f07b0f0.png,1047,389,1144,493,97,104,red blood cell,10088,1.0721649484536082,0.9326923076923077
21554,/images/49efc89d-9cba-44f7-8257-7f911b73f68a.png,353,734,460,829,107,95,red blood cell,10165,0.8878504672897196,1.1263157894736842
35434,/images/002f20ad-2ace-499c-9335-c9080bc3e6b5.png,842,852,964,971,122,119,red blood cell,14518,0.9754098360655737,1.0252100840336134
41452,/images/c4494d4f-732f-431a-8a9d-62403f0b74fe.png,353,462,463,568,110,106,red blood cell,11660,0.9636363636363636,1.0377358490566038
41732,/images/32a1ea24-b6b7-4253-ad3e-bdf99c2c9b9d.png,631,784,730,894,99,110,red blood cell,10890,1.1111111111111112,0.9
77785,/images/4849866a-73a2-4fcf-a407-2d0a25a09a89.png,422,86,516,197,94,111,red blood cell,10434,1.1808510638297873,0.8468468468468469
11469,/images/2f9f400d-2d67-4118-aaa1-9094bc4b0e47.png,535,1474,672,1595,137,121,red blood cell,16577,0.8832116788321168,1.1322314049586777
58713,/images/e4827c85-311a-4df1-89c2-99dad0c3558c.png,586,868,686,985,100,117,red blood cell,11700,1.17,0.8547008547008547
5991,/images/97eff653-3908-4e66-931f-eab36bc336c8.png,406,504,522,615,116,111,red blood cell,12876,0.9568965517241379,1.045045045045045
32018,/images/b8a4d467-c40c-4ebf-91dd-1c19d0f2a7ae.png,627,1328,729,1431,102,103,red blood cell,10506,1.0098039215686274,0.9902912621359223
54961,/images/f1872d08-f8a6-4b21-aa29-f56bbf607883.png,1063,873,1164,969,101,96,red blood cell,9696,0.9504950495049505,1.0520833333333333
69729,/images/f0713bee-2a71-4ced-b953-4041ea99496a.png,989,807,1075,910,86,103,red blood cell,8858,1.197674418604651,0.8349514563106796
46661,/images/da111ca5-520f-4ea8-97ad-ae5fce58ee91.png,571,260,670,359,99,99,red blood cell,9801,1.0,1.0
5685,/images/d3dcdf92-9328-4796-adf4-918646877ba1.png,849,500,951,610,102,110,red blood cell,11220,1.0784313725490196,0.9272727272727272
24524,/images/109fbb82-bc3c-41ac-984d-e2da86202873.png,601,391,709,503,108,112,red blood cell,12096,1.037037037037037,0.9642857142857143
16672,/images/bc377041-e098-45c4-9651-2b1ea90d1d7e.png,1011,683,1128,824,117,141,red blood cell,16497,1.205128205128205,0.8297872340425532
46607,/images/da111ca5-520f-4ea8-97ad-ae5fce58ee91.png,281,999,384,1098,103,99,red blood cell,10197,0.9611650485436893,1.0404040404040404
62325,/images/e0ff3476-226f-4125-b182-8e524d5503dd.png,473,494,588,595,115,101,red blood cell,11615,0.8782608695652174,1.1386138613861385
39815,/images/5c68070c-3391-4db6-8c01-94175105dbea.png,1055,1280,1175,1401,120,121,red blood cell,14520,1.0083333333333333,0.9917355371900827
52417,/images/a2a20600-f851-4db7-90f9-6f7be027c8b5.png,403,517,520,631,117,114,red blood cell,13338,0.9743589743589743,1.0263157894736843
74260,/images/4e43fc22-dc08-4cde-b3ce-ce8a4f377c47.png,1015,142,1093,233,78,91,red blood cell,7098,1.1666666666666667,0.8571428571428571
55150,/images/29d4b75f-d400-4702-a9ac-e5a4ed1a1db1.png,459,1014,550,1115,91,101,red blood cell,9191,1.10989010989011,0.900990099009901
75376,/images/468c261d-f5d8-423f-883e-48af2bbbc5d1.png,667,921,783,1040,116,119,red blood cell,13804,1.0258620689655173,0.9747899159663865
1873,/images/8855c685-5a8c-4967-a356-942ed89e3471.png,1062,869,1192,991,130,122,red blood cell,15860,0.9384615384615385,1.0655737704918034
21512,/images/7625dfc4-858a-4c8e-907c-8943d665e9a7.png,171,1358,276,1467,105,109,red blood cell,11445,1.0380952380952382,0.963302752293578
24192,/images/194aec70-41a5-4ac3-b22f-0b6eda91f730.png,1058,477,1185,610,127,133,red blood cell,16891,1.047244094488189,0.9548872180451128
21077,/images/c680004e-6ee2-43d7-877c-edc9b5ebeecc.png,342,566,450,672,108,106,red blood cell,11448,0.9814814814814815,1.0188679245283019
53979,/images/540a5fee-175b-4b92-bf62-1ea9b59c86c6.png,923,1451,1012,1556,89,105,red blood cell,9345,1.1797752808988764,0.8476190476190476
52343,/images/a86e0647-ae41-4b75-9d45-dd58f5ea65f5.png,297,1116,387,1206,90,90,red blood cell,8100,1.0,1.0
40580,/images/29861cf9-9a1e-4733-8309-4bd10706b4a3.png,482,1221,587,1338,105,117,red blood cell,12285,1.1142857142857143,0.8974358974358975
46126,/images/72088c26-d2dd-4906-b791-b8947fc7fbe4.png,137,1465,228,1564,91,99,red blood cell,9009,1.0879120879120878,0.9191919191919192
18836,/images/d1b48634-9ad5-46e8-b816-42d1d97c93cd.png,371,177,502,288,131,111,red blood cell,14541,0.8473282442748091,1.1801801801801801
5258,/images/729733ff-a349-4a96-b636-ccabe7d7e167.png,460,1426,556,1513,96,87,red blood cell,8352,0.90625,1.103448275862069
16393,/images/e474a20b-2769-48f1-a520-4f6ef5a0dbf5.png,116,36,235,138,119,102,red blood cell,12138,0.8571428571428571,1.1666666666666667
74553,/images/bbedfcbe-9528-4ba9-9d86-4ebba7589ac5.png,409,1295,510,1404,101,109,red blood cell,11009,1.0792079207920793,0.926605504587156
65343,/images/24418314-f7a4-49fc-a03e-ec597ca6796e.png,1024,994,1135,1104,111,110,red blood cell,12210,0.990990990990991,1.009090909090909
27263,/images/9f38055f-4fe6-47fd-a6dd-c0743db4eccf.png,396,1351,519,1470,123,119,red blood cell,14637,0.967479674796748,1.0336134453781514
64343,/images/0a7bfa8a-ee52-4f7a-b9c5-2919ecfa93ef.png,1075,37,1172,136,97,99,red blood cell,9603,1.0206185567010309,0.9797979797979798
6407,/images/1ecb0405-a6e9-4485-819e-2fbbf2b718aa.png,267,490,382,607,115,117,red blood cell,13455,1.017391304347826,0.9829059829059829
42248,/images/ca734448-0d52-42fa-b41c-17b2939e58ae.png,220,728,347,842,127,114,red blood cell,14478,0.8976377952755905,1.1140350877192982
25771,/images/1f8edb2a-40bc-4beb-aa6b-884d2473df0f.png,734,30,850,139,116,109,red blood cell,12644,0.9396551724137931,1.0642201834862386
59441,/images/a7c3c52f-3b40-4c92-a212-df9462cf25d8.png,427,541,529,647,102,106,red blood cell,10812,1.0392156862745099,0.9622641509433962
29860,/images/9cdee92c-6267-4188-a41e-125bc0abb9ae.png,1079,1137,1177,1229,98,92,red blood cell,9016,0.9387755102040817,1.065217391304348
46143,/images/72088c26-d2dd-4906-b791-b8947fc7fbe4.png,363,452,459,546,96,94,red blood cell,9024,0.9791666666666666,1.0212765957446808
30560,/images/7d9c1422-6332-44e9-b134-3ac94f07b0f0.png,1036,815,1145,923,109,108,red blood cell,11772,0.9908256880733946,1.0092592592592593
34507,/images/fa1f9f89-cecb-4972-842c-d14c632f89a9.png,577,1496,698,1598,121,102,red blood cell,12342,0.8429752066115702,1.1862745098039216
60374,/images/1c87b997-a8e6-48ca-bf40-19b9a7fd6a96.png,214,585,305,676,91,91,red blood cell,8281,1.0,1.0
60345,/images/1c87b997-a8e6-48ca-bf40-19b9a7fd6a96.png,426,1478,523,1563,97,85,red blood cell,8245,0.8762886597938144,1.1411764705882352
16021,/images/7e25ced3-5caf-47f8-ad0c-42946bd4468b.png,650,1384,765,1493,115,109,red blood cell,12535,0.9478260869565217,1.055045871559633
38196,/images/452ab003-ced5-40cb-82d1-5495d9e068b1.png,1,400,120,523,119,123,red blood cell,14637,1.0336134453781514,0.967479674796748
28229,/images/036404d1-b9fc-497b-bbe1-f4d9c5ac3ce0.png,720,1477,841,1593,121,116,red blood cell,14036,0.9586776859504132,1.043103448275862
26590,/images/4935818a-7e7a-4f44-a3b6-b361d1abfe16.png,519,667,643,786,124,119,red blood cell,14756,0.9596774193548387,1.0420168067226891
28115,/images/cd2774a0-dab2-4d68-aae9-7568b9f3d2a6.png,200,1054,307,1162,107,108,red blood cell,11556,1.0093457943925233,0.9907407407407407
45016,/images/13bab3c3-3f79-44d9-a287-0ae6d71eff31.png,1052,1230,1164,1349,112,119,red blood cell,13328,1.0625,0.9411764705882353
66367,/images/e5fd5949-4cd0-4cb6-837a-02c26a5eb87a.png,248,860,373,989,125,129,red blood cell,16125,1.032,0.9689922480620154
56255,/images/6b473806-e936-4b19-98cf-a2b94cac35ff.png,353,1083,465,1195,112,112,red blood cell,12544,1.0,1.0
60450,/images/93b47b14-7f78-4b31-8897-d63a81fdab01.png,480,197,579,311,99,114,red blood cell,11286,1.1515151515151516,0.868421052631579
44840,/images/83ec8923-6232-40d7-ba1f-a1b8bf7cb66c.png,42,1072,153,1177,111,105,red blood cell,11655,0.9459459459459459,1.0571428571428572
45722,/images/584d62ed-4329-45dd-94ce-e929d8b2bb74.png,367,72,468,190,101,118,red blood cell,11918,1.1683168316831682,0.8559322033898306
46780,/images/02fb5e19-6f94-4787-bb78-e550a29a3cbd.png,1070,557,1190,662,120,105,red blood cell,12600,0.875,1.1428571428571428
7512,/images/071901eb-4c3f-404b-a747-3d0b9d0a5158.png,550,711,659,823,109,112,red blood cell,12208,1.0275229357798166,0.9732142857142857
22481,/images/dd60b6a7-c545-45b9-8250-d1633aa1ac75.png,242,134,349,243,107,109,red blood cell,11663,1.0186915887850467,0.981651376146789
47787,/images/5a105b89-c592-4d78-b208-7db6c6572752.png,164,288,276,384,112,96,red blood cell,10752,0.8571428571428571,1.1666666666666667
67294,/images/49c4dbd3-6269-4d4c-9648-a2146c57bab1.png,300,547,390,639,90,92,red blood cell,8280,1.0222222222222221,0.9782608695652174
73086,/images/f39e2289-fedd-4d12-9e64-ffdafb89247e.png,396,661,506,771,110,110,red blood cell,12100,1.0,1.0
62696,/images/9e1b0217-0926-4fd1-bb9e-a815c05deb59.png,471,631,568,735,97,104,red blood cell,10088,1.0721649484536082,0.9326923076923077
28242,/images/036404d1-b9fc-497b-bbe1-f4d9c5ac3ce0.png,401,1348,508,1449,107,101,red blood cell,10807,0.9439252336448598,1.0594059405940595
24453,/images/b78ba2c8-ecb3-45b2-9cda-2c8088fa95d1.png,129,878,244,1009,115,131,red blood cell,15065,1.1391304347826088,0.8778625954198473
19040,/images/e9e78ff8-831b-46e9-9785-3eee9acbfcd8.png,0,1266,87,1348,87,82,red blood cell,7134,0.9425287356321839,1.0609756097560976
55420,/images/d67655e6-0a80-4a86-b552-1f5e85788377.png,970,971,1071,1063,101,92,red blood cell,9292,0.9108910891089109,1.0978260869565217
54001,/images/5e4f7425-11e6-4f9e-be2d-5a27deb9d1b4.png,308,786,414,890,106,104,red blood cell,11024,0.9811320754716981,1.0192307692307692
23310,/images/e5731221-814c-4894-a44e-e46b71460fa4.png,210,735,319,843,109,108,red blood cell,11772,0.9908256880733946,1.0092592592592593
41040,/images/e871f52c-77a6-4813-80d4-95bd97985f1a.png,72,731,199,848,127,117,red blood cell,14859,0.9212598425196851,1.0854700854700854
69343,/images/2ac343e4-c889-47c1-8fe2-461b626def76.png,1056,1140,1177,1253,121,113,red blood cell,13673,0.9338842975206612,1.0707964601769913
14793,/images/f8b6a868-60e9-4569-ae69-638a0c39834d.png,669,100,789,215,120,115,red blood cell,13800,0.9583333333333334,1.0434782608695652
11720,/images/082e1f81-4f49-44ad-b5bb-9dfc155b2ed8.png,573,304,663,394,90,90,red blood cell,8100,1.0,1.0
47438,/images/3e753a44-3264-438c-8389-a7822e4a84cc.png,46,318,163,447,117,129,red blood cell,15093,1.1025641025641026,0.9069767441860465
23630,/images/79d7a014-21ff-40f1-9ac4-a69839390654.png,587,230,681,322,94,92,red blood cell,8648,0.9787234042553191,1.0217391304347827
25874,/images/461a3ed6-039f-4a70-97cf-c474ecf51ccd.png,920,752,1036,855,116,103,red blood cell,11948,0.8879310344827587,1.1262135922330097
6722,/images/672e4ecf-a56b-462e-b83b-76f4efaa6634.png,237,1423,348,1538,111,115,red blood cell,12765,1.0360360360360361,0.9652173913043478
3700,/images/dacf7e3f-1d8c-42a0-8539-3abe3971c956.png,87,1276,212,1376,125,100,red blood cell,12500,0.8,1.25
75793,/images/f48bf825-13c4-42fc-8dd8-10cc4ae6b202.png,247,12,346,134,99,122,red blood cell,12078,1.2323232323232323,0.8114754098360656
55041,/images/1f8f08ea-b5b3-4f68-94d4-3cc071b7dce8.png,1057,1080,1167,1189,110,109,red blood cell,11990,0.990909090909091,1.0091743119266054
36189,/images/749df49e-5212-49ea-9e88-7d66f258f1df.png,714,1054,831,1175,117,121,red blood cell,14157,1.0341880341880343,0.9669421487603306
32633,/images/ed0d8763-e734-4506-b61b-53fc32a8d8c9.png,106,1101,223,1212,117,111,red blood cell,12987,0.9487179487179487,1.054054054054054
51526,/images/6afb3717-f197-4668-929a-4fab389ae6e8.png,995,149,1091,242,96,93,red blood cell,8928,0.96875,1.032258064516129
71675,/images/5c99cd97-39f6-4809-9528-9d380cc16b16.png,586,895,675,976,89,81,red blood cell,7209,0.9101123595505618,1.0987654320987654
34830,/images/4fc9a597-aaa8-43b0-ad1c-2eabbe442e84.png,749,155,824,242,75,87,red blood cell,6525,1.16,0.8620689655172413
20651,/images/d09eed76-e09b-4d90-b8f0-5a801beae41c.png,758,1389,884,1510,126,121,red blood cell,15246,0.9603174603174603,1.0413223140495869
76966,/images/51e86aa9-caa0-4297-94e8-34a57d7f7e36.png,778,1168,910,1287,132,119,red blood cell,15708,0.9015151515151515,1.1092436974789917
52003,/images/4f62b14e-c6f4-4155-8f50-881558f83fae.png,480,1486,568,1570,88,84,red blood cell,7392,0.9545454545454546,1.0476190476190477
29640,/images/b85fc640-de49-4f7e-afc0-978ff020f2e2.png,252,810,358,923,106,113,red blood cell,11978,1.0660377358490567,0.9380530973451328
66065,/images/c8af0297-ce1f-40ea-bf44-9256dcdae4e9.png,367,274,454,375,87,101,red blood cell,8787,1.160919540229885,0.8613861386138614
11347,/images/2f6224be-50d0-4e85-94ef-88315df561b6.png,108,510,210,620,102,110,red blood cell,11220,1.0784313725490196,0.9272727272727272
43045,/images/1345dc89-a3d9-4b71-8a75-b3bff01ba518.png,160,270,279,386,119,116,red blood cell,13804,0.9747899159663865,1.0258620689655173
24534,/images/109fbb82-bc3c-41ac-984d-e2da86202873.png,956,799,1067,898,111,99,red blood cell,10989,0.8918918918918919,1.121212121212121
14061,/images/eaf4b781-b3aa-41ce-8c5e-287979b4e15a.png,436,735,539,820,103,85,red blood cell,8755,0.8252427184466019,1.2117647058823529
63407,/images/289ef1b7-02d5-42e9-a401-687688181306.png,335,477,447,586,112,109,red blood cell,12208,0.9732142857142857,1.0275229357798166
42152,/images/04c07425-57c7-415c-a0bc-36857bbd4049.png,473,18,598,137,125,119,red blood cell,14875,0.952,1.050420168067227
78341,/images/24115f58-a7d6-4022-a95a-86b515a78d3e.png,257,1138,352,1239,95,101,red blood cell,9595,1.063157894736842,0.9405940594059405
47731,/images/afbb264e-ff60-443a-83f5-49d09be1b835.png,590,303,718,439,128,136,red blood cell,17408,1.0625,0.9411764705882353
57517,/images/00d04a90-80e5-4bce-9511-1b64eabb7a47.png,293,1163,381,1249,88,86,red blood cell,7568,0.9772727272727273,1.0232558139534884
29911,/images/f2a8a483-b254-43aa-817f-7d525adb8911.png,111,82,245,203,134,121,red blood cell,16214,0.9029850746268657,1.1074380165289257
7360,/images/89f10192-d3dd-4996-a571-4c851dbdc983.png,519,980,610,1060,91,80,red blood cell,7280,0.8791208791208791,1.1375
55759,/images/68f34a9c-f73d-4238-8f55-4b05a8a2154c.png,988,771,1102,873,114,102,red blood cell,11628,0.8947368421052632,1.1176470588235294
61848,/images/5f300fd1-7eec-41ac-bbd1-0f4a943c757c.png,198,253,309,377,111,124,red blood cell,13764,1.117117117117117,0.8951612903225806
45551,/images/e597f7ce-46c6-4dce-9063-50a2703fdd45.png,404,983,504,1088,100,105,red blood cell,10500,1.05,0.9523809523809523
53100,/images/04a567df-5463-4043-81f1-d726223c19a9.png,950,238,1050,331,100,93,red blood cell,9300,0.93,1.075268817204301
50636,/images/c956e531-6805-4fe1-b61c-8b96a9815a77.png,141,820,260,937,119,117,red blood cell,13923,0.9831932773109243,1.017094017094017
68573,/images/32700bc7-7a86-49d3-aded-ccaaed4ddc5c.png,196,1390,305,1488,109,98,red blood cell,10682,0.8990825688073395,1.1122448979591837
41428,/images/c4494d4f-732f-431a-8a9d-62403f0b74fe.png,832,274,925,371,93,97,red blood cell,9021,1.043010752688172,0.9587628865979382
12418,/images/cc94eabb-a3dc-4cfc-9fff-55c76b5b4a71.png,396,213,509,325,113,112,red blood cell,12656,0.9911504424778761,1.0089285714285714
33363,/images/f632981c-1330-4078-8a12-691beb2dab02.png,1062,516,1147,607,85,91,red blood cell,7735,1.0705882352941176,0.9340659340659341
18771,/images/cc882eae-a341-4783-bd19-8bdedf798538.png,557,1080,673,1191,116,111,red blood cell,12876,0.9568965517241379,1.045045045045045
13345,/images/a7f1bbb1-6058-4642-bd66-cfb90dce762e.png,454,310,571,417,117,107,red blood cell,12519,0.9145299145299145,1.0934579439252337
70745,/images/8ab5c462-045e-4b59-b53a-9b2bc3ed2487.png,103,176,187,280,84,104,red blood cell,8736,1.2380952380952381,0.8076923076923077
4243,/images/ac3358f1-ef9a-4ccc-b66c-da5e47e352e0.png,748,68,857,180,109,112,red blood cell,12208,1.0275229357798166,0.9732142857142857
71669,/images/5c99cd97-39f6-4809-9528-9d380cc16b16.png,161,436,253,517,92,81,red blood cell,7452,0.8804347826086957,1.1358024691358024
1933,/images/02ea7aa8-c142-4a3d-939f-e77689741341.png,588,29,692,129,104,100,red blood cell,10400,0.9615384615384616,1.04
52172,/images/94d9fa50-d3e4-4eaf-acfc-92e7f2ed9ea5.png,434,1135,511,1217,77,82,red blood cell,6314,1.0649350649350648,0.9390243902439024
69396,/images/fde0fd54-49cc-42e1-90c6-6b612cd062d8.png,601,831,690,934,89,103,red blood cell,9167,1.1573033707865168,0.8640776699029126
13267,/images/030f3421-ed3f-4bf1-8f27-4d02590bffbc.png,340,218,446,325,106,107,red blood cell,11342,1.009433962264151,0.9906542056074766
15586,/images/169d541c-daed-468e-8b41-0f1abccdf319.png,635,169,741,300,106,131,red blood cell,13886,1.2358490566037736,0.8091603053435115
50207,/images/8b89b3fc-95ef-4f2e-b94b-0291dbffe0f4.png,86,370,202,481,116,111,red blood cell,12876,0.9568965517241379,1.045045045045045
77987,/images/c691c8ef-d3c7-47b6-a941-f6a1089f21a9.png,1018,1174,1126,1271,108,97,red blood cell,10476,0.8981481481481481,1.1134020618556701
55447,/images/d67655e6-0a80-4a86-b552-1f5e85788377.png,623,642,716,728,93,86,red blood cell,7998,0.9247311827956989,1.0813953488372092
78682,/images/76a8a5f5-1328-4539-a131-baf877f40cf3.png,80,493,175,590,95,97,red blood cell,9215,1.0210526315789474,0.979381443298969
53596,/images/7c1cd7c7-7452-4428-a98e-dd7675c8ddea.png,0,545,115,648,115,103,red blood cell,11845,0.8956521739130435,1.116504854368932
67638,/images/59542a24-b409-4c95-8608-d9691a741526.png,867,239,955,329,88,90,red blood cell,7920,1.0227272727272727,0.9777777777777777
51826,/images/f07174a5-f799-4286-ac43-5b0f5c5777ac.png,998,387,1079,456,81,69,red blood cell,5589,0.8518518518518519,1.173913043478261
12300,/images/3b55c42f-ad59-422f-ba99-4f4f4ca9cb2e.png,903,813,1006,903,103,90,red blood cell,9270,0.8737864077669902,1.1444444444444444
224,/images/2559636b-f01a-4414-93da-210c3b12d153.png,734,1228,861,1347,127,119,red blood cell,15113,0.937007874015748,1.0672268907563025
21524,/images/7625dfc4-858a-4c8e-907c-8943d665e9a7.png,829,1374,936,1485,107,111,red blood cell,11877,1.0373831775700935,0.963963963963964
14775,/images/1fdf99d1-a494-4174-bcd7-efbe457ab899.png,751,840,853,962,102,122,red blood cell,12444,1.196078431372549,0.8360655737704918
66037,/images/c8af0297-ce1f-40ea-bf44-9256dcdae4e9.png,331,521,455,627,124,106,red blood cell,13144,0.8548387096774194,1.169811320754717
37839,/images/56a57a8d-c9b9-432a-a3b0-32a09355806c.png,948,1275,1053,1372,105,97,red blood cell,10185,0.9238095238095239,1.0824742268041236
67109,/images/4272cbd7-5b0a-4bf7-b690-dee1c128f07b.png,317,1136,402,1215,85,79,red blood cell,6715,0.9294117647058824,1.0759493670886076
66297,/images/fcdf6632-c03f-49a8-9fb3-42e87c99b9d0.png,305,952,403,1050,98,98,red blood cell,9604,1.0,1.0
77529,/images/2d2e81f3-e329-4765-9ba1-2c95f12dc9f3.png,816,392,918,494,102,102,red blood cell,10404,1.0,1.0
4890,/images/61cd8c7d-394d-42d3-9ed4-e09559110bed.png,708,768,821,878,113,110,red blood cell,12430,0.9734513274336283,1.0272727272727273
70626,/images/4ce5a070-9ede-4bb1-9ca2-1bae5746776b.png,1064,666,1191,770,127,104,red blood cell,13208,0.8188976377952756,1.2211538461538463
65439,/images/b523daee-317b-461d-bdc1-07b4add4d488.png,823,1281,917,1374,94,93,red blood cell,8742,0.9893617021276596,1.010752688172043
24509,/images/109fbb82-bc3c-41ac-984d-e2da86202873.png,891,885,1005,1000,114,115,red blood cell,13110,1.0087719298245614,0.991304347826087
36222,/images/c3209548-7f7c-4afd-b47c-b42a72b1ebf7.png,546,1442,667,1562,121,120,red blood cell,14520,0.9917355371900827,1.0083333333333333
60712,/images/45651e76-4bd0-45e5-895b-edec65f51987.png,122,833,225,953,103,120,red blood cell,12360,1.1650485436893203,0.8583333333333333
4740,/images/3fa1a4e3-c80d-49da-8f7b-a1abb0424f48.png,1052,971,1155,1060,103,89,red blood cell,9167,0.8640776699029126,1.1573033707865168
51285,/images/216f9d43-6869-4ba1-9106-4f5ea6aac223.png,950,1041,1055,1154,105,113,red blood cell,11865,1.0761904761904761,0.9292035398230089
12148,/images/87d6343b-70dd-4cdd-939f-d3ac0ca2e700.png,733,621,833,745,100,124,red blood cell,12400,1.24,0.8064516129032258
69741,/images/2bd15b6e-fe2d-49f3-b394-940d024d1f91.png,787,460,887,566,100,106,red blood cell,10600,1.06,0.9433962264150944
19469,/images/a85cd1ae-0c94-4387-8305-84ab8d96d137.png,436,146,546,251,110,105,red blood cell,11550,0.9545454545454546,1.0476190476190477
44961,/images/83ec8923-6232-40d7-ba1f-a1b8bf7cb66c.png,622,423,720,514,98,91,red blood cell,8918,0.9285714285714286,1.0769230769230769
18017,/images/eb77e4a9-acb0-4d83-8055-2c5fcaa54b45.png,452,160,533,256,81,96,red blood cell,7776,1.1851851851851851,0.84375
60108,/images/ec60ab26-3343-4c5f-9667-cdae999c7d86.png,253,1045,374,1166,121,121,red blood cell,14641,1.0,1.0
16995,/images/57e1879e-4294-45e7-9c1b-627e8cca0271.png,357,488,481,616,124,128,red blood cell,15872,1.032258064516129,0.96875
3361,/images/b1100ae1-0ac8-4fc2-b0ff-8819f7fbe724.png,905,1236,1013,1366,108,130,red blood cell,14040,1.2037037037037037,0.8307692307692308
17020,/images/57e1879e-4294-45e7-9c1b-627e8cca0271.png,121,1090,246,1209,125,119,red blood cell,14875,0.952,1.050420168067227
43492,/images/2d857091-efcd-41c0-ba3f-226de90445c4.png,386,1088,511,1190,125,102,red blood cell,12750,0.816,1.2254901960784315
74874,/images/81edcae1-65bf-4752-b0e4-494376b71e49.png,807,1121,898,1198,91,77,red blood cell,7007,0.8461538461538461,1.1818181818181819
1848,/images/8855c685-5a8c-4967-a356-942ed89e3471.png,520,250,641,366,121,116,red blood cell,14036,0.9586776859504132,1.043103448275862
31714,/images/bd432159-5956-457c-bdeb-1b5e702ba513.png,363,1398,499,1518,136,120,red blood cell,16320,0.8823529411764706,1.1333333333333333
25713,/images/412c9fa5-fcf4-402b-b1e4-3271f775058e.png,777,290,891,415,114,125,red blood cell,14250,1.0964912280701755,0.912
6465,/images/640c4a52-3742-4f57-aee3-9e3dc0887622.png,522,173,628,277,106,104,red blood cell,11024,0.9811320754716981,1.0192307692307692
6156,/images/cbec07ed-69d3-40e7-8b04-b3bd6680885b.png,480,555,610,683,130,128,red blood cell,16640,0.9846153846153847,1.015625
55508,/images/43072c64-4c08-47cd-ae8a-b74d31f80008.png,669,598,790,707,121,109,red blood cell,13189,0.9008264462809917,1.110091743119266
71360,/images/bcb447c9-5d37-414f-a513-d7076b04a532.png,711,797,816,899,105,102,red blood cell,10710,0.9714285714285714,1.0294117647058822
53074,/images/04a567df-5463-4043-81f1-d726223c19a9.png,234,1408,335,1508,101,100,red blood cell,10100,0.9900990099009901,1.01
75641,/images/50d7c6c9-3230-48fe-947c-7dcfd0aad710.png,788,643,888,759,100,116,red blood cell,11600,1.16,0.8620689655172413
65082,/images/5e042380-6ef2-496f-8231-0ca550fbfa71.png,1030,612,1116,707,86,95,red blood cell,8170,1.1046511627906976,0.9052631578947369
4774,/images/3fa1a4e3-c80d-49da-8f7b-a1abb0424f48.png,890,1148,983,1249,93,101,red blood cell,9393,1.086021505376344,0.9207920792079208
67582,/images/59542a24-b409-4c95-8608-d9691a741526.png,1007,951,1105,1057,98,106,red blood cell,10388,1.0816326530612246,0.9245283018867925
1829,/images/5f783f43-0090-4f8a-bd75-9562f4aa2dd5.png,187,839,277,928,90,89,red blood cell,8010,0.9888888888888889,1.0112359550561798
25568,/images/f6ab936d-924b-4038-aa47-71b07c26b4e2.png,438,1349,546,1472,108,123,red blood cell,13284,1.1388888888888888,0.8780487804878049
30953,/images/533c47c9-02a6-419b-961b-81797f022f6c.png,384,373,484,478,100,105,red blood cell,10500,1.05,0.9523809523809523
45294,/images/9e793460-d94c-47ac-b3a7-0d6ad86357da.png,822,1127,939,1256,117,129,red blood cell,15093,1.1025641025641026,0.9069767441860465
54556,/images/59dc7da9-35d1-421e-a61b-1e9637bfbfa1.png,990,65,1091,159,101,94,red blood cell,9494,0.9306930693069307,1.074468085106383
31359,/images/04fb49a2-07b8-4cdf-b6f7-df5c3688e5f8.png,266,1267,367,1382,101,115,red blood cell,11615,1.1386138613861385,0.8782608695652174
74893,/images/81edcae1-65bf-4752-b0e4-494376b71e49.png,585,1412,664,1498,79,86,red blood cell,6794,1.0886075949367089,0.9186046511627907
78599,/images/c5084fb8-2b62-464c-8a77-1a07ea653266.png,766,80,854,181,88,101,red blood cell,8888,1.1477272727272727,0.8712871287128713
61011,/images/3d1429ed-4619-41f7-8ff3-d698ad28034c.png,246,718,355,821,109,103,red blood cell,11227,0.944954128440367,1.058252427184466
325,/images/0dcca702-a4ef-4fb3-a940-9c0c140b21c7.png,772,838,881,948,109,110,red blood cell,11990,1.0091743119266054,0.990909090909091
70112,/images/c742ee2c-6814-46cd-af56-ae87bb9972f4.png,391,639,489,735,98,96,red blood cell,9408,0.9795918367346939,1.0208333333333333
719,/images/dcc1a193-7b74-44f8-ad8d-813751d8fa6b.png,37,1110,155,1233,118,123,red blood cell,14514,1.0423728813559323,0.959349593495935
44494,/images/b6573be3-9e04-49c3-9f48-6a145d065363.png,724,1220,825,1326,101,106,red blood cell,10706,1.0495049504950495,0.9528301886792453
19973,/images/8e69098c-fae0-47a3-8833-c2bfdfb1a416.png,992,770,1131,885,139,115,red blood cell,15985,0.8273381294964028,1.208695652173913
52445,/images/a2a20600-f851-4db7-90f9-6f7be027c8b5.png,127,1070,208,1154,81,84,red blood cell,6804,1.037037037037037,0.9642857142857143
61850,/images/5f300fd1-7eec-41ac-bbd1-0f4a943c757c.png,20,937,136,1043,116,106,red blood cell,12296,0.9137931034482759,1.0943396226415094
5604,/images/75c243e2-610d-4d5a-bc5a-4c53d99d9ae9.png,814,203,927,320,113,117,red blood cell,13221,1.0353982300884956,0.9658119658119658
36726,/images/aa2dfa24-2dc3-4279-a232-f84780ace190.png,44,1167,154,1285,110,118,red blood cell,12980,1.0727272727272728,0.9322033898305084
65065,/images/ff3b9d4d-373c-48ef-a75a-d23e2c2ade87.png,533,7,622,95,89,88,red blood cell,7832,0.9887640449438202,1.0113636363636365
74993,/images/b4c52960-bbee-439e-83dc-f89ddaade71b.png,727,408,834,522,107,114,red blood cell,12198,1.0654205607476634,0.9385964912280702
61705,/images/12269960-075f-40ca-9630-49ea2ce78294.png,1057,255,1178,357,121,102,red blood cell,12342,0.8429752066115702,1.1862745098039216
69696,/images/f0713bee-2a71-4ced-b953-4041ea99496a.png,218,695,308,789,90,94,red blood cell,8460,1.0444444444444445,0.9574468085106383
30744,/images/8e0dfc1f-e3eb-4a3f-a1c4-249bdfbfaa27.png,969,888,1092,1015,123,127,red blood cell,15621,1.032520325203252,0.968503937007874
70525,/images/8cca114a-ed05-4b87-95b7-fae02487f08c.png,268,121,361,222,93,101,red blood cell,9393,1.086021505376344,0.9207920792079208
52245,/images/4903d9c7-de88-426a-b42d-a7e797e5ebcd.png,476,1178,594,1288,118,110,red blood cell,12980,0.9322033898305084,1.0727272727272728
4217,/images/ac3358f1-ef9a-4ccc-b66c-da5e47e352e0.png,592,668,722,787,130,119,red blood cell,15470,0.9153846153846154,1.0924369747899159
67605,/images/59542a24-b409-4c95-8608-d9691a741526.png,527,609,619,692,92,83,red blood cell,7636,0.9021739130434783,1.108433734939759
24235,/images/bb3ae957-0f6d-4615-bfe5-24fbca50b459.png,10,692,135,808,125,116,red blood cell,14500,0.928,1.0775862068965518
30389,/images/58d75854-be99-484e-89f0-4ab208fe07e0.png,880,1179,1005,1305,125,126,red blood cell,15750,1.008,0.9920634920634921
1759,/images/5f783f43-0090-4f8a-bd75-9562f4aa2dd5.png,327,89,434,192,107,103,red blood cell,11021,0.9626168224299065,1.0388349514563107
58803,/images/434523fd-d4d9-4961-a7c2-d71d6ae68e13.png,600,166,701,280,101,114,red blood cell,11514,1.1287128712871286,0.8859649122807017
75233,/images/61dfc937-a428-44b4-94fb-d682bdb8dff0.png,1102,1376,1199,1472,97,96,red blood cell,9312,0.9896907216494846,1.0104166666666667
22139,/images/ca677c3c-083f-4d54-9dec-39f79f6a17d8.png,663,1251,770,1352,107,101,red blood cell,10807,0.9439252336448598,1.0594059405940595
72113,/images/64b0e49a-0e48-447d-8872-c1dd255e7a21.png,437,659,534,769,97,110,red blood cell,10670,1.134020618556701,0.8818181818181818
56796,/images/0dcbf2c9-f959-4703-a72b-f6a81e66c2ea.png,723,163,813,269,90,106,red blood cell,9540,1.1777777777777778,0.8490566037735849
50887,/images/0906111b-bac7-4541-a6dc-da435c0724a8.png,949,690,1053,795,104,105,red blood cell,10920,1.0096153846153846,0.9904761904761905
974,/images/a8cb75ba-3f2f-40d8-8bc7-c79ebd1b9603.png,953,642,1070,764,117,122,red blood cell,14274,1.0427350427350428,0.9590163934426229
10207,/images/e3ea07d7-884a-412e-874a-40fd6b856736.png,577,997,694,1127,117,130,red blood cell,15210,1.1111111111111112,0.9
8894,/images/29539cb0-1c52-46b2-9302-552f8349dc71.png,818,39,927,172,109,133,red blood cell,14497,1.2201834862385321,0.8195488721804511
45502,/images/e4eea7ea-8989-46a9-9c98-25a178146b28.png,1070,11,1168,103,98,92,red blood cell,9016,0.9387755102040817,1.065217391304348
38935,/images/d79b4e90-c45d-4f5d-a498-49c3e323c291.png,577,1168,680,1271,103,103,red blood cell,10609,1.0,1.0
72746,/images/caeb2d62-1166-43f0-8eac-5b8fc48f02eb.png,469,977,582,1092,113,115,red blood cell,12995,1.0176991150442478,0.9826086956521739
33541,/images/255d5f0c-87fc-4337-bb51-07c440df4f1b.png,82,1221,193,1338,111,117,red blood cell,12987,1.054054054054054,0.9487179487179487
59849,/images/1519257c-e3e5-4474-908f-8665b3cf1258.png,182,1217,291,1332,109,115,red blood cell,12535,1.055045871559633,0.9478260869565217
72475,/images/22516db4-8687-4051-90c4-2bb1ca3204a5.png,250,1263,369,1377,119,114,red blood cell,13566,0.957983193277311,1.043859649122807
22622,/images/406e05f0-4444-414c-bb40-f4cb08e75ac9.png,144,1165,267,1284,123,119,red blood cell,14637,0.967479674796748,1.0336134453781514
34208,/images/f1cda808-69a9-4d10-ba0a-6607c98e362d.png,990,700,1091,789,101,89,red blood cell,8989,0.8811881188118812,1.1348314606741574
27976,/images/c4d34e35-4db2-41de-ba77-1a94aa9ef788.png,1069,1358,1182,1483,113,125,red blood cell,14125,1.1061946902654867,0.904
65435,/images/b523daee-317b-461d-bdc1-07b4add4d488.png,630,622,717,727,87,105,red blood cell,9135,1.206896551724138,0.8285714285714286
42850,/images/7029feb3-9ffe-46e4-9883-6a9df84f7b62.png,1070,247,1165,365,95,118,red blood cell,11210,1.2421052631578948,0.8050847457627118
19147,/images/bb795ddf-ce72-42d5-9006-124db4d5cf1c.png,953,1443,1055,1542,102,99,red blood cell,10098,0.9705882352941176,1.0303030303030303
60752,/images/645cd195-af50-409f-8da9-6e7c7f18ea09.png,54,456,152,557,98,101,red blood cell,9898,1.030612244897959,0.9702970297029703
25697,/images/c118ff18-f9f2-4617-bddb-dc4091fb8f5f.png,719,583,844,697,125,114,red blood cell,14250,0.912,1.0964912280701755
14427,/images/3b13e20f-ec0d-44ec-b2f4-eaebfa09150e.png,88,1322,194,1436,106,114,red blood cell,12084,1.0754716981132075,0.9298245614035088
68805,/images/aa3ad405-828e-4986-8251-20fd981f34d3.png,1016,185,1127,311,111,126,red blood cell,13986,1.135135135135135,0.8809523809523809
67828,/images/04de3a31-fc09-40be-9c2c-9830c57f809d.png,468,494,569,597,101,103,red blood cell,10403,1.0198019801980198,0.9805825242718447
5203,/images/16a51468-9f93-45df-9ae2-5a74c25c5a4b.png,332,183,457,301,125,118,red blood cell,14750,0.944,1.0593220338983051
61679,/images/a3c0a876-be12-4ede-8aed-18b32a64401b.png,229,218,349,315,120,97,red blood cell,11640,0.8083333333333333,1.2371134020618557
51680,/images/592c941a-aa54-4971-b499-dc47356f80a3.png,257,783,359,887,102,104,red blood cell,10608,1.0196078431372548,0.9807692307692307
56985,/images/003d1cdc-0aec-430b-90e0-f4d82135b1ac.png,273,1380,404,1492,131,112,red blood cell,14672,0.8549618320610687,1.1696428571428572
64187,/images/2a91387a-d30f-418d-ac3a-f7cfa6836261.png,840,626,931,724,91,98,red blood cell,8918,1.0769230769230769,0.9285714285714286
76412,/images/34df8890-272d-423a-ae78-ff8d068d3306.png,182,282,299,390,117,108,red blood cell,12636,0.9230769230769231,1.0833333333333333
14364,/images/f5eb7c5e-bd77-4638-ba9f-58d42f87476b.png,660,476,780,592,120,116,red blood cell,13920,0.9666666666666667,1.0344827586206897
34676,/images/8d989997-038c-4924-b2d3-d02629a7cdf5.png,14,1156,155,1291,141,135,red blood cell,19035,0.9574468085106383,1.0444444444444445
37212,/images/71881a39-a30c-40c7-8c4a-9f64c93e79d9.png,482,132,595,237,113,105,red blood cell,11865,0.9292035398230089,1.0761904761904761
36064,/images/ca9626bc-21a4-46f4-ba94-e7ee7a4cf735.png,1069,818,1197,927,128,109,red blood cell,13952,0.8515625,1.1743119266055047
66553,/images/b87fb62d-2c36-4f68-aba9-37fcd7d46eef.png,82,791,188,896,106,105,red blood cell,11130,0.9905660377358491,1.0095238095238095
19428,/images/5487faad-24a7-46b6-92d8-479d3a8d229f.png,884,1430,984,1530,100,100,red blood cell,10000,1.0,1.0
34741,/images/6294153c-6db3-4f2b-a8ff-9c087225e737.png,484,292,600,419,116,127,red blood cell,14732,1.0948275862068966,0.9133858267716536
74423,/images/06a3effb-996c-4767-afd2-6aa3b697cb4e.png,145,27,223,106,78,79,red blood cell,6162,1.0128205128205128,0.9873417721518988
65147,/images/5e042380-6ef2-496f-8231-0ca550fbfa71.png,811,1093,891,1188,80,95,red blood cell,7600,1.1875,0.8421052631578947
35740,/images/4063945d-03fc-4ce3-a04c-17435dce8f91.png,779,1449,889,1552,110,103,red blood cell,11330,0.9363636363636364,1.0679611650485437
423,/images/84c88143-940d-4b62-bbd2-7acc4cadcb6b.png,977,513,1098,637,121,124,red blood cell,15004,1.024793388429752,0.9758064516129032
40685,/images/252071ac-e9f2-41d2-abbb-87ef01b8a997.png,98,1388,193,1481,95,93,red blood cell,8835,0.9789473684210527,1.021505376344086
56677,/images/89b3d781-2f81-4d23-bed4-84da064df7f3.png,33,638,142,755,109,117,red blood cell,12753,1.073394495412844,0.9316239316239316
64435,/images/34a70114-d3e3-4351-b8db-f6caab17e743.png,317,482,415,590,98,108,red blood cell,10584,1.1020408163265305,0.9074074074074074
57889,/images/f4c2b43f-a2e7-4746-8034-0b34aebba8ee.png,492,180,600,287,108,107,red blood cell,11556,0.9907407407407407,1.0093457943925233
25434,/images/5f742392-278d-461c-a848-08def2c28878.png,106,1366,216,1474,110,108,red blood cell,11880,0.9818181818181818,1.0185185185185186
27738,/images/e3c1442a-717f-41dd-bf97-81e1233ac9fa.png,71,404,175,518,104,114,red blood cell,11856,1.0961538461538463,0.9122807017543859
75116,/images/7fdc8be8-7579-4a5c-b369-8a07ee0a8b7d.png,464,179,569,305,105,126,red blood cell,13230,1.2,0.8333333333333334
61806,/images/985627c9-7b85-40de-a106-eb9cc47b47cb.png,267,138,357,213,90,75,red blood cell,6750,0.8333333333333334,1.2
48434,/images/0fa5b35d-6c44-4207-b6f8-d5b355086b5f.png,201,167,311,281,110,114,red blood cell,12540,1.0363636363636364,0.9649122807017544
59161,/images/4736f545-1f1f-4d77-9241-d69cbf4dae35.png,791,1381,888,1492,97,111,red blood cell,10767,1.1443298969072164,0.8738738738738738
54298,/images/3b5a8060-dec6-4a83-b7f2-b604e4e69dfc.png,263,318,366,405,103,87,red blood cell,8961,0.8446601941747572,1.1839080459770115
23538,/images/177f883a-f0f1-4b8e-b598-2ca4bab27381.png,937,988,1056,1113,119,125,red blood cell,14875,1.050420168067227,0.952
51476,/images/baa87bf8-786c-444c-81e8-9fa0a41d8149.png,357,153,464,263,107,110,red blood cell,11770,1.02803738317757,0.9727272727272728
28591,/images/dbdfad64-110c-421f-a1c7-f68fd9e82d67.png,950,1466,1051,1580,101,114,red blood cell,11514,1.1287128712871286,0.8859649122807017
73563,/images/7624ac36-1cf9-42fb-844d-376078309553.png,662,28,782,147,120,119,red blood cell,14280,0.9916666666666667,1.0084033613445378
39662,/images/04d21589-b777-43c2-86b5-038cbf8c3a4e.png,824,1485,909,1589,85,104,red blood cell,8840,1.223529411764706,0.8173076923076923
57091,/images/7d041c38-11f2-4186-8a24-29d7d0f5c3cf.png,84,502,198,618,114,116,red blood cell,13224,1.0175438596491229,0.9827586206896551
18259,/images/947348fe-4c70-468e-8009-3c14daeca69b.png,475,912,588,1004,113,92,red blood cell,10396,0.8141592920353983,1.2282608695652173
21387,/images/5077f87d-a19f-494c-b911-14ccb03bd230.png,422,1289,537,1395,115,106,red blood cell,12190,0.9217391304347826,1.0849056603773586
73367,/images/c890ee00-daa5-4b20-9cd5-930748ecc4e0.png,1030,697,1126,786,96,89,red blood cell,8544,0.9270833333333334,1.0786516853932584
79236,/images/eb0173a3-7e5e-4f53-8124-03d9d6317844.png,535,236,638,340,103,104,red blood cell,10712,1.0097087378640777,0.9903846153846154
1287,/images/6d91d1f0-636b-4f5a-a526-7c17fc857190.png,146,1083,242,1166,96,83,red blood cell,7968,0.8645833333333334,1.1566265060240963
16407,/images/e474a20b-2769-48f1-a520-4f6ef5a0dbf5.png,556,693,651,780,95,87,red blood cell,8265,0.9157894736842105,1.0919540229885059
48127,/images/05717db9-f1ef-4101-a9f7-7a007e83b1c9.png,472,1493,583,1592,111,99,red blood cell,10989,0.8918918918918919,1.121212121212121
30438,/images/dedbb10c-43f1-45fb-bb40-3ce2fb874015.png,676,1070,780,1194,104,124,red blood cell,12896,1.1923076923076923,0.8387096774193549
36915,/images/b2e34f5f-904e-4473-9dc7-c6bc1ce12640.png,535,1060,635,1157,100,97,red blood cell,9700,0.97,1.0309278350515463
62405,/images/9af1ee02-87fd-42bc-963e-fa9ac3eb45bb.png,873,93,966,194,93,101,red blood cell,9393,1.086021505376344,0.9207920792079208
53080,/images/04a567df-5463-4043-81f1-d726223c19a9.png,282,445,390,550,108,105,red blood cell,11340,0.9722222222222222,1.0285714285714285
13573,/images/370277f8-436b-4103-8210-b4feb5ab95ea.png,140,1129,240,1216,100,87,red blood cell,8700,0.87,1.1494252873563218
34901,/images/a4fbb9f2-9b75-4fdc-877d-2feaafac25b3.png,602,754,700,862,98,108,red blood cell,10584,1.1020408163265305,0.9074074074074074
78636,/images/3612aa3b-2906-44a6-9c80-6144511a35ce.png,290,235,379,341,89,106,red blood cell,9434,1.1910112359550562,0.839622641509434
55353,/images/4fb83278-adc5-4424-9f45-b6d0db2955b6.png,765,1483,873,1588,108,105,red blood cell,11340,0.9722222222222222,1.0285714285714285
14550,/images/458cb2e9-5a7f-437c-ac5d-a56f98a3efdf.png,606,930,708,1024,102,94,red blood cell,9588,0.9215686274509803,1.0851063829787233
72528,/images/01b99da8-b66b-464b-a7ee-1cadab8db18b.png,898,750,1023,871,125,121,red blood cell,15125,0.968,1.0330578512396693
52430,/images/a2a20600-f851-4db7-90f9-6f7be027c8b5.png,261,1444,376,1550,115,106,red blood cell,12190,0.9217391304347826,1.0849056603773586
44648,/images/8002cb71-0f25-4fa4-a46f-b49e5aeded0c.png,724,761,842,863,118,102,red blood cell,12036,0.864406779661017,1.1568627450980393
16833,/images/4823c1fe-a7f9-4b92-959f-0d9be09cd14b.png,723,1491,820,1579,97,88,red blood cell,8536,0.9072164948453608,1.1022727272727273
7125,/images/64a678d4-9048-4491-90c7-1924f38be19a.png,645,394,753,510,108,116,red blood cell,12528,1.0740740740740742,0.9310344827586207
49199,/images/a9daf82a-a46d-4296-bd72-2c374ed0a193.png,531,1505,632,1599,101,94,red blood cell,9494,0.9306930693069307,1.074468085106383
65359,/images/24418314-f7a4-49fc-a03e-ec597ca6796e.png,839,999,934,1093,95,94,red blood cell,8930,0.9894736842105263,1.0106382978723405
24142,/images/505355c9-23bf-4f90-8ebc-6a7ef50964d0.png,405,1134,516,1258,111,124,red blood cell,13764,1.117117117117117,0.8951612903225806
26691,/images/c1423156-82b3-4dd3-8e74-08eb7ed8e1d6.png,727,362,849,480,122,118,red blood cell,14396,0.9672131147540983,1.0338983050847457
18010,/images/eb77e4a9-acb0-4d83-8055-2c5fcaa54b45.png,1097,1362,1195,1456,98,94,red blood cell,9212,0.9591836734693877,1.0425531914893618
52336,/images/a86e0647-ae41-4b75-9d45-dd58f5ea65f5.png,805,805,901,922,96,117,red blood cell,11232,1.21875,0.8205128205128205
67694,/images/2b128a1a-95ed-408b-b9f8-8795cc814d80.png,725,528,814,630,89,102,red blood cell,9078,1.146067415730337,0.8725490196078431
1301,/images/6d91d1f0-636b-4f5a-a526-7c17fc857190.png,532,601,633,713,101,112,red blood cell,11312,1.108910891089109,0.9017857142857143
64600,/images/6dfafdf1-f588-4e80-8cf8-0126e1bf7af9.png,340,207,448,321,108,114,red blood cell,12312,1.0555555555555556,0.9473684210526315
24435,/images/b78ba2c8-ecb3-45b2-9cda-2c8088fa95d1.png,943,241,1049,349,106,108,red blood cell,11448,1.0188679245283019,0.9814814814814815
53053,/images/69b5b3de-ec64-4e5d-bcc2-44f495e06e76.png,832,190,939,291,107,101,red blood cell,10807,0.9439252336448598,1.0594059405940595
23705,/images/79d7a014-21ff-40f1-9ac4-a69839390654.png,841,1216,940,1326,99,110,red blood cell,10890,1.1111111111111112,0.9
12454,/images/cc94eabb-a3dc-4cfc-9fff-55c76b5b4a71.png,732,704,827,795,95,91,red blood cell,8645,0.9578947368421052,1.043956043956044
35221,/images/a9159b11-ba49-4885-902e-00c8d5095b98.png,849,1238,952,1346,103,108,red blood cell,11124,1.0485436893203883,0.9537037037037037
21691,/images/81af1442-d835-46bf-b80b-a898dba3da1b.png,366,1297,475,1430,109,133,red blood cell,14497,1.2201834862385321,0.8195488721804511
74011,/images/99a21c5c-f5a7-4c07-9cb6-5dda2d388f48.png,1037,1340,1114,1415,77,75,red blood cell,5775,0.974025974025974,1.0266666666666666
4398,/images/84041bf9-dace-4066-9fe0-52170d08f826.png,0,771,122,887,122,116,red blood cell,14152,0.9508196721311475,1.0517241379310345
20028,/images/ebfd9f67-138e-49f0-9cef-a0352069eedb.png,331,708,428,822,97,114,red blood cell,11058,1.175257731958763,0.8508771929824561
34871,/images/a4fbb9f2-9b75-4fdc-877d-2feaafac25b3.png,77,990,207,1096,130,106,red blood cell,13780,0.8153846153846154,1.2264150943396226
79130,/images/1c90231b-2830-42d9-884e-7301edb16933.png,852,191,954,287,102,96,red blood cell,9792,0.9411764705882353,1.0625
45610,/images/582e4b8b-404e-4b30-9df3-66f2afb3cdb3.png,515,1134,621,1258,106,124,red blood cell,13144,1.169811320754717,0.8548387096774194
77478,/images/a11ed7d0-12f6-468f-abad-5cba7d968123.png,970,1215,1062,1326,92,111,red blood cell,10212,1.2065217391304348,0.8288288288288288
70597,/images/4ce5a070-9ede-4bb1-9ca2-1bae5746776b.png,496,1384,594,1482,98,98,red blood cell,9604,1.0,1.0
32615,/images/ed0d8763-e734-4506-b61b-53fc32a8d8c9.png,765,184,875,305,110,121,red blood cell,13310,1.1,0.9090909090909091
59640,/images/a2754679-68b0-40f4-be01-bafad5ac1261.png,554,355,674,468,120,113,red blood cell,13560,0.9416666666666667,1.0619469026548674
60321,/images/1c87b997-a8e6-48ca-bf40-19b9a7fd6a96.png,1010,119,1137,239,127,120,red blood cell,15240,0.9448818897637795,1.0583333333333333
7021,/images/8be185e7-2a1a-441c-a5c7-b50a9eb926cb.png,286,1189,388,1299,102,110,red blood cell,11220,1.0784313725490196,0.9272727272727272
6361,/images/f06ba705-5509-479b-8067-127ffb37c5b6.png,545,1020,680,1160,135,140,red blood cell,18900,1.037037037037037,0.9642857142857143
45493,/images/e4eea7ea-8989-46a9-9c98-25a178146b28.png,432,791,514,892,82,101,red blood cell,8282,1.2317073170731707,0.8118811881188119
2015,/images/bfefa21c-11e1-4dab-ac5d-8ff6f046d65f.png,1068,24,1194,152,126,128,red blood cell,16128,1.0158730158730158,0.984375
59891,/images/1519257c-e3e5-4474-908f-8665b3cf1258.png,823,779,910,871,87,92,red blood cell,8004,1.0574712643678161,0.9456521739130435
71772,/images/093a831a-bf71-4333-bc06-942ae70cb164.png,33,184,147,285,114,101,red blood cell,11514,0.8859649122807017,1.1287128712871286
74184,/images/4e43fc22-dc08-4cde-b3ce-ce8a4f377c47.png,886,984,970,1070,84,86,red blood cell,7224,1.0238095238095237,0.9767441860465116
41553,/images/0fcd1ebe-ee4a-40a0-b787-29cee18bfa1b.png,278,1479,392,1581,114,102,red blood cell,11628,0.8947368421052632,1.1176470588235294
3008,/images/5a386082-397f-4524-a6f9-c2b8efe5014d.png,870,759,984,873,114,114,red blood cell,12996,1.0,1.0
22560,/images/bfe65b11-8aff-46aa-908b-1e989d25fdc4.png,595,847,710,964,115,117,red blood cell,13455,1.017391304347826,0.9829059829059829
10506,/images/46a2d369-4bea-4405-ac78-91bbe130b9a7.png,402,1513,498,1598,96,85,red blood cell,8160,0.8854166666666666,1.1294117647058823
50507,/images/79f2fbab-169d-4062-820d-3dfd12f062c8.png,425,1472,542,1579,117,107,red blood cell,12519,0.9145299145299145,1.0934579439252337
79131,/images/1c90231b-2830-42d9-884e-7301edb16933.png,10,554,118,659,108,105,red blood cell,11340,0.9722222222222222,1.0285714285714285
41788,/images/28bd16ba-2bcf-46af-b889-41b78d2a50c0.png,21,140,138,271,117,131,red blood cell,15327,1.1196581196581197,0.8931297709923665
22632,/images/4ab47131-c2ac-461f-b95c-ac19ce24edbd.png,718,1097,818,1202,100,105,red blood cell,10500,1.05,0.9523809523809523
74704,/images/5ccca8ee-abea-458a-a891-bedd31c3ddc3.png,595,956,715,1061,120,105,red blood cell,12600,0.875,1.1428571428571428
32160,/images/25cfca07-2101-484f-b312-a927395f2651.png,588,1047,688,1165,100,118,red blood cell,11800,1.18,0.847457627118644
31860,/images/f62d4fb6-df7c-446c-94a8-d5aede0b1e0c.png,81,258,175,366,94,108,red blood cell,10152,1.148936170212766,0.8703703703703703
4615,/images/9615ff33-b3fc-4d1e-9c05-0b8e3ef936df.png,775,1025,894,1159,119,134,red blood cell,15946,1.1260504201680672,0.8880597014925373
5179,/images/16a51468-9f93-45df-9ae2-5a74c25c5a4b.png,265,785,359,890,94,105,red blood cell,9870,1.1170212765957446,0.8952380952380953
58836,/images/434523fd-d4d9-4961-a7c2-d71d6ae68e13.png,413,724,497,819,84,95,red blood cell,7980,1.130952380952381,0.8842105263157894
27806,/images/e3c1442a-717f-41dd-bf97-81e1233ac9fa.png,158,963,265,1059,107,96,red blood cell,10272,0.897196261682243,1.1145833333333333
68768,/images/eb5f4f2f-2275-4a80-84a5-78a1eaf4ce4d.png,204,1114,307,1216,103,102,red blood cell,10506,0.9902912621359223,1.0098039215686274
56790,/images/0dcbf2c9-f959-4703-a72b-f6a81e66c2ea.png,143,45,250,154,107,109,red blood cell,11663,1.0186915887850467,0.981651376146789
14472,/images/3b13e20f-ec0d-44ec-b2f4-eaebfa09150e.png,1067,1288,1190,1417,123,129,red blood cell,15867,1.048780487804878,0.9534883720930233
26929,/images/71bbdc58-11af-41f2-9a93-3fe9257c5cf3.png,498,1308,610,1438,112,130,red blood cell,14560,1.1607142857142858,0.8615384615384616
66229,/images/14005767-9296-4b48-8a9d-bbe9b2040005.png,369,379,462,494,93,115,red blood cell,10695,1.2365591397849462,0.808695652173913
5953,/images/e0e6b676-c39c-4542-8adf-de257a8e92e2.png,675,1070,788,1207,113,137,red blood cell,15481,1.2123893805309736,0.8248175182481752
8218,/images/65e3d6a6-012c-4b40-9a42-83078eb85e31.png,824,496,932,604,108,108,red blood cell,11664,1.0,1.0
66415,/images/e5fd5949-4cd0-4cb6-837a-02c26a5eb87a.png,133,704,246,824,113,120,red blood cell,13560,1.0619469026548674,0.9416666666666667
32168,/images/25cfca07-2101-484f-b312-a927395f2651.png,614,373,731,488,117,115,red blood cell,13455,0.9829059829059829,1.017391304347826
74255,/images/4e43fc22-dc08-4cde-b3ce-ce8a4f377c47.png,0,746,70,816,70,70,red blood cell,4900,1.0,1.0
15738,/images/64113b22-03b1-4ab8-89ab-b2f32154fbbd.png,352,661,454,786,102,125,red blood cell,12750,1.2254901960784315,0.816
32463,/images/3911fcd2-4e26-4ad9-aaf0-d1c5bf41defc.png,1086,586,1196,700,110,114,red blood cell,12540,1.0363636363636364,0.9649122807017544
65677,/images/397f37bc-a3a4-4257-9430-c8fc5716f8b1.png,929,420,1030,518,101,98,red blood cell,9898,0.9702970297029703,1.030612244897959
28537,/images/dbdfad64-110c-421f-a1c7-f68fd9e82d67.png,502,458,595,567,93,109,red blood cell,10137,1.1720430107526882,0.8532110091743119
56924,/images/a93c35ba-1690-4358-8837-669bcd850bb7.png,360,660,486,782,126,122,red blood cell,15372,0.9682539682539683,1.0327868852459017
24846,/images/93f7e207-0d8e-47f8-8258-09a0e03dbdd6.png,592,557,696,677,104,120,red blood cell,12480,1.1538461538461537,0.8666666666666667
74483,/images/cbb58718-6319-48db-b84b-78ac9b12ff89.png,170,1034,272,1140,102,106,red blood cell,10812,1.0392156862745099,0.9622641509433962
73388,/images/c890ee00-daa5-4b20-9cd5-930748ecc4e0.png,446,1034,551,1124,105,90,red blood cell,9450,0.8571428571428571,1.1666666666666667
71278,/images/445d0db9-e830-4ceb-a845-b23d819e6097.png,614,1322,700,1427,86,105,red blood cell,9030,1.2209302325581395,0.819047619047619
44068,/images/8b494b40-cab5-49d3-893d-c805000fbe88.png,394,1488,479,1585,85,97,red blood cell,8245,1.1411764705882352,0.8762886597938144
53755,/images/76b24246-8571-4e7b-8815-b185414a2c51.png,1024,604,1114,695,90,91,red blood cell,8190,1.011111111111111,0.989010989010989
78578,/images/c5084fb8-2b62-464c-8a77-1a07ea653266.png,1016,483,1111,585,95,102,red blood cell,9690,1.0736842105263158,0.9313725490196079
44578,/images/6388e241-09a2-4fbe-a712-07d8fe714c51.png,49,1133,178,1270,129,137,red blood cell,17673,1.062015503875969,0.9416058394160584
22172,/images/ca677c3c-083f-4d54-9dec-39f79f6a17d8.png,467,160,577,269,110,109,red blood cell,11990,0.990909090909091,1.0091743119266054
28789,/images/686ed568-d5f8-475e-81ad-edab9dd473a0.png,697,656,798,758,101,102,red blood cell,10302,1.00990099009901,0.9901960784313726
35242,/images/a9159b11-ba49-4885-902e-00c8d5095b98.png,915,1474,1010,1566,95,92,red blood cell,8740,0.968421052631579,1.0326086956521738
74999,/images/b4c52960-bbee-439e-83dc-f89ddaade71b.png,44,830,157,932,113,102,red blood cell,11526,0.9026548672566371,1.107843137254902
45534,/images/e597f7ce-46c6-4dce-9063-50a2703fdd45.png,492,1344,591,1440,99,96,red blood cell,9504,0.9696969696969697,1.03125
55767,/images/68f34a9c-f73d-4238-8f55-4b05a8a2154c.png,273,1180,377,1287,104,107,red blood cell,11128,1.0288461538461537,0.9719626168224299
3232,/images/96596a68-8c95-43f3-b74e-e9506c235144.png,1086,41,1183,135,97,94,red blood cell,9118,0.9690721649484536,1.0319148936170213
71670,/images/5c99cd97-39f6-4809-9528-9d380cc16b16.png,641,1246,726,1351,85,105,red blood cell,8925,1.2352941176470589,0.8095238095238095
78073,/images/105af41b-13cc-4ad1-8a1f-8bc4d47cdd94.png,444,1010,557,1127,113,117,red blood cell,13221,1.0353982300884956,0.9658119658119658
41940,/images/46a03374-64c7-49ac-81c9-c3d62542bbf3.png,1059,584,1163,682,104,98,red blood cell,10192,0.9423076923076923,1.0612244897959184
70762,/images/8ab5c462-045e-4b59-b53a-9b2bc3ed2487.png,514,1499,591,1577,77,78,red blood cell,6006,1.0129870129870129,0.9871794871794872
64529,/images/6ba5d0b8-cdc7-4266-9d78-db76faa312e9.png,612,1016,716,1123,104,107,red blood cell,11128,1.0288461538461537,0.9719626168224299
75072,/images/073c10c9-5749-44b5-b08b-1be556a960f0.png,405,1240,527,1351,122,111,red blood cell,13542,0.9098360655737705,1.0990990990990992
11985,/images/ca16a5ad-b106-4e84-8a43-178710e854ba.png,318,1298,456,1431,138,133,red blood cell,18354,0.9637681159420289,1.037593984962406
68928,/images/bbaa004f-05dc-4cb8-8768-e148085bb0f9.png,943,1072,1046,1184,103,112,red blood cell,11536,1.087378640776699,0.9196428571428571
77587,/images/f20a4fcf-ea8e-4c14-883d-d26a9e08ce25.png,231,349,349,453,118,104,red blood cell,12272,0.8813559322033898,1.1346153846153846
39210,/images/2aeb7b85-7df9-4a63-8d37-2eecaaa190e7.png,26,178,146,282,120,104,red blood cell,12480,0.8666666666666667,1.1538461538461537
21472,/images/b701b5c5-b922-4315-b12a-aac4ec65ee8b.png,623,866,727,954,104,88,red blood cell,9152,0.8461538461538461,1.1818181818181819
26703,/images/c1423156-82b3-4dd3-8e74-08eb7ed8e1d6.png,294,381,414,500,120,119,red blood cell,14280,0.9916666666666667,1.0084033613445378
66504,/images/b87fb62d-2c36-4f68-aba9-37fcd7d46eef.png,22,107,133,216,111,109,red blood cell,12099,0.9819819819819819,1.018348623853211
36293,/images/81fed4a1-9d48-4938-90c9-c8bf3f5e6b1f.png,508,1300,606,1405,98,105,red blood cell,10290,1.0714285714285714,0.9333333333333333
19243,/images/b4d22412-a495-43a9-bec0-73a2322f8dad.png,772,1264,881,1371,109,107,red blood cell,11663,0.981651376146789,1.0186915887850467
21354,/images/5077f87d-a19f-494c-b911-14ccb03bd230.png,671,1446,781,1570,110,124,red blood cell,13640,1.1272727272727272,0.8870967741935484
31831,/images/f62d4fb6-df7c-446c-94a8-d5aede0b1e0c.png,459,623,572,723,113,100,red blood cell,11300,0.8849557522123894,1.13
61197,/images/0da07970-3146-479c-8a07-f61ed32814a9.png,737,54,839,154,102,100,red blood cell,10200,0.9803921568627451,1.02
31220,/images/1976cd04-d24f-457c-b423-7e4cdb05de9e.png,1001,1428,1095,1545,94,117,red blood cell,10998,1.2446808510638299,0.8034188034188035
30933,/images/533c47c9-02a6-419b-961b-81797f022f6c.png,871,562,992,686,121,124,red blood cell,15004,1.024793388429752,0.9758064516129032
13301,/images/030f3421-ed3f-4bf1-8f27-4d02590bffbc.png,1035,1381,1139,1485,104,104,red blood cell,10816,1.0,1.0
10746,/images/20d4f65e-6c63-433a-935c-d568d577967b.png,430,750,523,857,93,107,red blood cell,9951,1.1505376344086022,0.8691588785046729
22494,/images/dd60b6a7-c545-45b9-8250-d1633aa1ac75.png,124,700,224,820,100,120,red blood cell,12000,1.2,0.8333333333333334
3807,/images/3e764461-22ee-44d3-925d-cd658ff7d154.png,291,770,411,892,120,122,red blood cell,14640,1.0166666666666666,0.9836065573770492
34030,/images/1012abf2-cb05-4337-86c5-513ec4ca904d.png,536,113,637,216,101,103,red blood cell,10403,1.0198019801980198,0.9805825242718447
50602,/images/e98ea067-82b5-4a0d-87bf-b4bbdc10ddab.png,584,777,699,890,115,113,red blood cell,12995,0.9826086956521739,1.0176991150442478
79363,/images/dcb21739-3c36-459d-b3cc-1be5871d6fe7.png,527,693,622,790,95,97,red blood cell,9215,1.0210526315789474,0.979381443298969
15665,/images/3892b776-f49a-4368-b0fa-7e855e76ccec.png,441,311,549,423,108,112,red blood cell,12096,1.037037037037037,0.9642857142857143
63660,/images/d9c9479e-f1ea-4d6e-861f-843ff9a90d19.png,9,309,111,422,102,113,red blood cell,11526,1.107843137254902,0.9026548672566371
40409,/images/db249e5a-4142-432c-8288-bacd10d7273d.png,887,321,1001,445,114,124,red blood cell,14136,1.087719298245614,0.9193548387096774
65416,/images/b523daee-317b-461d-bdc1-07b4add4d488.png,772,839,884,948,112,109,red blood cell,12208,0.9732142857142857,1.0275229357798166
57238,/images/ca5e6a15-ba65-48ea-8913-2d986e71bf3a.png,947,597,1045,701,98,104,red blood cell,10192,1.0612244897959184,0.9423076923076923
36969,/images/b2e34f5f-904e-4473-9dc7-c6bc1ce12640.png,560,940,658,1054,98,114,red blood cell,11172,1.163265306122449,0.8596491228070176
5687,/images/d3dcdf92-9328-4796-adf4-918646877ba1.png,709,563,809,664,100,101,red blood cell,10100,1.01,0.9900990099009901
17556,/images/e80bad38-66d0-473e-85dd-92142dba37e6.png,917,1399,1031,1527,114,128,red blood cell,14592,1.1228070175438596,0.890625
20808,/images/c2ec116f-f091-422c-926c-70b548a8f6ef.png,402,208,509,327,107,119,red blood cell,12733,1.1121495327102804,0.8991596638655462
68606,/images/31653d0f-c4e6-4e12-8005-518c2de34687.png,1066,36,1169,128,103,92,red blood cell,9476,0.8932038834951457,1.1195652173913044
69990,/images/3e36698f-8c09-4c8b-8948-737310bf97e5.png,833,1092,951,1210,118,118,red blood cell,13924,1.0,1.0
79603,/images/161978c3-3a05-47a5-9fee-be7d25693eae.png,1,1267,79,1340,78,73,red blood cell,5694,0.9358974358974359,1.0684931506849316
29343,/images/3850f2a5-ab62-49d3-8135-68d60baa676b.png,852,92,977,215,125,123,red blood cell,15375,0.984,1.016260162601626
36307,/images/81fed4a1-9d48-4938-90c9-c8bf3f5e6b1f.png,524,1176,643,1302,119,126,red blood cell,14994,1.0588235294117647,0.9444444444444444
60831,/images/0ab56f9a-846d-49e2-a617-c6cc477fdfad.png,854,1255,978,1371,124,116,red blood cell,14384,0.9354838709677419,1.0689655172413792
22883,/images/be779f52-0bfa-4c01-a16f-b7f0bc92ed7c.png,522,641,641,766,119,125,red blood cell,14875,1.050420168067227,0.952
39623,/images/04d21589-b777-43c2-86b5-038cbf8c3a4e.png,65,1189,190,1307,125,118,red blood cell,14750,0.944,1.0593220338983051
72095,/images/64b0e49a-0e48-447d-8872-c1dd255e7a21.png,629,543,727,652,98,109,red blood cell,10682,1.1122448979591837,0.8990825688073395
11092,/images/98175327-da9e-4e0c-8912-ee68490a4672.png,646,201,748,298,102,97,red blood cell,9894,0.9509803921568627,1.0515463917525774
457,/images/c6d97845-8ad2-4ab7-b385-66613628df5b.png,9,311,147,426,138,115,red blood cell,15870,0.8333333333333334,1.2
1439,/images/5f17d2fb-22fa-4aa6-9dad-6a1d50c03815.png,139,141,269,258,130,117,red blood cell,15210,0.9,1.1111111111111112
71034,/images/59daa25e-85d6-42f2-8f39-cc9f9d5d252e.png,892,1119,1008,1226,116,107,red blood cell,12412,0.9224137931034483,1.0841121495327102
38484,/images/aa4a023b-55bd-4259-b15d-7086a9b491e0.png,929,895,1056,1019,127,124,red blood cell,15748,0.9763779527559056,1.0241935483870968
16271,/images/d5009906-bce1-4353-90b4-f4c79362f4cf.png,788,807,900,936,112,129,red blood cell,14448,1.1517857142857142,0.8682170542635659
74527,/images/cbb58718-6319-48db-b84b-78ac9b12ff89.png,671,1420,759,1508,88,88,red blood cell,7744,1.0,1.0
22005,/images/c5acd0ad-b0f2-478d-b0ad-5aa733aa7b32.png,167,1361,289,1490,122,129,red blood cell,15738,1.0573770491803278,0.9457364341085271
6090,/images/c147584d-4c61-412a-bdaf-b02b22c18708.png,160,946,275,1054,115,108,red blood cell,12420,0.9391304347826087,1.0648148148148149
17209,/images/471f75c6-bd5d-4c20-bcc1-258e836f4d69.png,53,340,165,458,112,118,red blood cell,13216,1.0535714285714286,0.9491525423728814
41260,/images/eed298b3-35f2-4127-88ad-0c4a9062207b.png,868,719,953,809,85,90,red blood cell,7650,1.0588235294117647,0.9444444444444444
49242,/images/989d86a1-6d76-4089-85cf-2f2ca0a8456c.png,968,107,1091,231,123,124,red blood cell,15252,1.008130081300813,0.9919354838709677
30688,/images/f939782b-f5a2-40a3-9c22-6c6d7e18edc3.png,988,1290,1072,1385,84,95,red blood cell,7980,1.130952380952381,0.8842105263157894
17642,/images/70a95e58-ba60-4c1f-adcd-49c198dc2ba0.png,436,952,521,1045,85,93,red blood cell,7905,1.0941176470588236,0.9139784946236559
78564,/images/c5084fb8-2b62-464c-8a77-1a07ea653266.png,119,956,241,1080,122,124,red blood cell,15128,1.0163934426229508,0.9838709677419355
9398,/images/e3a4b3e7-9500-4b6c-a402-b6d3f45e714b.png,569,504,694,631,125,127,red blood cell,15875,1.016,0.984251968503937
35931,/images/f8242b97-b8d5-48b5-b808-0b0f75a5de97.png,1014,357,1126,465,112,108,red blood cell,12096,0.9642857142857143,1.037037037037037
56210,/images/b600b38d-225b-46a5-b6f8-b607430f6a10.png,83,1429,185,1540,102,111,red blood cell,11322,1.088235294117647,0.918918918918919
63951,/images/5e974892-0ebe-4037-8427-ea8616d6d3b8.png,27,121,121,210,94,89,red blood cell,8366,0.9468085106382979,1.0561797752808988
13113,/images/711f6b3f-cd63-46d1-834a-bc8e9aa9b43e.png,994,688,1102,805,108,117,red blood cell,12636,1.0833333333333333,0.9230769230769231
14386,/images/f5eb7c5e-bd77-4638-ba9f-58d42f87476b.png,313,795,431,913,118,118,red blood cell,13924,1.0,1.0
17367,/images/04018590-4e66-4cb9-ad2d-83570f1b29ae.png,1016,944,1149,1073,133,129,red blood cell,17157,0.9699248120300752,1.0310077519379846
3765,/images/dacf7e3f-1d8c-42a0-8539-3abe3971c956.png,631,734,766,855,135,121,red blood cell,16335,0.8962962962962963,1.115702479338843
77449,/images/a11ed7d0-12f6-468f-abad-5cba7d968123.png,930,849,1045,965,115,116,red blood cell,13340,1.008695652173913,0.9913793103448276
30506,/images/5955289d-19e5-45ef-a012-c8ea08ef45e2.png,158,1114,271,1241,113,127,red blood cell,14351,1.1238938053097345,0.889763779527559
1731,/images/5f783f43-0090-4f8a-bd75-9562f4aa2dd5.png,437,416,528,521,91,105,red blood cell,9555,1.1538461538461537,0.8666666666666667
37056,/images/b2e34f5f-904e-4473-9dc7-c6bc1ce12640.png,556,1083,652,1195,96,112,red blood cell,10752,1.1666666666666667,0.8571428571428571
34105,/images/de5d19b7-e670-4ac7-843b-7ce7bcebdf45.png,740,144,854,269,114,125,red blood cell,14250,1.0964912280701755,0.912
59025,/images/597bbff8-6592-41cf-8946-e59b0d1f289a.png,679,313,777,418,98,105,red blood cell,10290,1.0714285714285714,0.9333333333333333
16918,/images/f5419bc0-4415-41b6-b832-5326cfcc534b.png,331,1232,447,1348,116,116,red blood cell,13456,1.0,1.0
14250,/images/6382976c-ee87-4916-b798-4ef1373b2df0.png,451,236,566,351,115,115,red blood cell,13225,1.0,1.0
75461,/images/468c261d-f5d8-423f-883e-48af2bbbc5d1.png,723,368,802,456,79,88,red blood cell,6952,1.1139240506329113,0.8977272727272727
61204,/images/0da07970-3146-479c-8a07-f61ed32814a9.png,515,504,616,616,101,112,red blood cell,11312,1.108910891089109,0.9017857142857143
56759,/images/0dcbf2c9-f959-4703-a72b-f6a81e66c2ea.png,35,1159,167,1267,132,108,red blood cell,14256,0.8181818181818182,1.2222222222222223
54467,/images/22a464ef-c3da-4d56-b37e-e22e95d945e7.png,59,1509,154,1600,95,91,red blood cell,8645,0.9578947368421052,1.043956043956044
52089,/images/de6d3020-9347-473b-9146-8909627790f6.png,181,738,277,846,96,108,red blood cell,10368,1.125,0.8888888888888888
34763,/images/6294153c-6db3-4f2b-a8ff-9c087225e737.png,766,1484,882,1593,116,109,red blood cell,12644,0.9396551724137931,1.0642201834862386
11917,/images/2e8d6a43-0110-4bf4-8e70-20567e513b81.png,181,1448,301,1566,120,118,red blood cell,14160,0.9833333333333333,1.0169491525423728
23693,/images/79d7a014-21ff-40f1-9ac4-a69839390654.png,928,1328,1028,1420,100,92,red blood cell,9200,0.92,1.0869565217391304
38126,/images/33bdb7b5-ad5b-4a73-bbc2-3350f8c2ac0c.png,389,206,501,325,112,119,red blood cell,13328,1.0625,0.9411764705882353
3200,/images/c3215597-a032-46be-9058-d6de1e5191d7.png,787,819,900,952,113,133,red blood cell,15029,1.176991150442478,0.849624060150376
61574,/images/4a717a39-80f8-4b75-a25e-c46d65d7dcd5.png,166,1007,264,1098,98,91,red blood cell,8918,0.9285714285714286,1.0769230769230769
64275,/images/83d4e1fe-da84-4175-a9e2-8efc18782dcf.png,61,847,178,963,117,116,red blood cell,13572,0.9914529914529915,1.0086206896551724
1858,/images/8855c685-5a8c-4967-a356-942ed89e3471.png,106,404,217,521,111,117,red blood cell,12987,1.054054054054054,0.9487179487179487
49177,/images/a9daf82a-a46d-4296-bd72-2c374ed0a193.png,716,986,811,1077,95,91,red blood cell,8645,0.9578947368421052,1.043956043956044
1347,/images/6d91d1f0-636b-4f5a-a526-7c17fc857190.png,597,924,686,1004,89,80,red blood cell,7120,0.898876404494382,1.1125
68749,/images/eb5f4f2f-2275-4a80-84a5-78a1eaf4ce4d.png,591,425,721,545,130,120,red blood cell,15600,0.9230769230769231,1.0833333333333333
13837,/images/345cb914-7583-49df-96e3-3cf19c2ba8f1.png,330,967,455,1077,125,110,red blood cell,13750,0.88,1.1363636363636365
45060,/images/13bab3c3-3f79-44d9-a287-0ae6d71eff31.png,35,174,158,288,123,114,red blood cell,14022,0.926829268292683,1.0789473684210527
38422,/images/674b0fd3-f247-4b7f-97f7-3e6c57c9ba9e.png,1079,839,1175,921,96,82,red blood cell,7872,0.8541666666666666,1.170731707317073
44295,/images/4257342d-6d77-4671-a84b-1f0c36ccb367.png,963,1410,1077,1534,114,124,red blood cell,14136,1.087719298245614,0.9193548387096774
9302,/images/261562a8-ffd8-4e0e-919b-22e267000b74.png,290,1410,394,1537,104,127,red blood cell,13208,1.2211538461538463,0.8188976377952756
65240,/images/45ac9409-5537-44ed-90cd-5c8a1ae0e1e0.png,45,1201,156,1304,111,103,red blood cell,11433,0.9279279279279279,1.0776699029126213
65255,/images/45ac9409-5537-44ed-90cd-5c8a1ae0e1e0.png,486,1046,607,1161,121,115,red blood cell,13915,0.9504132231404959,1.0521739130434782
21367,/images/5077f87d-a19f-494c-b911-14ccb03bd230.png,567,1180,681,1288,114,108,red blood cell,12312,0.9473684210526315,1.0555555555555556
69256,/images/f274b784-b995-4a7e-a2c2-6cc31c24c4b4.png,159,673,244,755,85,82,red blood cell,6970,0.9647058823529412,1.0365853658536586
14381,/images/f5eb7c5e-bd77-4638-ba9f-58d42f87476b.png,772,860,889,969,117,109,red blood cell,12753,0.9316239316239316,1.073394495412844
78799,/images/9174f910-3859-4839-8e30-2c3b25269322.png,566,537,684,642,118,105,red blood cell,12390,0.8898305084745762,1.1238095238095238
36505,/images/bd856928-96ee-4fc4-a377-f2fc4e84448b.png,606,1430,707,1533,101,103,red blood cell,10403,1.0198019801980198,0.9805825242718447
17044,/images/57e1879e-4294-45e7-9c1b-627e8cca0271.png,950,779,1051,888,101,109,red blood cell,11009,1.0792079207920793,0.926605504587156
42017,/images/46a03374-64c7-49ac-81c9-c3d62542bbf3.png,993,917,1095,1004,102,87,red blood cell,8874,0.8529411764705882,1.1724137931034482
58048,/images/a7c91b63-b97c-4f4b-8d34-7ad2b08d7a17.png,369,637,460,727,91,90,red blood cell,8190,0.989010989010989,1.011111111111111
22701,/images/4ab47131-c2ac-461f-b95c-ac19ce24edbd.png,908,1299,1025,1422,117,123,red blood cell,14391,1.0512820512820513,0.9512195121951219
1879,/images/8855c685-5a8c-4967-a356-942ed89e3471.png,341,928,477,1045,136,117,red blood cell,15912,0.8602941176470589,1.1623931623931625
5959,/images/97eff653-3908-4e66-931f-eab36bc336c8.png,770,405,871,522,101,117,red blood cell,11817,1.1584158415841583,0.8632478632478633
69280,/images/f274b784-b995-4a7e-a2c2-6cc31c24c4b4.png,263,1351,342,1446,79,95,red blood cell,7505,1.2025316455696202,0.8315789473684211
48529,/images/f3d84be2-8af0-4d62-9f72-23d3dc08cbbe.png,800,406,920,534,120,128,red blood cell,15360,1.0666666666666667,0.9375
36036,/images/ca9626bc-21a4-46f4-ba94-e7ee7a4cf735.png,559,903,683,1027,124,124,red blood cell,15376,1.0,1.0
15947,/images/c7c1b873-0548-4a73-9618-f60912e164df.png,405,57,523,153,118,96,red blood cell,11328,0.8135593220338984,1.2291666666666667
7885,/images/98c25ffe-c329-420a-bc22-b082f565eac9.png,987,560,1110,697,123,137,red blood cell,16851,1.113821138211382,0.8978102189781022
1819,/images/5f783f43-0090-4f8a-bd75-9562f4aa2dd5.png,654,1115,754,1204,100,89,red blood cell,8900,0.89,1.1235955056179776
22861,/images/95d5e689-c1d1-4ae8-a659-cc20c62a99f0.png,996,1484,1113,1598,117,114,red blood cell,13338,0.9743589743589743,1.0263157894736843
36241,/images/b2103776-9b32-4160-b4f0-0692deda19dc.png,1088,1146,1195,1255,107,109,red blood cell,11663,1.0186915887850467,0.981651376146789
18320,/images/9ca20b10-e2fd-4bd2-93ef-78298f763ed5.png,125,864,242,984,117,120,red blood cell,14040,1.0256410256410255,0.975
5109,/images/a777e78c-ad1f-4380-9ab2-b4f9f32b2d78.png,751,548,851,645,100,97,red blood cell,9700,0.97,1.0309278350515463
55281,/images/8ad7ba46-5db8-4ba9-b3e0-3cac52f7efc3.png,729,920,817,1009,88,89,red blood cell,7832,1.0113636363636365,0.9887640449438202
42516,/images/29648565-fe28-4517-ba72-68df0c82c9c5.png,802,1074,903,1170,101,96,red blood cell,9696,0.9504950495049505,1.0520833333333333
68811,/images/aa3ad405-828e-4986-8251-20fd981f34d3.png,594,214,689,319,95,105,red blood cell,9975,1.105263157894737,0.9047619047619048
7438,/images/37a94c0f-e5d4-46fc-b4f8-994d477995fd.png,581,18,676,111,95,93,red blood cell,8835,0.9789473684210527,1.021505376344086
69354,/images/2ac343e4-c889-47c1-8fe2-461b626def76.png,479,1157,576,1255,97,98,red blood cell,9506,1.0103092783505154,0.9897959183673469
25174,/images/90171428-f208-428a-b40e-f57ee3bea457.png,648,408,779,526,131,118,red blood cell,15458,0.9007633587786259,1.1101694915254237
9788,/images/3859deaf-6ae1-49a3-9051-898d0f0d7de6.png,259,893,357,996,98,103,red blood cell,10094,1.0510204081632653,0.9514563106796117
7814,/images/e726dac6-f962-449c-acff-4dd56847b685.png,311,438,430,561,119,123,red blood cell,14637,1.0336134453781514,0.967479674796748
47704,/images/afbb264e-ff60-443a-83f5-49d09be1b835.png,144,97,262,220,118,123,red blood cell,14514,1.0423728813559323,0.959349593495935
54183,/images/3b5a8060-dec6-4a83-b7f2-b604e4e69dfc.png,217,75,315,167,98,92,red blood cell,9016,0.9387755102040817,1.065217391304348
62541,/images/9ecf2006-8d49-4ae8-a14b-ed8b3b14ee7c.png,790,719,899,825,109,106,red blood cell,11554,0.9724770642201835,1.028301886792453
260,/images/0dcca702-a4ef-4fb3-a940-9c0c140b21c7.png,1016,1029,1130,1138,114,109,red blood cell,12426,0.956140350877193,1.0458715596330275
39132,/images/7bde7de1-889b-4218-b0e1-e2c04f6a7986.png,647,1271,752,1377,105,106,red blood cell,11130,1.0095238095238095,0.9905660377358491
57457,/images/00d04a90-80e5-4bce-9511-1b64eabb7a47.png,231,721,328,817,97,96,red blood cell,9312,0.9896907216494846,1.0104166666666667
62688,/images/9e1b0217-0926-4fd1-bb9e-a815c05deb59.png,7,254,112,358,105,104,red blood cell,10920,0.9904761904761905,1.0096153846153846
54854,/images/b6364a57-72a9-43f3-8d02-9f53a992dc95.png,236,1320,315,1412,79,92,red blood cell,7268,1.1645569620253164,0.8586956521739131
5427,/images/75579b27-8191-4044-859b-268be969c42b.png,671,200,794,329,123,129,red blood cell,15867,1.048780487804878,0.9534883720930233
71568,/images/b9c6db13-ca3a-4937-8ecf-e537047ed858.png,247,267,345,372,98,105,red blood cell,10290,1.0714285714285714,0.9333333333333333
29273,/images/6274fe0d-0d71-40be-b61b-f0bd5b5df1e2.png,855,1227,955,1323,100,96,red blood cell,9600,0.96,1.0416666666666667
69596,/images/4a49841f-216c-4815-8140-b8762c4f6603.png,88,639,199,746,111,107,red blood cell,11877,0.963963963963964,1.0373831775700935
48583,/images/f3d84be2-8af0-4d62-9f72-23d3dc08cbbe.png,68,502,178,611,110,109,red blood cell,11990,0.990909090909091,1.0091743119266054
50627,/images/c956e531-6805-4fe1-b61c-8b96a9815a77.png,356,1136,467,1239,111,103,red blood cell,11433,0.9279279279279279,1.0776699029126213
11914,/images/2e8d6a43-0110-4bf4-8e70-20567e513b81.png,406,961,525,1066,119,105,red blood cell,12495,0.8823529411764706,1.1333333333333333
68818,/images/aa3ad405-828e-4986-8251-20fd981f34d3.png,56,1387,167,1508,111,121,red blood cell,13431,1.09009009009009,0.9173553719008265
76711,/images/3317d733-ec0d-45e6-b631-40457392f343.png,193,606,310,718,117,112,red blood cell,13104,0.9572649572649573,1.0446428571428572
61070,/images/6e86206f-dafe-4c28-bacc-7b83b2d40f0c.png,866,736,951,816,85,80,red blood cell,6800,0.9411764705882353,1.0625
33831,/images/b9de8b1a-f96a-4eb5-bc05-84ad43a054f3.png,761,561,861,671,100,110,red blood cell,11000,1.1,0.9090909090909091
60219,/images/214f1d15-a081-476e-992d-6c3a77f03d59.png,331,385,422,473,91,88,red blood cell,8008,0.967032967032967,1.0340909090909092
75881,/images/3006096f-ceeb-42be-b69e-785179d7438b.png,978,1019,1089,1128,111,109,red blood cell,12099,0.9819819819819819,1.018348623853211
31434,/images/6695a204-e39c-4418-b904-3f080fdbe7e8.png,898,1117,1007,1238,109,121,red blood cell,13189,1.110091743119266,0.9008264462809917
78658,/images/fd1c4c7a-24bc-43f2-b84f-fee182207aee.png,881,180,1015,304,134,124,red blood cell,16616,0.9253731343283582,1.0806451612903225
28505,/images/dc4270fb-e5c2-414f-96e9-6769ba1d77e4.png,253,857,371,961,118,104,red blood cell,12272,0.8813559322033898,1.1346153846153846
810,/images/27fab82c-5bf0-426f-aeb9-47da829b6629.png,493,1445,601,1561,108,116,red blood cell,12528,1.0740740740740742,0.9310344827586207
56723,/images/b3606d0e-6fe5-478a-bb4b-64d7c4889d86.png,687,565,795,679,108,114,red blood cell,12312,1.0555555555555556,0.9473684210526315
44177,/images/8b494b40-cab5-49d3-893d-c805000fbe88.png,277,990,395,1086,118,96,red blood cell,11328,0.8135593220338984,1.2291666666666667
55027,/images/1f8f08ea-b5b3-4f68-94d4-3cc071b7dce8.png,761,1355,863,1454,102,99,red blood cell,10098,0.9705882352941176,1.0303030303030303
70050,/images/b8339d7b-85ec-48d0-83e8-c8f831070459.png,133,948,251,1061,118,113,red blood cell,13334,0.9576271186440678,1.0442477876106195
33732,/images/441d7843-b20b-4c10-84e3-e6d32621e880.png,787,538,871,634,84,96,red blood cell,8064,1.1428571428571428,0.875
50853,/images/0906111b-bac7-4541-a6dc-da435c0724a8.png,940,286,1048,395,108,109,red blood cell,11772,1.0092592592592593,0.9908256880733946
3394,/images/fd1302e2-3cd2-4a1a-9c13-00f810a9c41b.png,804,1077,906,1178,102,101,red blood cell,10302,0.9901960784313726,1.00990099009901
12129,/images/87d6343b-70dd-4cdd-939f-d3ac0ca2e700.png,84,1195,192,1304,108,109,red blood cell,11772,1.0092592592592593,0.9908256880733946
11848,/images/3cdcb09b-6a8c-43ca-b1d0-c1a289202f65.png,719,844,817,956,98,112,red blood cell,10976,1.1428571428571428,0.875
71968,/images/61575482-91e1-4db9-83c7-687b7ddbbfc4.png,1126,922,1199,1013,73,91,red blood cell,6643,1.2465753424657535,0.8021978021978022
58629,/images/a4d7a7e1-5ae1-486d-b6ee-c9af1476ccad.png,336,1110,442,1218,106,108,red blood cell,11448,1.0188679245283019,0.9814814814814815
46446,/images/bbecf1a8-a728-4c83-87f8-4dfbac0a1e03.png,949,670,1061,793,112,123,red blood cell,13776,1.0982142857142858,0.9105691056910569
47129,/images/3d1b889e-bb4a-4ee6-b899-974ee7d956a7.png,508,988,623,1091,115,103,red blood cell,11845,0.8956521739130435,1.116504854368932
6754,/images/672e4ecf-a56b-462e-b83b-76f4efaa6634.png,143,1237,251,1352,108,115,red blood cell,12420,1.0648148148148149,0.9391304347826087
37182,/images/befe6182-266b-4f8a-ac82-3a4154f05f60.png,475,73,595,179,120,106,red blood cell,12720,0.8833333333333333,1.1320754716981132
68428,/images/040112be-3c8d-49aa-93f1-522f94a592ff.png,13,187,110,280,97,93,red blood cell,9021,0.9587628865979382,1.043010752688172
52496,/images/d1144956-5a0c-4bd2-b67d-8498c82d6a12.png,723,1318,816,1423,93,105,red blood cell,9765,1.1290322580645162,0.8857142857142857
74043,/images/fe436c09-b680-4f4c-8faf-aa10a55a335b.png,79,805,186,908,107,103,red blood cell,11021,0.9626168224299065,1.0388349514563107
30993,/images/b59dc3a0-3d54-4e3b-a485-33b3e43966de.png,1073,1392,1178,1513,105,121,red blood cell,12705,1.1523809523809523,0.8677685950413223
57716,/images/5c037ffc-f515-48b3-b231-c110fbd2b8ca.png,619,930,726,1042,107,112,red blood cell,11984,1.0467289719626167,0.9553571428571429
16286,/images/d5009906-bce1-4353-90b4-f4c79362f4cf.png,400,35,530,163,130,128,red blood cell,16640,0.9846153846153847,1.015625
55471,/images/d67655e6-0a80-4a86-b552-1f5e85788377.png,497,817,591,914,94,97,red blood cell,9118,1.0319148936170213,0.9690721649484536
5916,/images/a30da226-b452-408a-a556-bfae4d521464.png,261,442,365,553,104,111,red blood cell,11544,1.0673076923076923,0.9369369369369369
15614,/images/84d7545e-c3a8-4b1f-9a39-36aab78c8699.png,1015,724,1129,848,114,124,red blood cell,14136,1.087719298245614,0.9193548387096774
1488,/images/0ac747cd-ff32-49bf-bc1a-3e9b7702ce9c.png,236,934,334,1037,98,103,red blood cell,10094,1.0510204081632653,0.9514563106796117
75379,/images/468c261d-f5d8-423f-883e-48af2bbbc5d1.png,722,704,830,801,108,97,red blood cell,10476,0.8981481481481481,1.1134020618556701
37244,/images/2fdbd9bc-bbaf-44c2-b40c-d193709639fa.png,838,600,940,700,102,100,red blood cell,10200,0.9803921568627451,1.02
41069,/images/e871f52c-77a6-4813-80d4-95bd97985f1a.png,335,1221,438,1338,103,117,red blood cell,12051,1.1359223300970873,0.8803418803418803
34885,/images/a4fbb9f2-9b75-4fdc-877d-2feaafac25b3.png,937,1214,1044,1310,107,96,red blood cell,10272,0.897196261682243,1.1145833333333333
39050,/images/8f96ee1f-4ef7-4279-a610-316319bedcf9.png,609,144,732,263,123,119,red blood cell,14637,0.967479674796748,1.0336134453781514
64252,/images/83d4e1fe-da84-4175-a9e2-8efc18782dcf.png,325,853,439,966,114,113,red blood cell,12882,0.9912280701754386,1.008849557522124
50026,/images/b1145408-feae-4637-b4cf-3e70b99cc62d.png,727,1219,832,1331,105,112,red blood cell,11760,1.0666666666666667,0.9375
34158,/images/f1cda808-69a9-4d10-ba0a-6607c98e362d.png,502,624,642,744,140,120,red blood cell,16800,0.8571428571428571,1.1666666666666667
42523,/images/29648565-fe28-4517-ba72-68df0c82c9c5.png,806,1226,907,1331,101,105,red blood cell,10605,1.0396039603960396,0.9619047619047619
79468,/images/a2fc0093-8645-43c7-bdee-ec8ca9484815.png,661,1221,752,1334,91,113,red blood cell,10283,1.2417582417582418,0.8053097345132744
30913,/images/533c47c9-02a6-419b-961b-81797f022f6c.png,988,180,1087,295,99,115,red blood cell,11385,1.1616161616161615,0.8608695652173913
42676,/images/3abbc4d3-1d7e-40c9-9963-33732da7cc50.png,241,1356,361,1470,120,114,red blood cell,13680,0.95,1.0526315789473684
3179,/images/c3215597-a032-46be-9058-d6de1e5191d7.png,964,500,1089,626,125,126,red blood cell,15750,1.008,0.9920634920634921
13829,/images/345cb914-7583-49df-96e3-3cf19c2ba8f1.png,1051,87,1183,211,132,124,red blood cell,16368,0.9393939393939394,1.064516129032258
75638,/images/c35ee701-fde2-46b5-b178-1fe3f1ea7da2.png,459,1125,560,1216,101,91,red blood cell,9191,0.900990099009901,1.10989010989011
71625,/images/390ad256-e1ed-476a-9f14-2dc34e0da632.png,619,233,720,347,101,114,red blood cell,11514,1.1287128712871286,0.8859649122807017
56484,/images/7dcc84ce-e8b4-46c8-9506-7c8ebda5da2f.png,315,101,417,203,102,102,red blood cell,10404,1.0,1.0
20864,/images/c2ec116f-f091-422c-926c-70b548a8f6ef.png,1085,1028,1186,1135,101,107,red blood cell,10807,1.0594059405940595,0.9439252336448598
29675,/images/b85fc640-de49-4f7e-afc0-978ff020f2e2.png,420,1371,537,1486,117,115,red blood cell,13455,0.9829059829059829,1.017391304347826
34058,/images/1012abf2-cb05-4337-86c5-513ec4ca904d.png,1022,1003,1138,1120,116,117,red blood cell,13572,1.0086206896551724,0.9914529914529915
38600,/images/f8b14fc4-dd6b-4ad0-a96d-c62845f48681.png,291,1164,425,1287,134,123,red blood cell,16482,0.917910447761194,1.089430894308943
39636,/images/04d21589-b777-43c2-86b5-038cbf8c3a4e.png,779,1414,877,1518,98,104,red blood cell,10192,1.0612244897959184,0.9423076923076923
60734,/images/45651e76-4bd0-45e5-895b-edec65f51987.png,608,699,707,818,99,119,red blood cell,11781,1.202020202020202,0.8319327731092437
77326,/images/3ff98212-7c2a-46cd-afb7-34a2479bed07.png,879,56,980,165,101,109,red blood cell,11009,1.0792079207920793,0.926605504587156
2013,/images/bfefa21c-11e1-4dab-ac5d-8ff6f046d65f.png,823,300,934,414,111,114,red blood cell,12654,1.027027027027027,0.9736842105263158
65580,/images/01b38a56-13eb-447b-89ee-fc21cb40dcc1.png,803,463,898,557,95,94,red blood cell,8930,0.9894736842105263,1.0106382978723405
53827,/images/f24c8fe0-a534-44cf-9995-b2b314d945ba.png,1028,1480,1141,1594,113,114,red blood cell,12882,1.008849557522124,0.9912280701754386
63883,/images/5e974892-0ebe-4037-8427-ea8616d6d3b8.png,802,578,892,688,90,110,red blood cell,9900,1.2222222222222223,0.8181818181818182
38770,/images/b426ef1d-4a59-4f90-b593-50226af60a60.png,539,1381,656,1494,117,113,red blood cell,13221,0.9658119658119658,1.0353982300884956
67284,/images/5f491efd-a21c-4a80-aaba-70b8876238ac.png,398,1376,490,1469,92,93,red blood cell,8556,1.0108695652173914,0.989247311827957
46724,/images/da111ca5-520f-4ea8-97ad-ae5fce58ee91.png,821,882,907,958,86,76,red blood cell,6536,0.8837209302325582,1.131578947368421
44798,/images/6795acae-e84d-4e97-b9a1-b4f4f0a72cfd.png,533,1023,632,1134,99,111,red blood cell,10989,1.121212121212121,0.8918918918918919
61693,/images/12269960-075f-40ca-9630-49ea2ce78294.png,846,956,982,1080,136,124,red blood cell,16864,0.9117647058823529,1.096774193548387
69547,/images/664c570b-4822-413c-9724-11b1d91fac44.png,113,469,211,551,98,82,red blood cell,8036,0.8367346938775511,1.1951219512195121
42489,/images/29648565-fe28-4517-ba72-68df0c82c9c5.png,565,1488,661,1591,96,103,red blood cell,9888,1.0729166666666667,0.9320388349514563
4903,/images/61cd8c7d-394d-42d3-9ed4-e09559110bed.png,650,1243,790,1357,140,114,red blood cell,15960,0.8142857142857143,1.2280701754385965
73377,/images/c890ee00-daa5-4b20-9cd5-930748ecc4e0.png,816,309,910,405,94,96,red blood cell,9024,1.0212765957446808,0.9791666666666666
46208,/images/d8632217-ec33-4d0a-98e6-427824c58869.png,909,403,994,505,85,102,red blood cell,8670,1.2,0.8333333333333334
31514,/images/83ec1cb9-1714-4bf1-81f6-115fde84564d.png,374,981,490,1103,116,122,red blood cell,14152,1.0517241379310345,0.9508196721311475
60252,/images/abf4cf2a-4532-4772-9f0f-9e123cc1713d.png,184,454,325,570,141,116,red blood cell,16356,0.8226950354609929,1.2155172413793103
5718,/images/d3dcdf92-9328-4796-adf4-918646877ba1.png,340,1131,439,1248,99,117,red blood cell,11583,1.1818181818181819,0.8461538461538461
1820,/images/5f783f43-0090-4f8a-bd75-9562f4aa2dd5.png,651,978,759,1086,108,108,red blood cell,11664,1.0,1.0
40109,/images/6fd30823-3b77-40c9-ba5d-e1eda9660674.png,638,1117,748,1233,110,116,red blood cell,12760,1.0545454545454545,0.9482758620689655
15365,/images/035f6c4b-0897-46ab-9c3b-5f3b0feff043.png,103,214,207,318,104,104,red blood cell,10816,1.0,1.0
21602,/images/49efc89d-9cba-44f7-8257-7f911b73f68a.png,1100,111,1199,204,99,93,red blood cell,9207,0.9393939393939394,1.064516129032258
9340,/images/261562a8-ffd8-4e0e-919b-22e267000b74.png,738,128,823,226,85,98,red blood cell,8330,1.1529411764705881,0.8673469387755102
19375,/images/a302a6fa-f635-4ade-b72b-b6f3c2a34ec9.png,496,82,619,200,123,118,red blood cell,14514,0.959349593495935,1.0423728813559323
23346,/images/a7688988-2bcc-4458-83d3-5e482da5f87b.png,388,1331,496,1429,108,98,red blood cell,10584,0.9074074074074074,1.1020408163265305
70552,/images/8cca114a-ed05-4b87-95b7-fae02487f08c.png,363,706,469,812,106,106,red blood cell,11236,1.0,1.0
36619,/images/21f001d6-f568-4ea4-82da-fab54c77c419.png,906,326,1004,429,98,103,red blood cell,10094,1.0510204081632653,0.9514563106796117
10792,/images/2a02cec2-a09b-483a-ad38-14359a763fa4.png,439,171,569,295,130,124,red blood cell,16120,0.9538461538461539,1.0483870967741935
19593,/images/883d9731-a04d-4f84-83c9-d3bef954759d.png,986,917,1098,1032,112,115,red blood cell,12880,1.0267857142857142,0.9739130434782609
43391,/images/aabca37c-f9ef-4415-aab6-3246caa348e9.png,135,1421,242,1538,107,117,red blood cell,12519,1.0934579439252337,0.9145299145299145
67925,/images/41ebf9a1-24dc-454e-8bf8-508218f5ee57.png,619,318,695,411,76,93,red blood cell,7068,1.2236842105263157,0.8172043010752689
37267,/images/2fdbd9bc-bbaf-44c2-b40c-d193709639fa.png,516,582,629,695,113,113,red blood cell,12769,1.0,1.0
1921,/images/02ea7aa8-c142-4a3d-939f-e77689741341.png,705,214,823,346,118,132,red blood cell,15576,1.11864406779661,0.8939393939393939
76388,/images/3dad6483-ac30-4d2b-b045-9f24fe6ff75e.png,774,435,869,517,95,82,red blood cell,7790,0.8631578947368421,1.1585365853658536
77716,/images/4849866a-73a2-4fcf-a407-2d0a25a09a89.png,1029,1304,1122,1416,93,112,red blood cell,10416,1.2043010752688172,0.8303571428571429
16673,/images/bc377041-e098-45c4-9651-2b1ea90d1d7e.png,703,1332,832,1441,129,109,red blood cell,14061,0.8449612403100775,1.18348623853211
32268,/images/f4722a74-35e7-42bd-8ef6-dfff04b9cd22.png,502,1276,618,1390,116,114,red blood cell,13224,0.9827586206896551,1.0175438596491229
76624,/images/4184a235-d209-4151-86e9-6c77e7938dab.png,93,1308,191,1398,98,90,red blood cell,8820,0.9183673469387755,1.0888888888888888
56205,/images/b600b38d-225b-46a5-b6f8-b607430f6a10.png,348,1076,454,1176,106,100,red blood cell,10600,0.9433962264150944,1.06
36682,/images/21f001d6-f568-4ea4-82da-fab54c77c419.png,409,635,505,731,96,96,red blood cell,9216,1.0,1.0
9006,/images/ef815e3a-02a6-4cf8-9262-45bc74c50b00.png,860,713,969,837,109,124,red blood cell,13516,1.1376146788990826,0.8790322580645161
3564,/images/25132962-ff5d-4737-995f-c54d8490539b.png,735,1469,850,1581,115,112,red blood cell,12880,0.9739130434782609,1.0267857142857142
19296,/images/b4d22412-a495-43a9-bec0-73a2322f8dad.png,154,687,265,792,111,105,red blood cell,11655,0.9459459459459459,1.0571428571428572
29756,/images/7ef90770-6aeb-45eb-9744-49c5247dde30.png,707,558,787,649,80,91,red blood cell,7280,1.1375,0.8791208791208791
49308,/images/99b13257-b9d9-422f-8262-802da0bdc510.png,17,158,142,274,125,116,red blood cell,14500,0.928,1.0775862068965518
13598,/images/c0c3041f-78cd-46de-8e36-0a7dad0c04c4.png,962,1308,1083,1423,121,115,red blood cell,13915,0.9504132231404959,1.0521739130434782
19905,/images/0ca25c88-457f-4f03-bbc1-98fb6663f1d1.png,778,1364,878,1450,100,86,red blood cell,8600,0.86,1.1627906976744187
29561,/images/42845335-4ab2-4963-806d-0985d1382a31.png,629,321,725,423,96,102,red blood cell,9792,1.0625,0.9411764705882353
74452,/images/cbb58718-6319-48db-b84b-78ac9b12ff89.png,865,1441,969,1537,104,96,red blood cell,9984,0.9230769230769231,1.0833333333333333
1231,/images/5ff7c0c8-d208-4e7d-958d-ca3c2260ff39.png,698,1356,811,1479,113,123,red blood cell,13899,1.0884955752212389,0.9186991869918699
5561,/images/eb6e8684-b84e-483d-b835-f59286d2516b.png,228,962,359,1084,131,122,red blood cell,15982,0.9312977099236641,1.0737704918032787
76721,/images/3317d733-ec0d-45e6-b631-40457392f343.png,89,324,197,437,108,113,red blood cell,12204,1.0462962962962963,0.9557522123893806
56488,/images/7dcc84ce-e8b4-46c8-9506-7c8ebda5da2f.png,986,826,1090,952,104,126,red blood cell,13104,1.2115384615384615,0.8253968253968254
66938,/images/9acf303a-fcba-4e52-be3e-8d061aa5e72a.png,629,1508,733,1598,104,90,red blood cell,9360,0.8653846153846154,1.1555555555555554
67276,/images/5f491efd-a21c-4a80-aaba-70b8876238ac.png,615,516,708,615,93,99,red blood cell,9207,1.064516129032258,0.9393939393939394
883,/images/dce55b59-c6c3-4693-aa75-6b348c8f52cd.png,630,1140,722,1244,92,104,red blood cell,9568,1.1304347826086956,0.8846153846153846
10217,/images/e3ea07d7-884a-412e-874a-40fd6b856736.png,743,618,857,724,114,106,red blood cell,12084,0.9298245614035088,1.0754716981132075
79337,/images/dcb21739-3c36-459d-b3cc-1be5871d6fe7.png,993,633,1102,740,109,107,red blood cell,11663,0.981651376146789,1.0186915887850467
46102,/images/72088c26-d2dd-4906-b791-b8947fc7fbe4.png,757,757,846,850,89,93,red blood cell,8277,1.0449438202247192,0.956989247311828
28778,/images/686ed568-d5f8-475e-81ad-edab9dd473a0.png,197,701,296,796,99,95,red blood cell,9405,0.9595959595959596,1.0421052631578946
7429,/images/37a94c0f-e5d4-46fc-b4f8-994d477995fd.png,327,681,458,794,131,113,red blood cell,14803,0.8625954198473282,1.1592920353982301
55326,/images/4fb83278-adc5-4424-9f45-b6d0db2955b6.png,564,244,658,346,94,102,red blood cell,9588,1.0851063829787233,0.9215686274509803
531,/images/67acd5bc-4658-4c6e-a9b9-cd8ea3a03418.png,694,618,812,724,118,106,red blood cell,12508,0.8983050847457628,1.1132075471698113
10611,/images/20d4f65e-6c63-433a-935c-d568d577967b.png,466,301,561,399,95,98,red blood cell,9310,1.0315789473684212,0.9693877551020408
35229,/images/a9159b11-ba49-4885-902e-00c8d5095b98.png,1044,712,1149,817,105,105,red blood cell,11025,1.0,1.0
57562,/images/8190ec37-9a5e-419f-89ed-fbfb079370db.png,728,496,820,590,92,94,red blood cell,8648,1.0217391304347827,0.9787234042553191
43349,/images/36569710-a574-40be-ad42-897a6e74a128.png,113,1095,212,1200,99,105,red blood cell,10395,1.0606060606060606,0.9428571428571428
24884,/images/ed0bee2f-05e0-4392-8357-19750cec577c.png,373,135,464,242,91,107,red blood cell,9737,1.1758241758241759,0.8504672897196262
62362,/images/e0ff3476-226f-4125-b182-8e524d5503dd.png,510,1175,606,1262,96,87,red blood cell,8352,0.90625,1.103448275862069
32509,/images/d31dd2c0-ae8e-4499-86bb-7cabb6e438b9.png,927,991,1047,1105,120,114,red blood cell,13680,0.95,1.0526315789473684
22360,/images/78c35732-7e31-4153-842e-55ab1cd656f6.png,143,1455,236,1555,93,100,red blood cell,9300,1.075268817204301,0.93
28016,/images/c4d34e35-4db2-41de-ba77-1a94aa9ef788.png,891,765,993,866,102,101,red blood cell,10302,0.9901960784313726,1.00990099009901
68997,/images/b5246b58-6f40-4c9e-8024-f49b0ed6bdbd.png,979,973,1097,1074,118,101,red blood cell,11918,0.8559322033898306,1.1683168316831682
10565,/images/9fbf38ab-44b9-4096-a818-603017a4300e.png,584,103,710,228,126,125,red blood cell,15750,0.9920634920634921,1.008
65724,/images/c54fcef1-0c51-4426-9a93-15ec5f2bf58a.png,910,300,1017,411,107,111,red blood cell,11877,1.0373831775700935,0.963963963963964
37531,/images/205306da-0ed8-475a-ace6-f2f81d4be88a.png,340,777,449,881,109,104,red blood cell,11336,0.9541284403669725,1.0480769230769231
17733,/images/b5143aae-6e98-4dc6-b546-980cb472de67.png,824,1140,939,1265,115,125,red blood cell,14375,1.0869565217391304,0.92
62718,/images/9e1b0217-0926-4fd1-bb9e-a815c05deb59.png,751,1477,854,1579,103,102,red blood cell,10506,0.9902912621359223,1.0098039215686274
22802,/images/8490c623-3d88-4532-baf5-0d266a45b16f.png,682,747,795,840,113,93,red blood cell,10509,0.8230088495575221,1.2150537634408602
53609,/images/7bcd3735-3134-46d1-8ca2-d4379f2d51c0.png,246,1140,368,1245,122,105,red blood cell,12810,0.860655737704918,1.161904761904762
45901,/images/939ad732-d7c5-4339-b087-4335b49d6a3c.png,775,862,908,976,133,114,red blood cell,15162,0.8571428571428571,1.1666666666666667
70846,/images/bf002a25-6535-4621-be19-56d468be5413.png,220,972,343,1080,123,108,red blood cell,13284,0.8780487804878049,1.1388888888888888
27093,/images/f232eec3-02c0-43f9-bf32-3e60245397e2.png,654,8,746,117,92,109,red blood cell,10028,1.184782608695652,0.8440366972477065
18737,/images/f6f8a69a-3fd2-4684-ac77-3e83ea0fb36d.png,702,781,817,902,115,121,red blood cell,13915,1.0521739130434782,0.9504132231404959
61845,/images/5f300fd1-7eec-41ac-bbd1-0f4a943c757c.png,597,224,690,327,93,103,red blood cell,9579,1.10752688172043,0.9029126213592233
2274,/images/fe851c88-692d-4199-87e0-d19d9c4eb591.png,350,1001,455,1100,105,99,red blood cell,10395,0.9428571428571428,1.0606060606060606
31760,/images/ab59c9e4-3e50-48b9-874d-060d317410cc.png,296,851,412,973,116,122,red blood cell,14152,1.0517241379310345,0.9508196721311475
59003,/images/597bbff8-6592-41cf-8946-e59b0d1f289a.png,268,1339,383,1445,115,106,red blood cell,12190,0.9217391304347826,1.0849056603773586
58439,/images/7eae1169-e294-4594-8e03-1366d23ff2d1.png,708,413,794,504,86,91,red blood cell,7826,1.058139534883721,0.945054945054945
64294,/images/83d4e1fe-da84-4175-a9e2-8efc18782dcf.png,1068,550,1182,680,114,130,red blood cell,14820,1.1403508771929824,0.8769230769230769
8517,/images/dfc026a9-079f-4f45-8666-e0ccba5bb437.png,775,28,858,120,83,92,red blood cell,7636,1.108433734939759,0.9021739130434783
72328,/images/ee57e743-a876-4f69-9fe5-bf5d01b44689.png,431,1121,531,1245,100,124,red blood cell,12400,1.24,0.8064516129032258
61430,/images/7e837856-3519-4dc0-b357-4cdcfd30b4eb.png,834,796,927,897,93,101,red blood cell,9393,1.086021505376344,0.9207920792079208
20971,/images/d4fef0c5-6597-48b6-97e9-32ed504488e6.png,451,1097,588,1225,137,128,red blood cell,17536,0.9343065693430657,1.0703125
61414,/images/e16c0dab-780d-4035-872e-1bb91e49f9d2.png,800,718,922,833,122,115,red blood cell,14030,0.9426229508196722,1.0608695652173914
75877,/images/3006096f-ceeb-42be-b69e-785179d7438b.png,292,755,389,859,97,104,red blood cell,10088,1.0721649484536082,0.9326923076923077
74829,/images/81edcae1-65bf-4752-b0e4-494376b71e49.png,530,982,626,1087,96,105,red blood cell,10080,1.09375,0.9142857142857143
68443,/images/040112be-3c8d-49aa-93f1-522f94a592ff.png,245,718,327,817,82,99,red blood cell,8118,1.2073170731707317,0.8282828282828283
62657,/images/f7a4334a-4332-4de8-b39b-22da907976f2.png,624,860,711,960,87,100,red blood cell,8700,1.1494252873563218,0.87
33522,/images/795d0331-da56-4d45-a58a-54803408ffd9.png,656,1393,783,1512,127,119,red blood cell,15113,0.937007874015748,1.0672268907563025
58455,/images/5cac6ddf-c8c6-45de-bce0-a1db64b14fb5.png,1032,994,1145,1092,113,98,red blood cell,11074,0.8672566371681416,1.153061224489796
44518,/images/419309ef-da3f-4424-93cf-01ff4c52b017.png,323,1282,422,1381,99,99,red blood cell,9801,1.0,1.0
37114,/images/d6942996-5664-4370-ad87-2bdcbd49ac16.png,1054,1019,1160,1151,106,132,red blood cell,13992,1.2452830188679245,0.803030303030303
35724,/images/4063945d-03fc-4ce3-a04c-17435dce8f91.png,953,904,1069,1018,116,114,red blood cell,13224,0.9827586206896551,1.0175438596491229
79492,/images/a2fc0093-8645-43c7-bdee-ec8ca9484815.png,546,329,651,423,105,94,red blood cell,9870,0.8952380952380953,1.1170212765957446
67983,/images/bcaefb02-682a-41b9-acc7-e6cc010f5b30.png,666,1252,776,1365,110,113,red blood cell,12430,1.0272727272727273,0.9734513274336283
59067,/images/5e2cea49-0823-49d1-83cf-8fd1559cdd93.png,1066,1218,1164,1315,98,97,red blood cell,9506,0.9897959183673469,1.0103092783505154
32175,/images/25cfca07-2101-484f-b312-a927395f2651.png,9,21,107,136,98,115,red blood cell,11270,1.1734693877551021,0.8521739130434782
30456,/images/5955289d-19e5-45ef-a012-c8ea08ef45e2.png,289,1098,409,1212,120,114,red blood cell,13680,0.95,1.0526315789473684
4007,/images/a5e05ba8-0c19-41e3-92d5-10e42a03b85e.png,228,1143,333,1256,105,113,red blood cell,11865,1.0761904761904761,0.9292035398230089
36103,/images/cb2fac19-90b0-48b4-bdc5-7dbbd58756d1.png,359,988,488,1109,129,121,red blood cell,15609,0.937984496124031,1.0661157024793388
16946,/images/8eeb378e-90f0-47ea-ac1c-2a201eb8d090.png,1000,1464,1100,1559,100,95,red blood cell,9500,0.95,1.0526315789473684
3392,/images/fd1302e2-3cd2-4a1a-9c13-00f810a9c41b.png,933,787,1031,885,98,98,red blood cell,9604,1.0,1.0
25563,/images/f6ab936d-924b-4038-aa47-71b07c26b4e2.png,201,538,321,660,120,122,red blood cell,14640,1.0166666666666666,0.9836065573770492
68427,/images/040112be-3c8d-49aa-93f1-522f94a592ff.png,43,551,136,647,93,96,red blood cell,8928,1.032258064516129,0.96875
53487,/images/43158031-a335-4533-9c20-48bebba90123.png,147,474,237,571,90,97,red blood cell,8730,1.0777777777777777,0.9278350515463918
14771,/images/1fdf99d1-a494-4174-bcd7-efbe457ab899.png,292,688,385,797,93,109,red blood cell,10137,1.1720430107526882,0.8532110091743119
63126,/images/d82c657e-5678-41da-9a6e-3ad29430b759.png,896,508,1021,618,125,110,red blood cell,13750,0.88,1.1363636363636365
24397,/images/4d8a4ce8-0f9c-4f21-8844-4cf0e5514bbf.png,308,805,384,896,76,91,red blood cell,6916,1.1973684210526316,0.8351648351648352
70129,/images/c742ee2c-6814-46cd-af56-ae87bb9972f4.png,188,1244,279,1337,91,93,red blood cell,8463,1.021978021978022,0.978494623655914
4700,/images/b91b1641-ee06-44d8-94cc-24cdb583cc37.png,287,56,410,185,123,129,red blood cell,15867,1.048780487804878,0.9534883720930233
44487,/images/b6573be3-9e04-49c3-9f48-6a145d065363.png,242,961,363,1076,121,115,red blood cell,13915,0.9504132231404959,1.0521739130434782
16371,/images/69569ecf-cfa1-4ddd-9342-b22c23387fdb.png,425,799,544,910,119,111,red blood cell,13209,0.9327731092436975,1.072072072072072
53843,/images/f24c8fe0-a534-44cf-9995-b2b314d945ba.png,415,72,545,185,130,113,red blood cell,14690,0.8692307692307693,1.1504424778761062
70608,/images/4ce5a070-9ede-4bb1-9ca2-1bae5746776b.png,844,192,964,314,120,122,red blood cell,14640,1.0166666666666666,0.9836065573770492
77713,/images/4849866a-73a2-4fcf-a407-2d0a25a09a89.png,540,1439,636,1534,96,95,red blood cell,9120,0.9895833333333334,1.0105263157894737
11918,/images/2e8d6a43-0110-4bf4-8e70-20567e513b81.png,164,730,284,853,120,123,red blood cell,14760,1.025,0.975609756097561
46897,/images/9e0e1928-d19a-4100-b093-0b962ac09e05.png,500,1316,607,1429,107,113,red blood cell,12091,1.0560747663551402,0.9469026548672567
31548,/images/3130f950-8345-4315-9711-92f7af3f5c14.png,569,39,685,161,116,122,red blood cell,14152,1.0517241379310345,0.9508196721311475
47828,/images/5a105b89-c592-4d78-b208-7db6c6572752.png,421,473,534,583,113,110,red blood cell,12430,0.9734513274336283,1.0272727272727273
7027,/images/8be185e7-2a1a-441c-a5c7-b50a9eb926cb.png,657,1098,751,1204,94,106,red blood cell,9964,1.127659574468085,0.8867924528301887
9485,/images/f1faab5f-3033-45ea-9673-8b816fea5ce8.png,299,1161,412,1277,113,116,red blood cell,13108,1.0265486725663717,0.9741379310344828
28902,/images/686ed568-d5f8-475e-81ad-edab9dd473a0.png,784,1136,887,1244,103,108,red blood cell,11124,1.0485436893203883,0.9537037037037037
25287,/images/587e5464-d70b-4279-8562-010279f6efbd.png,215,423,324,554,109,131,red blood cell,14279,1.201834862385321,0.8320610687022901
76460,/images/34df8890-272d-423a-ae78-ff8d068d3306.png,609,861,726,969,117,108,red blood cell,12636,0.9230769230769231,1.0833333333333333
10752,/images/20d4f65e-6c63-433a-935c-d568d577967b.png,896,1483,994,1595,98,112,red blood cell,10976,1.1428571428571428,0.875
74735,/images/c53fd511-31bd-4901-baac-3b44891f6744.png,572,211,682,311,110,100,red blood cell,11000,0.9090909090909091,1.1
22771,/images/8490c623-3d88-4532-baf5-0d266a45b16f.png,631,911,733,1013,102,102,red blood cell,10404,1.0,1.0
9137,/images/d3ed519e-2152-4e30-838d-a3ea23be512f.png,998,675,1108,790,110,115,red blood cell,12650,1.0454545454545454,0.9565217391304348
9409,/images/e3a4b3e7-9500-4b6c-a402-b6d3f45e714b.png,956,1454,1052,1563,96,109,red blood cell,10464,1.1354166666666667,0.8807339449541285
7778,/images/e726dac6-f962-449c-acff-4dd56847b685.png,332,1158,432,1254,100,96,red blood cell,9600,0.96,1.0416666666666667
42460,/images/29648565-fe28-4517-ba72-68df0c82c9c5.png,986,1184,1114,1306,128,122,red blood cell,15616,0.953125,1.0491803278688525
67485,/images/8e72e20e-e714-4db6-a1da-c05a409257d4.png,1114,432,1200,527,86,95,red blood cell,8170,1.1046511627906976,0.9052631578947369
21645,/images/66183740-e1e5-43c9-8539-a87028bb3621.png,257,1185,361,1288,104,103,red blood cell,10712,0.9903846153846154,1.0097087378640777
60643,/images/724e0c34-32cd-41f1-ae37-586038bc67ab.png,716,768,804,850,88,82,red blood cell,7216,0.9318181818181818,1.0731707317073171
18031,/images/0f0c949e-018a-4f3f-ab02-3704f49c7754.png,454,406,554,515,100,109,red blood cell,10900,1.09,0.9174311926605505
43950,/images/d7c7eb2c-2acd-4f86-8a5a-09ab3dd02d16.png,843,533,954,651,111,118,red blood cell,13098,1.063063063063063,0.940677966101695
9153,/images/d3ed519e-2152-4e30-838d-a3ea23be512f.png,543,1025,653,1127,110,102,red blood cell,11220,0.9272727272727272,1.0784313725490196
37769,/images/fe0c5e48-f65e-488c-9c3c-1ea7c7835c0c.png,422,627,508,723,86,96,red blood cell,8256,1.1162790697674418,0.8958333333333334
64885,/images/dec61ae1-5037-4c3a-8952-15371becca7d.png,905,840,1022,967,117,127,red blood cell,14859,1.0854700854700854,0.9212598425196851
54196,/images/3b5a8060-dec6-4a83-b7f2-b604e4e69dfc.png,675,1124,773,1231,98,107,red blood cell,10486,1.0918367346938775,0.9158878504672897
41346,/images/a065c50b-341d-4803-b4b0-0fe8f04fdbb5.png,9,1435,109,1534,100,99,red blood cell,9900,0.99,1.0101010101010102
46305,/images/e11515b4-9527-4c23-a0ba-43719bacca0d.png,200,1253,305,1365,105,112,red blood cell,11760,1.0666666666666667,0.9375
27914,/images/46f5bd4f-8bea-48d1-a1da-4dea28e3b814.png,256,505,367,624,111,119,red blood cell,13209,1.072072072072072,0.9327731092436975
40186,/images/ef1a9020-5e45-450d-a237-165114308592.png,466,1171,578,1282,112,111,red blood cell,12432,0.9910714285714286,1.009009009009009
73153,/images/f39e2289-fedd-4d12-9e64-ffdafb89247e.png,795,640,895,725,100,85,red blood cell,8500,0.85,1.1764705882352942
68268,/images/a6391703-0820-4913-a7cd-e843ff0d84ba.png,111,333,229,448,118,115,red blood cell,13570,0.9745762711864406,1.0260869565217392
38448,/images/674b0fd3-f247-4b7f-97f7-3e6c57c9ba9e.png,27,581,114,668,87,87,red blood cell,7569,1.0,1.0
27688,/images/18dbe7c4-89d2-42a6-a969-1e951ab313b1.png,69,1126,182,1240,113,114,red blood cell,12882,1.008849557522124,0.9912280701754386
37967,/images/56a57a8d-c9b9-432a-a3b0-32a09355806c.png,325,501,423,596,98,95,red blood cell,9310,0.9693877551020408,1.0315789473684212
67745,/images/48e2f0bd-2164-40c3-af43-1f2708359978.png,628,1175,740,1273,112,98,red blood cell,10976,0.875,1.1428571428571428
72480,/images/22516db4-8687-4051-90c4-2bb1ca3204a5.png,294,1073,416,1196,122,123,red blood cell,15006,1.0081967213114753,0.991869918699187
10608,/images/20d4f65e-6c63-433a-935c-d568d577967b.png,779,1102,860,1197,81,95,red blood cell,7695,1.1728395061728396,0.8526315789473684
77248,/images/07a80340-f65e-4f58-9317-94bb6ebd5a28.png,891,6,988,88,97,82,red blood cell,7954,0.845360824742268,1.1829268292682926
60118,/images/ec60ab26-3343-4c5f-9667-cdae999c7d86.png,286,613,403,709,117,96,red blood cell,11232,0.8205128205128205,1.21875
1735,/images/5f783f43-0090-4f8a-bd75-9562f4aa2dd5.png,0,1435,119,1560,119,125,red blood cell,14875,1.050420168067227,0.952
67415,/images/266180ed-77a3-4284-8292-50a49fc47fce.png,984,1028,1092,1132,108,104,red blood cell,11232,0.9629629629629629,1.0384615384615385
11497,/images/834a30bb-26bf-4e60-9ea1-3250b926892e.png,237,1217,360,1363,123,146,red blood cell,17958,1.1869918699186992,0.8424657534246576
32470,/images/3911fcd2-4e26-4ad9-aaf0-d1c5bf41defc.png,965,108,1063,214,98,106,red blood cell,10388,1.0816326530612246,0.9245283018867925
42371,/images/1a27ebe9-93a1-4898-af69-f276057d4012.png,107,891,217,991,110,100,red blood cell,11000,0.9090909090909091,1.1
77220,/images/fe691faa-3bc7-475e-b558-aa8fe7b795bc.png,343,1113,457,1215,114,102,red blood cell,11628,0.8947368421052632,1.1176470588235294
42455,/images/29648565-fe28-4517-ba72-68df0c82c9c5.png,247,1387,366,1503,119,116,red blood cell,13804,0.9747899159663865,1.0258620689655173
9733,/images/3859deaf-6ae1-49a3-9051-898d0f0d7de6.png,565,963,681,1063,116,100,red blood cell,11600,0.8620689655172413,1.16
9286,/images/261562a8-ffd8-4e0e-919b-22e267000b74.png,988,1134,1088,1225,100,91,red blood cell,9100,0.91,1.098901098901099
33659,/images/84ee2ea3-9edd-4672-a1b3-f09c607d833a.png,348,487,450,595,102,108,red blood cell,11016,1.0588235294117647,0.9444444444444444
62659,/images/f7a4334a-4332-4de8-b39b-22da907976f2.png,456,301,553,394,97,93,red blood cell,9021,0.9587628865979382,1.043010752688172
79660,/images/a4409217-be11-4478-90a5-b406057d154d.png,480,311,602,413,122,102,red blood cell,12444,0.8360655737704918,1.196078431372549
73513,/images/5f2b32bd-fdca-4d6f-b13a-ee9f83626c8d.png,1066,1489,1177,1597,111,108,red blood cell,11988,0.972972972972973,1.0277777777777777
10381,/images/46a2d369-4bea-4405-ac78-91bbe130b9a7.png,962,142,1061,242,99,100,red blood cell,9900,1.0101010101010102,0.99
30379,/images/58d75854-be99-484e-89f0-4ab208fe07e0.png,1036,812,1138,918,102,106,red blood cell,10812,1.0392156862745099,0.9622641509433962
53366,/images/f23ae29e-1bda-4784-b10c-d736757d39b8.png,722,678,807,774,85,96,red blood cell,8160,1.1294117647058823,0.8854166666666666
14696,/images/4e2873dd-651e-4ecc-ac70-7335cf21a469.png,516,386,634,501,118,115,red blood cell,13570,0.9745762711864406,1.0260869565217392
78096,/images/105af41b-13cc-4ad1-8a1f-8bc4d47cdd94.png,968,0,1065,98,97,98,red blood cell,9506,1.0103092783505154,0.9897959183673469
60955,/images/5397d8e2-bb09-42e7-9861-65ffad0fe94e.png,647,1070,772,1186,125,116,red blood cell,14500,0.928,1.0775862068965518
68917,/images/bbaa004f-05dc-4cb8-8768-e148085bb0f9.png,309,1448,418,1559,109,111,red blood cell,12099,1.018348623853211,0.9819819819819819
17379,/images/04018590-4e66-4cb9-ad2d-83570f1b29ae.png,590,202,711,322,121,120,red blood cell,14520,0.9917355371900827,1.0083333333333333
30400,/images/58d75854-be99-484e-89f0-4ab208fe07e0.png,585,1072,695,1196,110,124,red blood cell,13640,1.1272727272727272,0.8870967741935484
49035,/images/df3d98b9-3dd7-4107-8d4a-ae1b7f247793.png,297,1281,399,1371,102,90,red blood cell,9180,0.8823529411764706,1.1333333333333333
28465,/images/c3042130-a6e2-458f-9fde-bb012f68f5f2.png,979,151,1115,291,136,140,red blood cell,19040,1.0294117647058822,0.9714285714285714
15867,/images/c7c1b873-0548-4a73-9618-f60912e164df.png,188,126,288,240,100,114,red blood cell,11400,1.14,0.8771929824561403
5400,/images/75579b27-8191-4044-859b-268be969c42b.png,0,1092,112,1198,112,106,red blood cell,11872,0.9464285714285714,1.0566037735849056
53110,/images/04a567df-5463-4043-81f1-d726223c19a9.png,435,625,541,716,106,91,red blood cell,9646,0.8584905660377359,1.164835164835165
79100,/images/1c90231b-2830-42d9-884e-7301edb16933.png,803,1251,914,1362,111,111,red blood cell,12321,1.0,1.0
73243,/images/67a4fb91-6f38-4ca2-8f20-6b2f5f1b29a7.png,507,944,622,1048,115,104,red blood cell,11960,0.9043478260869565,1.1057692307692308
50770,/images/db0a1123-0b35-48d7-8337-3b1ebd6af0cc.png,190,809,297,912,107,103,red blood cell,11021,0.9626168224299065,1.0388349514563107
60731,/images/45651e76-4bd0-45e5-895b-edec65f51987.png,475,888,574,996,99,108,red blood cell,10692,1.0909090909090908,0.9166666666666666
76231,/images/90a82250-1f68-48c9-9af9-15f18bf8c974.png,802,806,909,916,107,110,red blood cell,11770,1.02803738317757,0.9727272727272728
35640,/images/45f18ac0-f097-4b20-a99d-8837cf488822.png,905,798,1007,914,102,116,red blood cell,11832,1.1372549019607843,0.8793103448275862
22721,/images/4ab47131-c2ac-461f-b95c-ac19ce24edbd.png,963,1080,1080,1181,117,101,red blood cell,11817,0.8632478632478633,1.1584158415841583
11620,/images/37e072a6-000d-4773-8d9f-d66b60ace668.png,335,435,441,536,106,101,red blood cell,10706,0.9528301886792453,1.0495049504950495
15060,/images/3003252a-2d2e-4687-ad30-9c38d68f1394.png,1040,487,1156,607,116,120,red blood cell,13920,1.0344827586206897,0.9666666666666667
11387,/images/2f6224be-50d0-4e85-94ef-88315df561b6.png,584,909,680,1012,96,103,red blood cell,9888,1.0729166666666667,0.9320388349514563
76707,/images/3317d733-ec0d-45e6-b631-40457392f343.png,1049,695,1161,785,112,90,red blood cell,10080,0.8035714285714286,1.2444444444444445
60474,/images/93b47b14-7f78-4b31-8897-d63a81fdab01.png,1081,1208,1199,1322,118,114,red blood cell,13452,0.9661016949152542,1.0350877192982457
23327,/images/e5731221-814c-4894-a44e-e46b71460fa4.png,328,6,439,123,111,117,red blood cell,12987,1.054054054054054,0.9487179487179487
75565,/images/c35ee701-fde2-46b5-b178-1fe3f1ea7da2.png,265,695,371,802,106,107,red blood cell,11342,1.009433962264151,0.9906542056074766
74750,/images/c53fd511-31bd-4901-baac-3b44891f6744.png,638,1271,723,1356,85,85,red blood cell,7225,1.0,1.0
47554,/images/adff132d-3af0-4cef-942c-58fc09729bee.png,135,751,247,872,112,121,red blood cell,13552,1.0803571428571428,0.9256198347107438
44136,/images/8b494b40-cab5-49d3-893d-c805000fbe88.png,315,439,418,542,103,103,red blood cell,10609,1.0,1.0
42842,/images/7029feb3-9ffe-46e4-9883-6a9df84f7b62.png,120,1070,224,1197,104,127,red blood cell,13208,1.2211538461538463,0.8188976377952756
38976,/images/5939f341-a886-4f63-ae87-2219d000a1d4.png,196,1085,317,1209,121,124,red blood cell,15004,1.024793388429752,0.9758064516129032
13481,/images/370277f8-436b-4103-8210-b4feb5ab95ea.png,34,192,143,289,109,97,red blood cell,10573,0.8899082568807339,1.1237113402061856
13272,/images/030f3421-ed3f-4bf1-8f27-4d02590bffbc.png,395,338,495,455,100,117,red blood cell,11700,1.17,0.8547008547008547
29598,/images/42845335-4ab2-4963-806d-0985d1382a31.png,848,618,959,736,111,118,red blood cell,13098,1.063063063063063,0.940677966101695
2411,/images/fe851c88-692d-4199-87e0-d19d9c4eb591.png,418,613,516,711,98,98,red blood cell,9604,1.0,1.0
209,/images/2559636b-f01a-4414-93da-210c3b12d153.png,495,731,605,835,110,104,red blood cell,11440,0.9454545454545454,1.0576923076923077
73300,/images/67a4fb91-6f38-4ca2-8f20-6b2f5f1b29a7.png,980,729,1071,822,91,93,red blood cell,8463,1.021978021978022,0.978494623655914
17116,/images/dc3bdfe9-1565-4cda-9c4e-0979846dab60.png,444,259,546,372,102,113,red blood cell,11526,1.107843137254902,0.9026548672566371
46608,/images/da111ca5-520f-4ea8-97ad-ae5fce58ee91.png,174,817,270,912,96,95,red blood cell,9120,0.9895833333333334,1.0105263157894737
1217,/images/5ff7c0c8-d208-4e7d-958d-ca3c2260ff39.png,642,765,771,877,129,112,red blood cell,14448,0.8682170542635659,1.1517857142857142
21490,/images/7625dfc4-858a-4c8e-907c-8943d665e9a7.png,306,614,394,704,88,90,red blood cell,7920,1.0227272727272727,0.9777777777777777
12882,/images/b10ea12f-cd36-4f2c-994a-67d1665269ab.png,583,231,679,332,96,101,red blood cell,9696,1.0520833333333333,0.9504950495049505
36496,/images/bd856928-96ee-4fc4-a377-f2fc4e84448b.png,70,846,181,942,111,96,red blood cell,10656,0.8648648648648649,1.15625
27963,/images/c4d34e35-4db2-41de-ba77-1a94aa9ef788.png,787,252,904,383,117,131,red blood cell,15327,1.1196581196581197,0.8931297709923665
982,/images/a8cb75ba-3f2f-40d8-8bc7-c79ebd1b9603.png,104,1193,207,1299,103,106,red blood cell,10918,1.029126213592233,0.9716981132075472
56923,/images/a93c35ba-1690-4358-8837-669bcd850bb7.png,802,1422,898,1518,96,96,red blood cell,9216,1.0,1.0
19098,/images/6e39fb0a-aa41-4b16-b783-7589e97bf289.png,476,973,610,1100,134,127,red blood cell,17018,0.9477611940298507,1.0551181102362204
29619,/images/42845335-4ab2-4963-806d-0985d1382a31.png,717,436,824,548,107,112,red blood cell,11984,1.0467289719626167,0.9553571428571429
78943,/images/4d0a1598-e4dd-45c4-8a90-dd7c780fe1da.png,112,557,202,630,90,73,red blood cell,6570,0.8111111111111111,1.2328767123287672
52044,/images/de6d3020-9347-473b-9146-8909627790f6.png,1027,757,1137,871,110,114,red blood cell,12540,1.0363636363636364,0.9649122807017544
27367,/images/9f38055f-4fe6-47fd-a6dd-c0743db4eccf.png,971,460,1086,569,115,109,red blood cell,12535,0.9478260869565217,1.055045871559633
2214,/images/5bf91ff9-80df-49c0-9c3e-599357d95530.png,786,546,887,643,101,97,red blood cell,9797,0.9603960396039604,1.041237113402062
44740,/images/ccb4b13d-ab20-4222-892f-5adf70249aaa.png,701,514,816,617,115,103,red blood cell,11845,0.8956521739130435,1.116504854368932
38060,/images/e3e9c2de-0a24-4c7e-8a69-3d3093d5bdab.png,1019,1461,1123,1574,104,113,red blood cell,11752,1.0865384615384615,0.9203539823008849
14097,/images/eaf4b781-b3aa-41ce-8c5e-287979b4e15a.png,62,757,153,857,91,100,red blood cell,9100,1.098901098901099,0.91
39772,/images/5c68070c-3391-4db6-8c01-94175105dbea.png,207,279,319,381,112,102,red blood cell,11424,0.9107142857142857,1.0980392156862746
56222,/images/b600b38d-225b-46a5-b6f8-b607430f6a10.png,628,55,723,155,95,100,red blood cell,9500,1.0526315789473684,0.95
31933,/images/9eb66577-7857-43dc-a879-8f2c9d7f780f.png,24,1028,134,1139,110,111,red blood cell,12210,1.009090909090909,0.990990990990991
58597,/images/a4d7a7e1-5ae1-486d-b6ee-c9af1476ccad.png,83,188,184,292,101,104,red blood cell,10504,1.0297029702970297,0.9711538461538461
30908,/images/533c47c9-02a6-419b-961b-81797f022f6c.png,652,275,757,387,105,112,red blood cell,11760,1.0666666666666667,0.9375
64527,/images/6ba5d0b8-cdc7-4266-9d78-db76faa312e9.png,420,226,513,315,93,89,red blood cell,8277,0.956989247311828,1.0449438202247192
31054,/images/9c48fdf4-621d-4f40-bcd7-6a28cd530de7.png,219,181,310,272,91,91,red blood cell,8281,1.0,1.0
35971,/images/5836500a-221e-40ca-a8be-caaa37f7d300.png,380,1078,493,1187,113,109,red blood cell,12317,0.9646017699115044,1.036697247706422
6173,/images/27cdd837-e40f-491e-8adb-61e493189832.png,628,344,746,447,118,103,red blood cell,12154,0.8728813559322034,1.145631067961165
63919,/images/5e974892-0ebe-4037-8427-ea8616d6d3b8.png,241,1048,369,1156,128,108,red blood cell,13824,0.84375,1.1851851851851851
17163,/images/dc3bdfe9-1565-4cda-9c4e-0979846dab60.png,819,307,923,416,104,109,red blood cell,11336,1.0480769230769231,0.9541284403669725
16290,/images/d5009906-bce1-4353-90b4-f4c79362f4cf.png,886,1053,1013,1163,127,110,red blood cell,13970,0.8661417322834646,1.1545454545454545
38969,/images/5939f341-a886-4f63-ae87-2219d000a1d4.png,766,640,899,767,133,127,red blood cell,16891,0.9548872180451128,1.047244094488189
25094,/images/9e74feb8-017d-4d53-8896-9ebda4327dd1.png,580,349,691,461,111,112,red blood cell,12432,1.009009009009009,0.9910714285714286
64249,/images/83d4e1fe-da84-4175-a9e2-8efc18782dcf.png,291,1046,399,1144,108,98,red blood cell,10584,0.9074074074074074,1.1020408163265305
71126,/images/b666fcc2-d0b2-441e-bc5a-c660345eeb5d.png,583,1144,717,1274,134,130,red blood cell,17420,0.9701492537313433,1.0307692307692307
46556,/images/edd09b2e-2673-4405-8ac0-e476e003e96a.png,547,408,690,541,143,133,red blood cell,19019,0.9300699300699301,1.0751879699248121
78991,/images/6144887d-a1c1-46db-91a1-f7ff5bf8c8a5.png,7,1159,92,1265,85,106,red blood cell,9010,1.2470588235294118,0.8018867924528302
2099,/images/f3bd0fcc-647d-4ca0-8c43-a16bd6ea3878.png,840,624,957,740,117,116,red blood cell,13572,0.9914529914529915,1.0086206896551724
37685,/images/003a89b0-a095-417a-8dd6-f408339bbc68.png,1050,127,1156,240,106,113,red blood cell,11978,1.0660377358490567,0.9380530973451328
74955,/images/dd090806-e4ac-4a78-b2ee-55a30626369c.png,977,1478,1102,1584,125,106,red blood cell,13250,0.848,1.179245283018868
54693,/images/6473ddb6-ad56-48a2-81e8-c7cb45f06825.png,248,301,346,402,98,101,red blood cell,9898,1.030612244897959,0.9702970297029703
77639,/images/07d15855-eb9b-46a9-b894-7cfe4d097826.png,11,1211,137,1328,126,117,red blood cell,14742,0.9285714285714286,1.0769230769230769
57755,/images/5c037ffc-f515-48b3-b231-c110fbd2b8ca.png,388,188,485,288,97,100,red blood cell,9700,1.0309278350515463,0.97
23011,/images/0d095f3a-9243-472b-90b4-0ce8309e778c.png,654,16,782,124,128,108,red blood cell,13824,0.84375,1.1851851851851851
12319,/images/3b55c42f-ad59-422f-ba99-4f4f4ca9cb2e.png,775,1004,892,1099,117,95,red blood cell,11115,0.811965811965812,1.231578947368421
39470,/images/5a631871-2fc7-4a68-9c39-f3b9a0bf4a04.png,263,693,376,816,113,123,red blood cell,13899,1.0884955752212389,0.9186991869918699
767,/images/27fab82c-5bf0-426f-aeb9-47da829b6629.png,573,754,675,849,102,95,red blood cell,9690,0.9313725490196079,1.0736842105263158
55067,/images/1f8f08ea-b5b3-4f68-94d4-3cc071b7dce8.png,945,1217,1040,1300,95,83,red blood cell,7885,0.8736842105263158,1.144578313253012
24997,/images/ed0bee2f-05e0-4392-8357-19750cec577c.png,293,420,396,523,103,103,red blood cell,10609,1.0,1.0
17384,/images/04018590-4e66-4cb9-ad2d-83570f1b29ae.png,224,1339,338,1454,114,115,red blood cell,13110,1.0087719298245614,0.991304347826087
1790,/images/5f783f43-0090-4f8a-bd75-9562f4aa2dd5.png,66,1090,167,1193,101,103,red blood cell,10403,1.0198019801980198,0.9805825242718447
52792,/images/0a747cb3-c720-4572-a661-ab5670a5c42e.png,213,570,318,680,105,110,red blood cell,11550,1.0476190476190477,0.9545454545454546
33434,/images/244ac6fa-8a92-4214-9cf4-ae0811d9ec7e.png,38,175,158,291,120,116,red blood cell,13920,0.9666666666666667,1.0344827586206897
20610,/images/0f2a6cda-afec-437b-8803-8d3176b072c1.png,886,798,1001,906,115,108,red blood cell,12420,0.9391304347826087,1.0648148148148149
63681,/images/d9c9479e-f1ea-4d6e-861f-843ff9a90d19.png,202,0,308,88,106,88,red blood cell,9328,0.8301886792452831,1.2045454545454546
53685,/images/6f67a66b-56ec-4c36-ae7c-f250d3b86a23.png,91,546,200,652,109,106,red blood cell,11554,0.9724770642201835,1.028301886792453
19661,/images/a3ada657-de00-44db-b1e2-54ba17e39983.png,205,1454,328,1600,123,146,red blood cell,17958,1.1869918699186992,0.8424657534246576
51292,/images/216f9d43-6869-4ba1-9106-4f5ea6aac223.png,1030,167,1123,263,93,96,red blood cell,8928,1.032258064516129,0.96875
66417,/images/e5fd5949-4cd0-4cb6-837a-02c26a5eb87a.png,790,0,909,113,119,113,red blood cell,13447,0.9495798319327731,1.0530973451327434
539,/images/67acd5bc-4658-4c6e-a9b9-cd8ea3a03418.png,240,157,358,274,118,117,red blood cell,13806,0.9915254237288136,1.0085470085470085
9963,/images/b9ccf7ca-953f-4832-9575-5e70b2a8c224.png,339,260,436,361,97,101,red blood cell,9797,1.041237113402062,0.9603960396039604
57082,/images/7d041c38-11f2-4186-8a24-29d7d0f5c3cf.png,90,1290,192,1391,102,101,red blood cell,10302,0.9901960784313726,1.00990099009901
3182,/images/c3215597-a032-46be-9058-d6de1e5191d7.png,1023,660,1147,788,124,128,red blood cell,15872,1.032258064516129,0.96875
35356,/images/452482bc-24a3-413e-ba03-fad4c9d61f3c.png,508,1454,600,1555,92,101,red blood cell,9292,1.0978260869565217,0.9108910891089109
40774,/images/252071ac-e9f2-41d2-abbb-87ef01b8a997.png,708,420,798,512,90,92,red blood cell,8280,1.0222222222222221,0.9782608695652174
14977,/images/5d1418d3-1559-4725-ad4a-9afb6eaecdfd.png,222,1470,341,1570,119,100,red blood cell,11900,0.8403361344537815,1.19
8623,/images/a6aa3b72-2970-4c78-b655-ea8dfe6e018c.png,787,996,866,1087,79,91,red blood cell,7189,1.1518987341772151,0.8681318681318682
55743,/images/68f34a9c-f73d-4238-8f55-4b05a8a2154c.png,28,1339,139,1452,111,113,red blood cell,12543,1.018018018018018,0.9823008849557522
53289,/images/d8f7e159-b7e3-49e4-86e8-aed8c5fbcd97.png,1013,894,1120,1001,107,107,red blood cell,11449,1.0,1.0
47834,/images/5a105b89-c592-4d78-b208-7db6c6572752.png,955,730,1090,857,135,127,red blood cell,17145,0.9407407407407408,1.062992125984252
735,/images/dcc1a193-7b74-44f8-ad8d-813751d8fa6b.png,278,10,400,144,122,134,red blood cell,16348,1.098360655737705,0.9104477611940298
23920,/images/3d8fb5bf-3315-48fb-8ab1-802eafd550bc.png,11,775,114,894,103,119,red blood cell,12257,1.1553398058252426,0.865546218487395
20609,/images/0f2a6cda-afec-437b-8803-8d3176b072c1.png,609,1109,722,1231,113,122,red blood cell,13786,1.079646017699115,0.9262295081967213
68376,/images/040112be-3c8d-49aa-93f1-522f94a592ff.png,921,1462,1018,1558,97,96,red blood cell,9312,0.9896907216494846,1.0104166666666667
50832,/images/db0a1123-0b35-48d7-8337-3b1ebd6af0cc.png,645,818,748,935,103,117,red blood cell,12051,1.1359223300970873,0.8803418803418803
62456,/images/7dfbfeaf-e3b1-4159-8dcd-d7f731280ac8.png,1047,1406,1161,1526,114,120,red blood cell,13680,1.0526315789473684,0.95
73279,/images/67a4fb91-6f38-4ca2-8f20-6b2f5f1b29a7.png,438,978,557,1090,119,112,red blood cell,13328,0.9411764705882353,1.0625
4017,/images/a5e05ba8-0c19-41e3-92d5-10e42a03b85e.png,635,464,761,565,126,101,red blood cell,12726,0.8015873015873016,1.2475247524752475
55365,/images/4fb83278-adc5-4424-9f45-b6d0db2955b6.png,106,755,193,859,87,104,red blood cell,9048,1.1954022988505748,0.8365384615384616
62014,/images/bdb5d571-27bc-4a42-ae45-aa5a9af40a81.png,601,111,705,211,104,100,red blood cell,10400,0.9615384615384616,1.04
31093,/images/9c48fdf4-621d-4f40-bcd7-6a28cd530de7.png,720,140,853,248,133,108,red blood cell,14364,0.8120300751879699,1.2314814814814814
36047,/images/ca9626bc-21a4-46f4-ba94-e7ee7a4cf735.png,722,49,842,169,120,120,red blood cell,14400,1.0,1.0
40110,/images/6fd30823-3b77-40c9-ba5d-e1eda9660674.png,827,1052,938,1165,111,113,red blood cell,12543,1.018018018018018,0.9823008849557522
76774,/images/2165fe38-b474-467d-be11-d1d728085efd.png,305,567,442,679,137,112,red blood cell,15344,0.8175182481751825,1.2232142857142858
51882,/images/d67398c5-8b0e-463f-a04e-8583c820786c.png,293,1058,400,1145,107,87,red blood cell,9309,0.8130841121495327,1.2298850574712643
10698,/images/20d4f65e-6c63-433a-935c-d568d577967b.png,612,1419,711,1513,99,94,red blood cell,9306,0.9494949494949495,1.053191489361702
49351,/images/28c96a4a-4549-4761-99e4-ace4ea7e7ac9.png,644,792,764,926,120,134,red blood cell,16080,1.1166666666666667,0.8955223880597015
62235,/images/a72cd558-b7ac-4bf2-a344-2ce6c73a354e.png,319,1339,424,1443,105,104,red blood cell,10920,0.9904761904761905,1.0096153846153846
25261,/images/587e5464-d70b-4279-8562-010279f6efbd.png,682,1348,783,1473,101,125,red blood cell,12625,1.2376237623762376,0.808
16218,/images/acdc6e12-73d9-44ba-be8c-2a56aaffef4f.png,64,840,185,961,121,121,red blood cell,14641,1.0,1.0
55755,/images/68f34a9c-f73d-4238-8f55-4b05a8a2154c.png,872,568,976,677,104,109,red blood cell,11336,1.0480769230769231,0.9541284403669725
63711,/images/06401963-8b02-46c5-ab2a-3d70bd01623f.png,843,1105,936,1200,93,95,red blood cell,8835,1.021505376344086,0.9789473684210527
18467,/images/9b410534-3b70-4a88-9f93-205cf4e55a05.png,415,580,513,690,98,110,red blood cell,10780,1.1224489795918366,0.8909090909090909
48032,/images/1d4f06e1-9c9b-487e-84cd-e7e50cc754da.png,14,161,131,280,117,119,red blood cell,13923,1.017094017094017,0.9831932773109243
56158,/images/137d540f-d71e-47e8-bd9b-6cd0a6433c33.png,675,124,782,231,107,107,red blood cell,11449,1.0,1.0
1238,/images/5ff7c0c8-d208-4e7d-958d-ca3c2260ff39.png,1064,1015,1189,1117,125,102,red blood cell,12750,0.816,1.2254901960784315
42270,/images/ca734448-0d52-42fa-b41c-17b2939e58ae.png,130,908,239,1015,109,107,red blood cell,11663,0.981651376146789,1.0186915887850467
73282,/images/67a4fb91-6f38-4ca2-8f20-6b2f5f1b29a7.png,647,559,739,640,92,81,red blood cell,7452,0.8804347826086957,1.1358024691358024
28398,/images/a6d85204-24b8-4b23-a8b1-c3e8b93f9f22.png,115,1423,230,1533,115,110,red blood cell,12650,0.9565217391304348,1.0454545454545454
16410,/images/e474a20b-2769-48f1-a520-4f6ef5a0dbf5.png,970,1380,1073,1488,103,108,red blood cell,11124,1.0485436893203883,0.9537037037037037
55432,/images/d67655e6-0a80-4a86-b552-1f5e85788377.png,391,359,499,461,108,102,red blood cell,11016,0.9444444444444444,1.0588235294117647
28442,/images/c3042130-a6e2-458f-9fde-bb012f68f5f2.png,872,1484,994,1600,122,116,red blood cell,14152,0.9508196721311475,1.0517241379310345
61591,/images/4a717a39-80f8-4b75-a25e-c46d65d7dcd5.png,522,252,609,335,87,83,red blood cell,7221,0.9540229885057471,1.0481927710843373
3002,/images/5a386082-397f-4524-a6f9-c2b8efe5014d.png,532,30,652,129,120,99,red blood cell,11880,0.825,1.2121212121212122
27587,/images/715761a2-745e-4743-9849-956a034ad3c4.png,164,1136,259,1242,95,106,red blood cell,10070,1.1157894736842104,0.8962264150943396
50568,/images/e98ea067-82b5-4a0d-87bf-b4bbdc10ddab.png,278,872,390,989,112,117,red blood cell,13104,1.0446428571428572,0.9572649572649573
40389,/images/db249e5a-4142-432c-8288-bacd10d7273d.png,457,59,581,181,124,122,red blood cell,15128,0.9838709677419355,1.0163934426229508
18067,/images/0f0c949e-018a-4f3f-ab02-3704f49c7754.png,843,28,950,134,107,106,red blood cell,11342,0.9906542056074766,1.009433962264151
1519,/images/0ac747cd-ff32-49bf-bc1a-3e9b7702ce9c.png,273,1206,373,1315,100,109,red blood cell,10900,1.09,0.9174311926605505
22943,/images/ecd68ba2-48af-4866-826a-7cd1c147c055.png,909,1183,1034,1293,125,110,red blood cell,13750,0.88,1.1363636363636365
71313,/images/bcb447c9-5d37-414f-a513-d7076b04a532.png,346,95,457,213,111,118,red blood cell,13098,1.063063063063063,0.940677966101695
26781,/images/2518f6e4-29cc-4ae4-a914-b215a4c56099.png,209,810,309,924,100,114,red blood cell,11400,1.14,0.8771929824561403
49449,/images/f2574be3-81c6-4fc3-8a40-0230d1264f52.png,565,130,657,227,92,97,red blood cell,8924,1.0543478260869565,0.9484536082474226
37922,/images/56a57a8d-c9b9-432a-a3b0-32a09355806c.png,419,742,526,839,107,97,red blood cell,10379,0.9065420560747663,1.1030927835051547
54801,/images/b6364a57-72a9-43f3-8d02-9f53a992dc95.png,916,956,1018,1073,102,117,red blood cell,11934,1.1470588235294117,0.8717948717948718
18517,/images/c22f7031-9cf8-48ce-b03b-1b12d0db4951.png,209,1397,302,1498,93,101,red blood cell,9393,1.086021505376344,0.9207920792079208
40433,/images/db249e5a-4142-432c-8288-bacd10d7273d.png,148,1074,239,1169,91,95,red blood cell,8645,1.043956043956044,0.9578947368421052
10372,/images/46a2d369-4bea-4405-ac78-91bbe130b9a7.png,683,1435,786,1532,103,97,red blood cell,9991,0.941747572815534,1.0618556701030928
27523,/images/f5869ba8-6253-426b-93f3-82af59a86144.png,832,733,930,851,98,118,red blood cell,11564,1.2040816326530612,0.8305084745762712
57762,/images/5c037ffc-f515-48b3-b231-c110fbd2b8ca.png,284,1305,389,1417,105,112,red blood cell,11760,1.0666666666666667,0.9375
54453,/images/22a464ef-c3da-4d56-b37e-e22e95d945e7.png,904,279,995,366,91,87,red blood cell,7917,0.9560439560439561,1.0459770114942528
22435,/images/f97c7c87-5e27-45ea-9f93-3285d74091de.png,420,706,532,823,112,117,red blood cell,13104,1.0446428571428572,0.9572649572649573
9237,/images/261562a8-ffd8-4e0e-919b-22e267000b74.png,777,648,883,755,106,107,red blood cell,11342,1.009433962264151,0.9906542056074766
7728,/images/9f959520-e15e-45c2-bc29-ef3c19154d1c.png,1087,717,1196,821,109,104,red blood cell,11336,0.9541284403669725,1.0480769230769231
61794,/images/985627c9-7b85-40de-a106-eb9cc47b47cb.png,81,81,187,166,106,85,red blood cell,9010,0.8018867924528302,1.2470588235294118
47265,/images/58ced55c-bf0d-4204-b6b2-4f8992d92779.png,23,286,127,390,104,104,red blood cell,10816,1.0,1.0
62593,/images/f7a4334a-4332-4de8-b39b-22da907976f2.png,994,584,1100,698,106,114,red blood cell,12084,1.0754716981132075,0.9298245614035088
72815,/images/31435107-c77d-42f8-a619-75cba6a5161b.png,676,353,794,457,118,104,red blood cell,12272,0.8813559322033898,1.1346153846153846
37430,/images/08f5a524-0554-49c2-83a8-ae9a6d51e8fd.png,0,622,118,730,118,108,red blood cell,12744,0.9152542372881356,1.0925925925925926
7932,/images/9af4b8ae-c912-41fd-b4c0-34864c75360f.png,1043,1,1159,117,116,116,red blood cell,13456,1.0,1.0
55291,/images/4fb83278-adc5-4424-9f45-b6d0db2955b6.png,449,750,567,852,118,102,red blood cell,12036,0.864406779661017,1.1568627450980393
58222,/images/2f68686f-1fe8-46e7-ad92-a08e3523ea79.png,623,106,746,221,123,115,red blood cell,14145,0.9349593495934959,1.0695652173913044
32328,/images/1c406ce1-023b-47fc-a2cd-5ea2e255de65.png,951,330,1070,458,119,128,red blood cell,15232,1.0756302521008403,0.9296875
57054,/images/9e82c996-2cfa-418d-9482-8ee23e9d0a5d.png,802,886,906,991,104,105,red blood cell,10920,1.0096153846153846,0.9904761904761905
75762,/images/f48bf825-13c4-42fc-8dd8-10cc4ae6b202.png,296,94,390,196,94,102,red blood cell,9588,1.0851063829787233,0.9215686274509803
26533,/images/4935818a-7e7a-4f44-a3b6-b361d1abfe16.png,576,158,689,287,113,129,red blood cell,14577,1.1415929203539823,0.875968992248062
48624,/images/55836297-fc8e-4e00-9767-0d12b86e4604.png,654,704,743,812,89,108,red blood cell,9612,1.2134831460674158,0.8240740740740741
17019,/images/57e1879e-4294-45e7-9c1b-627e8cca0271.png,796,603,907,709,111,106,red blood cell,11766,0.954954954954955,1.0471698113207548
68444,/images/040112be-3c8d-49aa-93f1-522f94a592ff.png,314,785,421,880,107,95,red blood cell,10165,0.8878504672897196,1.1263157894736842
73924,/images/2ae3e6e6-7482-4ab8-ad73-b530b5c2ee3b.png,800,1036,916,1143,116,107,red blood cell,12412,0.9224137931034483,1.0841121495327102
23133,/images/c94a5851-b846-4fde-8c89-05bec3a8ac53.png,516,443,638,569,122,126,red blood cell,15372,1.0327868852459017,0.9682539682539683
36245,/images/b2103776-9b32-4160-b4f0-0692deda19dc.png,64,484,179,598,115,114,red blood cell,13110,0.991304347826087,1.0087719298245614
42298,/images/ca734448-0d52-42fa-b41c-17b2939e58ae.png,128,244,227,361,99,117,red blood cell,11583,1.1818181818181819,0.8461538461538461
60667,/images/45651e76-4bd0-45e5-895b-edec65f51987.png,799,1389,917,1496,118,107,red blood cell,12626,0.9067796610169492,1.102803738317757
31482,/images/83ec1cb9-1714-4bf1-81f6-115fde84564d.png,898,524,1012,660,114,136,red blood cell,15504,1.1929824561403508,0.8382352941176471
51366,/images/b4f3b2a4-f4b9-48de-ac5d-0e681b77be27.png,956,377,1078,487,122,110,red blood cell,13420,0.9016393442622951,1.1090909090909091
47949,/images/ab27173b-6e30-4957-bd68-29194328fd39.png,1090,242,1194,351,104,109,red blood cell,11336,1.0480769230769231,0.9541284403669725
10899,/images/1380f9b4-bf54-4492-90c3-743c7aa8898b.png,211,1261,315,1366,104,105,red blood cell,10920,1.0096153846153846,0.9904761904761905
34353,/images/1a48cbc1-5423-47e5-8ca5-2ab4f83a05a5.png,130,52,247,162,117,110,red blood cell,12870,0.9401709401709402,1.0636363636363637
53249,/images/d8f7e159-b7e3-49e4-86e8-aed8c5fbcd97.png,648,1481,737,1573,89,92,red blood cell,8188,1.0337078651685394,0.967391304347826
58489,/images/5cac6ddf-c8c6-45de-bce0-a1db64b14fb5.png,448,1104,555,1228,107,124,red blood cell,13268,1.158878504672897,0.8629032258064516
59671,/images/a2754679-68b0-40f4-be01-bafad5ac1261.png,198,250,292,338,94,88,red blood cell,8272,0.9361702127659575,1.0681818181818181
47809,/images/5a105b89-c592-4d78-b208-7db6c6572752.png,139,826,246,950,107,124,red blood cell,13268,1.158878504672897,0.8629032258064516
47512,/images/adff132d-3af0-4cef-942c-58fc09729bee.png,929,642,1029,757,100,115,red blood cell,11500,1.15,0.8695652173913043
41292,/images/2374ae5b-c2df-4db5-afea-c54180aa22e3.png,185,384,304,500,119,116,red blood cell,13804,0.9747899159663865,1.0258620689655173
67280,/images/5f491efd-a21c-4a80-aaba-70b8876238ac.png,828,1465,914,1564,86,99,red blood cell,8514,1.1511627906976745,0.8686868686868687
57252,/images/6d05ed67-43e2-43af-9d57-70c7a6eeef5e.png,821,813,929,932,108,119,red blood cell,12852,1.1018518518518519,0.907563025210084
74394,/images/06a3effb-996c-4767-afd2-6aa3b697cb4e.png,116,417,211,512,95,95,red blood cell,9025,1.0,1.0
63813,/images/6013bff0-dc4b-4bde-9409-0f6139c3495c.png,226,1357,305,1445,79,88,red blood cell,6952,1.1139240506329113,0.8977272727272727
2868,/images/521a26aa-0a31-4c07-b4d0-fac08eb08344.png,687,765,806,897,119,132,red blood cell,15708,1.1092436974789917,0.9015151515151515
75304,/images/9ec1dcec-87c2-4aca-8e6b-0db3cd05509c.png,804,681,906,781,102,100,red blood cell,10200,0.9803921568627451,1.02
2010,/images/bfefa21c-11e1-4dab-ac5d-8ff6f046d65f.png,973,423,1099,563,126,140,red blood cell,17640,1.1111111111111112,0.9
74161,/images/4e43fc22-dc08-4cde-b3ce-ce8a4f377c47.png,702,350,812,461,110,111,red blood cell,12210,1.009090909090909,0.990990990990991
54018,/images/5e4f7425-11e6-4f9e-be2d-5a27deb9d1b4.png,614,820,721,918,107,98,red blood cell,10486,0.9158878504672897,1.0918367346938775
6317,/images/c6575e75-c8ce-4766-841f-1137b9e0956c.png,52,504,173,631,121,127,red blood cell,15367,1.0495867768595042,0.952755905511811
6829,/images/e36cb882-c6d0-4467-812e-d18c169a9a47.png,518,520,625,635,107,115,red blood cell,12305,1.074766355140187,0.9304347826086956
44475,/images/b6573be3-9e04-49c3-9f48-6a145d065363.png,278,689,398,810,120,121,red blood cell,14520,1.0083333333333333,0.9917355371900827
10535,/images/46a2d369-4bea-4405-ac78-91bbe130b9a7.png,272,1294,370,1404,98,110,red blood cell,10780,1.1224489795918366,0.8909090909090909
79390,/images/dcb21739-3c36-459d-b3cc-1be5871d6fe7.png,8,668,139,804,131,136,red blood cell,17816,1.0381679389312977,0.9632352941176471
16512,/images/1315c2a4-0794-4dfa-a709-e2451723d2b6.png,45,458,176,600,131,142,red blood cell,18602,1.083969465648855,0.9225352112676056
15987,/images/c7c1b873-0548-4a73-9618-f60912e164df.png,745,293,841,382,96,89,red blood cell,8544,0.9270833333333334,1.0786516853932584
48572,/images/f3d84be2-8af0-4d62-9f72-23d3dc08cbbe.png,896,1200,1003,1328,107,128,red blood cell,13696,1.1962616822429906,0.8359375
39566,/images/5a631871-2fc7-4a68-9c39-f3b9a0bf4a04.png,69,1435,162,1544,93,109,red blood cell,10137,1.1720430107526882,0.8532110091743119
64300,/images/0a7bfa8a-ee52-4f7a-b9c5-2919ecfa93ef.png,227,563,339,678,112,115,red blood cell,12880,1.0267857142857142,0.9739130434782609
73717,/images/f11d05e4-538a-4024-8711-b08a4ce3c540.png,337,552,442,645,105,93,red blood cell,9765,0.8857142857142857,1.1290322580645162
25767,/images/1f8edb2a-40bc-4beb-aa6b-884d2473df0f.png,1052,668,1174,792,122,124,red blood cell,15128,1.0163934426229508,0.9838709677419355
23144,/images/c94a5851-b846-4fde-8c89-05bec3a8ac53.png,5,477,98,580,93,103,red blood cell,9579,1.10752688172043,0.9029126213592233
67114,/images/4272cbd7-5b0a-4bf7-b690-dee1c128f07b.png,293,378,389,469,96,91,red blood cell,8736,0.9479166666666666,1.054945054945055
128,/images/10be6380-cbbb-4886-8b9e-ff56b1710576.png,526,638,637,734,111,96,red blood cell,10656,0.8648648648648649,1.15625
57671,/images/5c037ffc-f515-48b3-b231-c110fbd2b8ca.png,950,156,1070,260,120,104,red blood cell,12480,0.8666666666666667,1.1538461538461537
30153,/images/a1669b59-fe09-4fe6-ba9f-06bec6725502.png,878,1328,985,1432,107,104,red blood cell,11128,0.9719626168224299,1.0288461538461537
43651,/images/a4851ed0-1499-4eae-9157-dcd34773254f.png,631,1192,738,1311,107,119,red blood cell,12733,1.1121495327102804,0.8991596638655462
70922,/images/bf002a25-6535-4621-be19-56d468be5413.png,231,546,313,632,82,86,red blood cell,7052,1.048780487804878,0.9534883720930233
10085,/images/d1617cf7-eb56-42ee-85af-66c4748753c0.png,57,495,188,628,131,133,red blood cell,17423,1.015267175572519,0.9849624060150376
61611,/images/4a717a39-80f8-4b75-a25e-c46d65d7dcd5.png,837,1,918,77,81,76,red blood cell,6156,0.9382716049382716,1.0657894736842106
45404,/images/e4eea7ea-8989-46a9-9c98-25a178146b28.png,264,1310,347,1397,83,87,red blood cell,7221,1.0481927710843373,0.9540229885057471
8108,/images/694222bb-cddf-469a-9526-f873c6fba58e.png,916,496,1019,585,103,89,red blood cell,9167,0.8640776699029126,1.1573033707865168
57333,/images/a88a48b6-f85c-45c1-b42f-79716c8463f1.png,531,1049,625,1150,94,101,red blood cell,9494,1.074468085106383,0.9306930693069307
24082,/images/505355c9-23bf-4f90-8ebc-6a7ef50964d0.png,800,1454,897,1551,97,97,red blood cell,9409,1.0,1.0
6255,/images/f4a27dfd-4c52-459f-96b5-ee6b452a3395.png,760,398,877,517,117,119,red blood cell,13923,1.017094017094017,0.9831932773109243
39405,/images/fbcb2ef0-3c97-4d7a-8b96-0147c73f3941.png,536,247,649,351,113,104,red blood cell,11752,0.9203539823008849,1.0865384615384615
59945,/images/f0fe292d-85ae-4c3a-a676-037dde2594e6.png,168,783,265,890,97,107,red blood cell,10379,1.1030927835051547,0.9065420560747663
53903,/images/540a5fee-175b-4b92-bf62-1ea9b59c86c6.png,930,923,1031,1035,101,112,red blood cell,11312,1.108910891089109,0.9017857142857143
58029,/images/a7c91b63-b97c-4f4b-8d34-7ad2b08d7a17.png,175,317,262,420,87,103,red blood cell,8961,1.1839080459770115,0.8446601941747572
16416,/images/e474a20b-2769-48f1-a520-4f6ef5a0dbf5.png,817,1338,934,1434,117,96,red blood cell,11232,0.8205128205128205,1.21875
77443,/images/c7ec51d5-9f45-4209-8357-39e9a984a733.png,7,26,105,129,98,103,red blood cell,10094,1.0510204081632653,0.9514563106796117
50482,/images/833b1d3e-d389-4d0f-8638-6aca5b89f917.png,560,1376,696,1501,136,125,red blood cell,17000,0.9191176470588235,1.088
6410,/images/1ecb0405-a6e9-4485-819e-2fbbf2b718aa.png,953,483,1065,601,112,118,red blood cell,13216,1.0535714285714286,0.9491525423728814
12140,/images/87d6343b-70dd-4cdd-939f-d3ac0ca2e700.png,321,66,427,180,106,114,red blood cell,12084,1.0754716981132075,0.9298245614035088
45417,/images/e4eea7ea-8989-46a9-9c98-25a178146b28.png,423,16,509,96,86,80,red blood cell,6880,0.9302325581395349,1.075
38866,/images/d79b4e90-c45d-4f5d-a498-49c3e323c291.png,669,507,777,612,108,105,red blood cell,11340,0.9722222222222222,1.0285714285714285
47126,/images/3d1b889e-bb4a-4ee6-b899-974ee7d956a7.png,999,1288,1090,1386,91,98,red blood cell,8918,1.0769230769230769,0.9285714285714286
23610,/images/79d7a014-21ff-40f1-9ac4-a69839390654.png,962,835,1060,930,98,95,red blood cell,9310,0.9693877551020408,1.0315789473684212
64916,/images/dec61ae1-5037-4c3a-8952-15371becca7d.png,964,1269,1066,1368,102,99,red blood cell,10098,0.9705882352941176,1.0303030303030303
26257,/images/52767904-4cdc-4821-ba68-8cd0c28f9023.png,909,318,1034,434,125,116,red blood cell,14500,0.928,1.0775862068965518
36060,/images/ca9626bc-21a4-46f4-ba94-e7ee7a4cf735.png,443,244,564,364,121,120,red blood cell,14520,0.9917355371900827,1.0083333333333333
64045,/images/03cbfcf2-8da6-462c-b30d-16d63357371f.png,117,817,203,903,86,86,red blood cell,7396,1.0,1.0
29385,/images/30167dc1-f739-4036-b5c4-5fad435c2c67.png,329,985,456,1106,127,121,red blood cell,15367,0.952755905511811,1.0495867768595042
36779,/images/aa2dfa24-2dc3-4279-a232-f84780ace190.png,563,1221,667,1330,104,109,red blood cell,11336,1.0480769230769231,0.9541284403669725
57175,/images/7c870293-2665-4a6b-a4fa-336959051dfc.png,741,615,860,727,119,112,red blood cell,13328,0.9411764705882353,1.0625
11647,/images/0ed416f9-7c20-4829-9016-559e4009568e.png,574,91,682,194,108,103,red blood cell,11124,0.9537037037037037,1.0485436893203883
74836,/images/81edcae1-65bf-4752-b0e4-494376b71e49.png,409,959,510,1057,101,98,red blood cell,9898,0.9702970297029703,1.030612244897959
47166,/images/3d1b889e-bb4a-4ee6-b899-974ee7d956a7.png,268,299,374,395,106,96,red blood cell,10176,0.9056603773584906,1.1041666666666667
62363,/images/e0ff3476-226f-4125-b182-8e524d5503dd.png,1104,1381,1200,1477,96,96,red blood cell,9216,1.0,1.0
49268,/images/989d86a1-6d76-4089-85cf-2f2ca0a8456c.png,14,352,128,462,114,110,red blood cell,12540,0.9649122807017544,1.0363636363636364
71426,/images/bcb447c9-5d37-414f-a513-d7076b04a532.png,539,1383,631,1488,92,105,red blood cell,9660,1.141304347826087,0.8761904761904762
5431,/images/75579b27-8191-4044-859b-268be969c42b.png,819,163,940,285,121,122,red blood cell,14762,1.0082644628099173,0.9918032786885246
45906,/images/939ad732-d7c5-4339-b087-4335b49d6a3c.png,554,750,657,869,103,119,red blood cell,12257,1.1553398058252426,0.865546218487395
9058,/images/21c2a8aa-407c-4569-8212-96fcafa84138.png,585,403,704,525,119,122,red blood cell,14518,1.0252100840336134,0.9754098360655737
72303,/images/ee57e743-a876-4f69-9fe5-bf5d01b44689.png,683,265,800,374,117,109,red blood cell,12753,0.9316239316239316,1.073394495412844
12299,/images/3b55c42f-ad59-422f-ba99-4f4f4ca9cb2e.png,799,1326,894,1417,95,91,red blood cell,8645,0.9578947368421052,1.043956043956044
71012,/images/deaa1931-5f97-45bf-8c00-be6ddeb37b9a.png,120,629,232,719,112,90,red blood cell,10080,0.8035714285714286,1.2444444444444445
68386,/images/040112be-3c8d-49aa-93f1-522f94a592ff.png,610,868,699,968,89,100,red blood cell,8900,1.1235955056179776,0.89
61350,/images/e16c0dab-780d-4035-872e-1bb91e49f9d2.png,83,1230,196,1334,113,104,red blood cell,11752,0.9203539823008849,1.0865384615384615
74786,/images/91e93160-eb8d-4de0-b6bc-b98ec33d1663.png,1000,736,1125,856,125,120,red blood cell,15000,0.96,1.0416666666666667
76340,/images/3dad6483-ac30-4d2b-b045-9f24fe6ff75e.png,380,149,474,257,94,108,red blood cell,10152,1.148936170212766,0.8703703703703703
70617,/images/4ce5a070-9ede-4bb1-9ca2-1bae5746776b.png,550,951,682,1078,132,127,red blood cell,16764,0.9621212121212122,1.0393700787401574
44093,/images/8b494b40-cab5-49d3-893d-c805000fbe88.png,671,879,786,985,115,106,red blood cell,12190,0.9217391304347826,1.0849056603773586
20932,/images/c2ec116f-f091-422c-926c-70b548a8f6ef.png,846,773,933,871,87,98,red blood cell,8526,1.1264367816091954,0.8877551020408163
29133,/images/4c13e22e-dfd1-4fa1-b373-be9d0c272c0f.png,709,311,789,405,80,94,red blood cell,7520,1.175,0.851063829787234
28349,/images/34e024a5-5698-42d4-972f-fee234b4bd64.png,42,533,164,653,122,120,red blood cell,14640,0.9836065573770492,1.0166666666666666
35305,/images/516bf1d5-5d00-4985-926c-3993e9bc3ff5.png,1054,444,1179,560,125,116,red blood cell,14500,0.928,1.0775862068965518
79626,/images/a4409217-be11-4478-90a5-b406057d154d.png,848,778,955,878,107,100,red blood cell,10700,0.9345794392523364,1.07
8642,/images/ea6b012a-3425-4bfc-a61d-88563aa2a264.png,301,172,400,283,99,111,red blood cell,10989,1.121212121212121,0.8918918918918919
1787,/images/5f783f43-0090-4f8a-bd75-9562f4aa2dd5.png,350,804,453,912,103,108,red blood cell,11124,1.0485436893203883,0.9537037037037037
28244,/images/036404d1-b9fc-497b-bbe1-f4d9c5ac3ce0.png,62,231,162,331,100,100,red blood cell,10000,1.0,1.0
43710,/images/ef83ed4c-2724-4d5f-8abe-1a18d25cea35.png,871,608,983,719,112,111,red blood cell,12432,0.9910714285714286,1.009009009009009
32194,/images/07346d2e-a6e6-4dc0-95f1-9f7d8d7e3f66.png,880,233,986,348,106,115,red blood cell,12190,1.0849056603773586,0.9217391304347826
18650,/images/c22f7031-9cf8-48ce-b03b-1b12d0db4951.png,265,1145,375,1253,110,108,red blood cell,11880,0.9818181818181818,1.0185185185185186
74666,/images/5ccca8ee-abea-458a-a891-bedd31c3ddc3.png,197,779,299,877,102,98,red blood cell,9996,0.9607843137254902,1.0408163265306123
41222,/images/eed298b3-35f2-4127-88ad-0c4a9062207b.png,738,1168,853,1273,115,105,red blood cell,12075,0.9130434782608695,1.0952380952380953
77405,/images/c7ec51d5-9f45-4209-8357-39e9a984a733.png,730,824,838,929,108,105,red blood cell,11340,0.9722222222222222,1.0285714285714285
8973,/images/ef815e3a-02a6-4cf8-9262-45bc74c50b00.png,291,1273,391,1384,100,111,red blood cell,11100,1.11,0.9009009009009009
34086,/images/de5d19b7-e670-4ac7-843b-7ce7bcebdf45.png,520,811,625,937,105,126,red blood cell,13230,1.2,0.8333333333333334
77668,/images/07d15855-eb9b-46a9-b894-7cfe4d097826.png,760,503,860,599,100,96,red blood cell,9600,0.96,1.0416666666666667
20227,/images/c66cb6b2-1480-446a-a9d2-b8032a3de0d7.png,93,1038,205,1150,112,112,red blood cell,12544,1.0,1.0
70609,/images/4ce5a070-9ede-4bb1-9ca2-1bae5746776b.png,183,468,296,573,113,105,red blood cell,11865,0.9292035398230089,1.0761904761904761
55690,/images/c32b8bb8-c89d-4ae9-9c77-5b9356ca35a1.png,29,1395,143,1524,114,129,red blood cell,14706,1.131578947368421,0.8837209302325582
45828,/images/584d62ed-4329-45dd-94ce-e929d8b2bb74.png,412,464,503,549,91,85,red blood cell,7735,0.9340659340659341,1.0705882352941176
595,/images/065af549-320a-4862-b92a-8ef750d7b5fb.png,845,1445,969,1564,124,119,red blood cell,14756,0.9596774193548387,1.0420168067226891
60107,/images/ec60ab26-3343-4c5f-9667-cdae999c7d86.png,931,455,1030,562,99,107,red blood cell,10593,1.0808080808080809,0.9252336448598131
1650,/images/5f783f43-0090-4f8a-bd75-9562f4aa2dd5.png,31,50,146,153,115,103,red blood cell,11845,0.8956521739130435,1.116504854368932
54755,/images/10891eed-b0f2-4dd0-90cb-da185f6761b2.png,416,25,536,126,120,101,red blood cell,12120,0.8416666666666667,1.188118811881188
74571,/images/bbedfcbe-9528-4ba9-9d86-4ebba7589ac5.png,963,953,1064,1064,101,111,red blood cell,11211,1.099009900990099,0.9099099099099099
63622,/images/d9c9479e-f1ea-4d6e-861f-843ff9a90d19.png,360,1001,452,1102,92,101,red blood cell,9292,1.0978260869565217,0.9108910891089109
11159,/images/6303f964-98ef-47c6-bb2d-283aa393f918.png,165,1300,266,1400,101,100,red blood cell,10100,0.9900990099009901,1.01
61190,/images/0da07970-3146-479c-8a07-f61ed32814a9.png,252,177,360,281,108,104,red blood cell,11232,0.9629629629629629,1.0384615384615385
56835,/images/a588091c-5e4c-4e61-914d-e96f3ee3e505.png,749,60,862,179,113,119,red blood cell,13447,1.0530973451327434,0.9495798319327731
69815,/images/2bd15b6e-fe2d-49f3-b394-940d024d1f91.png,897,583,1001,675,104,92,red blood cell,9568,0.8846153846153846,1.1304347826086956
70537,/images/8cca114a-ed05-4b87-95b7-fae02487f08c.png,112,1374,215,1468,103,94,red blood cell,9682,0.912621359223301,1.0957446808510638
76730,/images/3317d733-ec0d-45e6-b631-40457392f343.png,851,1033,933,1130,82,97,red blood cell,7954,1.1829268292682926,0.845360824742268
44115,/images/8b494b40-cab5-49d3-893d-c805000fbe88.png,628,356,736,444,108,88,red blood cell,9504,0.8148148148148148,1.2272727272727273
4958,/images/755e5bf8-e8e1-492b-a32f-f7d87cccaa40.png,370,1439,477,1551,107,112,red blood cell,11984,1.0467289719626167,0.9553571428571429
39434,/images/55f8c052-8e49-4423-a4c4-365fc6afb6e1.png,723,252,861,375,138,123,red blood cell,16974,0.8913043478260869,1.1219512195121952
75658,/images/50d7c6c9-3230-48fe-947c-7dcfd0aad710.png,184,954,276,1061,92,107,red blood cell,9844,1.1630434782608696,0.8598130841121495
45397,/images/e4eea7ea-8989-46a9-9c98-25a178146b28.png,984,955,1068,1040,84,85,red blood cell,7140,1.0119047619047619,0.9882352941176471
49660,/images/bd7937db-fca2-44d0-8538-460110210927.png,423,245,521,359,98,114,red blood cell,11172,1.163265306122449,0.8596491228070176
37936,/images/56a57a8d-c9b9-432a-a3b0-32a09355806c.png,34,60,130,148,96,88,red blood cell,8448,0.9166666666666666,1.0909090909090908
701,/images/e61e6af2-7f8b-47b0-bbe7-acb2ed0299ab.png,928,374,1023,475,95,101,red blood cell,9595,1.063157894736842,0.9405940594059405
60651,/images/724e0c34-32cd-41f1-ae37-586038bc67ab.png,325,298,415,381,90,83,red blood cell,7470,0.9222222222222223,1.0843373493975903
55808,/images/68f34a9c-f73d-4238-8f55-4b05a8a2154c.png,953,87,1045,178,92,91,red blood cell,8372,0.9891304347826086,1.010989010989011
1977,/images/b95ceeeb-8870-4492-9037-2091ff268c5a.png,353,564,452,683,99,119,red blood cell,11781,1.202020202020202,0.8319327731092437
37754,/images/fe0c5e48-f65e-488c-9c3c-1ea7c7835c0c.png,774,1236,876,1330,102,94,red blood cell,9588,0.9215686274509803,1.0851063829787233
75765,/images/f48bf825-13c4-42fc-8dd8-10cc4ae6b202.png,307,1092,410,1183,103,91,red blood cell,9373,0.883495145631068,1.1318681318681318
7779,/images/e726dac6-f962-449c-acff-4dd56847b685.png,120,810,235,932,115,122,red blood cell,14030,1.0608695652173914,0.9426229508196722
41038,/images/e871f52c-77a6-4813-80d4-95bd97985f1a.png,146,376,260,478,114,102,red blood cell,11628,0.8947368421052632,1.1176470588235294
1413,/images/6d91d1f0-636b-4f5a-a526-7c17fc857190.png,201,613,290,700,89,87,red blood cell,7743,0.9775280898876404,1.0229885057471264
34142,/images/de5d19b7-e670-4ac7-843b-7ce7bcebdf45.png,1008,633,1110,729,102,96,red blood cell,9792,0.9411764705882353,1.0625
31835,/images/f62d4fb6-df7c-446c-94a8-d5aede0b1e0c.png,1077,10,1177,132,100,122,red blood cell,12200,1.22,0.819672131147541
56291,/images/6b473806-e936-4b19-98cf-a2b94cac35ff.png,891,1339,985,1451,94,112,red blood cell,10528,1.1914893617021276,0.8392857142857143
64693,/images/6dfafdf1-f588-4e80-8cf8-0126e1bf7af9.png,1033,798,1129,900,96,102,red blood cell,9792,1.0625,0.9411764705882353
46642,/images/da111ca5-520f-4ea8-97ad-ae5fce58ee91.png,64,1474,173,1577,109,103,red blood cell,11227,0.944954128440367,1.058252427184466
69100,/images/de2b8835-552c-4f01-98b7-67bc4910062e.png,415,1056,511,1163,96,107,red blood cell,10272,1.1145833333333333,0.897196261682243
37006,/images/b2e34f5f-904e-4473-9dc7-c6bc1ce12640.png,521,396,633,516,112,120,red blood cell,13440,1.0714285714285714,0.9333333333333333
19811,/images/d67fb447-4dd7-4a82-a305-2b70927b69bb.png,742,1498,848,1600,106,102,red blood cell,10812,0.9622641509433962,1.0392156862745099
50142,/images/4cccfcf0-cac9-46f0-870c-0eabfdc781ba.png,360,609,479,726,119,117,red blood cell,13923,0.9831932773109243,1.017094017094017
55224,/images/8ad7ba46-5db8-4ba9-b3e0-3cac52f7efc3.png,701,633,803,741,102,108,red blood cell,11016,1.0588235294117647,0.9444444444444444
78643,/images/fd1c4c7a-24bc-43f2-b84f-fee182207aee.png,223,1026,337,1122,114,96,red blood cell,10944,0.8421052631578947,1.1875
70447,/images/8cca114a-ed05-4b87-95b7-fae02487f08c.png,822,1072,936,1174,114,102,red blood cell,11628,0.8947368421052632,1.1176470588235294
66591,/images/087f2c9c-188d-43cc-a94c-0eb8f10ac092.png,582,553,677,667,95,114,red blood cell,10830,1.2,0.8333333333333334
19942,/images/0ca25c88-457f-4f03-bbc1-98fb6663f1d1.png,216,1055,325,1169,109,114,red blood cell,12426,1.0458715596330275,0.956140350877193
3308,/images/b901c906-91be-48c4-88ec-2c527544a258.png,403,1216,529,1333,126,117,red blood cell,14742,0.9285714285714286,1.0769230769230769
33976,/images/701206c5-aaac-4b99-9cc0-4a6854359457.png,731,1110,863,1234,132,124,red blood cell,16368,0.9393939393939394,1.064516129032258
62407,/images/9af1ee02-87fd-42bc-963e-fa9ac3eb45bb.png,387,1281,489,1378,102,97,red blood cell,9894,0.9509803921568627,1.0515463917525774
31348,/images/04fb49a2-07b8-4cdf-b6f7-df5c3688e5f8.png,773,1466,879,1570,106,104,red blood cell,11024,0.9811320754716981,1.0192307692307692
8061,/images/694222bb-cddf-469a-9526-f873c6fba58e.png,338,980,448,1081,110,101,red blood cell,11110,0.9181818181818182,1.0891089108910892
7165,/images/56551792-4aa1-4301-9f8f-8bfebcd20050.png,257,536,376,652,119,116,red blood cell,13804,0.9747899159663865,1.0258620689655173
19232,/images/b4d22412-a495-43a9-bec0-73a2322f8dad.png,297,670,400,771,103,101,red blood cell,10403,0.9805825242718447,1.0198019801980198
79232,/images/eb0173a3-7e5e-4f53-8124-03d9d6317844.png,255,949,355,1070,100,121,red blood cell,12100,1.21,0.8264462809917356
5698,/images/d3dcdf92-9328-4796-adf4-918646877ba1.png,327,1431,433,1550,106,119,red blood cell,12614,1.1226415094339623,0.8907563025210085
43512,/images/2d857091-efcd-41c0-ba3f-226de90445c4.png,464,92,569,217,105,125,red blood cell,13125,1.1904761904761905,0.84
44544,/images/419309ef-da3f-4424-93cf-01ff4c52b017.png,418,1201,523,1303,105,102,red blood cell,10710,0.9714285714285714,1.0294117647058822
47279,/images/1dd3e6dd-343f-4cc9-b0ed-e4d27fb36f0a.png,140,796,260,917,120,121,red blood cell,14520,1.0083333333333333,0.9917355371900827
45744,/images/584d62ed-4329-45dd-94ce-e929d8b2bb74.png,176,529,277,633,101,104,red blood cell,10504,1.0297029702970297,0.9711538461538461
60670,/images/45651e76-4bd0-45e5-895b-edec65f51987.png,721,340,844,446,123,106,red blood cell,13038,0.8617886178861789,1.1603773584905661
67572,/images/59542a24-b409-4c95-8608-d9691a741526.png,255,96,364,208,109,112,red blood cell,12208,1.0275229357798166,0.9732142857142857
12213,/images/313ed8d9-3c00-4415-9de0-0eda07c60ad9.png,1073,156,1192,268,119,112,red blood cell,13328,0.9411764705882353,1.0625
47378,/images/477e541c-0519-4542-9b13-8ee7922644d3.png,194,1404,291,1508,97,104,red blood cell,10088,1.0721649484536082,0.9326923076923077
4349,/images/84041bf9-dace-4066-9fe0-52170d08f826.png,291,907,389,1005,98,98,red blood cell,9604,1.0,1.0
2819,/images/e79bd81b-f878-4bee-9be2-d91a722c031e.png,163,725,280,840,117,115,red blood cell,13455,0.9829059829059829,1.017391304347826
25186,/images/90171428-f208-428a-b40e-f57ee3bea457.png,169,33,266,140,97,107,red blood cell,10379,1.1030927835051547,0.9065420560747663
53887,/images/540a5fee-175b-4b92-bf62-1ea9b59c86c6.png,716,634,820,740,104,106,red blood cell,11024,1.0192307692307692,0.9811320754716981
55452,/images/d67655e6-0a80-4a86-b552-1f5e85788377.png,748,114,830,195,82,81,red blood cell,6642,0.9878048780487805,1.0123456790123457
984,/images/a8cb75ba-3f2f-40d8-8bc7-c79ebd1b9603.png,968,1274,1084,1407,116,133,red blood cell,15428,1.146551724137931,0.8721804511278195
10224,/images/e3ea07d7-884a-412e-874a-40fd6b856736.png,873,1066,995,1193,122,127,red blood cell,15494,1.040983606557377,0.9606299212598425
40887,/images/550cf4ce-b641-44a3-8487-3e16d4049187.png,846,145,972,264,126,119,red blood cell,14994,0.9444444444444444,1.0588235294117647
61042,/images/6e86206f-dafe-4c28-bacc-7b83b2d40f0c.png,465,1199,583,1317,118,118,red blood cell,13924,1.0,1.0
42374,/images/1a27ebe9-93a1-4898-af69-f276057d4012.png,1056,1151,1174,1274,118,123,red blood cell,14514,1.0423728813559323,0.959349593495935
42538,/images/9a25f103-1683-47d1-8b07-ac20fe0b3ee9.png,328,1048,429,1159,101,111,red blood cell,11211,1.099009900990099,0.9099099099099099
56972,/images/a93c35ba-1690-4358-8837-669bcd850bb7.png,5,539,123,636,118,97,red blood cell,11446,0.8220338983050848,1.2164948453608246
54887,/images/8f84a2c9-ca38-4405-a488-12fcd101278b.png,420,1243,535,1355,115,112,red blood cell,12880,0.9739130434782609,1.0267857142857142
18585,/images/c22f7031-9cf8-48ce-b03b-1b12d0db4951.png,637,788,749,892,112,104,red blood cell,11648,0.9285714285714286,1.0769230769230769
19112,/images/2196389c-45ec-46b5-bc6c-1f4a33df7f7c.png,397,1329,500,1428,103,99,red blood cell,10197,0.9611650485436893,1.0404040404040404
17499,/images/56077789-8580-41b4-89d6-deea227e5c60.png,101,1022,230,1139,129,117,red blood cell,15093,0.9069767441860465,1.1025641025641026
71616,/images/390ad256-e1ed-476a-9f14-2dc34e0da632.png,432,356,545,484,113,128,red blood cell,14464,1.1327433628318584,0.8828125
20787,/images/c2ec116f-f091-422c-926c-70b548a8f6ef.png,703,1330,808,1433,105,103,red blood cell,10815,0.9809523809523809,1.0194174757281553
30726,/images/8e0dfc1f-e3eb-4a3f-a1c4-249bdfbfaa27.png,186,638,331,761,145,123,red blood cell,17835,0.8482758620689655,1.1788617886178863
55234,/images/8ad7ba46-5db8-4ba9-b3e0-3cac52f7efc3.png,603,205,700,313,97,108,red blood cell,10476,1.1134020618556701,0.8981481481481481
53839,/images/f24c8fe0-a534-44cf-9995-b2b314d945ba.png,577,927,683,1041,106,114,red blood cell,12084,1.0754716981132075,0.9298245614035088
45295,/images/9e793460-d94c-47ac-b3a7-0d6ad86357da.png,573,608,668,720,95,112,red blood cell,10640,1.1789473684210525,0.8482142857142857
39658,/images/04d21589-b777-43c2-86b5-038cbf8c3a4e.png,161,359,276,466,115,107,red blood cell,12305,0.9304347826086956,1.074766355140187
72036,/images/6ad3efc9-4392-4cee-98a5-186564a96373.png,1039,37,1137,155,98,118,red blood cell,11564,1.2040816326530612,0.8305084745762712
38966,/images/5939f341-a886-4f63-ae87-2219d000a1d4.png,417,985,521,1106,104,121,red blood cell,12584,1.1634615384615385,0.859504132231405
5546,/images/eb6e8684-b84e-483d-b835-f59286d2516b.png,272,409,377,517,105,108,red blood cell,11340,1.0285714285714285,0.9722222222222222
11031,/images/c442e2d6-aaf9-417a-9905-4737a1115f33.png,294,845,387,943,93,98,red blood cell,9114,1.053763440860215,0.9489795918367347
75938,/images/034c8d57-04d5-4786-93a4-6ae8fde2c258.png,233,1242,349,1363,116,121,red blood cell,14036,1.043103448275862,0.9586776859504132
6513,/images/640c4a52-3742-4f57-aee3-9e3dc0887622.png,581,567,668,660,87,93,red blood cell,8091,1.0689655172413792,0.9354838709677419
77745,/images/4849866a-73a2-4fcf-a407-2d0a25a09a89.png,22,1001,112,1086,90,85,red blood cell,7650,0.9444444444444444,1.0588235294117647
20217,/images/c66cb6b2-1480-446a-a9d2-b8032a3de0d7.png,839,1239,964,1351,125,112,red blood cell,14000,0.896,1.1160714285714286
7629,/images/21cc498b-8cb2-42ed-8f80-bfa27b86ef11.png,771,582,904,711,133,129,red blood cell,17157,0.9699248120300752,1.0310077519379846
6752,/images/672e4ecf-a56b-462e-b83b-76f4efaa6634.png,277,649,383,778,106,129,red blood cell,13674,1.2169811320754718,0.8217054263565892
64265,/images/83d4e1fe-da84-4175-a9e2-8efc18782dcf.png,318,1168,406,1261,88,93,red blood cell,8184,1.0568181818181819,0.946236559139785
37186,/images/befe6182-266b-4f8a-ac82-3a4154f05f60.png,76,909,197,1029,121,120,red blood cell,14520,0.9917355371900827,1.0083333333333333
58315,/images/319c9c52-f316-49f3-baad-4444ab19f85b.png,1068,139,1172,252,104,113,red blood cell,11752,1.0865384615384615,0.9203539823008849
48875,/images/fed6ba05-36a5-45dc-a4e1-9baa7de2c622.png,965,592,1058,699,93,107,red blood cell,9951,1.1505376344086022,0.8691588785046729
61417,/images/e16c0dab-780d-4035-872e-1bb91e49f9d2.png,0,307,104,409,104,102,red blood cell,10608,0.9807692307692307,1.0196078431372548
6745,/images/672e4ecf-a56b-462e-b83b-76f4efaa6634.png,70,1431,187,1551,117,120,red blood cell,14040,1.0256410256410255,0.975
57259,/images/6d05ed67-43e2-43af-9d57-70c7a6eeef5e.png,267,1159,378,1256,111,97,red blood cell,10767,0.8738738738738738,1.1443298969072164
55139,/images/29d4b75f-d400-4702-a9ac-e5a4ed1a1db1.png,190,1111,302,1219,112,108,red blood cell,12096,0.9642857142857143,1.037037037037037
18493,/images/9b410534-3b70-4a88-9f93-205cf4e55a05.png,330,830,423,929,93,99,red blood cell,9207,1.064516129032258,0.9393939393939394
67844,/images/04de3a31-fc09-40be-9c2c-9830c57f809d.png,143,1205,266,1319,123,114,red blood cell,14022,0.926829268292683,1.0789473684210527
25224,/images/90171428-f208-428a-b40e-f57ee3bea457.png,554,1001,683,1121,129,120,red blood cell,15480,0.9302325581395349,1.075
14187,/images/c186dcd1-af61-455f-9619-1fdd8c881b06.png,654,1271,778,1388,124,117,red blood cell,14508,0.9435483870967742,1.0598290598290598
30541,/images/7d9c1422-6332-44e9-b134-3ac94f07b0f0.png,15,1406,123,1525,108,119,red blood cell,12852,1.1018518518518519,0.907563025210084
36295,/images/81fed4a1-9d48-4938-90c9-c8bf3f5e6b1f.png,14,119,109,225,95,106,red blood cell,10070,1.1157894736842104,0.8962264150943396
23756,/images/6b2ff7ca-c5b3-415c-9481-7b14efc6d7ef.png,878,914,1010,1047,132,133,red blood cell,17556,1.0075757575757576,0.9924812030075187
3760,/images/dacf7e3f-1d8c-42a0-8539-3abe3971c956.png,386,660,485,757,99,97,red blood cell,9603,0.9797979797979798,1.0206185567010309
51239,/images/216f9d43-6869-4ba1-9106-4f5ea6aac223.png,1028,430,1136,539,108,109,red blood cell,11772,1.0092592592592593,0.9908256880733946
18317,/images/9ca20b10-e2fd-4bd2-93ef-78298f763ed5.png,76,226,190,336,114,110,red blood cell,12540,0.9649122807017544,1.0363636363636364
7969,/images/933e7e07-fc3d-42eb-be0c-6b1623ee60fa.png,565,301,664,408,99,107,red blood cell,10593,1.0808080808080809,0.9252336448598131
60481,/images/93b47b14-7f78-4b31-8897-d63a81fdab01.png,495,1110,608,1219,113,109,red blood cell,12317,0.9646017699115044,1.036697247706422
24369,/images/4d8a4ce8-0f9c-4f21-8844-4cf0e5514bbf.png,1042,225,1131,325,89,100,red blood cell,8900,1.1235955056179776,0.89
51034,/images/7eb95580-693f-41b6-9338-174be1430c23.png,964,913,1063,1024,99,111,red blood cell,10989,1.121212121212121,0.8918918918918919
74176,/images/4e43fc22-dc08-4cde-b3ce-ce8a4f377c47.png,503,1128,605,1223,102,95,red blood cell,9690,0.9313725490196079,1.0736842105263158
57297,/images/aaade430-4c49-4038-97b7-f8cdd937db57.png,176,760,286,862,110,102,red blood cell,11220,0.9272727272727272,1.0784313725490196
11756,/images/082e1f81-4f49-44ad-b5bb-9dfc155b2ed8.png,203,1016,299,1121,96,105,red blood cell,10080,1.09375,0.9142857142857143
79278,/images/05ac7b2a-6a77-4464-926b-8570f7c01693.png,470,1099,565,1205,95,106,red blood cell,10070,1.1157894736842104,0.8962264150943396
47820,/images/5a105b89-c592-4d78-b208-7db6c6572752.png,313,1499,431,1598,118,99,red blood cell,11682,0.8389830508474576,1.1919191919191918
24604,/images/c03d9b87-e19b-402b-ad86-b30d6e8aeb59.png,650,439,755,550,105,111,red blood cell,11655,1.0571428571428572,0.9459459459459459
50129,/images/4cccfcf0-cac9-46f0-870c-0eabfdc781ba.png,596,1161,721,1298,125,137,red blood cell,17125,1.096,0.9124087591240876
65051,/images/ff3b9d4d-373c-48ef-a75a-d23e2c2ade87.png,178,717,263,807,85,90,red blood cell,7650,1.0588235294117647,0.9444444444444444
9232,/images/261562a8-ffd8-4e0e-919b-22e267000b74.png,110,151,224,258,114,107,red blood cell,12198,0.9385964912280702,1.0654205607476634
39232,/images/2aeb7b85-7df9-4a63-8d37-2eecaaa190e7.png,948,1035,1044,1127,96,92,red blood cell,8832,0.9583333333333334,1.0434782608695652
7262,/images/89f10192-d3dd-4996-a571-4c851dbdc983.png,936,656,1063,759,127,103,red blood cell,13081,0.8110236220472441,1.233009708737864
55441,/images/d67655e6-0a80-4a86-b552-1f5e85788377.png,316,1394,419,1491,103,97,red blood cell,9991,0.941747572815534,1.0618556701030928
34047,/images/1012abf2-cb05-4337-86c5-513ec4ca904d.png,618,305,722,410,104,105,red blood cell,10920,1.0096153846153846,0.9904761904761905
31910,/images/9eb66577-7857-43dc-a879-8f2c9d7f780f.png,843,1137,944,1248,101,111,red blood cell,11211,1.099009900990099,0.9099099099099099
53926,/images/540a5fee-175b-4b92-bf62-1ea9b59c86c6.png,101,891,206,1000,105,109,red blood cell,11445,1.0380952380952382,0.963302752293578
79007,/images/6144887d-a1c1-46db-91a1-f7ff5bf8c8a5.png,139,4,254,116,115,112,red blood cell,12880,0.9739130434782609,1.0267857142857142
62102,/images/f5c51193-8a27-4ef3-83ad-771395d63caf.png,281,481,376,579,95,98,red blood cell,9310,1.0315789473684212,0.9693877551020408
29415,/images/b4e5e08d-6427-46f3-aca8-a4df165a151d.png,743,833,856,954,113,121,red blood cell,13673,1.0707964601769913,0.9338842975206612
38081,/images/907650b5-edae-471d-bc54-a825be3d3fac.png,113,1015,224,1138,111,123,red blood cell,13653,1.1081081081081081,0.9024390243902439
9778,/images/3859deaf-6ae1-49a3-9051-898d0f0d7de6.png,418,276,525,377,107,101,red blood cell,10807,0.9439252336448598,1.0594059405940595
43532,/images/2d857091-efcd-41c0-ba3f-226de90445c4.png,92,521,209,644,117,123,red blood cell,14391,1.0512820512820513,0.9512195121951219
77205,/images/fe691faa-3bc7-475e-b558-aa8fe7b795bc.png,680,920,788,1027,108,107,red blood cell,11556,0.9907407407407407,1.0093457943925233
43583,/images/e0ef520d-7b65-485d-9888-e6859f189f70.png,3,184,106,295,103,111,red blood cell,11433,1.0776699029126213,0.9279279279279279
37466,/images/c6530038-6d4e-49e1-8427-d1d3acc9fa21.png,100,629,206,750,106,121,red blood cell,12826,1.1415094339622642,0.8760330578512396
52178,/images/f4c00b8c-d675-4255-8277-ca65bd757f51.png,611,1484,704,1581,93,97,red blood cell,9021,1.043010752688172,0.9587628865979382
63114,/images/d82c657e-5678-41da-9a6e-3ad29430b759.png,738,80,848,175,110,95,red blood cell,10450,0.8636363636363636,1.1578947368421053
6574,/images/640c4a52-3742-4f57-aee3-9e3dc0887622.png,55,1454,169,1548,114,94,red blood cell,10716,0.8245614035087719,1.2127659574468086
24938,/images/ed0bee2f-05e0-4392-8357-19750cec577c.png,843,1133,946,1243,103,110,red blood cell,11330,1.0679611650485437,0.9363636363636364
36692,/images/21f001d6-f568-4ea4-82da-fab54c77c419.png,800,695,889,789,89,94,red blood cell,8366,1.0561797752808988,0.9468085106382979
5130,/images/a777e78c-ad1f-4380-9ab2-b4f9f32b2d78.png,308,524,423,647,115,123,red blood cell,14145,1.0695652173913044,0.9349593495934959
59632,/images/a2754679-68b0-40f4-be01-bafad5ac1261.png,23,912,127,1009,104,97,red blood cell,10088,0.9326923076923077,1.0721649484536082
50053,/images/b1145408-feae-4637-b4cf-3e70b99cc62d.png,597,477,708,596,111,119,red blood cell,13209,1.072072072072072,0.9327731092436975
48426,/images/0fa5b35d-6c44-4207-b6f8-d5b355086b5f.png,473,1066,583,1197,110,131,red blood cell,14410,1.190909090909091,0.8396946564885496
9919,/images/b4261fa5-876d-48ea-b6da-ec7ca5b48fe2.png,50,552,147,654,97,102,red blood cell,9894,1.0515463917525774,0.9509803921568627
77340,/images/3ff98212-7c2a-46cd-afb7-34a2479bed07.png,255,1004,359,1100,104,96,red blood cell,9984,0.9230769230769231,1.0833333333333333
25453,/images/5f742392-278d-461c-a848-08def2c28878.png,640,1436,730,1518,90,82,red blood cell,7380,0.9111111111111111,1.0975609756097562
750,/images/dcc1a193-7b74-44f8-ad8d-813751d8fa6b.png,310,866,430,993,120,127,red blood cell,15240,1.0583333333333333,0.9448818897637795
57467,/images/00d04a90-80e5-4bce-9511-1b64eabb7a47.png,65,985,168,1075,103,90,red blood cell,9270,0.8737864077669902,1.1444444444444444
948,/images/a8cb75ba-3f2f-40d8-8bc7-c79ebd1b9603.png,309,1365,415,1492,106,127,red blood cell,13462,1.1981132075471699,0.8346456692913385
23943,/images/3d8fb5bf-3315-48fb-8ab1-802eafd550bc.png,1017,634,1128,756,111,122,red blood cell,13542,1.0990990990990992,0.9098360655737705
44963,/images/83ec8923-6232-40d7-ba1f-a1b8bf7cb66c.png,247,681,357,789,110,108,red blood cell,11880,0.9818181818181818,1.0185185185185186
68452,/images/040112be-3c8d-49aa-93f1-522f94a592ff.png,759,1501,843,1581,84,80,red blood cell,6720,0.9523809523809523,1.05
69893,/images/9edba799-e169-46cd-b100-c9f8fc7a8c7d.png,12,1502,112,1591,100,89,red blood cell,8900,0.89,1.1235955056179776
37618,/images/205306da-0ed8-475a-ace6-f2f81d4be88a.png,873,1205,965,1282,92,77,red blood cell,7084,0.8369565217391305,1.1948051948051948
54577,/images/59dc7da9-35d1-421e-a61b-1e9637bfbfa1.png,215,8,321,120,106,112,red blood cell,11872,1.0566037735849056,0.9464285714285714
59038,/images/597bbff8-6592-41cf-8946-e59b0d1f289a.png,26,101,147,206,121,105,red blood cell,12705,0.8677685950413223,1.1523809523809523
27396,/images/9f38055f-4fe6-47fd-a6dd-c0743db4eccf.png,535,364,638,460,103,96,red blood cell,9888,0.9320388349514563,1.0729166666666667
60757,/images/645cd195-af50-409f-8da9-6e7c7f18ea09.png,503,1016,616,1134,113,118,red blood cell,13334,1.0442477876106195,0.9576271186440678
54429,/images/22a464ef-c3da-4d56-b37e-e22e95d945e7.png,381,338,464,419,83,81,red blood cell,6723,0.9759036144578314,1.0246913580246915
47495,/images/adff132d-3af0-4cef-942c-58fc09729bee.png,488,898,602,1013,114,115,red blood cell,13110,1.0087719298245614,0.991304347826087
57227,/images/ca5e6a15-ba65-48ea-8913-2d986e71bf3a.png,958,236,1071,345,113,109,red blood cell,12317,0.9646017699115044,1.036697247706422
46327,/images/e11515b4-9527-4c23-a0ba-43719bacca0d.png,764,886,875,990,111,104,red blood cell,11544,0.9369369369369369,1.0673076923076923
75071,/images/073c10c9-5749-44b5-b08b-1be556a960f0.png,514,617,635,734,121,117,red blood cell,14157,0.9669421487603306,1.0341880341880343
24108,/images/505355c9-23bf-4f90-8ebc-6a7ef50964d0.png,790,856,909,984,119,128,red blood cell,15232,1.0756302521008403,0.9296875
10543,/images/9fbf38ab-44b9-4096-a818-603017a4300e.png,345,291,465,435,120,144,red blood cell,17280,1.2,0.8333333333333334
62272,/images/59f5699f-885f-4004-b783-a60060144e43.png,389,992,512,1114,123,122,red blood cell,15006,0.991869918699187,1.0081967213114753
72727,/images/6ab870ba-b24b-49a9-9570-8eafe63aa74e.png,441,1057,522,1156,81,99,red blood cell,8019,1.2222222222222223,0.8181818181818182
13013,/images/b10ea12f-cd36-4f2c-994a-67d1665269ab.png,885,1072,971,1145,86,73,red blood cell,6278,0.8488372093023255,1.178082191780822
40904,/images/550cf4ce-b641-44a3-8487-3e16d4049187.png,332,111,455,237,123,126,red blood cell,15498,1.024390243902439,0.9761904761904762
48052,/images/1d4f06e1-9c9b-487e-84cd-e7e50cc754da.png,521,1343,635,1445,114,102,red blood cell,11628,0.8947368421052632,1.1176470588235294
77660,/images/07d15855-eb9b-46a9-b894-7cfe4d097826.png,795,1215,877,1305,82,90,red blood cell,7380,1.0975609756097562,0.9111111111111111
63532,/images/44b4a765-104e-4182-8871-e933c83c91ef.png,405,370,492,460,87,90,red blood cell,7830,1.0344827586206897,0.9666666666666667
50456,/images/a2de1248-7bc0-44dc-b508-70a357eedd68.png,642,1440,749,1549,107,109,red blood cell,11663,1.0186915887850467,0.981651376146789
55482,/images/43072c64-4c08-47cd-ae8a-b74d31f80008.png,929,353,1026,451,97,98,red blood cell,9506,1.0103092783505154,0.9897959183673469
66317,/images/fcdf6632-c03f-49a8-9fb3-42e87c99b9d0.png,863,1453,964,1549,101,96,red blood cell,9696,0.9504950495049505,1.0520833333333333
57453,/images/00d04a90-80e5-4bce-9511-1b64eabb7a47.png,338,599,440,711,102,112,red blood cell,11424,1.0980392156862746,0.9107142857142857
34284,/images/259da25f-40f3-4d37-bca9-a9c807af1547.png,847,554,939,650,92,96,red blood cell,8832,1.0434782608695652,0.9583333333333334
61288,/images/b3058064-d817-47dd-a8c4-cdb1f62374f8.png,755,1269,845,1361,90,92,red blood cell,8280,1.0222222222222221,0.9782608695652174
37092,/images/d6942996-5664-4370-ad87-2bdcbd49ac16.png,582,1117,692,1224,110,107,red blood cell,11770,0.9727272727272728,1.02803738317757
67641,/images/59542a24-b409-4c95-8608-d9691a741526.png,1041,407,1129,505,88,98,red blood cell,8624,1.1136363636363635,0.8979591836734694
46151,/images/d8632217-ec33-4d0a-98e6-427824c58869.png,599,12,701,119,102,107,red blood cell,10914,1.0490196078431373,0.9532710280373832
63101,/images/6afd8203-d61a-4e9b-a4cf-dcb53a16b57c.png,467,955,550,1039,83,84,red blood cell,6972,1.0120481927710843,0.9880952380952381
72544,/images/01b99da8-b66b-464b-a7ee-1cadab8db18b.png,358,832,463,937,105,105,red blood cell,11025,1.0,1.0
23160,/images/c94a5851-b846-4fde-8c89-05bec3a8ac53.png,96,454,188,556,92,102,red blood cell,9384,1.108695652173913,0.9019607843137255
21394,/images/b701b5c5-b922-4315-b12a-aac4ec65ee8b.png,1019,797,1122,911,103,114,red blood cell,11742,1.1067961165048543,0.9035087719298246
6938,/images/a9feccda-18f2-405e-9aa1-409fa1f49fe4.png,965,1036,1084,1153,119,117,red blood cell,13923,0.9831932773109243,1.017094017094017
38426,/images/674b0fd3-f247-4b7f-97f7-3e6c57c9ba9e.png,937,1248,1024,1326,87,78,red blood cell,6786,0.896551724137931,1.1153846153846154
17190,/images/471f75c6-bd5d-4c20-bcc1-258e836f4d69.png,277,603,379,712,102,109,red blood cell,11118,1.0686274509803921,0.9357798165137615
50306,/images/3d32a988-449d-4d58-b71f-abbfdc3f2fbc.png,1033,236,1140,363,107,127,red blood cell,13589,1.1869158878504673,0.84251968503937
54485,/images/22a464ef-c3da-4d56-b37e-e22e95d945e7.png,103,24,215,118,112,94,red blood cell,10528,0.8392857142857143,1.1914893617021276
11090,/images/98175327-da9e-4e0c-8912-ee68490a4672.png,355,1122,467,1223,112,101,red blood cell,11312,0.9017857142857143,1.108910891089109
67148,/images/be6fe358-dee1-4dcf-9b0d-5d8612aba577.png,590,209,711,323,121,114,red blood cell,13794,0.9421487603305785,1.0614035087719298
28569,/images/dbdfad64-110c-421f-a1c7-f68fd9e82d67.png,452,990,565,1093,113,103,red blood cell,11639,0.911504424778761,1.0970873786407767
57734,/images/5c037ffc-f515-48b3-b231-c110fbd2b8ca.png,787,525,882,632,95,107,red blood cell,10165,1.1263157894736842,0.8878504672897196
62047,/images/bdb5d571-27bc-4a42-ae45-aa5a9af40a81.png,0,441,102,547,102,106,red blood cell,10812,1.0392156862745099,0.9622641509433962
2167,/images/e94a811d-3145-4313-ba42-2d5ed283179f.png,932,237,1030,330,98,93,red blood cell,9114,0.9489795918367347,1.053763440860215
57888,/images/f4c2b43f-a2e7-4746-8034-0b34aebba8ee.png,402,937,505,1054,103,117,red blood cell,12051,1.1359223300970873,0.8803418803418803
13691,/images/0b04ec46-5119-4cda-8c35-c4e5b6f0eed0.png,246,990,356,1103,110,113,red blood cell,12430,1.0272727272727273,0.9734513274336283
35466,/images/3722d213-f2a9-46d5-aa76-9183b443e455.png,374,1016,485,1118,111,102,red blood cell,11322,0.918918918918919,1.088235294117647
76434,/images/34df8890-272d-423a-ae78-ff8d068d3306.png,1097,1055,1193,1167,96,112,red blood cell,10752,1.1666666666666667,0.8571428571428571
57428,/images/00d04a90-80e5-4bce-9511-1b64eabb7a47.png,1077,1151,1174,1251,97,100,red blood cell,9700,1.0309278350515463,0.97
70260,/images/a5c3b3f8-7ceb-4573-a400-a76b9479af46.png,704,1504,806,1589,102,85,red blood cell,8670,0.8333333333333334,1.2
42604,/images/184b376b-03cb-4c2d-af51-fc1a62196293.png,329,393,438,504,109,111,red blood cell,12099,1.018348623853211,0.9819819819819819
15471,/images/1b7f47fc-26cd-4273-b848-88a7cbfd9f85.png,849,370,946,456,97,86,red blood cell,8342,0.8865979381443299,1.127906976744186
5971,/images/97eff653-3908-4e66-931f-eab36bc336c8.png,624,460,747,578,123,118,red blood cell,14514,0.959349593495935,1.0423728813559323
16276,/images/d5009906-bce1-4353-90b4-f4c79362f4cf.png,110,118,224,245,114,127,red blood cell,14478,1.1140350877192982,0.8976377952755905
16379,/images/69569ecf-cfa1-4ddd-9342-b22c23387fdb.png,643,1377,738,1472,95,95,red blood cell,9025,1.0,1.0
54315,/images/3b5a8060-dec6-4a83-b7f2-b604e4e69dfc.png,320,548,423,647,103,99,red blood cell,10197,0.9611650485436893,1.0404040404040404
80039,/images/38d1b930-dd97-4248-9160-e9389a1a8dd7.png,824,1323,952,1437,128,114,red blood cell,14592,0.890625,1.1228070175438596
33917,/images/1a332b2c-9d49-4ff2-810c-5633d2314527.png,971,1189,1070,1294,99,105,red blood cell,10395,1.0606060606060606,0.9428571428571428
12609,/images/0901f9d1-be4f-4c19-8e83-dd724dded9f5.png,296,177,439,299,143,122,red blood cell,17446,0.8531468531468531,1.1721311475409837
4908,/images/61cd8c7d-394d-42d3-9ed4-e09559110bed.png,814,136,947,267,133,131,red blood cell,17423,0.9849624060150376,1.015267175572519
71258,/images/445d0db9-e830-4ceb-a845-b23d819e6097.png,277,678,372,768,95,90,red blood cell,8550,0.9473684210526315,1.0555555555555556
18242,/images/947348fe-4c70-468e-8009-3c14daeca69b.png,805,107,926,219,121,112,red blood cell,13552,0.9256198347107438,1.0803571428571428
33172,/images/6231d81d-9e84-4a5a-8cb8-47c6a37a0176.png,837,331,923,421,86,90,red blood cell,7740,1.0465116279069768,0.9555555555555556
44782,/images/6795acae-e84d-4e97-b9a1-b4f4f0a72cfd.png,954,464,1053,568,99,104,red blood cell,10296,1.0505050505050506,0.9519230769230769
59972,/images/f0fe292d-85ae-4c3a-a676-037dde2594e6.png,585,798,712,919,127,121,red blood cell,15367,0.952755905511811,1.0495867768595042
24945,/images/ed0bee2f-05e0-4392-8357-19750cec577c.png,795,507,897,593,102,86,red blood cell,8772,0.8431372549019608,1.186046511627907
41328,/images/a065c50b-341d-4803-b4b0-0fe8f04fdbb5.png,13,281,116,380,103,99,red blood cell,10197,0.9611650485436893,1.0404040404040404
55360,/images/4fb83278-adc5-4424-9f45-b6d0db2955b6.png,73,1259,196,1381,123,122,red blood cell,15006,0.991869918699187,1.0081967213114753
41321,/images/2374ae5b-c2df-4db5-afea-c54180aa22e3.png,639,1258,737,1358,98,100,red blood cell,9800,1.0204081632653061,0.98
11472,/images/2f9f400d-2d67-4118-aaa1-9094bc4b0e47.png,811,1188,941,1321,130,133,red blood cell,17290,1.023076923076923,0.9774436090225563
42571,/images/184b376b-03cb-4c2d-af51-fc1a62196293.png,799,955,925,1086,126,131,red blood cell,16506,1.0396825396825398,0.9618320610687023
63715,/images/06401963-8b02-46c5-ab2a-3d70bd01623f.png,184,1334,297,1449,113,115,red blood cell,12995,1.0176991150442478,0.9826086956521739
30444,/images/dedbb10c-43f1-45fb-bb40-3ce2fb874015.png,541,1113,663,1216,122,103,red blood cell,12566,0.8442622950819673,1.1844660194174756
50552,/images/e98ea067-82b5-4a0d-87bf-b4bbdc10ddab.png,439,190,538,285,99,95,red blood cell,9405,0.9595959595959596,1.0421052631578946
44176,/images/8b494b40-cab5-49d3-893d-c805000fbe88.png,354,1104,457,1211,103,107,red blood cell,11021,1.0388349514563107,0.9626168224299065
72124,/images/64b0e49a-0e48-447d-8872-c1dd255e7a21.png,487,361,587,458,100,97,red blood cell,9700,0.97,1.0309278350515463
17444,/images/56077789-8580-41b4-89d6-deea227e5c60.png,238,208,349,324,111,116,red blood cell,12876,1.045045045045045,0.9568965517241379
15057,/images/3003252a-2d2e-4687-ad30-9c38d68f1394.png,404,470,529,586,125,116,red blood cell,14500,0.928,1.0775862068965518
30251,/images/cecbf663-0751-4e7f-b298-770c88afc2c1.png,1056,1038,1159,1145,103,107,red blood cell,11021,1.0388349514563107,0.9626168224299065
9530,/images/a18f122f-3a3e-4478-8ac4-91b83e050e65.png,928,820,1040,925,112,105,red blood cell,11760,0.9375,1.0666666666666667
34194,/images/f1cda808-69a9-4d10-ba0a-6607c98e362d.png,682,130,796,252,114,122,red blood cell,13908,1.0701754385964912,0.9344262295081968
72355,/images/ee57e743-a876-4f69-9fe5-bf5d01b44689.png,990,1060,1079,1161,89,101,red blood cell,8989,1.1348314606741574,0.8811881188118812
14800,/images/f8b6a868-60e9-4569-ae69-638a0c39834d.png,155,1274,275,1395,120,121,red blood cell,14520,1.0083333333333333,0.9917355371900827
56666,/images/4adcaa26-aa1f-47b5-bdf0-18c9f814f576.png,1058,1299,1161,1415,103,116,red blood cell,11948,1.1262135922330097,0.8879310344827587
40837,/images/bf20d04d-ff8a-4910-91d7-94054c267d1b.png,322,748,443,864,121,116,red blood cell,14036,0.9586776859504132,1.043103448275862
61291,/images/b3058064-d817-47dd-a8c4-cdb1f62374f8.png,147,60,237,143,90,83,red blood cell,7470,0.9222222222222223,1.0843373493975903
64607,/images/6dfafdf1-f588-4e80-8cf8-0126e1bf7af9.png,276,488,391,589,115,101,red blood cell,11615,0.8782608695652174,1.1386138613861385
52912,/images/abb2f9d6-26fa-4328-983c-959ef6717c05.png,793,9,909,123,116,114,red blood cell,13224,0.9827586206896551,1.0175438596491229
48149,/images/913099c5-8085-4908-bf4b-1f098bbfcf66.png,242,920,353,1035,111,115,red blood cell,12765,1.0360360360360361,0.9652173913043478
52991,/images/42e87148-a015-4148-923a-fb83016f64e7.png,544,1408,661,1521,117,113,red blood cell,13221,0.9658119658119658,1.0353982300884956
66060,/images/c8af0297-ce1f-40ea-bf44-9256dcdae4e9.png,1010,901,1105,1001,95,100,red blood cell,9500,1.0526315789473684,0.95
74808,/images/91e93160-eb8d-4de0-b6bc-b98ec33d1663.png,492,722,576,800,84,78,red blood cell,6552,0.9285714285714286,1.0769230769230769
19450,/images/5487faad-24a7-46b6-92d8-479d3a8d229f.png,958,1270,1052,1367,94,97,red blood cell,9118,1.0319148936170213,0.9690721649484536
41432,/images/c4494d4f-732f-431a-8a9d-62403f0b74fe.png,438,82,536,189,98,107,red blood cell,10486,1.0918367346938775,0.9158878504672897
18232,/images/947348fe-4c70-468e-8009-3c14daeca69b.png,640,299,745,402,105,103,red blood cell,10815,0.9809523809523809,1.0194174757281553
26746,/images/2518f6e4-29cc-4ae4-a914-b215a4c56099.png,632,278,743,386,111,108,red blood cell,11988,0.972972972972973,1.0277777777777777
26519,/images/b2f05937-b965-4c4b-b86e-f50e95d9d691.png,807,505,925,624,118,119,red blood cell,14042,1.0084745762711864,0.9915966386554622
63809,/images/6013bff0-dc4b-4bde-9409-0f6139c3495c.png,299,1176,397,1286,98,110,red blood cell,10780,1.1224489795918366,0.8909090909090909
43167,/images/c5db0fc0-b96c-496e-90b4-f9fb1b85b28e.png,788,1047,906,1154,118,107,red blood cell,12626,0.9067796610169492,1.102803738317757
33989,/images/701206c5-aaac-4b99-9cc0-4a6854359457.png,88,939,201,1055,113,116,red blood cell,13108,1.0265486725663717,0.9741379310344828
31144,/images/1976cd04-d24f-457c-b423-7e4cdb05de9e.png,732,1093,853,1200,121,107,red blood cell,12947,0.8842975206611571,1.1308411214953271
1333,/images/6d91d1f0-636b-4f5a-a526-7c17fc857190.png,466,804,549,895,83,91,red blood cell,7553,1.0963855421686748,0.9120879120879121
41534,/images/0fcd1ebe-ee4a-40a0-b787-29cee18bfa1b.png,118,1266,223,1377,105,111,red blood cell,11655,1.0571428571428572,0.9459459459459459
315,/images/0dcca702-a4ef-4fb3-a940-9c0c140b21c7.png,342,49,441,156,99,107,red blood cell,10593,1.0808080808080809,0.9252336448598131
60630,/images/724e0c34-32cd-41f1-ae37-586038bc67ab.png,743,489,832,583,89,94,red blood cell,8366,1.0561797752808988,0.9468085106382979
22085,/images/ac4d6507-d710-497b-ad7c-e0dd75c1d06d.png,269,955,390,1071,121,116,red blood cell,14036,0.9586776859504132,1.043103448275862
28471,/images/c3042130-a6e2-458f-9fde-bb012f68f5f2.png,282,344,402,474,120,130,red blood cell,15600,1.0833333333333333,0.9230769230769231
66243,/images/e8058bed-c362-4e1c-85dc-62f80f32938f.png,926,257,1044,360,118,103,red blood cell,12154,0.8728813559322034,1.145631067961165
41836,/images/c3b07675-9d02-477c-91fe-f0737867049b.png,390,1415,522,1542,132,127,red blood cell,16764,0.9621212121212122,1.0393700787401574
68325,/images/0f735cca-051c-4048-a1fa-cb36f389e12f.png,700,442,790,540,90,98,red blood cell,8820,1.0888888888888888,0.9183673469387755
11063,/images/85a4d82e-cfb7-4983-b272-626c9e8c7583.png,50,420,168,543,118,123,red blood cell,14514,1.0423728813559323,0.959349593495935
68566,/images/32700bc7-7a86-49d3-aded-ccaaed4ddc5c.png,835,243,952,347,117,104,red blood cell,12168,0.8888888888888888,1.125
27875,/images/948c94ad-395c-41f4-9a68-8a1dcb76888c.png,467,798,573,904,106,106,red blood cell,11236,1.0,1.0
70514,/images/8cca114a-ed05-4b87-95b7-fae02487f08c.png,221,699,327,804,106,105,red blood cell,11130,0.9905660377358491,1.0095238095238095
64189,/images/2a91387a-d30f-418d-ac3a-f7cfa6836261.png,188,781,299,887,111,106,red blood cell,11766,0.954954954954955,1.0471698113207548
9808,/images/3859deaf-6ae1-49a3-9051-898d0f0d7de6.png,972,74,1081,187,109,113,red blood cell,12317,1.036697247706422,0.9646017699115044
17172,/images/dc3bdfe9-1565-4cda-9c4e-0979846dab60.png,242,860,308,939,66,79,red blood cell,5214,1.196969696969697,0.8354430379746836
9806,/images/3859deaf-6ae1-49a3-9051-898d0f0d7de6.png,139,87,235,182,96,95,red blood cell,9120,0.9895833333333334,1.0105263157894737
68884,/images/6347dd6a-cfdf-4cb5-bc50-cff5403cfecb.png,83,45,180,137,97,92,red blood cell,8924,0.9484536082474226,1.0543478260869565
43060,/images/340a1727-0df7-4e6f-9c0e-9c5deddbfca2.png,882,1069,1013,1207,131,138,red blood cell,18078,1.0534351145038168,0.9492753623188406
55271,/images/8ad7ba46-5db8-4ba9-b3e0-3cac52f7efc3.png,1002,843,1095,948,93,105,red blood cell,9765,1.1290322580645162,0.8857142857142857
246,/images/0dcca702-a4ef-4fb3-a940-9c0c140b21c7.png,230,455,352,582,122,127,red blood cell,15494,1.040983606557377,0.9606299212598425
32691,/images/0154dd8e-72f8-4d78-a4dd-93e139577bd1.png,1024,1077,1130,1177,106,100,red blood cell,10600,0.9433962264150944,1.06
66730,/images/334bf865-e3fb-4200-bd53-d9ff5808ed9f.png,888,843,985,943,97,100,red blood cell,9700,1.0309278350515463,0.97
70612,/images/4ce5a070-9ede-4bb1-9ca2-1bae5746776b.png,1001,388,1097,491,96,103,red blood cell,9888,1.0729166666666667,0.9320388349514563
30186,/images/a1669b59-fe09-4fe6-ba9f-06bec6725502.png,658,717,775,824,117,107,red blood cell,12519,0.9145299145299145,1.0934579439252337
1769,/images/5f783f43-0090-4f8a-bd75-9562f4aa2dd5.png,928,720,1024,821,96,101,red blood cell,9696,1.0520833333333333,0.9504950495049505
65246,/images/45ac9409-5537-44ed-90cd-5c8a1ae0e1e0.png,972,707,1083,817,111,110,red blood cell,12210,0.990990990990991,1.009090909090909
54456,/images/22a464ef-c3da-4d56-b37e-e22e95d945e7.png,1014,986,1109,1077,95,91,red blood cell,8645,0.9578947368421052,1.043956043956044
35258,/images/a9159b11-ba49-4885-902e-00c8d5095b98.png,948,1105,1031,1192,83,87,red blood cell,7221,1.0481927710843373,0.9540229885057471
35002,/images/2b369d75-9c55-43e0-b352-d981aea544e3.png,123,642,244,765,121,123,red blood cell,14883,1.0165289256198347,0.983739837398374
46299,/images/e11515b4-9527-4c23-a0ba-43719bacca0d.png,145,987,268,1105,123,118,red blood cell,14514,0.959349593495935,1.0423728813559323
16646,/images/bc377041-e098-45c4-9651-2b1ea90d1d7e.png,498,145,623,272,125,127,red blood cell,15875,1.016,0.984251968503937
44808,/images/6795acae-e84d-4e97-b9a1-b4f4f0a72cfd.png,792,1261,907,1371,115,110,red blood cell,12650,0.9565217391304348,1.0454545454545454
54125,/images/d9345456-b76d-46cc-b81e-46d4a0a7b652.png,1114,1022,1189,1108,75,86,red blood cell,6450,1.1466666666666667,0.872093023255814
76986,/images/51e86aa9-caa0-4297-94e8-34a57d7f7e36.png,193,50,306,150,113,100,red blood cell,11300,0.8849557522123894,1.13
4783,/images/3fa1a4e3-c80d-49da-8f7b-a1abb0424f48.png,796,1177,877,1268,81,91,red blood cell,7371,1.123456790123457,0.8901098901098901
69262,/images/f274b784-b995-4a7e-a2c2-6cc31c24c4b4.png,234,235,325,321,91,86,red blood cell,7826,0.945054945054945,1.058139534883721
3138,/images/14efbfc8-39f6-4599-9994-a8cc95605b9c.png,510,1318,617,1440,107,122,red blood cell,13054,1.1401869158878504,0.8770491803278688
41387,/images/65e8b0cd-05d1-4c8d-8efd-24bf71df3167.png,942,381,1049,512,107,131,red blood cell,14017,1.2242990654205608,0.816793893129771
67086,/images/4272cbd7-5b0a-4bf7-b690-dee1c128f07b.png,389,304,480,405,91,101,red blood cell,9191,1.10989010989011,0.900990099009901
32486,/images/d31dd2c0-ae8e-4499-86bb-7cabb6e438b9.png,297,1200,415,1318,118,118,red blood cell,13924,1.0,1.0
11539,/images/834a30bb-26bf-4e60-9ea1-3250b926892e.png,325,700,446,817,121,117,red blood cell,14157,0.9669421487603306,1.0341880341880343
51344,/images/b4f3b2a4-f4b9-48de-ac5d-0e681b77be27.png,328,534,430,633,102,99,red blood cell,10098,0.9705882352941176,1.0303030303030303
25293,/images/587e5464-d70b-4279-8562-010279f6efbd.png,700,946,810,1071,110,125,red blood cell,13750,1.1363636363636365,0.88
63459,/images/b9d65ef3-1adc-4479-abee-2e422f5a613a.png,87,642,187,743,100,101,red blood cell,10100,1.01,0.9900990099009901
43094,/images/340a1727-0df7-4e6f-9c0e-9c5deddbfca2.png,120,1273,218,1371,98,98,red blood cell,9604,1.0,1.0
55709,/images/c32b8bb8-c89d-4ae9-9c77-5b9356ca35a1.png,110,489,212,603,102,114,red blood cell,11628,1.1176470588235294,0.8947368421052632
71748,/images/093a831a-bf71-4333-bc06-942ae70cb164.png,497,932,602,1037,105,105,red blood cell,11025,1.0,1.0
33433,/images/244ac6fa-8a92-4214-9cf4-ae0811d9ec7e.png,647,834,745,941,98,107,red blood cell,10486,1.0918367346938775,0.9158878504672897
3653,/images/8bd71314-e38a-4670-bb25-5cd6c9acb595.png,583,1468,697,1570,114,102,red blood cell,11628,0.8947368421052632,1.1176470588235294
21777,/images/f68ae8e9-e760-4106-88e0-4bdef2785f06.png,576,1351,680,1460,104,109,red blood cell,11336,1.0480769230769231,0.9541284403669725
20525,/images/cbde7f7e-2458-4dda-9db2-3d5ccf950ced.png,898,1443,1026,1562,128,119,red blood cell,15232,0.9296875,1.0756302521008403
71195,/images/4fac16e1-8e62-499b-a66b-c4c890372914.png,135,916,228,1003,93,87,red blood cell,8091,0.9354838709677419,1.0689655172413792
1211,/images/5ff7c0c8-d208-4e7d-958d-ca3c2260ff39.png,134,706,254,828,120,122,red blood cell,14640,1.0166666666666666,0.9836065573770492
11119,/images/6303f964-98ef-47c6-bb2d-283aa393f918.png,23,1117,132,1229,109,112,red blood cell,12208,1.0275229357798166,0.9732142857142857
49826,/images/5e17f8e6-fd8d-426c-b444-1515d14f04b7.png,439,391,524,491,85,100,red blood cell,8500,1.1764705882352942,0.85
11861,/images/3cdcb09b-6a8c-43ca-b1d0-c1a289202f65.png,984,686,1085,794,101,108,red blood cell,10908,1.0693069306930694,0.9351851851851852
9686,/images/53afd70c-08a7-4b9a-b137-7003b2ecbeab.png,598,1154,714,1270,116,116,red blood cell,13456,1.0,1.0
71742,/images/093a831a-bf71-4333-bc06-942ae70cb164.png,375,1214,479,1312,104,98,red blood cell,10192,0.9423076923076923,1.0612244897959184
48981,/images/df3d98b9-3dd7-4107-8d4a-ae1b7f247793.png,288,927,391,1019,103,92,red blood cell,9476,0.8932038834951457,1.1195652173913044
23820,/images/eeb06e39-482b-443d-8cf6-b9b5c763df78.png,886,959,1012,1068,126,109,red blood cell,13734,0.8650793650793651,1.1559633027522935
58546,/images/7fd2d254-b062-4f3d-8970-687e73c5a00a.png,328,400,428,488,100,88,red blood cell,8800,0.88,1.1363636363636365
40849,/images/bf20d04d-ff8a-4910-91d7-94054c267d1b.png,464,492,591,640,127,148,red blood cell,18796,1.1653543307086613,0.8581081081081081
13913,/images/de00f9a5-aa8b-4679-8ec6-85528a942d6f.png,664,920,799,1053,135,133,red blood cell,17955,0.9851851851851852,1.0150375939849625
77768,/images/4849866a-73a2-4fcf-a407-2d0a25a09a89.png,308,133,401,236,93,103,red blood cell,9579,1.10752688172043,0.9029126213592233
12440,/images/cc94eabb-a3dc-4cfc-9fff-55c76b5b4a71.png,481,438,588,554,107,116,red blood cell,12412,1.0841121495327102,0.9224137931034483
70975,/images/deaa1931-5f97-45bf-8c00-be6ddeb37b9a.png,1062,747,1162,868,100,121,red blood cell,12100,1.21,0.8264462809917356
57810,/images/c9ad92d4-b408-4506-916e-def47b2e6ed0.png,442,1133,542,1243,100,110,red blood cell,11000,1.1,0.9090909090909091
20893,/images/c2ec116f-f091-422c-926c-70b548a8f6ef.png,550,76,661,185,111,109,red blood cell,12099,0.9819819819819819,1.018348623853211
26766,/images/2518f6e4-29cc-4ae4-a914-b215a4c56099.png,859,775,965,873,106,98,red blood cell,10388,0.9245283018867925,1.0816326530612246
78583,/images/c5084fb8-2b62-464c-8a77-1a07ea653266.png,638,271,753,380,115,109,red blood cell,12535,0.9478260869565217,1.055045871559633
78560,/images/c5084fb8-2b62-464c-8a77-1a07ea653266.png,636,137,735,239,99,102,red blood cell,10098,1.0303030303030303,0.9705882352941176
8264,/images/65e3d6a6-012c-4b40-9a42-83078eb85e31.png,903,1444,1008,1550,105,106,red blood cell,11130,1.0095238095238095,0.9905660377358491
56172,/images/137d540f-d71e-47e8-bd9b-6cd0a6433c33.png,397,168,519,280,122,112,red blood cell,13664,0.9180327868852459,1.0892857142857142
31525,/images/3130f950-8345-4315-9711-92f7af3f5c14.png,324,899,456,1031,132,132,red blood cell,17424,1.0,1.0
43919,/images/d7c7eb2c-2acd-4f86-8a5a-09ab3dd02d16.png,799,1383,911,1489,112,106,red blood cell,11872,0.9464285714285714,1.0566037735849056
74451,/images/cbb58718-6319-48db-b84b-78ac9b12ff89.png,424,1202,526,1298,102,96,red blood cell,9792,0.9411764705882353,1.0625
74059,/images/fe436c09-b680-4f4c-8faf-aa10a55a335b.png,686,1450,795,1558,109,108,red blood cell,11772,0.9908256880733946,1.0092592592592593
6363,/images/f06ba705-5509-479b-8067-127ffb37c5b6.png,695,1200,818,1330,123,130,red blood cell,15990,1.056910569105691,0.9461538461538461
35818,/images/bb2042c5-35e1-43cc-8171-7de81b764361.png,265,642,361,725,96,83,red blood cell,7968,0.8645833333333334,1.1566265060240963
49577,/images/bd7937db-fca2-44d0-8538-460110210927.png,422,1431,527,1561,105,130,red blood cell,13650,1.2380952380952381,0.8076923076923077
3927,/images/f09acb0c-b270-4e91-99f8-410adfa7f34a.png,517,402,610,499,93,97,red blood cell,9021,1.043010752688172,0.9587628865979382
35857,/images/027ab174-e47a-44f8-b85b-372449eeb7d8.png,919,621,1050,751,131,130,red blood cell,17030,0.9923664122137404,1.0076923076923077
41213,/images/eed298b3-35f2-4127-88ad-0c4a9062207b.png,690,100,785,201,95,101,red blood cell,9595,1.063157894736842,0.9405940594059405
72864,/images/31435107-c77d-42f8-a619-75cba6a5161b.png,63,1366,157,1476,94,110,red blood cell,10340,1.1702127659574468,0.8545454545454545
46061,/images/72088c26-d2dd-4906-b791-b8947fc7fbe4.png,1016,321,1116,433,100,112,red blood cell,11200,1.12,0.8928571428571429
34088,/images/de5d19b7-e670-4ac7-843b-7ce7bcebdf45.png,167,440,296,571,129,131,red blood cell,16899,1.0155038759689923,0.9847328244274809
9681,/images/53afd70c-08a7-4b9a-b137-7003b2ecbeab.png,498,117,618,236,120,119,red blood cell,14280,0.9916666666666667,1.0084033613445378
63858,/images/5e974892-0ebe-4037-8427-ea8616d6d3b8.png,476,818,580,930,104,112,red blood cell,11648,1.0769230769230769,0.9285714285714286
79945,/images/e640ae51-cbf1-4a84-b7cf-d38b17f59c2f.png,276,504,384,613,108,109,red blood cell,11772,1.0092592592592593,0.9908256880733946
8127,/images/694222bb-cddf-469a-9526-f873c6fba58e.png,208,852,318,955,110,103,red blood cell,11330,0.9363636363636364,1.0679611650485437
23372,/images/a7688988-2bcc-4458-83d3-5e482da5f87b.png,1003,1169,1115,1263,112,94,red blood cell,10528,0.8392857142857143,1.1914893617021276
4366,/images/84041bf9-dace-4066-9fe0-52170d08f826.png,1050,184,1153,292,103,108,red blood cell,11124,1.0485436893203883,0.9537037037037037
23088,/images/be5bb7d0-7c3f-4bb9-8bb4-f8bc8d875943.png,784,462,888,561,104,99,red blood cell,10296,0.9519230769230769,1.0505050505050506
18970,/images/e9e78ff8-831b-46e9-9785-3eee9acbfcd8.png,910,56,999,140,89,84,red blood cell,7476,0.9438202247191011,1.0595238095238095
15268,/images/2d0f600d-f94e-4907-b712-52fb37d9ed52.png,315,161,430,283,115,122,red blood cell,14030,1.0608695652173914,0.9426229508196722
56014,/images/177a3141-fa93-426a-9b52-7da71547ce44.png,906,500,1033,608,127,108,red blood cell,13716,0.8503937007874016,1.1759259259259258
48221,/images/71204a6d-814e-44b6-9cee-7b979f478021.png,411,1358,512,1464,101,106,red blood cell,10706,1.0495049504950495,0.9528301886792453
56054,/images/177a3141-fa93-426a-9b52-7da71547ce44.png,193,1390,306,1503,113,113,red blood cell,12769,1.0,1.0
69337,/images/2ac343e4-c889-47c1-8fe2-461b626def76.png,275,335,394,448,119,113,red blood cell,13447,0.9495798319327731,1.0530973451327434
79463,/images/a2fc0093-8645-43c7-bdee-ec8ca9484815.png,921,1422,1025,1529,104,107,red blood cell,11128,1.0288461538461537,0.9719626168224299
45528,/images/94b5a9a1-1c88-4400-aca4-3d56f543fc4a.png,290,605,426,714,136,109,red blood cell,14824,0.8014705882352942,1.2477064220183487
39439,/images/55f8c052-8e49-4423-a4c4-365fc6afb6e1.png,5,1192,144,1322,139,130,red blood cell,18070,0.935251798561151,1.0692307692307692
55336,/images/4fb83278-adc5-4424-9f45-b6d0db2955b6.png,685,190,789,306,104,116,red blood cell,12064,1.1153846153846154,0.896551724137931
73286,/images/67a4fb91-6f38-4ca2-8f20-6b2f5f1b29a7.png,927,1026,1017,1127,90,101,red blood cell,9090,1.1222222222222222,0.8910891089108911
22702,/images/4ab47131-c2ac-461f-b95c-ac19ce24edbd.png,106,815,201,920,95,105,red blood cell,9975,1.105263157894737,0.9047619047619048
48559,/images/f3d84be2-8af0-4d62-9f72-23d3dc08cbbe.png,316,648,422,758,106,110,red blood cell,11660,1.0377358490566038,0.9636363636363636
39568,/images/5a631871-2fc7-4a68-9c39-f3b9a0bf4a04.png,75,922,192,1022,117,100,red blood cell,11700,0.8547008547008547,1.17
70300,/images/90246988-0d6d-4bf8-8a76-94107de4121e.png,636,1411,743,1510,107,99,red blood cell,10593,0.9252336448598131,1.0808080808080809
66132,/images/191f87a4-6f2d-49e7-bba0-08e3aa78ddaf.png,858,360,959,473,101,113,red blood cell,11413,1.118811881188119,0.8938053097345132
13029,/images/b10ea12f-cd36-4f2c-994a-67d1665269ab.png,466,1143,567,1228,101,85,red blood cell,8585,0.8415841584158416,1.188235294117647
38800,/images/d0d3ae45-b434-4869-a518-427320ebe62d.png,667,589,786,708,119,119,red blood cell,14161,1.0,1.0
49891,/images/5e17f8e6-fd8d-426c-b444-1515d14f04b7.png,299,1367,398,1470,99,103,red blood cell,10197,1.0404040404040404,0.9611650485436893
26243,/images/7ba9db7e-9d3f-413c-b672-2bba5fb5b415.png,711,510,816,627,105,117,red blood cell,12285,1.1142857142857143,0.8974358974358975
32940,/images/d1924af6-7512-4ccc-9c6b-adbbaa8db41f.png,1014,1016,1123,1119,109,103,red blood cell,11227,0.944954128440367,1.058252427184466
56893,/images/f28e6d66-af71-40c1-b30c-da71d7230a3f.png,515,102,615,215,100,113,red blood cell,11300,1.13,0.8849557522123894
22007,/images/c5acd0ad-b0f2-478d-b0ad-5aa733aa7b32.png,717,140,830,251,113,111,red blood cell,12543,0.9823008849557522,1.018018018018018
74551,/images/bbedfcbe-9528-4ba9-9d86-4ebba7589ac5.png,907,1398,1007,1506,100,108,red blood cell,10800,1.08,0.9259259259259259
17475,/images/56077789-8580-41b4-89d6-deea227e5c60.png,1031,40,1147,150,116,110,red blood cell,12760,0.9482758620689655,1.0545454545454545
18834,/images/d1b48634-9ad5-46e8-b816-42d1d97c93cd.png,63,1304,179,1431,116,127,red blood cell,14732,1.0948275862068966,0.9133858267716536
3739,/images/dacf7e3f-1d8c-42a0-8539-3abe3971c956.png,512,769,630,894,118,125,red blood cell,14750,1.0593220338983051,0.944
3285,/images/b901c906-91be-48c4-88ec-2c527544a258.png,303,599,426,711,123,112,red blood cell,13776,0.9105691056910569,1.0982142857142858
55554,/images/a27b451d-44a6-4740-861a-9e7e99915563.png,207,993,306,1091,99,98,red blood cell,9702,0.98989898989899,1.010204081632653
17233,/images/471f75c6-bd5d-4c20-bcc1-258e836f4d69.png,216,42,318,137,102,95,red blood cell,9690,0.9313725490196079,1.0736842105263158
45756,/images/584d62ed-4329-45dd-94ce-e929d8b2bb74.png,868,11,959,111,91,100,red blood cell,9100,1.098901098901099,0.91
63673,/images/d9c9479e-f1ea-4d6e-861f-843ff9a90d19.png,480,1235,569,1325,89,90,red blood cell,8010,1.0112359550561798,0.9888888888888889
31618,/images/0d7bf56f-3b5a-40bd-971c-2ca33dd89b2c.png,168,923,272,1027,104,104,red blood cell,10816,1.0,1.0
62049,/images/7f528918-27d4-421f-ab57-0cf9c693e697.png,924,332,1026,437,102,105,red blood cell,10710,1.0294117647058822,0.9714285714285714
20846,/images/c2ec116f-f091-422c-926c-70b548a8f6ef.png,823,247,918,329,95,82,red blood cell,7790,0.8631578947368421,1.1585365853658536
68751,/images/eb5f4f2f-2275-4a80-84a5-78a1eaf4ce4d.png,246,594,350,701,104,107,red blood cell,11128,1.0288461538461537,0.9719626168224299
33002,/images/6231d81d-9e84-4a5a-8cb8-47c6a37a0176.png,740,939,854,1039,114,100,red blood cell,11400,0.8771929824561403,1.14
29195,/images/6274fe0d-0d71-40be-b61b-f0bd5b5df1e2.png,986,680,1087,793,101,113,red blood cell,11413,1.118811881188119,0.8938053097345132
7028,/images/8be185e7-2a1a-441c-a5c7-b50a9eb926cb.png,430,558,553,689,123,131,red blood cell,16113,1.065040650406504,0.9389312977099237
30481,/images/5955289d-19e5-45ef-a012-c8ea08ef45e2.png,494,82,602,203,108,121,red blood cell,13068,1.1203703703703705,0.8925619834710744
15036,/images/3003252a-2d2e-4687-ad30-9c38d68f1394.png,707,633,811,739,104,106,red blood cell,11024,1.0192307692307692,0.9811320754716981
6800,/images/e36cb882-c6d0-4467-812e-d18c169a9a47.png,119,1336,233,1451,114,115,red blood cell,13110,1.0087719298245614,0.991304347826087
16988,/images/8eeb378e-90f0-47ea-ac1c-2a201eb8d090.png,272,1125,374,1240,102,115,red blood cell,11730,1.1274509803921569,0.8869565217391304
67864,/images/41ebf9a1-24dc-454e-8bf8-508218f5ee57.png,746,865,846,954,100,89,red blood cell,8900,0.89,1.1235955056179776
8033,/images/694222bb-cddf-469a-9526-f873c6fba58e.png,1074,944,1161,1038,87,94,red blood cell,8178,1.0804597701149425,0.925531914893617
34524,/images/fa1f9f89-cecb-4972-842c-d14c632f89a9.png,773,338,870,437,97,99,red blood cell,9603,1.0206185567010309,0.9797979797979798
27170,/images/f232eec3-02c0-43f9-bf32-3e60245397e2.png,569,1244,696,1352,127,108,red blood cell,13716,0.8503937007874016,1.1759259259259258
44153,/images/8b494b40-cab5-49d3-893d-c805000fbe88.png,21,1264,121,1383,100,119,red blood cell,11900,1.19,0.8403361344537815
5692,/images/d3dcdf92-9328-4796-adf4-918646877ba1.png,328,766,439,879,111,113,red blood cell,12543,1.018018018018018,0.9823008849557522
75015,/images/9147a21d-0de2-4c04-88da-b788311696ac.png,916,1285,1020,1397,104,112,red blood cell,11648,1.0769230769230769,0.9285714285714286
53512,/images/43158031-a335-4533-9c20-48bebba90123.png,261,423,358,505,97,82,red blood cell,7954,0.845360824742268,1.1829268292682926
51496,/images/baa87bf8-786c-444c-81e8-9fa0a41d8149.png,225,437,324,537,99,100,red blood cell,9900,1.0101010101010102,0.99
19717,/images/627d6331-7bb9-4d1a-b20d-e6541af4d0f9.png,911,362,1025,462,114,100,red blood cell,11400,0.8771929824561403,1.14
48222,/images/71204a6d-814e-44b6-9cee-7b979f478021.png,650,362,751,454,101,92,red blood cell,9292,0.9108910891089109,1.0978260869565217
21513,/images/7625dfc4-858a-4c8e-907c-8943d665e9a7.png,32,327,128,430,96,103,red blood cell,9888,1.0729166666666667,0.9320388349514563
435,/images/84c88143-940d-4b62-bbd2-7acc4cadcb6b.png,571,411,690,515,119,104,red blood cell,12376,0.8739495798319328,1.1442307692307692
16205,/images/acdc6e12-73d9-44ba-be8c-2a56aaffef4f.png,464,1343,593,1477,129,134,red blood cell,17286,1.0387596899224807,0.9626865671641791
39694,/images/56adbb1e-96a8-40a5-a5a2-243c97ea889b.png,751,322,880,452,129,130,red blood cell,16770,1.0077519379844961,0.9923076923076923
2106,/images/e94a811d-3145-4313-ba42-2d5ed283179f.png,939,1395,1057,1493,118,98,red blood cell,11564,0.8305084745762712,1.2040816326530612
53940,/images/540a5fee-175b-4b92-bf62-1ea9b59c86c6.png,834,1025,955,1164,121,139,red blood cell,16819,1.1487603305785123,0.8705035971223022
7552,/images/071901eb-4c3f-404b-a747-3d0b9d0a5158.png,627,13,731,113,104,100,red blood cell,10400,0.9615384615384616,1.04
39467,/images/5a631871-2fc7-4a68-9c39-f3b9a0bf4a04.png,530,701,618,800,88,99,red blood cell,8712,1.125,0.8888888888888888
30036,/images/deeaa5b3-3895-4aec-a2ce-ed6404862cdf.png,871,999,965,1090,94,91,red blood cell,8554,0.9680851063829787,1.032967032967033
68716,/images/dcf7a19a-ec3d-44ef-8d7c-33b1e91fb9af.png,654,1019,753,1118,99,99,red blood cell,9801,1.0,1.0
24203,/images/194aec70-41a5-4ac3-b22f-0b6eda91f730.png,128,1113,238,1234,110,121,red blood cell,13310,1.1,0.9090909090909091
20375,/images/11e517bf-943b-4928-929a-e9f72c097880.png,1017,934,1129,1053,112,119,red blood cell,13328,1.0625,0.9411764705882353
77325,/images/07a80340-f65e-4f58-9317-94bb6ebd5a28.png,1047,1020,1140,1124,93,104,red blood cell,9672,1.118279569892473,0.8942307692307693
10158,/images/09ecf7be-28e2-4531-b9e2-07e01c44097d.png,33,18,131,137,98,119,red blood cell,11662,1.2142857142857142,0.8235294117647058
50051,/images/b1145408-feae-4637-b4cf-3e70b99cc62d.png,839,73,964,181,125,108,red blood cell,13500,0.864,1.1574074074074074
36372,/images/4a0a05e1-11ad-4bfc-bfa3-adf3b9bd0b56.png,805,868,927,982,122,114,red blood cell,13908,0.9344262295081968,1.0701754385964912
75295,/images/9ec1dcec-87c2-4aca-8e6b-0db3cd05509c.png,907,705,996,789,89,84,red blood cell,7476,0.9438202247191011,1.0595238095238095
17566,/images/e80bad38-66d0-473e-85dd-92142dba37e6.png,890,851,1015,964,125,113,red blood cell,14125,0.904,1.1061946902654867
51060,/images/93f40356-5676-45d3-8e83-8028708c93ba.png,687,256,808,387,121,131,red blood cell,15851,1.0826446280991735,0.9236641221374046
79133,/images/1c90231b-2830-42d9-884e-7301edb16933.png,592,1279,678,1374,86,95,red blood cell,8170,1.1046511627906976,0.9052631578947369
41926,/images/46a03374-64c7-49ac-81c9-c3d62542bbf3.png,625,339,722,432,97,93,red blood cell,9021,0.9587628865979382,1.043010752688172
6112,/images/c147584d-4c61-412a-bdaf-b02b22c18708.png,1022,847,1122,952,100,105,red blood cell,10500,1.05,0.9523809523809523
16949,/images/8eeb378e-90f0-47ea-ac1c-2a201eb8d090.png,581,1323,682,1422,101,99,red blood cell,9999,0.9801980198019802,1.02020202020202
69526,/images/664c570b-4822-413c-9724-11b1d91fac44.png,825,863,920,943,95,80,red blood cell,7600,0.8421052631578947,1.1875
68333,/images/0f735cca-051c-4048-a1fa-cb36f389e12f.png,446,72,557,191,111,119,red blood cell,13209,1.072072072072072,0.9327731092436975
43262,/images/fe1ee954-ba71-47b3-954a-d20ab940cd7b.png,587,1454,704,1588,117,134,red blood cell,15678,1.1452991452991452,0.8731343283582089
45592,/images/e597f7ce-46c6-4dce-9063-50a2703fdd45.png,753,1026,843,1132,90,106,red blood cell,9540,1.1777777777777778,0.8490566037735849
47531,/images/adff132d-3af0-4cef-942c-58fc09729bee.png,516,1478,612,1594,96,116,red blood cell,11136,1.2083333333333333,0.8275862068965517
65190,/images/50715879-2300-4dba-8f4a-3314ff8cfcce.png,674,272,771,370,97,98,red blood cell,9506,1.0103092783505154,0.9897959183673469
69748,/images/2bd15b6e-fe2d-49f3-b394-940d024d1f91.png,608,1451,718,1563,110,112,red blood cell,12320,1.018181818181818,0.9821428571428571
52870,/images/58f7e1da-3478-48f4-958c-e9b1cb8696aa.png,640,7,762,120,122,113,red blood cell,13786,0.9262295081967213,1.079646017699115
9875,/images/b4261fa5-876d-48ea-b6da-ec7ca5b48fe2.png,132,820,259,945,127,125,red blood cell,15875,0.984251968503937,1.016
71130,/images/b666fcc2-d0b2-441e-bc5a-c660345eeb5d.png,27,60,123,159,96,99,red blood cell,9504,1.03125,0.9696969696969697
30080,/images/81c3c8f0-d5a9-4dda-afd5-e86f6afd9424.png,569,558,674,676,105,118,red blood cell,12390,1.1238095238095238,0.8898305084745762
52891,/images/abb2f9d6-26fa-4328-983c-959ef6717c05.png,819,337,919,447,100,110,red blood cell,11000,1.1,0.9090909090909091
17032,/images/57e1879e-4294-45e7-9c1b-627e8cca0271.png,1079,395,1194,504,115,109,red blood cell,12535,0.9478260869565217,1.055045871559633
7892,/images/98c25ffe-c329-420a-bc22-b082f565eac9.png,594,945,730,1074,136,129,red blood cell,17544,0.9485294117647058,1.054263565891473
2666,/images/a2ccbf70-e444-49a9-8b7e-9797a05220d8.png,322,1404,430,1525,108,121,red blood cell,13068,1.1203703703703705,0.8925619834710744
59352,/images/565513be-2c20-4ee3-94f3-093869515d3d.png,978,900,1068,1003,90,103,red blood cell,9270,1.1444444444444444,0.8737864077669902
35635,/images/45f18ac0-f097-4b20-a99d-8837cf488822.png,932,107,1052,222,120,115,red blood cell,13800,0.9583333333333334,1.0434782608695652
16426,/images/e474a20b-2769-48f1-a520-4f6ef5a0dbf5.png,822,118,926,238,104,120,red blood cell,12480,1.1538461538461537,0.8666666666666667
21377,/images/5077f87d-a19f-494c-b911-14ccb03bd230.png,838,1388,959,1507,121,119,red blood cell,14399,0.9834710743801653,1.0168067226890756
31678,/images/bd432159-5956-457c-bdeb-1b5e702ba513.png,674,647,789,753,115,106,red blood cell,12190,0.9217391304347826,1.0849056603773586
33062,/images/6231d81d-9e84-4a5a-8cb8-47c6a37a0176.png,312,854,406,959,94,105,red blood cell,9870,1.1170212765957446,0.8952380952380953
69704,/images/f0713bee-2a71-4ced-b953-4041ea99496a.png,654,671,758,782,104,111,red blood cell,11544,1.0673076923076923,0.9369369369369369
73549,/images/7624ac36-1cf9-42fb-844d-376078309553.png,43,97,139,194,96,97,red blood cell,9312,1.0104166666666667,0.9896907216494846
65772,/images/daea4860-a296-4f6d-acef-996ab0882676.png,737,211,844,315,107,104,red blood cell,11128,0.9719626168224299,1.0288461538461537
27122,/images/f232eec3-02c0-43f9-bf32-3e60245397e2.png,48,367,160,490,112,123,red blood cell,13776,1.0982142857142858,0.9105691056910569
9617,/images/239f17eb-a2e2-47e9-82e3-fa0d9a70fb9f.png,899,805,1010,928,111,123,red blood cell,13653,1.1081081081081081,0.9024390243902439
15133,/images/3a8f468f-f9de-46a8-a7c8-f2be239fa207.png,874,316,973,410,99,94,red blood cell,9306,0.9494949494949495,1.053191489361702
59813,/images/acb16781-11ad-4327-874a-5c9c35dcb085.png,465,43,559,155,94,112,red blood cell,10528,1.1914893617021276,0.8392857142857143
63621,/images/d9c9479e-f1ea-4d6e-861f-843ff9a90d19.png,321,791,433,901,112,110,red blood cell,12320,0.9821428571428571,1.018181818181818
24490,/images/109fbb82-bc3c-41ac-984d-e2da86202873.png,112,692,246,807,134,115,red blood cell,15410,0.8582089552238806,1.1652173913043478
9593,/images/239f17eb-a2e2-47e9-82e3-fa0d9a70fb9f.png,168,414,298,544,130,130,red blood cell,16900,1.0,1.0
50360,/images/3d32a988-449d-4d58-b71f-abbfdc3f2fbc.png,325,450,420,544,95,94,red blood cell,8930,0.9894736842105263,1.0106382978723405
50742,/images/6b4c79f5-b194-4586-be9f-e339c5af4188.png,1,1322,118,1436,117,114,red blood cell,13338,0.9743589743589743,1.0263157894736843
68947,/images/bbaa004f-05dc-4cb8-8768-e148085bb0f9.png,957,167,1059,263,102,96,red blood cell,9792,0.9411764705882353,1.0625
3615,/images/8bd71314-e38a-4670-bb25-5cd6c9acb595.png,240,1159,352,1260,112,101,red blood cell,11312,0.9017857142857143,1.108910891089109
52334,/images/a86e0647-ae41-4b75-9d45-dd58f5ea65f5.png,498,630,594,722,96,92,red blood cell,8832,0.9583333333333334,1.0434782608695652
64172,/images/2a91387a-d30f-418d-ac3a-f7cfa6836261.png,924,291,1010,387,86,96,red blood cell,8256,1.1162790697674418,0.8958333333333334
27197,/images/bca27923-b270-45df-a0bf-3e1a7d135b2c.png,427,402,523,497,96,95,red blood cell,9120,0.9895833333333334,1.0105263157894737
5684,/images/d3dcdf92-9328-4796-adf4-918646877ba1.png,140,302,247,425,107,123,red blood cell,13161,1.1495327102803738,0.8699186991869918
18064,/images/0f0c949e-018a-4f3f-ab02-3704f49c7754.png,31,129,146,233,115,104,red blood cell,11960,0.9043478260869565,1.1057692307692308
42750,/images/a6f8a029-44ee-4fe3-b807-38d137347729.png,394,334,525,460,131,126,red blood cell,16506,0.9618320610687023,1.0396825396825398
38483,/images/aa4a023b-55bd-4259-b15d-7086a9b491e0.png,816,403,944,512,128,109,red blood cell,13952,0.8515625,1.1743119266055047
17676,/images/b5143aae-6e98-4dc6-b546-980cb472de67.png,1065,592,1180,700,115,108,red blood cell,12420,0.9391304347826087,1.0648148148148149
24571,/images/c03d9b87-e19b-402b-ad86-b30d6e8aeb59.png,758,584,852,682,94,98,red blood cell,9212,1.0425531914893618,0.9591836734693877
33537,/images/255d5f0c-87fc-4337-bb51-07c440df4f1b.png,141,88,250,202,109,114,red blood cell,12426,1.0458715596330275,0.956140350877193
77462,/images/a11ed7d0-12f6-468f-abad-5cba7d968123.png,655,823,757,922,102,99,red blood cell,10098,0.9705882352941176,1.0303030303030303
30042,/images/deeaa5b3-3895-4aec-a2ce-ed6404862cdf.png,789,1227,905,1356,116,129,red blood cell,14964,1.1120689655172413,0.8992248062015504
28166,/images/cd2774a0-dab2-4d68-aae9-7568b9f3d2a6.png,965,1148,1055,1239,90,91,red blood cell,8190,1.011111111111111,0.989010989010989
3583,/images/25132962-ff5d-4737-995f-c54d8490539b.png,570,1427,676,1529,106,102,red blood cell,10812,0.9622641509433962,1.0392156862745099
6243,/images/effd6334-516f-4d48-9f3c-5272a99780fb.png,920,854,1050,972,130,118,red blood cell,15340,0.9076923076923077,1.1016949152542372
77619,/images/f20a4fcf-ea8e-4c14-883d-d26a9e08ce25.png,778,876,869,970,91,94,red blood cell,8554,1.032967032967033,0.9680851063829787
24480,/images/109fbb82-bc3c-41ac-984d-e2da86202873.png,1038,638,1160,757,122,119,red blood cell,14518,0.9754098360655737,1.0252100840336134
1348,/images/6d91d1f0-636b-4f5a-a526-7c17fc857190.png,16,432,107,512,91,80,red blood cell,7280,0.8791208791208791,1.1375
24552,/images/c03d9b87-e19b-402b-ad86-b30d6e8aeb59.png,391,732,490,836,99,104,red blood cell,10296,1.0505050505050506,0.9519230769230769
78911,/images/4d0a1598-e4dd-45c4-8a90-dd7c780fe1da.png,300,719,381,798,81,79,red blood cell,6399,0.9753086419753086,1.0253164556962024
59645,/images/a2754679-68b0-40f4-be01-bafad5ac1261.png,918,509,1007,604,89,95,red blood cell,8455,1.0674157303370786,0.9368421052631579
56757,/images/0dcbf2c9-f959-4703-a72b-f6a81e66c2ea.png,465,1226,587,1343,122,117,red blood cell,14274,0.9590163934426229,1.0427350427350428
8553,/images/a6aa3b72-2970-4c78-b655-ea8dfe6e018c.png,722,767,818,863,96,96,red blood cell,9216,1.0,1.0
10477,/images/46a2d369-4bea-4405-ac78-91bbe130b9a7.png,500,313,613,407,113,94,red blood cell,10622,0.831858407079646,1.202127659574468
41334,/images/a065c50b-341d-4803-b4b0-0fe8f04fdbb5.png,606,172,737,291,131,119,red blood cell,15589,0.9083969465648855,1.1008403361344539
66881,/images/9acf303a-fcba-4e52-be3e-8d061aa5e72a.png,547,459,638,558,91,99,red blood cell,9009,1.0879120879120878,0.9191919191919192
39472,/images/5a631871-2fc7-4a68-9c39-f3b9a0bf4a04.png,550,354,649,450,99,96,red blood cell,9504,0.9696969696969697,1.03125
67891,/images/41ebf9a1-24dc-454e-8bf8-508218f5ee57.png,345,816,440,918,95,102,red blood cell,9690,1.0736842105263158,0.9313725490196079
48039,/images/1d4f06e1-9c9b-487e-84cd-e7e50cc754da.png,763,1030,893,1153,130,123,red blood cell,15990,0.9461538461538461,1.056910569105691
75656,/images/50d7c6c9-3230-48fe-947c-7dcfd0aad710.png,938,1122,1028,1223,90,101,red blood cell,9090,1.1222222222222222,0.8910891089108911
16582,/images/c7045ab6-230e-4c1e-a8e0-f624d41a00d9.png,344,844,451,942,107,98,red blood cell,10486,0.9158878504672897,1.0918367346938775
9661,/images/d997337e-e4a8-4ef0-b8ba-975e6c43b62c.png,200,1256,326,1384,126,128,red blood cell,16128,1.0158730158730158,0.984375
13755,/images/1b369bcf-ced4-4ae2-9196-2664bd2b1738.png,707,1385,829,1516,122,131,red blood cell,15982,1.0737704918032787,0.9312977099236641
38876,/images/d79b4e90-c45d-4f5d-a498-49c3e323c291.png,603,747,704,849,101,102,red blood cell,10302,1.00990099009901,0.9901960784313726
71009,/images/deaa1931-5f97-45bf-8c00-be6ddeb37b9a.png,123,1047,207,1145,84,98,red blood cell,8232,1.1666666666666667,0.8571428571428571
40818,/images/252071ac-e9f2-41d2-abbb-87ef01b8a997.png,352,1035,448,1131,96,96,red blood cell,9216,1.0,1.0
56965,/images/a93c35ba-1690-4358-8837-669bcd850bb7.png,906,1416,995,1520,89,104,red blood cell,9256,1.1685393258426966,0.8557692307692307
43743,/images/ef83ed4c-2724-4d5f-8abe-1a18d25cea35.png,1032,471,1141,585,109,114,red blood cell,12426,1.0458715596330275,0.956140350877193
56340,/images/4372709c-f356-4906-be17-415384d916e8.png,1039,51,1157,170,118,119,red blood cell,14042,1.0084745762711864,0.9915966386554622
44734,/images/ccb4b13d-ab20-4222-892f-5adf70249aaa.png,536,1289,649,1430,113,141,red blood cell,15933,1.247787610619469,0.8014184397163121
29057,/images/4c13e22e-dfd1-4fa1-b373-be9d0c272c0f.png,328,1354,451,1470,123,116,red blood cell,14268,0.943089430894309,1.0603448275862069
41761,/images/32a1ea24-b6b7-4253-ad3e-bdf99c2c9b9d.png,693,1386,808,1498,115,112,red blood cell,12880,0.9739130434782609,1.0267857142857142
24388,/images/4d8a4ce8-0f9c-4f21-8844-4cf0e5514bbf.png,144,809,242,908,98,99,red blood cell,9702,1.010204081632653,0.98989898989899
37611,/images/205306da-0ed8-475a-ace6-f2f81d4be88a.png,60,1218,178,1319,118,101,red blood cell,11918,0.8559322033898306,1.1683168316831682
29091,/images/4c13e22e-dfd1-4fa1-b373-be9d0c272c0f.png,805,988,916,1111,111,123,red blood cell,13653,1.1081081081081081,0.9024390243902439
4586,/images/98efca97-37d2-4459-aca6-375ecc0c4539.png,272,634,400,745,128,111,red blood cell,14208,0.8671875,1.1531531531531531
35662,/images/45f18ac0-f097-4b20-a99d-8837cf488822.png,533,835,644,947,111,112,red blood cell,12432,1.009009009009009,0.9910714285714286
10161,/images/09ecf7be-28e2-4531-b9e2-07e01c44097d.png,133,254,239,364,106,110,red blood cell,11660,1.0377358490566038,0.9636363636363636
23281,/images/157ac97a-396e-4f6c-94c6-72a4d06ccc5f.png,380,875,498,1004,118,129,red blood cell,15222,1.0932203389830508,0.9147286821705426
67929,/images/41ebf9a1-24dc-454e-8bf8-508218f5ee57.png,632,871,740,966,108,95,red blood cell,10260,0.8796296296296297,1.1368421052631579
43425,/images/367663b2-5d09-4020-ab0a-c2200e7a1c8c.png,422,215,542,333,120,118,red blood cell,14160,0.9833333333333333,1.0169491525423728
35713,/images/4063945d-03fc-4ce3-a04c-17435dce8f91.png,55,347,184,457,129,110,red blood cell,14190,0.8527131782945736,1.1727272727272726
37059,/images/b2e34f5f-904e-4473-9dc7-c6bc1ce12640.png,204,722,300,827,96,105,red blood cell,10080,1.09375,0.9142857142857143
16162,/images/1e978dfa-d339-4025-809d-09cee76728ed.png,864,84,985,208,121,124,red blood cell,15004,1.024793388429752,0.9758064516129032
12876,/images/b10ea12f-cd36-4f2c-994a-67d1665269ab.png,297,1148,406,1258,109,110,red blood cell,11990,1.0091743119266054,0.990909090909091
11189,/images/6303f964-98ef-47c6-bb2d-283aa393f918.png,732,485,841,574,109,89,red blood cell,9701,0.8165137614678899,1.2247191011235956
21599,/images/49efc89d-9cba-44f7-8257-7f911b73f68a.png,672,366,786,492,114,126,red blood cell,14364,1.105263157894737,0.9047619047619048
53387,/images/766d5547-8dd2-4c8d-b78e-3007f83932e8.png,334,711,432,796,98,85,red blood cell,8330,0.8673469387755102,1.1529411764705881
10514,/images/46a2d369-4bea-4405-ac78-91bbe130b9a7.png,1090,800,1193,891,103,91,red blood cell,9373,0.883495145631068,1.1318681318681318
2842,/images/e79bd81b-f878-4bee-9be2-d91a722c031e.png,725,1108,829,1203,104,95,red blood cell,9880,0.9134615384615384,1.0947368421052632
12770,/images/b634137b-bc8b-4e88-b0e3-b536ad6e7e18.png,468,94,585,200,117,106,red blood cell,12402,0.905982905982906,1.1037735849056605
1838,/images/5f783f43-0090-4f8a-bd75-9562f4aa2dd5.png,668,1319,786,1419,118,100,red blood cell,11800,0.847457627118644,1.18
12301,/images/3b55c42f-ad59-422f-ba99-4f4f4ca9cb2e.png,1014,1027,1104,1134,90,107,red blood cell,9630,1.1888888888888889,0.8411214953271028
45978,/images/72088c26-d2dd-4906-b791-b8947fc7fbe4.png,743,284,857,383,114,99,red blood cell,11286,0.868421052631579,1.1515151515151516
78804,/images/9174f910-3859-4839-8e30-2c3b25269322.png,373,419,492,523,119,104,red blood cell,12376,0.8739495798319328,1.1442307692307692
60716,/images/45651e76-4bd0-45e5-895b-edec65f51987.png,155,1132,282,1241,127,109,red blood cell,13843,0.8582677165354331,1.165137614678899
35396,/images/002f20ad-2ace-499c-9335-c9080bc3e6b5.png,926,52,1048,173,122,121,red blood cell,14762,0.9918032786885246,1.0082644628099173
29206,/images/6274fe0d-0d71-40be-b61b-f0bd5b5df1e2.png,839,268,928,361,89,93,red blood cell,8277,1.0449438202247192,0.956989247311828
51139,/images/d64cd75a-df26-44d5-ac25-69061a4e4d57.png,340,561,445,669,105,108,red blood cell,11340,1.0285714285714285,0.9722222222222222
18521,/images/c22f7031-9cf8-48ce-b03b-1b12d0db4951.png,70,679,183,785,113,106,red blood cell,11978,0.9380530973451328,1.0660377358490567
74383,/images/06a3effb-996c-4767-afd2-6aa3b697cb4e.png,97,1176,183,1274,86,98,red blood cell,8428,1.1395348837209303,0.8775510204081632
41242,/images/eed298b3-35f2-4127-88ad-0c4a9062207b.png,309,1071,407,1163,98,92,red blood cell,9016,0.9387755102040817,1.065217391304348
59730,/images/f77d7469-d083-4c2d-a4ea-5a9ff162e3e2.png,606,1103,725,1215,119,112,red blood cell,13328,0.9411764705882353,1.0625
59593,/images/faead1c7-bb2c-4adf-bfce-9ff36cd2cf6a.png,298,767,407,889,109,122,red blood cell,13298,1.1192660550458715,0.8934426229508197
5176,/images/a777e78c-ad1f-4380-9ab2-b4f9f32b2d78.png,26,1410,131,1521,105,111,red blood cell,11655,1.0571428571428572,0.9459459459459459
4204,/images/ac3358f1-ef9a-4ccc-b66c-da5e47e352e0.png,592,448,719,573,127,125,red blood cell,15875,0.984251968503937,1.016
64772,/images/76021d69-8919-4688-95ef-7418eff620cc.png,991,0,1092,93,101,93,red blood cell,9393,0.9207920792079208,1.086021505376344
60820,/images/0ab56f9a-846d-49e2-a617-c6cc477fdfad.png,419,651,530,762,111,111,red blood cell,12321,1.0,1.0
1480,/images/0ac747cd-ff32-49bf-bc1a-3e9b7702ce9c.png,386,350,496,476,110,126,red blood cell,13860,1.1454545454545455,0.873015873015873
48282,/images/71204a6d-814e-44b6-9cee-7b979f478021.png,1097,362,1199,469,102,107,red blood cell,10914,1.0490196078431373,0.9532710280373832
50476,/images/833b1d3e-d389-4d0f-8638-6aca5b89f917.png,702,1274,813,1383,111,109,red blood cell,12099,0.9819819819819819,1.018348623853211
37558,/images/205306da-0ed8-475a-ace6-f2f81d4be88a.png,684,180,780,279,96,99,red blood cell,9504,1.03125,0.9696969696969697
50266,/images/3d32a988-449d-4d58-b71f-abbfdc3f2fbc.png,503,393,603,486,100,93,red blood cell,9300,0.93,1.075268817204301
71080,/images/2dbf6f69-e020-4948-9e49-4b33edb7cebd.png,995,732,1096,848,101,116,red blood cell,11716,1.1485148514851484,0.8706896551724138
35915,/images/f8242b97-b8d5-48b5-b808-0b0f75a5de97.png,890,754,987,867,97,113,red blood cell,10961,1.1649484536082475,0.8584070796460177
71113,/images/b666fcc2-d0b2-441e-bc5a-c660345eeb5d.png,356,1024,482,1144,126,120,red blood cell,15120,0.9523809523809523,1.05
48295,/images/6fa2b30f-9b89-46ac-9b79-c0bc105d4271.png,411,1261,503,1362,92,101,red blood cell,9292,1.0978260869565217,0.9108910891089109
16262,/images/acdc6e12-73d9-44ba-be8c-2a56aaffef4f.png,645,69,755,192,110,123,red blood cell,13530,1.1181818181818182,0.8943089430894309
23478,/images/6fb707b1-5c07-479f-8385-5404bf5747b0.png,780,8,896,120,116,112,red blood cell,12992,0.9655172413793104,1.0357142857142858
43132,/images/c5db0fc0-b96c-496e-90b4-f9fb1b85b28e.png,901,22,1008,125,107,103,red blood cell,11021,0.9626168224299065,1.0388349514563107
49279,/images/99b13257-b9d9-422f-8262-802da0bdc510.png,777,1438,894,1566,117,128,red blood cell,14976,1.0940170940170941,0.9140625
3220,/images/96596a68-8c95-43f3-b74e-e9506c235144.png,436,891,536,982,100,91,red blood cell,9100,0.91,1.098901098901099
52962,/images/e81bf478-27ff-458c-ac30-9e1f8480bc5c.png,333,162,447,263,114,101,red blood cell,11514,0.8859649122807017,1.1287128712871286
32937,/images/d1924af6-7512-4ccc-9c6b-adbbaa8db41f.png,908,577,1003,687,95,110,red blood cell,10450,1.1578947368421053,0.8636363636363636
36332,/images/4a0a05e1-11ad-4bfc-bfa3-adf3b9bd0b56.png,1029,174,1128,276,99,102,red blood cell,10098,1.0303030303030303,0.9705882352941176
59691,/images/a2754679-68b0-40f4-be01-bafad5ac1261.png,1061,393,1149,481,88,88,red blood cell,7744,1.0,1.0
54107,/images/d9345456-b76d-46cc-b81e-46d4a0a7b652.png,106,633,189,725,83,92,red blood cell,7636,1.108433734939759,0.9021739130434783
10575,/images/20d4f65e-6c63-433a-935c-d568d577967b.png,125,179,231,287,106,108,red blood cell,11448,1.0188679245283019,0.9814814814814815
71909,/images/61575482-91e1-4db9-83c7-687b7ddbbfc4.png,646,113,752,212,106,99,red blood cell,10494,0.9339622641509434,1.0707070707070707
3408,/images/fd1302e2-3cd2-4a1a-9c13-00f810a9c41b.png,1037,1120,1166,1242,129,122,red blood cell,15738,0.9457364341085271,1.0573770491803278
13231,/images/711f6b3f-cd63-46d1-834a-bc8e9aa9b43e.png,1060,921,1156,1013,96,92,red blood cell,8832,0.9583333333333334,1.0434782608695652
48136,/images/913099c5-8085-4908-bf4b-1f098bbfcf66.png,611,88,725,212,114,124,red blood cell,14136,1.087719298245614,0.9193548387096774
55717,/images/c32b8bb8-c89d-4ae9-9c77-5b9356ca35a1.png,894,444,999,539,105,95,red blood cell,9975,0.9047619047619048,1.105263157894737
71589,/images/390ad256-e1ed-476a-9f14-2dc34e0da632.png,173,1014,292,1125,119,111,red blood cell,13209,0.9327731092436975,1.072072072072072
77112,/images/dd6f047e-af73-43df-9c46-354534fc20e0.png,525,1454,635,1554,110,100,red blood cell,11000,0.9090909090909091,1.1
76252,/images/90a82250-1f68-48c9-9af9-15f18bf8c974.png,599,1071,713,1201,114,130,red blood cell,14820,1.1403508771929824,0.8769230769230769
30846,/images/fbc1f360-4382-48bb-a32e-3f5f2f9dbe57.png,71,542,179,649,108,107,red blood cell,11556,0.9907407407407407,1.0093457943925233
39598,/images/04d21589-b777-43c2-86b5-038cbf8c3a4e.png,634,347,753,481,119,134,red blood cell,15946,1.1260504201680672,0.8880597014925373
46612,/images/da111ca5-520f-4ea8-97ad-ae5fce58ee91.png,154,1288,260,1387,106,99,red blood cell,10494,0.9339622641509434,1.0707070707070707
36094,/images/cb2fac19-90b0-48b4-bdc5-7dbbd58756d1.png,493,338,614,468,121,130,red blood cell,15730,1.0743801652892562,0.9307692307692308
35659,/images/45f18ac0-f097-4b20-a99d-8837cf488822.png,504,1010,607,1133,103,123,red blood cell,12669,1.1941747572815533,0.8373983739837398
74588,/images/bbedfcbe-9528-4ba9-9d86-4ebba7589ac5.png,959,1056,1045,1156,86,100,red blood cell,8600,1.1627906976744187,0.86
66708,/images/b88fe674-fb9a-41d4-b100-cb1c86440d44.png,379,748,462,817,83,69,red blood cell,5727,0.8313253012048193,1.2028985507246377
49028,/images/df3d98b9-3dd7-4107-8d4a-ae1b7f247793.png,985,1206,1072,1310,87,104,red blood cell,9048,1.1954022988505748,0.8365384615384616
79266,/images/05ac7b2a-6a77-4464-926b-8570f7c01693.png,332,654,431,741,99,87,red blood cell,8613,0.8787878787878788,1.1379310344827587
35878,/images/33068c1a-48f7-470b-8e49-e2f0888042e9.png,676,317,794,430,118,113,red blood cell,13334,0.9576271186440678,1.0442477876106195
65584,/images/01b38a56-13eb-447b-89ee-fc21cb40dcc1.png,583,387,702,498,119,111,red blood cell,13209,0.9327731092436975,1.072072072072072
54506,/images/db871d17-28fd-4ceb-b421-e4e4afa0a7a0.png,509,464,632,579,123,115,red blood cell,14145,0.9349593495934959,1.0695652173913044
39898,/images/af2e63a3-9fde-46aa-a867-81c5c259d1dc.png,693,834,813,939,120,105,red blood cell,12600,0.875,1.1428571428571428
7147,/images/56551792-4aa1-4301-9f8f-8bfebcd20050.png,590,575,726,692,136,117,red blood cell,15912,0.8602941176470589,1.1623931623931625
52921,/images/abb2f9d6-26fa-4328-983c-959ef6717c05.png,184,934,263,1018,79,84,red blood cell,6636,1.0632911392405062,0.9404761904761905
22561,/images/bfe65b11-8aff-46aa-908b-1e989d25fdc4.png,112,1260,239,1380,127,120,red blood cell,15240,0.9448818897637795,1.0583333333333333
62345,/images/e0ff3476-226f-4125-b182-8e524d5503dd.png,439,759,523,852,84,93,red blood cell,7812,1.1071428571428572,0.9032258064516129
31830,/images/f62d4fb6-df7c-446c-94a8-d5aede0b1e0c.png,979,522,1089,624,110,102,red blood cell,11220,0.9272727272727272,1.0784313725490196
66512,/images/b87fb62d-2c36-4f68-aba9-37fcd7d46eef.png,949,362,1047,459,98,97,red blood cell,9506,0.9897959183673469,1.0103092783505154
71108,/images/b666fcc2-d0b2-441e-bc5a-c660345eeb5d.png,855,1402,978,1529,123,127,red blood cell,15621,1.032520325203252,0.968503937007874
12282,/images/3b55c42f-ad59-422f-ba99-4f4f4ca9cb2e.png,210,1432,328,1528,118,96,red blood cell,11328,0.8135593220338984,1.2291666666666667
58637,/images/a4d7a7e1-5ae1-486d-b6ee-c9af1476ccad.png,9,1412,91,1487,82,75,red blood cell,6150,0.9146341463414634,1.0933333333333333
30304,/images/cecbf663-0751-4e7f-b298-770c88afc2c1.png,244,1438,343,1541,99,103,red blood cell,10197,1.0404040404040404,0.9611650485436893
71334,/images/bcb447c9-5d37-414f-a513-d7076b04a532.png,28,454,133,564,105,110,red blood cell,11550,1.0476190476190477,0.9545454545454546
41325,/images/a065c50b-341d-4803-b4b0-0fe8f04fdbb5.png,89,1177,180,1273,91,96,red blood cell,8736,1.054945054945055,0.9479166666666666
61772,/images/985627c9-7b85-40de-a106-eb9cc47b47cb.png,1013,1043,1115,1168,102,125,red blood cell,12750,1.2254901960784315,0.816
77754,/images/4849866a-73a2-4fcf-a407-2d0a25a09a89.png,627,515,730,626,103,111,red blood cell,11433,1.0776699029126213,0.9279279279279279
38536,/images/c3ae7090-fc68-41b4-85a1-8d9bce9825a7.png,918,67,1053,192,135,125,red blood cell,16875,0.9259259259259259,1.08
66733,/images/334bf865-e3fb-4200-bd53-d9ff5808ed9f.png,1059,444,1153,538,94,94,red blood cell,8836,1.0,1.0
36233,/images/c3209548-7f7c-4afd-b47c-b42a72b1ebf7.png,631,806,744,927,113,121,red blood cell,13673,1.0707964601769913,0.9338842975206612
12618,/images/0901f9d1-be4f-4c19-8e83-dd724dded9f5.png,228,531,326,638,98,107,red blood cell,10486,1.0918367346938775,0.9158878504672897
51411,/images/b4f3b2a4-f4b9-48de-ac5d-0e681b77be27.png,1077,14,1183,117,106,103,red blood cell,10918,0.9716981132075472,1.029126213592233
62149,/images/a63fa2c7-3ec8-4bb7-bde6-a39e09d2f806.png,648,120,742,219,94,99,red blood cell,9306,1.053191489361702,0.9494949494949495
36338,/images/4a0a05e1-11ad-4bfc-bfa3-adf3b9bd0b56.png,964,1344,1089,1476,125,132,red blood cell,16500,1.056,0.946969696969697
76936,/images/25ddc1ca-d368-4fff-b1ad-1dbf1e7c97aa.png,382,1269,509,1375,127,106,red blood cell,13462,0.8346456692913385,1.1981132075471699
67172,/images/be6fe358-dee1-4dcf-9b0d-5d8612aba577.png,883,1284,994,1409,111,125,red blood cell,13875,1.1261261261261262,0.888
49722,/images/5e17f8e6-fd8d-426c-b444-1515d14f04b7.png,116,640,215,736,99,96,red blood cell,9504,0.9696969696969697,1.03125
75404,/images/468c261d-f5d8-423f-883e-48af2bbbc5d1.png,245,1076,338,1191,93,115,red blood cell,10695,1.2365591397849462,0.808695652173913
61337,/images/e16c0dab-780d-4035-872e-1bb91e49f9d2.png,48,537,158,652,110,115,red blood cell,12650,1.0454545454545454,0.9565217391304348
17554,/images/e80bad38-66d0-473e-85dd-92142dba37e6.png,1010,362,1115,481,105,119,red blood cell,12495,1.1333333333333333,0.8823529411764706
70927,/images/bf002a25-6535-4621-be19-56d468be5413.png,764,1305,841,1385,77,80,red blood cell,6160,1.0389610389610389,0.9625
40990,/images/bbe65c18-8a56-4dfe-875c-94e124a84125.png,353,469,496,587,143,118,red blood cell,16874,0.8251748251748252,1.2118644067796611
59146,/images/4736f545-1f1f-4d77-9241-d69cbf4dae35.png,543,393,652,504,109,111,red blood cell,12099,1.018348623853211,0.9819819819819819
18271,/images/947348fe-4c70-468e-8009-3c14daeca69b.png,693,87,796,183,103,96,red blood cell,9888,0.9320388349514563,1.0729166666666667
37939,/images/56a57a8d-c9b9-432a-a3b0-32a09355806c.png,151,459,251,549,100,90,red blood cell,9000,0.9,1.1111111111111112
74464,/images/cbb58718-6319-48db-b84b-78ac9b12ff89.png,87,789,180,897,93,108,red blood cell,10044,1.1612903225806452,0.8611111111111112
29983,/images/deeaa5b3-3895-4aec-a2ce-ed6404862cdf.png,714,66,836,182,122,116,red blood cell,14152,0.9508196721311475,1.0517241379310345
11135,/images/6303f964-98ef-47c6-bb2d-283aa393f918.png,281,96,389,187,108,91,red blood cell,9828,0.8425925925925926,1.1868131868131868
41835,/images/c3b07675-9d02-477c-91fe-f0737867049b.png,477,450,620,591,143,141,red blood cell,20163,0.986013986013986,1.0141843971631206
47084,/images/997eabd9-55bf-4683-83c4-4cee4673a4ef.png,1023,1455,1117,1564,94,109,red blood cell,10246,1.1595744680851063,0.8623853211009175
79433,/images/dcb21739-3c36-459d-b3cc-1be5871d6fe7.png,1052,1178,1131,1262,79,84,red blood cell,6636,1.0632911392405062,0.9404761904761905
64563,/images/6ba5d0b8-cdc7-4266-9d78-db76faa312e9.png,59,47,143,130,84,83,red blood cell,6972,0.9880952380952381,1.0120481927710843
34444,/images/b4bde4e8-f48b-4ae2-be01-86d8c91d0af9.png,1057,132,1163,230,106,98,red blood cell,10388,0.9245283018867925,1.0816326530612246
78921,/images/4d0a1598-e4dd-45c4-8a90-dd7c780fe1da.png,1090,1022,1177,1122,87,100,red blood cell,8700,1.1494252873563218,0.87
43998,/images/de81bf7a-7a56-437f-a068-4d9c3e01134c.png,582,174,680,285,98,111,red blood cell,10878,1.1326530612244898,0.8828828828828829
33204,/images/877d5e7f-19b6-40e7-81bd-c92f25e72503.png,140,157,259,277,119,120,red blood cell,14280,1.0084033613445378,0.9916666666666667
67364,/images/266180ed-77a3-4284-8292-50a49fc47fce.png,62,1026,164,1114,102,88,red blood cell,8976,0.8627450980392157,1.1590909090909092
25090,/images/9e74feb8-017d-4d53-8896-9ebda4327dd1.png,283,1404,399,1522,116,118,red blood cell,13688,1.0172413793103448,0.9830508474576272
14102,/images/eaf4b781-b3aa-41ce-8c5e-287979b4e15a.png,450,130,542,222,92,92,red blood cell,8464,1.0,1.0
15629,/images/84d7545e-c3a8-4b1f-9a39-36aab78c8699.png,270,301,397,415,127,114,red blood cell,14478,0.8976377952755905,1.1140350877192982
30981,/images/b59dc3a0-3d54-4e3b-a485-33b3e43966de.png,623,1367,719,1476,96,109,red blood cell,10464,1.1354166666666667,0.8807339449541285
75191,/images/61dfc937-a428-44b4-94fb-d682bdb8dff0.png,147,789,238,887,91,98,red blood cell,8918,1.0769230769230769,0.9285714285714286
14436,/images/3b13e20f-ec0d-44ec-b2f4-eaebfa09150e.png,483,87,618,201,135,114,red blood cell,15390,0.8444444444444444,1.1842105263157894
59534,/images/6bfe6a90-8a69-4171-8e7f-42dc9417c6d9.png,662,25,757,113,95,88,red blood cell,8360,0.9263157894736842,1.0795454545454546
46632,/images/da111ca5-520f-4ea8-97ad-ae5fce58ee91.png,999,1423,1088,1509,89,86,red blood cell,7654,0.9662921348314607,1.0348837209302326
42556,/images/9a25f103-1683-47d1-8b07-ac20fe0b3ee9.png,921,518,1032,636,111,118,red blood cell,13098,1.063063063063063,0.940677966101695
61372,/images/e16c0dab-780d-4035-872e-1bb91e49f9d2.png,245,158,345,262,100,104,red blood cell,10400,1.04,0.9615384615384616
16928,/images/8eeb378e-90f0-47ea-ac1c-2a201eb8d090.png,225,1483,335,1591,110,108,red blood cell,11880,0.9818181818181818,1.0185185185185186
21681,/images/66183740-e1e5-43c9-8539-a87028bb3621.png,1067,1330,1153,1420,86,90,red blood cell,7740,1.0465116279069768,0.9555555555555556
34891,/images/a4fbb9f2-9b75-4fdc-877d-2feaafac25b3.png,147,683,243,782,96,99,red blood cell,9504,1.03125,0.9696969696969697
65663,/images/397f37bc-a3a4-4257-9430-c8fc5716f8b1.png,868,54,993,168,125,114,red blood cell,14250,0.912,1.0964912280701755
51738,/images/592c941a-aa54-4971-b499-dc47356f80a3.png,616,462,703,542,87,80,red blood cell,6960,0.9195402298850575,1.0875
60891,/images/11b72c7b-5c52-44b7-adb7-21eacc25e441.png,875,1123,972,1224,97,101,red blood cell,9797,1.041237113402062,0.9603960396039604
62825,/images/631340cc-cedf-4bca-a3d8-a0731a5482b4.png,639,285,726,378,87,93,red blood cell,8091,1.0689655172413792,0.9354838709677419
54353,/images/19370afd-f897-47d8-bfae-c0d257bbf795.png,202,64,309,169,107,105,red blood cell,11235,0.9813084112149533,1.019047619047619
410,/images/84c88143-940d-4b62-bbd2-7acc4cadcb6b.png,395,985,506,1107,111,122,red blood cell,13542,1.0990990990990992,0.9098360655737705
45390,/images/e4eea7ea-8989-46a9-9c98-25a178146b28.png,971,249,1065,345,94,96,red blood cell,9024,1.0212765957446808,0.9791666666666666
54562,/images/59dc7da9-35d1-421e-a61b-1e9637bfbfa1.png,113,1344,222,1456,109,112,red blood cell,12208,1.0275229357798166,0.9732142857142857
33771,/images/cb08956d-dd6a-4e13-817b-40a0a93068f1.png,820,437,947,565,127,128,red blood cell,16256,1.0078740157480315,0.9921875
51665,/images/592c941a-aa54-4971-b499-dc47356f80a3.png,616,188,705,297,89,109,red blood cell,9701,1.2247191011235956,0.8165137614678899
46653,/images/da111ca5-520f-4ea8-97ad-ae5fce58ee91.png,1050,276,1150,366,100,90,red blood cell,9000,0.9,1.1111111111111112
6741,/images/672e4ecf-a56b-462e-b83b-76f4efaa6634.png,403,920,501,1019,98,99,red blood cell,9702,1.010204081632653,0.98989898989899
14879,/images/3090a362-1f3d-49e9-a76e-ce76ff9c2276.png,139,66,244,178,105,112,red blood cell,11760,1.0666666666666667,0.9375
58085,/images/a7c91b63-b97c-4f4b-8d34-7ad2b08d7a17.png,291,1291,385,1379,94,88,red blood cell,8272,0.9361702127659575,1.0681818181818181
22449,/images/99d6a7e5-128e-4455-841d-8fbd1663905e.png,612,736,736,865,124,129,red blood cell,15996,1.0403225806451613,0.9612403100775194
1881,/images/8855c685-5a8c-4967-a356-942ed89e3471.png,600,466,722,567,122,101,red blood cell,12322,0.8278688524590164,1.2079207920792079
47305,/images/1dd3e6dd-343f-4cc9-b0ed-e4d27fb36f0a.png,1058,721,1173,827,115,106,red blood cell,12190,0.9217391304347826,1.0849056603773586
23628,/images/79d7a014-21ff-40f1-9ac4-a69839390654.png,740,41,837,139,97,98,red blood cell,9506,1.0103092783505154,0.9897959183673469
29270,/images/6274fe0d-0d71-40be-b61b-f0bd5b5df1e2.png,267,1280,357,1360,90,80,red blood cell,7200,0.8888888888888888,1.125
15477,/images/79f63258-24ce-4e69-a5cb-8529635a89a9.png,693,342,788,453,95,111,red blood cell,10545,1.168421052631579,0.8558558558558559
5195,/images/16a51468-9f93-45df-9ae2-5a74c25c5a4b.png,146,1369,260,1478,114,109,red blood cell,12426,0.956140350877193,1.0458715596330275
52384,/images/a2a20600-f851-4db7-90f9-6f7be027c8b5.png,494,568,612,687,118,119,red blood cell,14042,1.0084745762711864,0.9915966386554622
44164,/images/8b494b40-cab5-49d3-893d-c805000fbe88.png,548,1408,654,1508,106,100,red blood cell,10600,0.9433962264150944,1.06
52657,/images/3f390b82-8859-4c27-bbfe-d1b242477f63.png,309,603,425,720,116,117,red blood cell,13572,1.0086206896551724,0.9914529914529915
39841,/images/af2e63a3-9fde-46aa-a867-81c5c259d1dc.png,723,191,832,301,109,110,red blood cell,11990,1.0091743119266054,0.990909090909091
36687,/images/21f001d6-f568-4ea4-82da-fab54c77c419.png,492,535,585,629,93,94,red blood cell,8742,1.010752688172043,0.9893617021276596
6836,/images/e36cb882-c6d0-4467-812e-d18c169a9a47.png,546,627,659,731,113,104,red blood cell,11752,0.9203539823008849,1.0865384615384615
39266,/images/f7cced00-9b41-45ec-9fdf-fb9e1a74da90.png,757,731,866,848,109,117,red blood cell,12753,1.073394495412844,0.9316239316239316
676,/images/e61e6af2-7f8b-47b0-bbe7-acb2ed0299ab.png,315,798,417,898,102,100,red blood cell,10200,0.9803921568627451,1.02
20423,/images/781d4bea-c6a9-4b36-ae10-ba9e328c87fe.png,188,547,305,676,117,129,red blood cell,15093,1.1025641025641026,0.9069767441860465
20887,/images/c2ec116f-f091-422c-926c-70b548a8f6ef.png,1106,1308,1197,1402,91,94,red blood cell,8554,1.032967032967033,0.9680851063829787
44831,/images/83ec8923-6232-40d7-ba1f-a1b8bf7cb66c.png,186,1326,299,1426,113,100,red blood cell,11300,0.8849557522123894,1.13
17780,/images/1863da5f-c595-4541-a8f4-21fe78678168.png,933,198,1040,315,107,117,red blood cell,12519,1.0934579439252337,0.9145299145299145
46669,/images/da111ca5-520f-4ea8-97ad-ae5fce58ee91.png,75,114,187,217,112,103,red blood cell,11536,0.9196428571428571,1.087378640776699
40773,/images/252071ac-e9f2-41d2-abbb-87ef01b8a997.png,629,162,718,272,89,110,red blood cell,9790,1.2359550561797752,0.8090909090909091
34628,/images/a0eedcb9-b85c-4612-b945-7e8227f53c35.png,129,739,228,839,99,100,red blood cell,9900,1.0101010101010102,0.99
51431,/images/b4f3b2a4-f4b9-48de-ac5d-0e681b77be27.png,837,1196,937,1305,100,109,red blood cell,10900,1.09,0.9174311926605505
33651,/images/84ee2ea3-9edd-4672-a1b3-f09c607d833a.png,745,1286,856,1405,111,119,red blood cell,13209,1.072072072072072,0.9327731092436975
72896,/images/31435107-c77d-42f8-a619-75cba6a5161b.png,480,204,574,320,94,116,red blood cell,10904,1.2340425531914894,0.8103448275862069
5920,/images/a30da226-b452-408a-a556-bfae4d521464.png,714,258,805,358,91,100,red blood cell,9100,1.098901098901099,0.91
79271,/images/05ac7b2a-6a77-4464-926b-8570f7c01693.png,468,744,561,837,93,93,red blood cell,8649,1.0,1.0
70270,/images/90246988-0d6d-4bf8-8a76-94107de4121e.png,143,617,244,720,101,103,red blood cell,10403,1.0198019801980198,0.9805825242718447
22948,/images/ecd68ba2-48af-4866-826a-7cd1c147c055.png,576,1470,686,1582,110,112,red blood cell,12320,1.018181818181818,0.9821428571428571
79324,/images/05ac7b2a-6a77-4464-926b-8570f7c01693.png,372,1,473,97,101,96,red blood cell,9696,0.9504950495049505,1.0520833333333333
66853,/images/9106a6bb-1352-411f-ac26-0d6fe48c16a8.png,1014,84,1132,209,118,125,red blood cell,14750,1.0593220338983051,0.944
72590,/images/a63ce82f-f3d1-4818-9035-d3d230e5f686.png,337,338,456,446,119,108,red blood cell,12852,0.907563025210084,1.1018518518518519
10511,/images/46a2d369-4bea-4405-ac78-91bbe130b9a7.png,729,1127,827,1211,98,84,red blood cell,8232,0.8571428571428571,1.1666666666666667
15103,/images/3a8f468f-f9de-46a8-a7c8-f2be239fa207.png,643,1383,741,1479,98,96,red blood cell,9408,0.9795918367346939,1.0208333333333333
18279,/images/947348fe-4c70-468e-8009-3c14daeca69b.png,763,1001,862,1109,99,108,red blood cell,10692,1.0909090909090908,0.9166666666666666
42381,/images/1a27ebe9-93a1-4898-af69-f276057d4012.png,451,1429,576,1544,125,115,red blood cell,14375,0.92,1.0869565217391304
73320,/images/67a4fb91-6f38-4ca2-8f20-6b2f5f1b29a7.png,735,1065,828,1174,93,109,red blood cell,10137,1.1720430107526882,0.8532110091743119
23360,/images/a7688988-2bcc-4458-83d3-5e482da5f87b.png,16,227,114,334,98,107,red blood cell,10486,1.0918367346938775,0.9158878504672897
57506,/images/00d04a90-80e5-4bce-9511-1b64eabb7a47.png,1007,1221,1097,1310,90,89,red blood cell,8010,0.9888888888888889,1.0112359550561798
10480,/images/46a2d369-4bea-4405-ac78-91bbe130b9a7.png,405,144,498,238,93,94,red blood cell,8742,1.010752688172043,0.9893617021276596
58740,/images/e4827c85-311a-4df1-89c2-99dad0c3558c.png,876,1378,960,1455,84,77,red blood cell,6468,0.9166666666666666,1.0909090909090908
72724,/images/6ab870ba-b24b-49a9-9570-8eafe63aa74e.png,979,75,1082,178,103,103,red blood cell,10609,1.0,1.0
17374,/images/04018590-4e66-4cb9-ad2d-83570f1b29ae.png,654,568,757,690,103,122,red blood cell,12566,1.1844660194174756,0.8442622950819673
20716,/images/79b3a64f-2fb9-46e0-85d4-2bdd59c2075e.png,970,332,1073,435,103,103,red blood cell,10609,1.0,1.0
34221,/images/4767bfcc-fe87-4962-8c40-6ce8d9363cdf.png,886,284,994,386,108,102,red blood cell,11016,0.9444444444444444,1.0588235294117647
12841,/images/b10ea12f-cd36-4f2c-994a-67d1665269ab.png,69,1144,166,1232,97,88,red blood cell,8536,0.9072164948453608,1.1022727272727273
79096,/images/1c90231b-2830-42d9-884e-7301edb16933.png,504,41,607,151,103,110,red blood cell,11330,1.0679611650485437,0.9363636363636364
18940,/images/e9e78ff8-831b-46e9-9785-3eee9acbfcd8.png,715,519,817,636,102,117,red blood cell,11934,1.1470588235294117,0.8717948717948718
36935,/images/b2e34f5f-904e-4473-9dc7-c6bc1ce12640.png,1072,377,1161,482,89,105,red blood cell,9345,1.1797752808988764,0.8476190476190476
67570,/images/59542a24-b409-4c95-8608-d9691a741526.png,579,823,700,937,121,114,red blood cell,13794,0.9421487603305785,1.0614035087719298
31009,/images/b59dc3a0-3d54-4e3b-a485-33b3e43966de.png,302,745,415,857,113,112,red blood cell,12656,0.9911504424778761,1.0089285714285714
8846,/images/91827f1a-9b04-4ef0-972c-12e90e60c516.png,273,9,392,127,119,118,red blood cell,14042,0.9915966386554622,1.0084745762711864
77213,/images/fe691faa-3bc7-475e-b558-aa8fe7b795bc.png,551,722,664,827,113,105,red blood cell,11865,0.9292035398230089,1.0761904761904761
21882,/images/30ad83f1-a9b3-4a07-aea6-6c06b71e9ace.png,829,1166,933,1264,104,98,red blood cell,10192,0.9423076923076923,1.0612244897959184
74199,/images/4e43fc22-dc08-4cde-b3ce-ce8a4f377c47.png,461,1058,571,1172,110,114,red blood cell,12540,1.0363636363636364,0.9649122807017544
66017,/images/25c6cfb1-01d0-4864-87f9-02b7593683c7.png,665,1512,761,1596,96,84,red blood cell,8064,0.875,1.1428571428571428
55679,/images/c32b8bb8-c89d-4ae9-9c77-5b9356ca35a1.png,759,1355,860,1451,101,96,red blood cell,9696,0.9504950495049505,1.0520833333333333
60054,/images/e63e1607-f344-43d6-a0d8-e10cf2e5054a.png,534,559,655,678,121,119,red blood cell,14399,0.9834710743801653,1.0168067226890756
257,/images/0dcca702-a4ef-4fb3-a940-9c0c140b21c7.png,346,210,447,319,101,109,red blood cell,11009,1.0792079207920793,0.926605504587156
37410,/images/08f5a524-0554-49c2-83a8-ae9a6d51e8fd.png,576,213,675,313,99,100,red blood cell,9900,1.0101010101010102,0.99
56394,/images/c10b125d-10c2-474a-9c6a-5249935c638e.png,1079,409,1199,524,120,115,red blood cell,13800,0.9583333333333334,1.0434782608695652
1497,/images/0ac747cd-ff32-49bf-bc1a-3e9b7702ce9c.png,568,14,698,119,130,105,red blood cell,13650,0.8076923076923077,1.2380952380952381
59229,/images/4736f545-1f1f-4d77-9241-d69cbf4dae35.png,705,1079,789,1165,84,86,red blood cell,7224,1.0238095238095237,0.9767441860465116
837,/images/c7a2d648-47cb-4b39-afa4-1b7fcfe51934.png,350,431,461,568,111,137,red blood cell,15207,1.2342342342342343,0.8102189781021898
24013,/images/5107dcb7-164f-4e10-bbff-822b39b76efc.png,123,529,242,654,119,125,red blood cell,14875,1.050420168067227,0.952
43622,/images/a4851ed0-1499-4eae-9157-dcd34773254f.png,877,893,970,990,93,97,red blood cell,9021,1.043010752688172,0.9587628865979382
59292,/images/03c8da48-04b9-4520-b674-44a0ecd35688.png,483,1470,583,1571,100,101,red blood cell,10100,1.01,0.9900990099009901
21373,/images/5077f87d-a19f-494c-b911-14ccb03bd230.png,139,774,254,883,115,109,red blood cell,12535,0.9478260869565217,1.055045871559633
34692,/images/8d989997-038c-4924-b2d3-d02629a7cdf5.png,1036,84,1139,195,103,111,red blood cell,11433,1.0776699029126213,0.9279279279279279
11862,/images/3cdcb09b-6a8c-43ca-b1d0-c1a289202f65.png,311,1008,432,1128,121,120,red blood cell,14520,0.9917355371900827,1.0083333333333333
43735,/images/ef83ed4c-2724-4d5f-8abe-1a18d25cea35.png,19,1473,139,1592,120,119,red blood cell,14280,0.9916666666666667,1.0084033613445378
72317,/images/ee57e743-a876-4f69-9fe5-bf5d01b44689.png,745,453,836,551,91,98,red blood cell,8918,1.0769230769230769,0.9285714285714286
67314,/images/49c4dbd3-6269-4d4c-9648-a2146c57bab1.png,149,548,254,645,105,97,red blood cell,10185,0.9238095238095239,1.0824742268041236
32347,/images/a6526894-e290-482d-ac43-f1df34864817.png,632,1198,753,1324,121,126,red blood cell,15246,1.0413223140495869,0.9603174603174603
31379,/images/04fb49a2-07b8-4cdf-b6f7-df5c3688e5f8.png,1026,1415,1139,1529,113,114,red blood cell,12882,1.008849557522124,0.9912280701754386
39228,/images/2aeb7b85-7df9-4a63-8d37-2eecaaa190e7.png,766,766,860,853,94,87,red blood cell,8178,0.925531914893617,1.0804597701149425
10457,/images/46a2d369-4bea-4405-ac78-91bbe130b9a7.png,21,1321,107,1419,86,98,red blood cell,8428,1.1395348837209303,0.8775510204081632
14223,/images/c186dcd1-af61-455f-9619-1fdd8c881b06.png,450,304,548,416,98,112,red blood cell,10976,1.1428571428571428,0.875
35487,/images/3722d213-f2a9-46d5-aa76-9183b443e455.png,562,1210,661,1327,99,117,red blood cell,11583,1.1818181818181819,0.8461538461538461
33364,/images/f632981c-1330-4078-8a12-691beb2dab02.png,853,22,951,123,98,101,red blood cell,9898,1.030612244897959,0.9702970297029703
75317,/images/9ec1dcec-87c2-4aca-8e6b-0db3cd05509c.png,1041,82,1140,186,99,104,red blood cell,10296,1.0505050505050506,0.9519230769230769
37937,/images/56a57a8d-c9b9-432a-a3b0-32a09355806c.png,361,21,471,128,110,107,red blood cell,11770,0.9727272727272728,1.02803738317757
76130,/images/16244280-6c74-47d3-b544-9fd6831a6bf9.png,130,1380,224,1476,94,96,red blood cell,9024,1.0212765957446808,0.9791666666666666
27025,/images/ec301f62-1302-4407-96f9-fcfe45c150ae.png,643,57,769,184,126,127,red blood cell,16002,1.007936507936508,0.9921259842519685
62760,/images/e1937e32-85d5-4cd8-bb4a-b9cf8ee7ceeb.png,713,100,833,212,120,112,red blood cell,13440,0.9333333333333333,1.0714285714285714
27489,/images/f5869ba8-6253-426b-93f3-82af59a86144.png,130,1015,245,1132,115,117,red blood cell,13455,1.017391304347826,0.9829059829059829
62717,/images/9e1b0217-0926-4fd1-bb9e-a815c05deb59.png,236,182,349,290,113,108,red blood cell,12204,0.9557522123893806,1.0462962962962963
9129,/images/d3ed519e-2152-4e30-838d-a3ea23be512f.png,684,327,808,463,124,136,red blood cell,16864,1.096774193548387,0.9117647058823529
58728,/images/e4827c85-311a-4df1-89c2-99dad0c3558c.png,69,1223,170,1339,101,116,red blood cell,11716,1.1485148514851484,0.8706896551724138
24987,/images/ed0bee2f-05e0-4392-8357-19750cec577c.png,546,366,633,473,87,107,red blood cell,9309,1.2298850574712643,0.8130841121495327
69228,/images/f274b784-b995-4a7e-a2c2-6cc31c24c4b4.png,150,505,259,599,109,94,red blood cell,10246,0.8623853211009175,1.1595744680851063
30876,/images/fbc1f360-4382-48bb-a32e-3f5f2f9dbe57.png,952,13,1057,121,105,108,red blood cell,11340,1.0285714285714285,0.9722222222222222
18545,/images/c22f7031-9cf8-48ce-b03b-1b12d0db4951.png,1006,1198,1123,1317,117,119,red blood cell,13923,1.017094017094017,0.9831932773109243
52975,/images/e81bf478-27ff-458c-ac30-9e1f8480bc5c.png,278,462,372,555,94,93,red blood cell,8742,0.9893617021276596,1.010752688172043
19528,/images/2c1eaf87-3fd3-4803-92b8-23bab40bf28c.png,893,700,1011,828,118,128,red blood cell,15104,1.0847457627118644,0.921875
9991,/images/b9ccf7ca-953f-4832-9575-5e70b2a8c224.png,1025,568,1133,676,108,108,red blood cell,11664,1.0,1.0
79179,/images/1c90231b-2830-42d9-884e-7301edb16933.png,662,1331,746,1417,84,86,red blood cell,7224,1.0238095238095237,0.9767441860465116
54369,/images/19370afd-f897-47d8-bfae-c0d257bbf795.png,545,727,646,839,101,112,red blood cell,11312,1.108910891089109,0.9017857142857143
21073,/images/c680004e-6ee2-43d7-877c-edc9b5ebeecc.png,537,300,647,417,110,117,red blood cell,12870,1.0636363636363637,0.9401709401709402
31847,/images/f62d4fb6-df7c-446c-94a8-d5aede0b1e0c.png,758,112,886,216,128,104,red blood cell,13312,0.8125,1.2307692307692308
47619,/images/06cd484f-e864-4fee-8819-688b45eed98e.png,602,282,711,413,109,131,red blood cell,14279,1.201834862385321,0.8320610687022901
14095,/images/eaf4b781-b3aa-41ce-8c5e-287979b4e15a.png,394,816,494,908,100,92,red blood cell,9200,0.92,1.0869565217391304
41278,/images/2374ae5b-c2df-4db5-afea-c54180aa22e3.png,438,829,550,936,112,107,red blood cell,11984,0.9553571428571429,1.0467289719626167
13752,/images/1b369bcf-ced4-4ae2-9196-2664bd2b1738.png,102,1282,230,1401,128,119,red blood cell,15232,0.9296875,1.0756302521008403
49020,/images/df3d98b9-3dd7-4107-8d4a-ae1b7f247793.png,1063,200,1168,304,105,104,red blood cell,10920,0.9904761904761905,1.0096153846153846
50934,/images/ef8fcfa4-8466-4186-8c69-f5f4904eb489.png,826,1069,929,1183,103,114,red blood cell,11742,1.1067961165048543,0.9035087719298246
47052,/images/997eabd9-55bf-4683-83c4-4cee4673a4ef.png,186,1046,310,1164,124,118,red blood cell,14632,0.9516129032258065,1.0508474576271187
24812,/images/65054b19-5c6a-4870-99a9-eef994721d3a.png,718,1270,847,1383,129,113,red blood cell,14577,0.875968992248062,1.1415929203539823
1472,/images/0ac747cd-ff32-49bf-bc1a-3e9b7702ce9c.png,581,1116,694,1220,113,104,red blood cell,11752,0.9203539823008849,1.0865384615384615
56258,/images/6b473806-e936-4b19-98cf-a2b94cac35ff.png,43,1151,158,1269,115,118,red blood cell,13570,1.0260869565217392,0.9745762711864406
62277,/images/e0ff3476-226f-4125-b182-8e524d5503dd.png,297,1136,405,1254,108,118,red blood cell,12744,1.0925925925925926,0.9152542372881356
22858,/images/95d5e689-c1d1-4ae8-a659-cc20c62a99f0.png,607,336,721,445,114,109,red blood cell,12426,0.956140350877193,1.0458715596330275
4952,/images/755e5bf8-e8e1-492b-a32f-f7d87cccaa40.png,651,1258,761,1366,110,108,red blood cell,11880,0.9818181818181818,1.0185185185185186
17805,/images/1863da5f-c595-4541-a8f4-21fe78678168.png,212,122,303,210,91,88,red blood cell,8008,0.967032967032967,1.0340909090909092
50875,/images/0906111b-bac7-4541-a6dc-da435c0724a8.png,1101,623,1196,726,95,103,red blood cell,9785,1.0842105263157895,0.9223300970873787
22854,/images/95d5e689-c1d1-4ae8-a659-cc20c62a99f0.png,1057,1402,1163,1529,106,127,red blood cell,13462,1.1981132075471699,0.8346456692913385
69936,/images/9edba799-e169-46cd-b100-c9f8fc7a8c7d.png,510,949,619,1047,109,98,red blood cell,10682,0.8990825688073395,1.1122448979591837
75491,/images/6c20abb2-c4bb-4de0-8774-03f4d30ce93d.png,715,1009,850,1135,135,126,red blood cell,17010,0.9333333333333333,1.0714285714285714
27206,/images/bca27923-b270-45df-a0bf-3e1a7d135b2c.png,1055,726,1172,834,117,108,red blood cell,12636,0.9230769230769231,1.0833333333333333
12065,/images/b234b6ea-b54d-470c-8461-ba7f4a024796.png,254,904,379,1010,125,106,red blood cell,13250,0.848,1.179245283018868
26897,/images/71bbdc58-11af-41f2-9a93-3fe9257c5cf3.png,962,1461,1068,1562,106,101,red blood cell,10706,0.9528301886792453,1.0495049504950495
40175,/images/ef1a9020-5e45-450d-a237-165114308592.png,861,41,975,161,114,120,red blood cell,13680,1.0526315789473684,0.95
45658,/images/584d62ed-4329-45dd-94ce-e929d8b2bb74.png,654,439,750,544,96,105,red blood cell,10080,1.09375,0.9142857142857143
43819,/images/c84edeb4-311c-4e82-88f9-ae0505b3ad13.png,250,276,360,376,110,100,red blood cell,11000,0.9090909090909091,1.1
61939,/images/c66a3e52-0f3f-4c81-bab9-0303499549f7.png,354,1304,450,1413,96,109,red blood cell,10464,1.1354166666666667,0.8807339449541285
49744,/images/5e17f8e6-fd8d-426c-b444-1515d14f04b7.png,982,1000,1083,1096,101,96,red blood cell,9696,0.9504950495049505,1.0520833333333333
75426,/images/468c261d-f5d8-423f-883e-48af2bbbc5d1.png,133,1274,238,1398,105,124,red blood cell,13020,1.180952380952381,0.8467741935483871
38550,/images/c3ae7090-fc68-41b4-85a1-8d9bce9825a7.png,751,514,880,647,129,133,red blood cell,17157,1.0310077519379846,0.9699248120300752
37691,/images/003a89b0-a095-417a-8dd6-f408339bbc68.png,137,715,258,844,121,129,red blood cell,15609,1.0661157024793388,0.937984496124031
78448,/images/72029aca-f0bc-477f-b790-f345f86228ce.png,652,240,756,338,104,98,red blood cell,10192,0.9423076923076923,1.0612244897959184
47467,/images/f7231477-f2c1-439a-9c8b-204de07686a4.png,115,719,234,851,119,132,red blood cell,15708,1.1092436974789917,0.9015151515151515
67173,/images/be6fe358-dee1-4dcf-9b0d-5d8612aba577.png,97,390,207,491,110,101,red blood cell,11110,0.9181818181818182,1.0891089108910892
65992,/images/25c6cfb1-01d0-4864-87f9-02b7593683c7.png,52,1097,149,1195,97,98,red blood cell,9506,1.0103092783505154,0.9897959183673469
21539,/images/7625dfc4-858a-4c8e-907c-8943d665e9a7.png,560,1221,670,1324,110,103,red blood cell,11330,0.9363636363636364,1.0679611650485437
23125,/images/c94a5851-b846-4fde-8c89-05bec3a8ac53.png,990,1392,1109,1507,119,115,red blood cell,13685,0.9663865546218487,1.0347826086956522
29284,/images/6274fe0d-0d71-40be-b61b-f0bd5b5df1e2.png,1081,556,1170,635,89,79,red blood cell,7031,0.8876404494382022,1.1265822784810127
47871,/images/ab27173b-6e30-4957-bd68-29194328fd39.png,577,1361,673,1472,96,111,red blood cell,10656,1.15625,0.8648648648648649
70364,/images/4876c9d0-b386-48fb-84e8-91bf87529161.png,312,821,416,915,104,94,red blood cell,9776,0.9038461538461539,1.1063829787234043
26346,/images/580210c2-a8ed-4720-b71c-a77945968abc.png,117,1207,248,1334,131,127,red blood cell,16637,0.9694656488549618,1.031496062992126
42565,/images/184b376b-03cb-4c2d-af51-fc1a62196293.png,173,609,270,710,97,101,red blood cell,9797,1.041237113402062,0.9603960396039604
48085,/images/05717db9-f1ef-4101-a9f7-7a007e83b1c9.png,61,614,175,732,114,118,red blood cell,13452,1.0350877192982457,0.9661016949152542
6598,/images/640c4a52-3742-4f57-aee3-9e3dc0887622.png,455,57,540,148,85,91,red blood cell,7735,1.0705882352941176,0.9340659340659341
24627,/images/c03d9b87-e19b-402b-ad86-b30d6e8aeb59.png,338,1491,449,1600,111,109,red blood cell,12099,0.9819819819819819,1.018348623853211
73848,/images/3eba916c-998b-40a7-993c-7ed916c2a04c.png,567,614,678,709,111,95,red blood cell,10545,0.8558558558558559,1.168421052631579
42367,/images/1a27ebe9-93a1-4898-af69-f276057d4012.png,856,1036,983,1162,127,126,red blood cell,16002,0.9921259842519685,1.007936507936508
6848,/images/b21f6c6e-4b45-407a-b4c7-034a115f3ee4.png,680,228,802,344,122,116,red blood cell,14152,0.9508196721311475,1.0517241379310345
76525,/images/38c69905-8a4f-451a-8d0a-b855dc88dd16.png,990,754,1100,865,110,111,red blood cell,12210,1.009090909090909,0.990990990990991
1229,/images/5ff7c0c8-d208-4e7d-958d-ca3c2260ff39.png,612,85,754,205,142,120,red blood cell,17040,0.8450704225352113,1.1833333333333333
59215,/images/4736f545-1f1f-4d77-9241-d69cbf4dae35.png,258,671,340,757,82,86,red blood cell,7052,1.048780487804878,0.9534883720930233
66623,/images/b88fe674-fb9a-41d4-b100-cb1c86440d44.png,131,502,234,593,103,91,red blood cell,9373,0.883495145631068,1.1318681318681318
5317,/images/06df7bbe-60d4-4f7c-ba4a-5a42ac4be91b.png,470,1280,579,1401,109,121,red blood cell,13189,1.110091743119266,0.9008264462809917
55916,/images/afd39466-aafa-4d81-9520-483727418723.png,402,672,495,773,93,101,red blood cell,9393,1.086021505376344,0.9207920792079208
9362,/images/261562a8-ffd8-4e0e-919b-22e267000b74.png,992,1186,1084,1278,92,92,red blood cell,8464,1.0,1.0
30598,/images/f939782b-f5a2-40a3-9c22-6c6d7e18edc3.png,1054,1102,1151,1207,97,105,red blood cell,10185,1.0824742268041236,0.9238095238095239
30259,/images/cecbf663-0751-4e7f-b298-770c88afc2c1.png,984,876,1076,969,92,93,red blood cell,8556,1.0108695652173914,0.989247311827957
19099,/images/6e39fb0a-aa41-4b16-b783-7589e97bf289.png,576,1025,696,1139,120,114,red blood cell,13680,0.95,1.0526315789473684
34756,/images/6294153c-6db3-4f2b-a8ff-9c087225e737.png,485,65,602,179,117,114,red blood cell,13338,0.9743589743589743,1.0263157894736843
32689,/images/0154dd8e-72f8-4d78-a4dd-93e139577bd1.png,353,587,450,685,97,98,red blood cell,9506,1.0103092783505154,0.9897959183673469
54227,/images/3b5a8060-dec6-4a83-b7f2-b604e4e69dfc.png,5,226,114,340,109,114,red blood cell,12426,1.0458715596330275,0.956140350877193
42889,/images/a7b6894d-eeea-4ed5-bc0e-785d6c6da8df.png,93,293,201,403,108,110,red blood cell,11880,1.0185185185185186,0.9818181818181818
74368,/images/06a3effb-996c-4767-afd2-6aa3b697cb4e.png,270,375,384,486,114,111,red blood cell,12654,0.9736842105263158,1.027027027027027
1513,/images/0ac747cd-ff32-49bf-bc1a-3e9b7702ce9c.png,29,808,130,906,101,98,red blood cell,9898,0.9702970297029703,1.030612244897959
8416,/images/ae779806-6d01-4dc6-89df-294c368db6bc.png,284,648,405,767,121,119,red blood cell,14399,0.9834710743801653,1.0168067226890756
12898,/images/b10ea12f-cd36-4f2c-994a-67d1665269ab.png,366,320,459,432,93,112,red blood cell,10416,1.2043010752688172,0.8303571428571429
20023,/images/ebfd9f67-138e-49f0-9cef-a0352069eedb.png,357,1431,456,1540,99,109,red blood cell,10791,1.101010101010101,0.908256880733945
60355,/images/1c87b997-a8e6-48ca-bf40-19b9a7fd6a96.png,187,1431,287,1545,100,114,red blood cell,11400,1.14,0.8771929824561403
54043,/images/d9345456-b76d-46cc-b81e-46d4a0a7b652.png,1010,468,1101,568,91,100,red blood cell,9100,1.098901098901099,0.91
36707,/images/21f001d6-f568-4ea4-82da-fab54c77c419.png,453,48,549,130,96,82,red blood cell,7872,0.8541666666666666,1.170731707317073
34218,/images/4767bfcc-fe87-4962-8c40-6ce8d9363cdf.png,986,78,1110,202,124,124,red blood cell,15376,1.0,1.0
48154,/images/913099c5-8085-4908-bf4b-1f098bbfcf66.png,680,219,791,333,111,114,red blood cell,12654,1.027027027027027,0.9736842105263158
68296,/images/a6391703-0820-4913-a7cd-e843ff0d84ba.png,456,1491,544,1593,88,102,red blood cell,8976,1.1590909090909092,0.8627450980392157
33979,/images/701206c5-aaac-4b99-9cc0-4a6854359457.png,311,1011,439,1143,128,132,red blood cell,16896,1.03125,0.9696969696969697
42398,/images/1a27ebe9-93a1-4898-af69-f276057d4012.png,456,299,565,387,109,88,red blood cell,9592,0.8073394495412844,1.2386363636363635
79675,/images/a4409217-be11-4478-90a5-b406057d154d.png,3,1477,115,1588,112,111,red blood cell,12432,0.9910714285714286,1.009009009009009
18844,/images/d1b48634-9ad5-46e8-b816-42d1d97c93cd.png,751,413,872,535,121,122,red blood cell,14762,1.0082644628099173,0.9918032786885246
65758,/images/daea4860-a296-4f6d-acef-996ab0882676.png,814,632,923,738,109,106,red blood cell,11554,0.9724770642201835,1.028301886792453
25487,/images/f6ab936d-924b-4038-aa47-71b07c26b4e2.png,467,1466,553,1564,86,98,red blood cell,8428,1.1395348837209303,0.8775510204081632
16241,/images/acdc6e12-73d9-44ba-be8c-2a56aaffef4f.png,297,1337,412,1459,115,122,red blood cell,14030,1.0608695652173914,0.9426229508196722
55675,/images/c32b8bb8-c89d-4ae9-9c77-5b9356ca35a1.png,446,288,556,393,110,105,red blood cell,11550,0.9545454545454546,1.0476190476190477
52090,/images/de6d3020-9347-473b-9146-8909627790f6.png,460,1033,557,1136,97,103,red blood cell,9991,1.0618556701030928,0.941747572815534
62677,/images/f7a4334a-4332-4de8-b39b-22da907976f2.png,700,2,795,84,95,82,red blood cell,7790,0.8631578947368421,1.1585365853658536
28692,/images/151f3af5-5e6e-4bcd-9389-4974fc68813e.png,948,454,1052,558,104,104,red blood cell,10816,1.0,1.0
4431,/images/21ea4841-8998-4c04-b345-bc99cd8ecee6.png,1029,1477,1146,1589,117,112,red blood cell,13104,0.9572649572649573,1.0446428571428572
20257,/images/c66cb6b2-1480-446a-a9d2-b8032a3de0d7.png,135,769,259,874,124,105,red blood cell,13020,0.8467741935483871,1.180952380952381
6304,/images/c6575e75-c8ce-4766-841f-1137b9e0956c.png,594,1390,709,1502,115,112,red blood cell,12880,0.9739130434782609,1.0267857142857142
20968,/images/d4fef0c5-6597-48b6-97e9-32ed504488e6.png,249,501,382,662,133,161,red blood cell,21413,1.2105263157894737,0.8260869565217391
41970,/images/46a03374-64c7-49ac-81c9-c3d62542bbf3.png,548,273,651,368,103,95,red blood cell,9785,0.9223300970873787,1.0842105263157895
21067,/images/c680004e-6ee2-43d7-877c-edc9b5ebeecc.png,955,1216,1096,1340,141,124,red blood cell,17484,0.8794326241134752,1.1370967741935485
70007,/images/3e36698f-8c09-4c8b-8948-737310bf97e5.png,859,810,950,918,91,108,red blood cell,9828,1.1868131868131868,0.8425925925925926
42642,/images/3abbc4d3-1d7e-40c9-9963-33732da7cc50.png,590,1220,688,1327,98,107,red blood cell,10486,1.0918367346938775,0.9158878504672897
73339,/images/c890ee00-daa5-4b20-9cd5-930748ecc4e0.png,993,247,1115,375,122,128,red blood cell,15616,1.0491803278688525,0.953125
18075,/images/947348fe-4c70-468e-8009-3c14daeca69b.png,313,957,419,1074,106,117,red blood cell,12402,1.1037735849056605,0.905982905982906
63456,/images/b9d65ef3-1adc-4479-abee-2e422f5a613a.png,789,790,885,890,96,100,red blood cell,9600,1.0416666666666667,0.96
50563,/images/e98ea067-82b5-4a0d-87bf-b4bbdc10ddab.png,597,390,727,528,130,138,red blood cell,17940,1.0615384615384615,0.9420289855072463
31692,/images/bd432159-5956-457c-bdeb-1b5e702ba513.png,147,798,261,903,114,105,red blood cell,11970,0.9210526315789473,1.0857142857142856
3800,/images/3e764461-22ee-44d3-925d-cd658ff7d154.png,808,952,933,1074,125,122,red blood cell,15250,0.976,1.0245901639344261
79265,/images/05ac7b2a-6a77-4464-926b-8570f7c01693.png,171,228,275,340,104,112,red blood cell,11648,1.0769230769230769,0.9285714285714286
45219,/images/b7a0d235-2217-43b4-aeff-cde4ccaf6789.png,399,1374,509,1501,110,127,red blood cell,13970,1.1545454545454545,0.8661417322834646
60524,/images/f5c395f1-f94c-440d-8221-cc656e52c0b1.png,581,1106,686,1210,105,104,red blood cell,10920,0.9904761904761905,1.0096153846153846
63422,/images/289ef1b7-02d5-42e9-a401-687688181306.png,828,240,909,321,81,81,red blood cell,6561,1.0,1.0
72626,/images/a63ce82f-f3d1-4818-9035-d3d230e5f686.png,155,1021,260,1126,105,105,red blood cell,11025,1.0,1.0
13732,/images/1b369bcf-ced4-4ae2-9196-2664bd2b1738.png,521,617,643,744,122,127,red blood cell,15494,1.040983606557377,0.9606299212598425
37789,/images/fe0c5e48-f65e-488c-9c3c-1ea7c7835c0c.png,163,1079,262,1187,99,108,red blood cell,10692,1.0909090909090908,0.9166666666666666
40599,/images/29861cf9-9a1e-4733-8309-4bd10706b4a3.png,980,484,1097,614,117,130,red blood cell,15210,1.1111111111111112,0.9
69379,/images/2ac343e4-c889-47c1-8fe2-461b626def76.png,769,30,872,135,103,105,red blood cell,10815,1.0194174757281553,0.9809523809523809
77647,/images/07d15855-eb9b-46a9-b894-7cfe4d097826.png,22,135,115,234,93,99,red blood cell,9207,1.064516129032258,0.9393939393939394
41980,/images/46a03374-64c7-49ac-81c9-c3d62542bbf3.png,885,49,978,139,93,90,red blood cell,8370,0.967741935483871,1.0333333333333334
10076,/images/26799d2b-a289-4eff-9218-0aad77e05e41.png,66,1382,192,1505,126,123,red blood cell,15498,0.9761904761904762,1.024390243902439
2562,/images/a23f5539-bfe6-4885-9a0e-dba972475ea9.png,633,155,720,239,87,84,red blood cell,7308,0.9655172413793104,1.0357142857142858
60100,/images/ec60ab26-3343-4c5f-9667-cdae999c7d86.png,126,1167,227,1266,101,99,red blood cell,9999,0.9801980198019802,1.02020202020202
57651,/images/5c037ffc-f515-48b3-b231-c110fbd2b8ca.png,741,1051,869,1166,128,115,red blood cell,14720,0.8984375,1.1130434782608696
49924,/images/05804cf0-f854-4099-97c2-df287f7c8a8c.png,177,543,275,655,98,112,red blood cell,10976,1.1428571428571428,0.875
19892,/images/b318889c-3c60-477c-b8f6-d18cb01a59df.png,594,1301,693,1401,99,100,red blood cell,9900,1.0101010101010102,0.99
43795,/images/ef83ed4c-2724-4d5f-8abe-1a18d25cea35.png,360,1360,464,1484,104,124,red blood cell,12896,1.1923076923076923,0.8387096774193549
21709,/images/81af1442-d835-46bf-b80b-a898dba3da1b.png,37,585,167,722,130,137,red blood cell,17810,1.0538461538461539,0.948905109489051
1799,/images/5f783f43-0090-4f8a-bd75-9562f4aa2dd5.png,1052,1042,1152,1134,100,92,red blood cell,9200,0.92,1.0869565217391304
6404,/images/1ecb0405-a6e9-4485-819e-2fbbf2b718aa.png,173,913,277,1023,104,110,red blood cell,11440,1.0576923076923077,0.9454545454545454
57520,/images/00d04a90-80e5-4bce-9511-1b64eabb7a47.png,789,527,884,634,95,107,red blood cell,10165,1.1263157894736842,0.8878504672897196
7292,/images/89f10192-d3dd-4996-a571-4c851dbdc983.png,875,1401,976,1510,101,109,red blood cell,11009,1.0792079207920793,0.926605504587156
13090,/images/9691c57a-ccf8-47f9-a8e9-9a324974585b.png,256,395,372,512,116,117,red blood cell,13572,1.0086206896551724,0.9914529914529915
53197,/images/d8f7e159-b7e3-49e4-86e8-aed8c5fbcd97.png,988,676,1095,793,107,117,red blood cell,12519,1.0934579439252337,0.9145299145299145
2425,/images/fe851c88-692d-4199-87e0-d19d9c4eb591.png,869,588,967,676,98,88,red blood cell,8624,0.8979591836734694,1.1136363636363635
15509,/images/79f63258-24ce-4e69-a5cb-8529635a89a9.png,348,149,461,248,113,99,red blood cell,11187,0.8761061946902655,1.1414141414141414
66823,/images/9106a6bb-1352-411f-ac26-0d6fe48c16a8.png,180,1402,279,1501,99,99,red blood cell,9801,1.0,1.0
34828,/images/4fc9a597-aaa8-43b0-ad1c-2eabbe442e84.png,830,175,947,287,117,112,red blood cell,13104,0.9572649572649573,1.0446428571428572
16396,/images/e474a20b-2769-48f1-a520-4f6ef5a0dbf5.png,425,823,531,924,106,101,red blood cell,10706,0.9528301886792453,1.0495049504950495
413,/images/84c88143-940d-4b62-bbd2-7acc4cadcb6b.png,15,357,141,460,126,103,red blood cell,12978,0.8174603174603174,1.2233009708737863
50336,/images/3d32a988-449d-4d58-b71f-abbfdc3f2fbc.png,10,663,127,780,117,117,red blood cell,13689,1.0,1.0
22519,/images/bfe65b11-8aff-46aa-908b-1e989d25fdc4.png,904,296,1017,404,113,108,red blood cell,12204,0.9557522123893806,1.0462962962962963
42795,/images/7029feb3-9ffe-46e4-9883-6a9df84f7b62.png,106,1281,203,1390,97,109,red blood cell,10573,1.1237113402061856,0.8899082568807339
5028,/images/b7d0ae11-a393-4aec-8f68-6ba07147f78a.png,521,1470,634,1599,113,129,red blood cell,14577,1.1415929203539823,0.875968992248062
48903,/images/5dec0204-af81-44ef-a942-8a173669c123.png,139,654,235,755,96,101,red blood cell,9696,1.0520833333333333,0.9504950495049505
47242,/images/58ced55c-bf0d-4204-b6b2-4f8992d92779.png,978,230,1087,333,109,103,red blood cell,11227,0.944954128440367,1.058252427184466
53234,/images/d8f7e159-b7e3-49e4-86e8-aed8c5fbcd97.png,1001,224,1092,323,91,99,red blood cell,9009,1.0879120879120878,0.9191919191919192
58432,/images/7eae1169-e294-4594-8e03-1366d23ff2d1.png,895,245,997,344,102,99,red blood cell,10098,0.9705882352941176,1.0303030303030303
9105,/images/21c2a8aa-407c-4569-8212-96fcafa84138.png,101,238,224,350,123,112,red blood cell,13776,0.9105691056910569,1.0982142857142858
15241,/images/dd7142e4-2d86-4170-a41f-e825743e8907.png,1050,749,1176,868,126,119,red blood cell,14994,0.9444444444444444,1.0588235294117647
10650,/images/20d4f65e-6c63-433a-935c-d568d577967b.png,76,1383,169,1487,93,104,red blood cell,9672,1.118279569892473,0.8942307692307693
63942,/images/5e974892-0ebe-4037-8427-ea8616d6d3b8.png,701,666,802,767,101,101,red blood cell,10201,1.0,1.0
26828,/images/2518f6e4-29cc-4ae4-a914-b215a4c56099.png,0,158,100,256,100,98,red blood cell,9800,0.98,1.0204081632653061
3297,/images/b901c906-91be-48c4-88ec-2c527544a258.png,915,559,1024,670,109,111,red blood cell,12099,1.018348623853211,0.9819819819819819
34592,/images/a0eedcb9-b85c-4612-b945-7e8227f53c35.png,39,1421,158,1537,119,116,red blood cell,13804,0.9747899159663865,1.0258620689655173
50773,/images/db0a1123-0b35-48d7-8337-3b1ebd6af0cc.png,1082,448,1199,583,117,135,red blood cell,15795,1.1538461538461537,0.8666666666666667
33025,/images/6231d81d-9e84-4a5a-8cb8-47c6a37a0176.png,316,1437,412,1556,96,119,red blood cell,11424,1.2395833333333333,0.8067226890756303
50720,/images/6b4c79f5-b194-4586-be9f-e339c5af4188.png,477,1411,588,1540,111,129,red blood cell,14319,1.162162162162162,0.8604651162790697
55273,/images/8ad7ba46-5db8-4ba9-b3e0-3cac52f7efc3.png,496,1254,614,1364,118,110,red blood cell,12980,0.9322033898305084,1.0727272727272728
57112,/images/7d041c38-11f2-4186-8a24-29d7d0f5c3cf.png,922,1124,1015,1220,93,96,red blood cell,8928,1.032258064516129,0.96875
79676,/images/a4409217-be11-4478-90a5-b406057d154d.png,473,1414,591,1532,118,118,red blood cell,13924,1.0,1.0
64692,/images/6dfafdf1-f588-4e80-8cf8-0126e1bf7af9.png,1017,617,1097,706,80,89,red blood cell,7120,1.1125,0.898876404494382
61160,/images/80da32ce-8c22-470e-9f35-558c5f7a5df9.png,273,786,366,890,93,104,red blood cell,9672,1.118279569892473,0.8942307692307693
72948,/images/a20d0b4b-6e2e-4507-bc22-f321dedc4ed9.png,58,43,150,140,92,97,red blood cell,8924,1.0543478260869565,0.9484536082474226
76763,/images/2165fe38-b474-467d-be11-d1d728085efd.png,234,46,345,152,111,106,red blood cell,11766,0.954954954954955,1.0471698113207548
66380,/images/e5fd5949-4cd0-4cb6-837a-02c26a5eb87a.png,1007,944,1128,1082,121,138,red blood cell,16698,1.140495867768595,0.8768115942028986
17110,/images/dc3bdfe9-1565-4cda-9c4e-0979846dab60.png,171,1309,271,1409,100,100,red blood cell,10000,1.0,1.0
41139,/images/2240b991-48f6-4c59-9b62-5a8b5e541fae.png,167,1192,264,1297,97,105,red blood cell,10185,1.0824742268041236,0.9238095238095239
17400,/images/6f4ffe7b-395f-41ea-ad61-df5e0cbd531c.png,436,1122,562,1241,126,119,red blood cell,14994,0.9444444444444444,1.0588235294117647
18040,/images/0f0c949e-018a-4f3f-ab02-3704f49c7754.png,674,256,783,367,109,111,red blood cell,12099,1.018348623853211,0.9819819819819819
9981,/images/b9ccf7ca-953f-4832-9575-5e70b2a8c224.png,728,184,832,302,104,118,red blood cell,12272,1.1346153846153846,0.8813559322033898
42060,/images/46a03374-64c7-49ac-81c9-c3d62542bbf3.png,592,249,684,345,92,96,red blood cell,8832,1.0434782608695652,0.9583333333333334
33845,/images/b9de8b1a-f96a-4eb5-bc05-84ad43a054f3.png,270,1074,387,1203,117,129,red blood cell,15093,1.1025641025641026,0.9069767441860465
64820,/images/a74b6d6a-7e04-40ac-9292-d62f13f7ded3.png,32,510,132,597,100,87,red blood cell,8700,0.87,1.1494252873563218
76641,/images/4184a235-d209-4151-86e9-6c77e7938dab.png,781,1492,888,1599,107,107,red blood cell,11449,1.0,1.0
33376,/images/f632981c-1330-4078-8a12-691beb2dab02.png,761,403,848,485,87,82,red blood cell,7134,0.9425287356321839,1.0609756097560976
31114,/images/9c48fdf4-621d-4f40-bcd7-6a28cd530de7.png,23,1172,115,1275,92,103,red blood cell,9476,1.1195652173913044,0.8932038834951457
30151,/images/a1669b59-fe09-4fe6-ba9f-06bec6725502.png,260,270,371,396,111,126,red blood cell,13986,1.135135135135135,0.8809523809523809
76625,/images/4184a235-d209-4151-86e9-6c77e7938dab.png,713,1102,799,1184,86,82,red blood cell,7052,0.9534883720930233,1.048780487804878
72526,/images/01b99da8-b66b-464b-a7ee-1cadab8db18b.png,28,1370,159,1494,131,124,red blood cell,16244,0.9465648854961832,1.0564516129032258
25794,/images/14b68d86-ac7f-419d-b4a5-6b0b1d9aaa18.png,957,1309,1093,1443,136,134,red blood cell,18224,0.9852941176470589,1.0149253731343284
50943,/images/ef8fcfa4-8466-4186-8c69-f5f4904eb489.png,455,235,559,344,104,109,red blood cell,11336,1.0480769230769231,0.9541284403669725
75591,/images/c35ee701-fde2-46b5-b178-1fe3f1ea7da2.png,342,934,449,1047,107,113,red blood cell,12091,1.0560747663551402,0.9469026548672567
35202,/images/a9159b11-ba49-4885-902e-00c8d5095b98.png,823,158,933,269,110,111,red blood cell,12210,1.009090909090909,0.990990990990991
17893,/images/eb77e4a9-acb0-4d83-8055-2c5fcaa54b45.png,901,1486,991,1591,90,105,red blood cell,9450,1.1666666666666667,0.8571428571428571
67457,/images/8e72e20e-e714-4db6-a1da-c05a409257d4.png,734,1489,825,1591,91,102,red blood cell,9282,1.120879120879121,0.8921568627450981
48160,/images/913099c5-8085-4908-bf4b-1f098bbfcf66.png,1086,126,1196,243,110,117,red blood cell,12870,1.0636363636363637,0.9401709401709402
44306,/images/4257342d-6d77-4671-a84b-1f0c36ccb367.png,630,1288,767,1421,137,133,red blood cell,18221,0.9708029197080292,1.0300751879699248
10548,/images/9fbf38ab-44b9-4096-a818-603017a4300e.png,1019,131,1160,253,141,122,red blood cell,17202,0.8652482269503546,1.1557377049180328
3442,/images/ad36bd67-594b-4f63-93e3-886af0bc618e.png,473,1175,582,1275,109,100,red blood cell,10900,0.9174311926605505,1.09
42369,/images/1a27ebe9-93a1-4898-af69-f276057d4012.png,480,985,603,1100,123,115,red blood cell,14145,0.9349593495934959,1.0695652173913044
66361,/images/e5fd5949-4cd0-4cb6-837a-02c26a5eb87a.png,362,799,481,918,119,119,red blood cell,14161,1.0,1.0
61592,/images/4a717a39-80f8-4b75-a25e-c46d65d7dcd5.png,0,549,113,663,113,114,red blood cell,12882,1.008849557522124,0.9912280701754386
44149,/images/8b494b40-cab5-49d3-893d-c805000fbe88.png,220,494,322,603,102,109,red blood cell,11118,1.0686274509803921,0.9357798165137615
21871,/images/9b3fd401-dab0-440f-8498-eb3cc9ffa970.png,900,64,995,171,95,107,red blood cell,10165,1.1263157894736842,0.8878504672897196
51274,/images/216f9d43-6869-4ba1-9106-4f5ea6aac223.png,766,822,861,923,95,101,red blood cell,9595,1.063157894736842,0.9405940594059405
47359,/images/477e541c-0519-4542-9b13-8ee7922644d3.png,1016,1475,1114,1578,98,103,red blood cell,10094,1.0510204081632653,0.9514563106796117
6737,/images/672e4ecf-a56b-462e-b83b-76f4efaa6634.png,367,1059,492,1178,125,119,red blood cell,14875,0.952,1.050420168067227
51519,/images/6afb3717-f197-4668-929a-4fab389ae6e8.png,101,1102,207,1205,106,103,red blood cell,10918,0.9716981132075472,1.029126213592233
27678,/images/18dbe7c4-89d2-42a6-a969-1e951ab313b1.png,289,1412,392,1517,103,105,red blood cell,10815,1.0194174757281553,0.9809523809523809
37957,/images/56a57a8d-c9b9-432a-a3b0-32a09355806c.png,996,1033,1092,1134,96,101,red blood cell,9696,1.0520833333333333,0.9504950495049505
13736,/images/1b369bcf-ced4-4ae2-9196-2664bd2b1738.png,1013,520,1134,647,121,127,red blood cell,15367,1.0495867768595042,0.952755905511811
74275,/images/8939e14b-fcdf-48b1-acb9-6514a2fc2fc0.png,916,1134,1016,1229,100,95,red blood cell,9500,0.95,1.0526315789473684
47721,/images/afbb264e-ff60-443a-83f5-49d09be1b835.png,1079,1087,1195,1208,116,121,red blood cell,14036,1.043103448275862,0.9586776859504132
40063,/images/6fd30823-3b77-40c9-ba5d-e1eda9660674.png,262,819,379,925,117,106,red blood cell,12402,0.905982905982906,1.1037735849056605
11483,/images/2f9f400d-2d67-4118-aaa1-9094bc4b0e47.png,194,819,316,949,122,130,red blood cell,15860,1.0655737704918034,0.9384615384615385
43308,/images/36569710-a574-40be-ad42-897a6e74a128.png,640,542,717,636,77,94,red blood cell,7238,1.2207792207792207,0.8191489361702128
39229,/images/2aeb7b85-7df9-4a63-8d37-2eecaaa190e7.png,732,791,847,901,115,110,red blood cell,12650,0.9565217391304348,1.0454545454545454
57625,/images/d32022fa-e492-4b31-a776-9435cfdef6d6.png,1061,271,1171,368,110,97,red blood cell,10670,0.8818181818181818,1.134020618556701
46277,/images/815bf40c-371a-4d34-aa41-c549c8221881.png,809,1185,930,1301,121,116,red blood cell,14036,0.9586776859504132,1.043103448275862
77944,/images/c691c8ef-d3c7-47b6-a941-f6a1089f21a9.png,587,516,689,625,102,109,red blood cell,11118,1.0686274509803921,0.9357798165137615
64127,/images/0d3c2521-da55-4df5-bf06-56b3bd4fb2fc.png,774,183,855,266,81,83,red blood cell,6723,1.0246913580246915,0.9759036144578314
68112,/images/5dec94a3-e3ca-4a58-9702-88e5a83ef612.png,816,332,917,436,101,104,red blood cell,10504,1.0297029702970297,0.9711538461538461
1810,/images/5f783f43-0090-4f8a-bd75-9562f4aa2dd5.png,562,1049,677,1145,115,96,red blood cell,11040,0.8347826086956521,1.1979166666666667
63706,/images/06401963-8b02-46c5-ab2a-3d70bd01623f.png,493,1457,597,1572,104,115,red blood cell,11960,1.1057692307692308,0.9043478260869565
55305,/images/4fb83278-adc5-4424-9f45-b6d0db2955b6.png,1052,580,1167,685,115,105,red blood cell,12075,0.9130434782608695,1.0952380952380953
22639,/images/4ab47131-c2ac-461f-b95c-ac19ce24edbd.png,12,355,110,462,98,107,red blood cell,10486,1.0918367346938775,0.9158878504672897
72195,/images/005e60b6-77b8-458c-b57c-bfe0c7e7df78.png,621,841,716,941,95,100,red blood cell,9500,1.0526315789473684,0.95
60136,/images/ec60ab26-3343-4c5f-9667-cdae999c7d86.png,166,892,260,979,94,87,red blood cell,8178,0.925531914893617,1.0804597701149425
38568,/images/c3ae7090-fc68-41b4-85a1-8d9bce9825a7.png,369,1298,492,1416,123,118,red blood cell,14514,0.959349593495935,1.0423728813559323
22480,/images/dd60b6a7-c545-45b9-8250-d1633aa1ac75.png,932,168,1037,272,105,104,red blood cell,10920,0.9904761904761905,1.0096153846153846
79013,/images/6144887d-a1c1-46db-91a1-f7ff5bf8c8a5.png,680,1407,765,1507,85,100,red blood cell,8500,1.1764705882352942,0.85
20495,/images/b809b407-7b69-4334-873d-d6c49135f04a.png,717,1170,835,1282,118,112,red blood cell,13216,0.9491525423728814,1.0535714285714286
41185,/images/2240b991-48f6-4c59-9b62-5a8b5e541fae.png,575,252,682,372,107,120,red blood cell,12840,1.1214953271028036,0.8916666666666667
14272,/images/6382976c-ee87-4916-b798-4ef1373b2df0.png,72,1449,198,1576,126,127,red blood cell,16002,1.007936507936508,0.9921259842519685
77519,/images/2d2e81f3-e329-4765-9ba1-2c95f12dc9f3.png,846,673,941,765,95,92,red blood cell,8740,0.968421052631579,1.0326086956521738
16482,/images/9e5437c6-b0d3-473b-b7c3-8f5afeb90c7a.png,918,656,1039,771,121,115,red blood cell,13915,0.9504132231404959,1.0521739130434782
10205,/images/e3ea07d7-884a-412e-874a-40fd6b856736.png,330,378,452,504,122,126,red blood cell,15372,1.0327868852459017,0.9682539682539683
22748,/images/8490c623-3d88-4532-baf5-0d266a45b16f.png,403,671,515,781,112,110,red blood cell,12320,0.9821428571428571,1.018181818181818
27422,/images/9f38055f-4fe6-47fd-a6dd-c0743db4eccf.png,720,866,823,978,103,112,red blood cell,11536,1.087378640776699,0.9196428571428571
19534,/images/2c1eaf87-3fd3-4803-92b8-23bab40bf28c.png,626,1290,747,1415,121,125,red blood cell,15125,1.0330578512396693,0.968
42375,/images/1a27ebe9-93a1-4898-af69-f276057d4012.png,7,8,117,106,110,98,red blood cell,10780,0.8909090909090909,1.1224489795918366
69661,/images/f0713bee-2a71-4ced-b953-4041ea99496a.png,537,131,642,235,105,104,red blood cell,10920,0.9904761904761905,1.0096153846153846
53200,/images/d8f7e159-b7e3-49e4-86e8-aed8c5fbcd97.png,965,98,1083,210,118,112,red blood cell,13216,0.9491525423728814,1.0535714285714286
7321,/images/89f10192-d3dd-4996-a571-4c851dbdc983.png,1086,875,1177,967,91,92,red blood cell,8372,1.010989010989011,0.9891304347826086
33783,/images/cb08956d-dd6a-4e13-817b-40a0a93068f1.png,956,14,1061,119,105,105,red blood cell,11025,1.0,1.0
7261,/images/89f10192-d3dd-4996-a571-4c851dbdc983.png,7,1456,113,1545,106,89,red blood cell,9434,0.839622641509434,1.1910112359550562
16279,/images/d5009906-bce1-4353-90b4-f4c79362f4cf.png,374,680,467,771,93,91,red blood cell,8463,0.978494623655914,1.021978021978022
68772,/images/eb5f4f2f-2275-4a80-84a5-78a1eaf4ce4d.png,1072,561,1193,680,121,119,red blood cell,14399,0.9834710743801653,1.0168067226890756
66959,/images/9acf303a-fcba-4e52-be3e-8d061aa5e72a.png,938,970,1021,1060,83,90,red blood cell,7470,1.0843373493975903,0.9222222222222223
54170,/images/c415532c-4cce-4580-9fcd-623c172a1abd.png,320,1484,429,1591,109,107,red blood cell,11663,0.981651376146789,1.0186915887850467
40940,/images/550cf4ce-b641-44a3-8487-3e16d4049187.png,997,483,1104,590,107,107,red blood cell,11449,1.0,1.0
28406,/images/a6d85204-24b8-4b23-a8b1-c3e8b93f9f22.png,942,760,1049,877,107,117,red blood cell,12519,1.0934579439252337,0.9145299145299145
11587,/images/b4dc3088-3fe2-4688-be24-70664a64e022.png,719,350,840,471,121,121,red blood cell,14641,1.0,1.0
44420,/images/edd3862f-04e1-49cf-97dd-ca566d17e71a.png,682,451,811,576,129,125,red blood cell,16125,0.9689922480620154,1.032
33327,/images/5721e41b-90ef-4851-8587-8dc71227ef90.png,247,1006,359,1108,112,102,red blood cell,11424,0.9107142857142857,1.0980392156862746
33576,/images/255d5f0c-87fc-4337-bb51-07c440df4f1b.png,315,931,429,1032,114,101,red blood cell,11514,0.8859649122807017,1.1287128712871286
40803,/images/252071ac-e9f2-41d2-abbb-87ef01b8a997.png,652,1212,754,1296,102,84,red blood cell,8568,0.8235294117647058,1.2142857142857142
53092,/images/04a567df-5463-4043-81f1-d726223c19a9.png,591,601,694,711,103,110,red blood cell,11330,1.0679611650485437,0.9363636363636364
7501,/images/071901eb-4c3f-404b-a747-3d0b9d0a5158.png,212,365,319,475,107,110,red blood cell,11770,1.02803738317757,0.9727272727272728
74099,/images/9fe8bdc8-847d-434e-93e5-ae14ff3b45e1.png,872,1335,999,1445,127,110,red blood cell,13970,0.8661417322834646,1.1545454545454545
73807,/images/3eba916c-998b-40a7-993c-7ed916c2a04c.png,35,1284,138,1386,103,102,red blood cell,10506,0.9902912621359223,1.0098039215686274
480,/images/f65a1633-9935-4984-a285-a60d30aa1707.png,118,795,224,901,106,106,red blood cell,11236,1.0,1.0
20945,/images/c2ec116f-f091-422c-926c-70b548a8f6ef.png,261,1227,350,1314,89,87,red blood cell,7743,0.9775280898876404,1.0229885057471264
76224,/images/90a82250-1f68-48c9-9af9-15f18bf8c974.png,365,932,484,1028,119,96,red blood cell,11424,0.8067226890756303,1.2395833333333333
60887,/images/11b72c7b-5c52-44b7-adb7-21eacc25e441.png,972,724,1054,813,82,89,red blood cell,7298,1.0853658536585367,0.9213483146067416
39794,/images/5c68070c-3391-4db6-8c01-94175105dbea.png,191,348,297,467,106,119,red blood cell,12614,1.1226415094339623,0.8907563025210085
12918,/images/b10ea12f-cd36-4f2c-994a-67d1665269ab.png,821,1336,904,1430,83,94,red blood cell,7802,1.1325301204819278,0.8829787234042553
16626,/images/a27858ef-6533-413e-bc75-cc54690261a2.png,184,1106,322,1242,138,136,red blood cell,18768,0.9855072463768116,1.0147058823529411
12804,/images/b634137b-bc8b-4e88-b0e3-b536ad6e7e18.png,204,591,293,679,89,88,red blood cell,7832,0.9887640449438202,1.0113636363636365
52861,/images/58f7e1da-3478-48f4-958c-e9b1cb8696aa.png,698,437,820,552,122,115,red blood cell,14030,0.9426229508196722,1.0608695652173914
49311,/images/99b13257-b9d9-422f-8262-802da0bdc510.png,260,648,391,769,131,121,red blood cell,15851,0.9236641221374046,1.0826446280991735
47098,/images/820bbfea-3dae-46fc-b61a-3d0ed2ea01c2.png,48,1179,150,1288,102,109,red blood cell,11118,1.0686274509803921,0.9357798165137615
78062,/images/105af41b-13cc-4ad1-8a1f-8bc4d47cdd94.png,135,491,234,590,99,99,red blood cell,9801,1.0,1.0
36151,/images/749df49e-5212-49ea-9e88-7d66f258f1df.png,200,364,307,472,107,108,red blood cell,11556,1.0093457943925233,0.9907407407407407
12694,/images/5a043d69-f435-46d4-8691-395c1602a76a.png,505,1020,641,1132,136,112,red blood cell,15232,0.8235294117647058,1.2142857142857142
10634,/images/20d4f65e-6c63-433a-935c-d568d577967b.png,816,1024,914,1138,98,114,red blood cell,11172,1.163265306122449,0.8596491228070176
65016,/images/ff3b9d4d-373c-48ef-a75a-d23e2c2ade87.png,909,1057,1009,1162,100,105,red blood cell,10500,1.05,0.9523809523809523
70888,/images/bf002a25-6535-4621-be19-56d468be5413.png,520,794,624,900,104,106,red blood cell,11024,1.0192307692307692,0.9811320754716981
13869,/images/7d65d296-0f7b-41cc-9073-a547e24326c8.png,279,221,399,336,120,115,red blood cell,13800,0.9583333333333334,1.0434782608695652
44881,/images/83ec8923-6232-40d7-ba1f-a1b8bf7cb66c.png,544,121,654,213,110,92,red blood cell,10120,0.8363636363636363,1.1956521739130435
65697,/images/c54fcef1-0c51-4426-9a93-15ec5f2bf58a.png,1072,720,1165,813,93,93,red blood cell,8649,1.0,1.0
17950,/images/eb77e4a9-acb0-4d83-8055-2c5fcaa54b45.png,263,292,354,388,91,96,red blood cell,8736,1.054945054945055,0.9479166666666666
5495,/images/eb6e8684-b84e-483d-b835-f59286d2516b.png,188,300,297,414,109,114,red blood cell,12426,1.0458715596330275,0.956140350877193
62444,/images/7dfbfeaf-e3b1-4159-8dcd-d7f731280ac8.png,992,1331,1091,1424,99,93,red blood cell,9207,0.9393939393939394,1.064516129032258
4423,/images/21ea4841-8998-4c04-b345-bc99cd8ecee6.png,229,1344,332,1470,103,126,red blood cell,12978,1.2233009708737863,0.8174603174603174
10625,/images/20d4f65e-6c63-433a-935c-d568d577967b.png,692,761,789,843,97,82,red blood cell,7954,0.845360824742268,1.1829268292682926
3614,/images/8bd71314-e38a-4670-bb25-5cd6c9acb595.png,412,1065,512,1174,100,109,red blood cell,10900,1.09,0.9174311926605505
9594,/images/239f17eb-a2e2-47e9-82e3-fa0d9a70fb9f.png,141,814,266,937,125,123,red blood cell,15375,0.984,1.016260162601626
30716,/images/8e0dfc1f-e3eb-4a3f-a1c4-249bdfbfaa27.png,472,423,590,547,118,124,red blood cell,14632,1.0508474576271187,0.9516129032258065
13199,/images/711f6b3f-cd63-46d1-834a-bc8e9aa9b43e.png,699,689,802,791,103,102,red blood cell,10506,0.9902912621359223,1.0098039215686274
4565,/images/0f26699f-a776-4424-b092-27da9a1d12e2.png,43,354,142,450,99,96,red blood cell,9504,0.9696969696969697,1.03125
68801,/images/aa3ad405-828e-4986-8251-20fd981f34d3.png,353,737,448,836,95,99,red blood cell,9405,1.0421052631578946,0.9595959595959596
18482,/images/9b410534-3b70-4a88-9f93-205cf4e55a05.png,248,1143,345,1250,97,107,red blood cell,10379,1.1030927835051547,0.9065420560747663
16090,/images/66557580-fd38-4d4b-80d8-88611ecc78c6.png,906,100,1010,223,104,123,red blood cell,12792,1.1826923076923077,0.8455284552845529
38362,/images/674b0fd3-f247-4b7f-97f7-3e6c57c9ba9e.png,921,1364,1031,1468,110,104,red blood cell,11440,0.9454545454545454,1.0576923076923077
47686,/images/4b3a49bc-8536-4760-9553-440a6f64db37.png,50,257,139,363,89,106,red blood cell,9434,1.1910112359550562,0.839622641509434
52926,/images/abb2f9d6-26fa-4328-983c-959ef6717c05.png,1009,589,1107,688,98,99,red blood cell,9702,1.010204081632653,0.98989898989899
5235,/images/729733ff-a349-4a96-b636-ccabe7d7e167.png,832,326,931,425,99,99,red blood cell,9801,1.0,1.0
43705,/images/ef83ed4c-2724-4d5f-8abe-1a18d25cea35.png,364,1096,487,1217,123,121,red blood cell,14883,0.983739837398374,1.0165289256198347
32446,/images/3911fcd2-4e26-4ad9-aaf0-d1c5bf41defc.png,437,1054,557,1173,120,119,red blood cell,14280,0.9916666666666667,1.0084033613445378
22128,/images/ca677c3c-083f-4d54-9dec-39f79f6a17d8.png,424,1031,524,1140,100,109,red blood cell,10900,1.09,0.9174311926605505
30166,/images/a1669b59-fe09-4fe6-ba9f-06bec6725502.png,84,758,195,863,111,105,red blood cell,11655,0.9459459459459459,1.0571428571428572
35080,/images/67582df6-bf13-4c83-a531-1214692b70de.png,917,63,1041,181,124,118,red blood cell,14632,0.9516129032258065,1.0508474576271187
69770,/images/2bd15b6e-fe2d-49f3-b394-940d024d1f91.png,68,962,169,1043,101,81,red blood cell,8181,0.801980198019802,1.2469135802469136
9826,/images/3859deaf-6ae1-49a3-9051-898d0f0d7de6.png,864,692,965,795,101,103,red blood cell,10403,1.0198019801980198,0.9805825242718447
26963,/images/1f337b61-1b0d-4539-91f9-73d4a0798a4a.png,785,292,894,408,109,116,red blood cell,12644,1.0642201834862386,0.9396551724137931
17302,/images/3d302619-473d-4c5b-af43-8833ff94233f.png,1050,423,1151,528,101,105,red blood cell,10605,1.0396039603960396,0.9619047619047619
43148,/images/c5db0fc0-b96c-496e-90b4-f9fb1b85b28e.png,332,1131,428,1249,96,118,red blood cell,11328,1.2291666666666667,0.8135593220338984
43260,/images/fe1ee954-ba71-47b3-954a-d20ab940cd7b.png,512,1369,635,1488,123,119,red blood cell,14637,0.967479674796748,1.0336134453781514
68096,/images/29d40b60-cde1-45b5-b403-692437a77ac1.png,1104,455,1199,551,95,96,red blood cell,9120,1.0105263157894737,0.9895833333333334
17570,/images/e80bad38-66d0-473e-85dd-92142dba37e6.png,207,1070,296,1169,89,99,red blood cell,8811,1.1123595505617978,0.898989898989899
6097,/images/c147584d-4c61-412a-bdaf-b02b22c18708.png,261,748,370,861,109,113,red blood cell,12317,1.036697247706422,0.9646017699115044
17242,/images/471f75c6-bd5d-4c20-bcc1-258e836f4d69.png,443,888,538,991,95,103,red blood cell,9785,1.0842105263157895,0.9223300970873787
22507,/images/bfe65b11-8aff-46aa-908b-1e989d25fdc4.png,1046,390,1157,503,111,113,red blood cell,12543,1.018018018018018,0.9823008849557522
5121,/images/a777e78c-ad1f-4380-9ab2-b4f9f32b2d78.png,96,98,200,204,104,106,red blood cell,11024,1.0192307692307692,0.9811320754716981
29934,/images/f2a8a483-b254-43aa-817f-7d525adb8911.png,278,1402,384,1509,106,107,red blood cell,11342,1.009433962264151,0.9906542056074766
40652,/images/252071ac-e9f2-41d2-abbb-87ef01b8a997.png,188,1284,297,1379,109,95,red blood cell,10355,0.8715596330275229,1.1473684210526316
57658,/images/5c037ffc-f515-48b3-b231-c110fbd2b8ca.png,903,498,1005,606,102,108,red blood cell,11016,1.0588235294117647,0.9444444444444444
27203,/images/bca27923-b270-45df-a0bf-3e1a7d135b2c.png,824,813,929,919,105,106,red blood cell,11130,1.0095238095238095,0.9905660377358491
69266,/images/f274b784-b995-4a7e-a2c2-6cc31c24c4b4.png,835,690,927,793,92,103,red blood cell,9476,1.1195652173913044,0.8932038834951457
6449,/images/1ecb0405-a6e9-4485-819e-2fbbf2b718aa.png,746,766,849,868,103,102,red blood cell,10506,0.9902912621359223,1.0098039215686274
42051,/images/46a03374-64c7-49ac-81c9-c3d62542bbf3.png,418,683,517,780,99,97,red blood cell,9603,0.9797979797979798,1.0206185567010309
77843,/images/6bc7b53c-5a98-48ef-a9de-59a476707ea4.png,108,983,212,1077,104,94,red blood cell,9776,0.9038461538461539,1.1063829787234043
53078,/images/04a567df-5463-4043-81f1-d726223c19a9.png,867,486,972,577,105,91,red blood cell,9555,0.8666666666666667,1.1538461538461537
50418,/images/a2de1248-7bc0-44dc-b508-70a357eedd68.png,218,528,328,628,110,100,red blood cell,11000,0.9090909090909091,1.1
75845,/images/c4c7ed75-dbdf-4bb6-b6ba-718903cf7264.png,191,441,328,584,137,143,red blood cell,19591,1.0437956204379562,0.958041958041958
20063,/images/ebfd9f67-138e-49f0-9cef-a0352069eedb.png,486,212,588,302,102,90,red blood cell,9180,0.8823529411764706,1.1333333333333333
36583,/images/21f001d6-f568-4ea4-82da-fab54c77c419.png,151,1303,267,1399,116,96,red blood cell,11136,0.8275862068965517,1.2083333333333333
34489,/images/fa1f9f89-cecb-4972-842c-d14c632f89a9.png,654,767,786,901,132,134,red blood cell,17688,1.0151515151515151,0.9850746268656716
13436,/images/370277f8-436b-4103-8210-b4feb5ab95ea.png,281,728,369,827,88,99,red blood cell,8712,1.125,0.8888888888888888
70044,/images/b8339d7b-85ec-48d0-83e8-c8f831070459.png,843,881,962,995,119,114,red blood cell,13566,0.957983193277311,1.043859649122807
7570,/images/071901eb-4c3f-404b-a747-3d0b9d0a5158.png,638,1181,744,1286,106,105,red blood cell,11130,0.9905660377358491,1.0095238095238095
24965,/images/ed0bee2f-05e0-4392-8357-19750cec577c.png,969,208,1054,310,85,102,red blood cell,8670,1.2,0.8333333333333334
30884,/images/fbc1f360-4382-48bb-a32e-3f5f2f9dbe57.png,848,1313,986,1435,138,122,red blood cell,16836,0.8840579710144928,1.1311475409836065
9895,/images/b4261fa5-876d-48ea-b6da-ec7ca5b48fe2.png,969,1024,1093,1139,124,115,red blood cell,14260,0.9274193548387096,1.0782608695652174
21975,/images/393df10a-5d64-476b-88f5-14ac56d6ed60.png,222,587,331,711,109,124,red blood cell,13516,1.1376146788990826,0.8790322580645161
4843,/images/c6ab535c-30e5-4b6b-8273-1ec8d78cdd13.png,94,1175,201,1279,107,104,red blood cell,11128,0.9719626168224299,1.0288461538461537
11012,/images/c442e2d6-aaf9-417a-9905-4737a1115f33.png,439,1260,539,1358,100,98,red blood cell,9800,0.98,1.0204081632653061
64570,/images/6ba5d0b8-cdc7-4266-9d78-db76faa312e9.png,1065,616,1149,696,84,80,red blood cell,6720,0.9523809523809523,1.05
40202,/images/ef1a9020-5e45-450d-a237-165114308592.png,610,680,719,799,109,119,red blood cell,12971,1.091743119266055,0.9159663865546218
11991,/images/ca16a5ad-b106-4e84-8a43-178710e854ba.png,964,1289,1073,1402,109,113,red blood cell,12317,1.036697247706422,0.9646017699115044
63043,/images/6afd8203-d61a-4e9b-a4cf-dcb53a16b57c.png,837,1479,947,1575,110,96,red blood cell,10560,0.8727272727272727,1.1458333333333333
18922,/images/e9e78ff8-831b-46e9-9785-3eee9acbfcd8.png,102,1265,203,1366,101,101,red blood cell,10201,1.0,1.0
53393,/images/766d5547-8dd2-4c8d-b78e-3007f83932e8.png,14,1229,102,1319,88,90,red blood cell,7920,1.0227272727272727,0.9777777777777777
75090,/images/073c10c9-5749-44b5-b08b-1be556a960f0.png,567,1206,693,1337,126,131,red blood cell,16506,1.0396825396825398,0.9618320610687023
80066,/images/99e979d4-ee97-4d7f-9da6-00bead40db4d.png,871,971,968,1083,97,112,red blood cell,10864,1.1546391752577319,0.8660714285714286
73053,/images/2bd26501-2fbc-4c1a-bef0-4ad57e02b4d0.png,264,827,348,912,84,85,red blood cell,7140,1.0119047619047619,0.9882352941176471
78090,/images/105af41b-13cc-4ad1-8a1f-8bc4d47cdd94.png,735,288,839,392,104,104,red blood cell,10816,1.0,1.0
35213,/images/a9159b11-ba49-4885-902e-00c8d5095b98.png,1029,109,1132,216,103,107,red blood cell,11021,1.0388349514563107,0.9626168224299065
67980,/images/bcaefb02-682a-41b9-acc7-e6cc010f5b30.png,845,762,937,861,92,99,red blood cell,9108,1.076086956521739,0.9292929292929293
62613,/images/f7a4334a-4332-4de8-b39b-22da907976f2.png,1089,292,1180,395,91,103,red blood cell,9373,1.1318681318681318,0.883495145631068
71680,/images/5c99cd97-39f6-4809-9528-9d380cc16b16.png,815,688,918,784,103,96,red blood cell,9888,0.9320388349514563,1.0729166666666667
29925,/images/f2a8a483-b254-43aa-817f-7d525adb8911.png,91,202,218,319,127,117,red blood cell,14859,0.9212598425196851,1.0854700854700854
35826,/images/bb2042c5-35e1-43cc-8171-7de81b764361.png,1013,1141,1106,1221,93,80,red blood cell,7440,0.8602150537634409,1.1625
23952,/images/3d8fb5bf-3315-48fb-8ab1-802eafd550bc.png,749,771,860,864,111,93,red blood cell,10323,0.8378378378378378,1.1935483870967742
10086,/images/d1617cf7-eb56-42ee-85af-66c4748753c0.png,1039,1173,1174,1290,135,117,red blood cell,15795,0.8666666666666667,1.1538461538461537
45932,/images/0d098413-6911-4535-b70a-3c3effd8cf49.png,548,440,683,569,135,129,red blood cell,17415,0.9555555555555556,1.0465116279069768
11916,/images/2e8d6a43-0110-4bf4-8e70-20567e513b81.png,29,1479,141,1599,112,120,red blood cell,13440,1.0714285714285714,0.9333333333333333
78505,/images/c94827ce-d619-4705-a68a-df63a2c95ffa.png,336,576,454,682,118,106,red blood cell,12508,0.8983050847457628,1.1132075471698113
47571,/images/06cd484f-e864-4fee-8819-688b45eed98e.png,925,272,1049,380,124,108,red blood cell,13392,0.8709677419354839,1.1481481481481481
66758,/images/334bf865-e3fb-4200-bd53-d9ff5808ed9f.png,995,108,1090,198,95,90,red blood cell,8550,0.9473684210526315,1.0555555555555556
72287,/images/ee57e743-a876-4f69-9fe5-bf5d01b44689.png,1082,410,1191,511,109,101,red blood cell,11009,0.926605504587156,1.0792079207920793
71323,/images/bcb447c9-5d37-414f-a513-d7076b04a532.png,707,1404,825,1508,118,104,red blood cell,12272,0.8813559322033898,1.1346153846153846
55659,/images/c32b8bb8-c89d-4ae9-9c77-5b9356ca35a1.png,844,993,946,1087,102,94,red blood cell,9588,0.9215686274509803,1.0851063829787233
27609,/images/715761a2-745e-4743-9849-956a034ad3c4.png,36,424,136,526,100,102,red blood cell,10200,1.02,0.9803921568627451
63988,/images/5e974892-0ebe-4037-8427-ea8616d6d3b8.png,597,393,704,503,107,110,red blood cell,11770,1.02803738317757,0.9727272727272728
73247,/images/67a4fb91-6f38-4ca2-8f20-6b2f5f1b29a7.png,598,1105,703,1200,105,95,red blood cell,9975,0.9047619047619048,1.105263157894737
77518,/images/2d2e81f3-e329-4765-9ba1-2c95f12dc9f3.png,941,1395,1048,1503,107,108,red blood cell,11556,1.0093457943925233,0.9907407407407407
10489,/images/46a2d369-4bea-4405-ac78-91bbe130b9a7.png,654,144,777,256,123,112,red blood cell,13776,0.9105691056910569,1.0982142857142858
56122,/images/50d9fc90-8642-4bb6-91a7-0069a7e37392.png,420,539,534,660,114,121,red blood cell,13794,1.0614035087719298,0.9421487603305785
40909,/images/550cf4ce-b641-44a3-8487-3e16d4049187.png,921,770,1024,876,103,106,red blood cell,10918,1.029126213592233,0.9716981132075472
7879,/images/98c25ffe-c329-420a-bc22-b082f565eac9.png,162,1124,288,1248,126,124,red blood cell,15624,0.9841269841269841,1.0161290322580645
29887,/images/bc1a58fd-736b-4812-a051-2c376cff50b7.png,236,504,364,622,128,118,red blood cell,15104,0.921875,1.0847457627118644
3348,/images/b1100ae1-0ac8-4fc2-b0ff-8819f7fbe724.png,878,37,988,150,110,113,red blood cell,12430,1.0272727272727273,0.9734513274336283
43571,/images/e0ef520d-7b65-485d-9888-e6859f189f70.png,51,1019,161,1141,110,122,red blood cell,13420,1.1090909090909091,0.9016393442622951
33623,/images/00c8364b-8c85-4502-bcfe-64736fe76815.png,607,244,695,344,88,100,red blood cell,8800,1.1363636363636365,0.88
76895,/images/2165fe38-b474-467d-be11-d1d728085efd.png,1054,350,1163,444,109,94,red blood cell,10246,0.8623853211009175,1.1595744680851063
30642,/images/f939782b-f5a2-40a3-9c22-6c6d7e18edc3.png,1070,1290,1156,1391,86,101,red blood cell,8686,1.1744186046511629,0.8514851485148515
68649,/images/31653d0f-c4e6-4e12-8005-518c2de34687.png,584,141,681,223,97,82,red blood cell,7954,0.845360824742268,1.1829268292682926
45508,/images/94b5a9a1-1c88-4400-aca4-3d56f543fc4a.png,37,816,136,923,99,107,red blood cell,10593,1.0808080808080809,0.9252336448598131
57901,/images/09bcedaa-e007-4692-a13f-ab02c3f872c4.png,617,587,734,708,117,121,red blood cell,14157,1.0341880341880343,0.9669421487603306
76131,/images/16244280-6c74-47d3-b544-9fd6831a6bf9.png,658,43,776,166,118,123,red blood cell,14514,1.0423728813559323,0.959349593495935
3556,/images/25132962-ff5d-4737-995f-c54d8490539b.png,169,288,285,406,116,118,red blood cell,13688,1.0172413793103448,0.9830508474576272
24189,/images/194aec70-41a5-4ac3-b22f-0b6eda91f730.png,216,1406,318,1533,102,127,red blood cell,12954,1.2450980392156863,0.8031496062992126
57693,/images/5c037ffc-f515-48b3-b231-c110fbd2b8ca.png,284,1033,408,1140,124,107,red blood cell,13268,0.8629032258064516,1.158878504672897
50913,/images/0906111b-bac7-4541-a6dc-da435c0724a8.png,644,109,752,206,108,97,red blood cell,10476,0.8981481481481481,1.1134020618556701
52574,/images/0546d843-d778-4aca-b8b5-bfe23d7c87da.png,1062,934,1175,1036,113,102,red blood cell,11526,0.9026548672566371,1.107843137254902
45544,/images/e597f7ce-46c6-4dce-9063-50a2703fdd45.png,564,113,653,206,89,93,red blood cell,8277,1.0449438202247192,0.956989247311828
64538,/images/6ba5d0b8-cdc7-4266-9d78-db76faa312e9.png,155,954,252,1052,97,98,red blood cell,9506,1.0103092783505154,0.9897959183673469
35843,/images/027ab174-e47a-44f8-b85b-372449eeb7d8.png,487,809,601,914,114,105,red blood cell,11970,0.9210526315789473,1.0857142857142856
29347,/images/3850f2a5-ab62-49d3-8135-68d60baa676b.png,363,29,477,138,114,109,red blood cell,12426,0.956140350877193,1.0458715596330275
17864,/images/eb77e4a9-acb0-4d83-8055-2c5fcaa54b45.png,820,1262,949,1370,129,108,red blood cell,13932,0.8372093023255814,1.1944444444444444
30193,/images/a1669b59-fe09-4fe6-ba9f-06bec6725502.png,1066,252,1184,355,118,103,red blood cell,12154,0.8728813559322034,1.145631067961165
72499,/images/22516db4-8687-4051-90c4-2bb1ca3204a5.png,437,617,559,741,122,124,red blood cell,15128,1.0163934426229508,0.9838709677419355
38268,/images/b834cbf7-ff97-49d9-9561-566c9343735c.png,1080,963,1199,1091,119,128,red blood cell,15232,1.0756302521008403,0.9296875
72800,/images/caeb2d62-1166-43f0-8eac-5b8fc48f02eb.png,493,1147,590,1236,97,89,red blood cell,8633,0.9175257731958762,1.0898876404494382
42013,/images/46a03374-64c7-49ac-81c9-c3d62542bbf3.png,549,770,640,876,91,106,red blood cell,9646,1.164835164835165,0.8584905660377359
52492,/images/d1144956-5a0c-4bd2-b67d-8498c82d6a12.png,97,846,200,941,103,95,red blood cell,9785,0.9223300970873787,1.0842105263157895
45509,/images/94b5a9a1-1c88-4400-aca4-3d56f543fc4a.png,699,864,798,961,99,97,red blood cell,9603,0.9797979797979798,1.0206185567010309
61132,/images/80da32ce-8c22-470e-9f35-558c5f7a5df9.png,699,1250,795,1340,96,90,red blood cell,8640,0.9375,1.0666666666666667
15182,/images/3a8f468f-f9de-46a8-a7c8-f2be239fa207.png,1036,1394,1129,1483,93,89,red blood cell,8277,0.956989247311828,1.0449438202247192
8181,/images/694222bb-cddf-469a-9526-f873c6fba58e.png,2,393,96,484,94,91,red blood cell,8554,0.9680851063829787,1.032967032967033
77272,/images/07a80340-f65e-4f58-9317-94bb6ebd5a28.png,320,643,403,721,83,78,red blood cell,6474,0.9397590361445783,1.064102564102564
53444,/images/766d5547-8dd2-4c8d-b78e-3007f83932e8.png,1000,381,1084,465,84,84,red blood cell,7056,1.0,1.0
72871,/images/31435107-c77d-42f8-a619-75cba6a5161b.png,768,611,890,725,122,114,red blood cell,13908,0.9344262295081968,1.0701754385964912
65578,/images/01b38a56-13eb-447b-89ee-fc21cb40dcc1.png,421,1201,519,1287,98,86,red blood cell,8428,0.8775510204081632,1.1395348837209303
22442,/images/f97c7c87-5e27-45ea-9f93-3285d74091de.png,483,979,585,1092,102,113,red blood cell,11526,1.107843137254902,0.9026548672566371
14857,/images/3090a362-1f3d-49e9-a76e-ce76ff9c2276.png,531,1138,640,1228,109,90,red blood cell,9810,0.8256880733944955,1.211111111111111
22524,/images/bfe65b11-8aff-46aa-908b-1e989d25fdc4.png,653,1207,780,1324,127,117,red blood cell,14859,0.9212598425196851,1.0854700854700854
71076,/images/2dbf6f69-e020-4948-9e49-4b33edb7cebd.png,247,655,358,775,111,120,red blood cell,13320,1.0810810810810811,0.925
51219,/images/ad8731b7-0dae-4983-9dc6-dec31767d761.png,615,93,717,184,102,91,red blood cell,9282,0.8921568627450981,1.120879120879121
52856,/images/58f7e1da-3478-48f4-958c-e9b1cb8696aa.png,281,1224,397,1352,116,128,red blood cell,14848,1.103448275862069,0.90625
10059,/images/26799d2b-a289-4eff-9218-0aad77e05e41.png,96,452,226,580,130,128,red blood cell,16640,0.9846153846153847,1.015625
40439,/images/db249e5a-4142-432c-8288-bacd10d7273d.png,3,149,94,242,91,93,red blood cell,8463,1.021978021978022,0.978494623655914
29029,/images/4c13e22e-dfd1-4fa1-b373-be9d0c272c0f.png,288,538,393,645,105,107,red blood cell,11235,1.019047619047619,0.9813084112149533
62262,/images/59f5699f-885f-4004-b783-a60060144e43.png,370,621,498,739,128,118,red blood cell,15104,0.921875,1.0847457627118644
75170,/images/7fdc8be8-7579-4a5c-b369-8a07ee0a8b7d.png,1109,1247,1198,1352,89,105,red blood cell,9345,1.1797752808988764,0.8476190476190476
17873,/images/eb77e4a9-acb0-4d83-8055-2c5fcaa54b45.png,130,208,222,297,92,89,red blood cell,8188,0.967391304347826,1.0337078651685394
51658,/images/592c941a-aa54-4971-b499-dc47356f80a3.png,740,342,829,438,89,96,red blood cell,8544,1.0786516853932584,0.9270833333333334
70377,/images/4876c9d0-b386-48fb-84e8-91bf87529161.png,207,1197,307,1290,100,93,red blood cell,9300,0.93,1.075268817204301
19153,/images/bb795ddf-ce72-42d5-9006-124db4d5cf1c.png,534,7,647,117,113,110,red blood cell,12430,0.9734513274336283,1.0272727272727273
22122,/images/ca677c3c-083f-4d54-9dec-39f79f6a17d8.png,969,1140,1087,1249,118,109,red blood cell,12862,0.923728813559322,1.0825688073394495
76649,/images/3317d733-ec0d-45e6-b631-40457392f343.png,149,706,241,809,92,103,red blood cell,9476,1.1195652173913044,0.8932038834951457
52444,/images/a2a20600-f851-4db7-90f9-6f7be027c8b5.png,32,972,125,1047,93,75,red blood cell,6975,0.8064516129032258,1.24
14020,/images/eaf4b781-b3aa-41ce-8c5e-287979b4e15a.png,823,1016,937,1111,114,95,red blood cell,10830,0.8333333333333334,1.2
45130,/images/56fbae44-4677-47f8-9c3a-22dac043c115.png,650,465,763,581,113,116,red blood cell,13108,1.0265486725663717,0.9741379310344828
53965,/images/540a5fee-175b-4b92-bf62-1ea9b59c86c6.png,962,260,1063,357,101,97,red blood cell,9797,0.9603960396039604,1.041237113402062
6707,/images/95fea6d8-413f-421e-b331-5d51c31df150.png,76,377,199,481,123,104,red blood cell,12792,0.8455284552845529,1.1826923076923077
61227,/images/0da07970-3146-479c-8a07-f61ed32814a9.png,117,461,214,572,97,111,red blood cell,10767,1.1443298969072164,0.8738738738738738
12187,/images/87d6343b-70dd-4cdd-939f-d3ac0ca2e700.png,265,922,388,1030,123,108,red blood cell,13284,0.8780487804878049,1.1388888888888888
74583,/images/bbedfcbe-9528-4ba9-9d86-4ebba7589ac5.png,764,854,857,953,93,99,red blood cell,9207,1.064516129032258,0.9393939393939394
31612,/images/0d7bf56f-3b5a-40bd-971c-2ca33dd89b2c.png,57,486,152,565,95,79,red blood cell,7505,0.8315789473684211,1.2025316455696202
75309,/images/9ec1dcec-87c2-4aca-8e6b-0db3cd05509c.png,101,861,194,960,93,99,red blood cell,9207,1.064516129032258,0.9393939393939394
78790,/images/9174f910-3859-4839-8e30-2c3b25269322.png,660,711,758,807,98,96,red blood cell,9408,0.9795918367346939,1.0208333333333333
71020,/images/59daa25e-85d6-42f2-8f39-cc9f9d5d252e.png,113,172,223,302,110,130,red blood cell,14300,1.1818181818181819,0.8461538461538461
25832,/images/14b68d86-ac7f-419d-b4a5-6b0b1d9aaa18.png,12,1227,130,1352,118,125,red blood cell,14750,1.0593220338983051,0.944
46549,/images/edd09b2e-2673-4405-8ac0-e476e003e96a.png,678,636,801,773,123,137,red blood cell,16851,1.113821138211382,0.8978102189781022
71042,/images/59daa25e-85d6-42f2-8f39-cc9f9d5d252e.png,665,1010,789,1123,124,113,red blood cell,14012,0.9112903225806451,1.0973451327433628
70982,/images/deaa1931-5f97-45bf-8c00-be6ddeb37b9a.png,140,1195,264,1306,124,111,red blood cell,13764,0.8951612903225806,1.117117117117117
16722,/images/d6352a03-ef81-421d-915e-226499555d20.png,235,599,349,723,114,124,red blood cell,14136,1.087719298245614,0.9193548387096774
12570,/images/8e4bdd0d-1c72-4836-ae3e-05e2e50e4983.png,276,421,366,518,90,97,red blood cell,8730,1.0777777777777777,0.9278350515463918
11590,/images/b4dc3088-3fe2-4688-be24-70664a64e022.png,510,820,611,934,101,114,red blood cell,11514,1.1287128712871286,0.8859649122807017
8419,/images/ae779806-6d01-4dc6-89df-294c368db6bc.png,840,73,960,191,120,118,red blood cell,14160,0.9833333333333333,1.0169491525423728
39034,/images/79806898-0214-44bd-ba2c-b570e911be62.png,1044,1464,1162,1594,118,130,red blood cell,15340,1.1016949152542372,0.9076923076923077
45773,/images/584d62ed-4329-45dd-94ce-e929d8b2bb74.png,380,1255,473,1369,93,114,red blood cell,10602,1.2258064516129032,0.8157894736842105
36238,/images/b2103776-9b32-4160-b4f0-0692deda19dc.png,766,822,863,940,97,118,red blood cell,11446,1.2164948453608246,0.8220338983050848
61807,/images/985627c9-7b85-40de-a106-eb9cc47b47cb.png,4,1219,86,1308,82,89,red blood cell,7298,1.0853658536585367,0.9213483146067416
47900,/images/ab27173b-6e30-4957-bd68-29194328fd39.png,27,591,136,701,109,110,red blood cell,11990,1.0091743119266054,0.990909090909091
62774,/images/631340cc-cedf-4bca-a3d8-a0731a5482b4.png,416,792,527,901,111,109,red blood cell,12099,0.9819819819819819,1.018348623853211
38317,/images/674b0fd3-f247-4b7f-97f7-3e6c57c9ba9e.png,51,1280,145,1390,94,110,red blood cell,10340,1.1702127659574468,0.8545454545454545
26193,/images/7ba9db7e-9d3f-413c-b672-2bba5fb5b415.png,59,836,179,968,120,132,red blood cell,15840,1.1,0.9090909090909091
13810,/images/345cb914-7583-49df-96e3-3cf19c2ba8f1.png,494,729,612,849,118,120,red blood cell,14160,1.0169491525423728,0.9833333333333333
71048,/images/59daa25e-85d6-42f2-8f39-cc9f9d5d252e.png,678,926,789,1030,111,104,red blood cell,11544,0.9369369369369369,1.0673076923076923
54739,/images/10891eed-b0f2-4dd0-90cb-da185f6761b2.png,693,78,794,181,101,103,red blood cell,10403,1.0198019801980198,0.9805825242718447
34257,/images/259da25f-40f3-4d37-bca9-a9c807af1547.png,82,1151,180,1255,98,104,red blood cell,10192,1.0612244897959184,0.9423076923076923
69286,/images/f274b784-b995-4a7e-a2c2-6cc31c24c4b4.png,907,476,999,558,92,82,red blood cell,7544,0.8913043478260869,1.1219512195121952
75202,/images/61dfc937-a428-44b4-94fb-d682bdb8dff0.png,124,309,216,407,92,98,red blood cell,9016,1.065217391304348,0.9387755102040817
17839,/images/1863da5f-c595-4541-a8f4-21fe78678168.png,850,1385,926,1462,76,77,red blood cell,5852,1.013157894736842,0.987012987012987
17863,/images/eb77e4a9-acb0-4d83-8055-2c5fcaa54b45.png,652,1066,757,1170,105,104,red blood cell,10920,0.9904761904761905,1.0096153846153846
55562,/images/a27b451d-44a6-4740-861a-9e7e99915563.png,368,1243,473,1355,105,112,red blood cell,11760,1.0666666666666667,0.9375
52464,/images/a2a20600-f851-4db7-90f9-6f7be027c8b5.png,684,546,752,621,68,75,red blood cell,5100,1.1029411764705883,0.9066666666666666
59150,/images/4736f545-1f1f-4d77-9241-d69cbf4dae35.png,877,1430,970,1534,93,104,red blood cell,9672,1.118279569892473,0.8942307692307693
39462,/images/5a631871-2fc7-4a68-9c39-f3b9a0bf4a04.png,667,841,757,939,90,98,red blood cell,8820,1.0888888888888888,0.9183673469387755
34124,/images/de5d19b7-e670-4ac7-843b-7ce7bcebdf45.png,508,646,626,743,118,97,red blood cell,11446,0.8220338983050848,1.2164948453608246
5804,/images/143f5959-5b6d-4f95-bcee-9e110450fc22.png,809,965,923,1078,114,113,red blood cell,12882,0.9912280701754386,1.008849557522124
32578,/images/3f26fbbc-deb1-494f-b71c-c7cb3d4819fb.png,332,1167,480,1291,148,124,red blood cell,18352,0.8378378378378378,1.1935483870967742
55456,/images/d67655e6-0a80-4a86-b552-1f5e85788377.png,909,1427,1002,1505,93,78,red blood cell,7254,0.8387096774193549,1.1923076923076923
72030,/images/6ad3efc9-4392-4cee-98a5-186564a96373.png,395,1452,499,1574,104,122,red blood cell,12688,1.1730769230769231,0.8524590163934426
11976,/images/ca16a5ad-b106-4e84-8a43-178710e854ba.png,580,1093,701,1216,121,123,red blood cell,14883,1.0165289256198347,0.983739837398374
39998,/images/8271d0d8-9985-43eb-94b3-c702adca139f.png,85,1035,195,1149,110,114,red blood cell,12540,1.0363636363636364,0.9649122807017544
24499,/images/109fbb82-bc3c-41ac-984d-e2da86202873.png,155,41,272,154,117,113,red blood cell,13221,0.9658119658119658,1.0353982300884956
34778,/images/4fc9a597-aaa8-43b0-ad1c-2eabbe442e84.png,941,416,1062,527,121,111,red blood cell,13431,0.9173553719008265,1.09009009009009
65956,/images/25c6cfb1-01d0-4864-87f9-02b7593683c7.png,245,1209,350,1323,105,114,red blood cell,11970,1.0857142857142856,0.9210526315789473
59795,/images/f77d7469-d083-4c2d-a4ea-5a9ff162e3e2.png,32,815,125,891,93,76,red blood cell,7068,0.8172043010752689,1.2236842105263157
54691,/images/6473ddb6-ad56-48a2-81e8-c7cb45f06825.png,406,703,503,786,97,83,red blood cell,8051,0.8556701030927835,1.1686746987951808
69506,/images/664c570b-4822-413c-9724-11b1d91fac44.png,954,557,1047,644,93,87,red blood cell,8091,0.9354838709677419,1.0689655172413792
76141,/images/16244280-6c74-47d3-b544-9fd6831a6bf9.png,968,420,1062,517,94,97,red blood cell,9118,1.0319148936170213,0.9690721649484536
61933,/images/c66a3e52-0f3f-4c81-bab9-0303499549f7.png,226,1170,338,1270,112,100,red blood cell,11200,0.8928571428571429,1.12
71192,/images/4fac16e1-8e62-499b-a66b-c4c890372914.png,758,210,889,350,131,140,red blood cell,18340,1.0687022900763359,0.9357142857142857
17170,/images/dc3bdfe9-1565-4cda-9c4e-0979846dab60.png,336,1108,413,1183,77,75,red blood cell,5775,0.974025974025974,1.0266666666666666
69261,/images/f274b784-b995-4a7e-a2c2-6cc31c24c4b4.png,805,764,893,847,88,83,red blood cell,7304,0.9431818181818182,1.0602409638554218
62941,/images/4b346035-b8c0-46ca-8fdb-a01b1421ee4a.png,138,1058,227,1159,89,101,red blood cell,8989,1.1348314606741574,0.8811881188118812
18085,/images/947348fe-4c70-468e-8009-3c14daeca69b.png,477,1193,597,1292,120,99,red blood cell,11880,0.825,1.2121212121212122
34581,/images/a0eedcb9-b85c-4612-b945-7e8227f53c35.png,197,325,288,432,91,107,red blood cell,9737,1.1758241758241759,0.8504672897196262
69607,/images/4a49841f-216c-4815-8140-b8762c4f6603.png,336,1283,425,1370,89,87,red blood cell,7743,0.9775280898876404,1.0229885057471264
11697,/images/0ed416f9-7c20-4829-9016-559e4009568e.png,619,322,731,450,112,128,red blood cell,14336,1.1428571428571428,0.875
73516,/images/5f2b32bd-fdca-4d6f-b13a-ee9f83626c8d.png,4,520,99,623,95,103,red blood cell,9785,1.0842105263157895,0.9223300970873787
24378,/images/4d8a4ce8-0f9c-4f21-8844-4cf0e5514bbf.png,23,828,123,925,100,97,red blood cell,9700,0.97,1.0309278350515463
29472,/images/8cc6fe77-5f2f-4670-b4ac-1b49550241a8.png,613,201,710,302,97,101,red blood cell,9797,1.041237113402062,0.9603960396039604
74962,/images/b4c52960-bbee-439e-83dc-f89ddaade71b.png,269,514,370,609,101,95,red blood cell,9595,0.9405940594059405,1.063157894736842
22964,/images/ecd68ba2-48af-4866-826a-7cd1c147c055.png,132,684,249,814,117,130,red blood cell,15210,1.1111111111111112,0.9
48340,/images/6fa2b30f-9b89-46ac-9b79-c0bc105d4271.png,983,578,1099,693,116,115,red blood cell,13340,0.9913793103448276,1.008695652173913
52195,/images/f4c00b8c-d675-4255-8277-ca65bd757f51.png,710,704,802,809,92,105,red blood cell,9660,1.141304347826087,0.8761904761904762
7897,/images/98c25ffe-c329-420a-bc22-b082f565eac9.png,754,24,886,156,132,132,red blood cell,17424,1.0,1.0
5200,/images/16a51468-9f93-45df-9ae2-5a74c25c5a4b.png,294,1314,411,1431,117,117,red blood cell,13689,1.0,1.0
9592,/images/239f17eb-a2e2-47e9-82e3-fa0d9a70fb9f.png,219,247,332,354,113,107,red blood cell,12091,0.9469026548672567,1.0560747663551402
35154,/images/bfc61c48-685d-470b-86b1-e4c7eb85c4fd.png,1084,866,1199,987,115,121,red blood cell,13915,1.0521739130434782,0.9504132231404959
76780,/images/2165fe38-b474-467d-be11-d1d728085efd.png,1035,706,1143,807,108,101,red blood cell,10908,0.9351851851851852,1.0693069306930694
72625,/images/a63ce82f-f3d1-4818-9035-d3d230e5f686.png,299,57,424,168,125,111,red blood cell,13875,0.888,1.1261261261261262
44919,/images/83ec8923-6232-40d7-ba1f-a1b8bf7cb66c.png,679,742,789,856,110,114,red blood cell,12540,1.0363636363636364,0.9649122807017544
66162,/images/191f87a4-6f2d-49e7-bba0-08e3aa78ddaf.png,985,344,1056,428,71,84,red blood cell,5964,1.1830985915492958,0.8452380952380952
5744,/images/21a50e4c-b750-46b5-801f-5429ede7dea9.png,639,1018,776,1148,137,130,red blood cell,17810,0.948905109489051,1.0538461538461539
6337,/images/c6575e75-c8ce-4766-841f-1137b9e0956c.png,314,1192,416,1291,102,99,red blood cell,10098,0.9705882352941176,1.0303030303030303
54330,/images/3b5a8060-dec6-4a83-b7f2-b604e4e69dfc.png,446,5,548,128,102,123,red blood cell,12546,1.2058823529411764,0.8292682926829268
42082,/images/46a03374-64c7-49ac-81c9-c3d62542bbf3.png,821,1404,921,1497,100,93,red blood cell,9300,0.93,1.075268817204301
12578,/images/8e4bdd0d-1c72-4836-ae3e-05e2e50e4983.png,613,620,695,709,82,89,red blood cell,7298,1.0853658536585367,0.9213483146067416
57128,/images/7d041c38-11f2-4186-8a24-29d7d0f5c3cf.png,762,173,842,259,80,86,red blood cell,6880,1.075,0.9302325581395349
52058,/images/de6d3020-9347-473b-9146-8909627790f6.png,295,1322,409,1442,114,120,red blood cell,13680,1.0526315789473684,0.95
60486,/images/93b47b14-7f78-4b31-8897-d63a81fdab01.png,950,825,1070,933,120,108,red blood cell,12960,0.9,1.1111111111111112
33120,/images/6231d81d-9e84-4a5a-8cb8-47c6a37a0176.png,149,656,252,766,103,110,red blood cell,11330,1.0679611650485437,0.9363636363636364
60335,/images/1c87b997-a8e6-48ca-bf40-19b9a7fd6a96.png,374,209,496,316,122,107,red blood cell,13054,0.8770491803278688,1.1401869158878504
23017,/images/0d095f3a-9243-472b-90b4-0ce8309e778c.png,469,322,595,439,126,117,red blood cell,14742,0.9285714285714286,1.0769230769230769
73763,/images/22cbf509-c9bf-46ec-bfce-f079c6b76c8c.png,119,1415,211,1527,92,112,red blood cell,10304,1.2173913043478262,0.8214285714285714
4531,/images/0f26699f-a776-4424-b092-27da9a1d12e2.png,881,1032,968,1113,87,81,red blood cell,7047,0.9310344827586207,1.0740740740740742
9796,/images/3859deaf-6ae1-49a3-9051-898d0f0d7de6.png,16,362,117,457,101,95,red blood cell,9595,0.9405940594059405,1.063157894736842
18196,/images/947348fe-4c70-468e-8009-3c14daeca69b.png,896,160,997,267,101,107,red blood cell,10807,1.0594059405940595,0.9439252336448598
54737,/images/10891eed-b0f2-4dd0-90cb-da185f6761b2.png,582,1019,687,1114,105,95,red blood cell,9975,0.9047619047619048,1.105263157894737
51118,/images/d64cd75a-df26-44d5-ac25-69061a4e4d57.png,900,452,1005,546,105,94,red blood cell,9870,0.8952380952380953,1.1170212765957446
59259,/images/03c8da48-04b9-4520-b674-44a0ecd35688.png,554,254,658,374,104,120,red blood cell,12480,1.1538461538461537,0.8666666666666667
2394,/images/fe851c88-692d-4199-87e0-d19d9c4eb591.png,475,1200,571,1298,96,98,red blood cell,9408,1.0208333333333333,0.9795918367346939
40953,/images/550cf4ce-b641-44a3-8487-3e16d4049187.png,235,165,323,255,88,90,red blood cell,7920,1.0227272727272727,0.9777777777777777
5135,/images/a777e78c-ad1f-4380-9ab2-b4f9f32b2d78.png,136,1056,249,1169,113,113,red blood cell,12769,1.0,1.0
55488,/images/43072c64-4c08-47cd-ae8a-b74d31f80008.png,362,1059,477,1176,115,117,red blood cell,13455,1.017391304347826,0.9829059829059829
65501,/images/da49db57-0c2f-4213-b322-c88c19fb9296.png,396,1139,496,1257,100,118,red blood cell,11800,1.18,0.847457627118644
28196,/images/c244166d-12ca-445f-9ed9-a13d9caa412f.png,320,611,442,749,122,138,red blood cell,16836,1.1311475409836065,0.8840579710144928
60523,/images/f5c395f1-f94c-440d-8221-cc656e52c0b1.png,834,1217,949,1324,115,107,red blood cell,12305,0.9304347826086956,1.074766355140187
27620,/images/a0785022-e82b-4878-b9d4-19cb7b75213f.png,1024,102,1145,212,121,110,red blood cell,13310,0.9090909090909091,1.1
38522,/images/c3ae7090-fc68-41b4-85a1-8d9bce9825a7.png,716,55,835,200,119,145,red blood cell,17255,1.218487394957983,0.8206896551724138
46130,/images/72088c26-d2dd-4906-b791-b8947fc7fbe4.png,375,923,455,1019,80,96,red blood cell,7680,1.2,0.8333333333333334
29889,/images/bc1a58fd-736b-4812-a051-2c376cff50b7.png,101,55,231,184,130,129,red blood cell,16770,0.9923076923076923,1.0077519379844961
47992,/images/eba73bff-fbe1-436d-9a5f-0a61331a0ea2.png,725,487,833,622,108,135,red blood cell,14580,1.25,0.8
36439,/images/cfe6086f-eb0b-4cb0-a430-8cd7de6556e2.png,748,713,863,836,115,123,red blood cell,14145,1.0695652173913044,0.9349593495934959
61292,/images/b3058064-d817-47dd-a8c4-cdb1f62374f8.png,1087,452,1193,555,106,103,red blood cell,10918,0.9716981132075472,1.029126213592233
28105,/images/cd2774a0-dab2-4d68-aae9-7568b9f3d2a6.png,918,1350,1026,1460,108,110,red blood cell,11880,1.0185185185185186,0.9818181818181818
20988,/images/666601e7-608d-4d19-999f-8fc6ab373a55.png,694,1341,820,1455,126,114,red blood cell,14364,0.9047619047619048,1.105263157894737
66476,/images/5f66d20c-fbfe-44ec-a01b-8a09da24807e.png,820,945,914,1046,94,101,red blood cell,9494,1.074468085106383,0.9306930693069307
57171,/images/7c870293-2665-4a6b-a4fa-336959051dfc.png,215,132,331,249,116,117,red blood cell,13572,1.0086206896551724,0.9914529914529915
6858,/images/b21f6c6e-4b45-407a-b4c7-034a115f3ee4.png,450,784,557,890,107,106,red blood cell,11342,0.9906542056074766,1.009433962264151
69731,/images/f0713bee-2a71-4ced-b953-4041ea99496a.png,658,839,735,929,77,90,red blood cell,6930,1.1688311688311688,0.8555555555555555
55980,/images/4c460388-e0c1-4970-8527-c9e5b42bea49.png,837,962,936,1079,99,117,red blood cell,11583,1.1818181818181819,0.8461538461538461
50001,/images/b1145408-feae-4637-b4cf-3e70b99cc62d.png,60,1400,157,1507,97,107,red blood cell,10379,1.1030927835051547,0.9065420560747663
24350,/images/4d8a4ce8-0f9c-4f21-8844-4cf0e5514bbf.png,812,35,907,124,95,89,red blood cell,8455,0.9368421052631579,1.0674157303370786
12063,/images/b234b6ea-b54d-470c-8461-ba7f4a024796.png,290,676,431,821,141,145,red blood cell,20445,1.0283687943262412,0.9724137931034482
78075,/images/105af41b-13cc-4ad1-8a1f-8bc4d47cdd94.png,4,1316,124,1443,120,127,red blood cell,15240,1.0583333333333333,0.9448818897637795
24022,/images/5107dcb7-164f-4e10-bbff-822b39b76efc.png,97,300,218,425,121,125,red blood cell,15125,1.0330578512396693,0.968
40737,/images/252071ac-e9f2-41d2-abbb-87ef01b8a997.png,356,7,455,96,99,89,red blood cell,8811,0.898989898989899,1.1123595505617978
68535,/images/74261741-4d6e-4dba-8ad4-4fbdf919c30f.png,936,7,1029,118,93,111,red blood cell,10323,1.1935483870967742,0.8378378378378378
45188,/images/2596eb32-1323-41e9-8c0f-64819abcfc73.png,732,1040,828,1127,96,87,red blood cell,8352,0.90625,1.103448275862069
39237,/images/2aeb7b85-7df9-4a63-8d37-2eecaaa190e7.png,702,674,804,776,102,102,red blood cell,10404,1.0,1.0
9024,/images/ef815e3a-02a6-4cf8-9262-45bc74c50b00.png,97,691,192,785,95,94,red blood cell,8930,0.9894736842105263,1.0106382978723405
51559,/images/6afb3717-f197-4668-929a-4fab389ae6e8.png,947,341,1042,447,95,106,red blood cell,10070,1.1157894736842104,0.8962264150943396
69394,/images/fde0fd54-49cc-42e1-90c6-6b612cd062d8.png,653,211,759,312,106,101,red blood cell,10706,0.9528301886792453,1.0495049504950495
66710,/images/334bf865-e3fb-4200-bd53-d9ff5808ed9f.png,413,1264,512,1373,99,109,red blood cell,10791,1.101010101010101,0.908256880733945
35765,/images/bb2042c5-35e1-43cc-8171-7de81b764361.png,855,24,974,122,119,98,red blood cell,11662,0.8235294117647058,1.2142857142857142
64413,/images/0a7bfa8a-ee52-4f7a-b9c5-2919ecfa93ef.png,86,333,176,422,90,89,red blood cell,8010,0.9888888888888889,1.0112359550561798
6485,/images/640c4a52-3742-4f57-aee3-9e3dc0887622.png,416,1472,526,1582,110,110,red blood cell,12100,1.0,1.0
1144,/images/edcb4d77-a4d3-465d-9b59-eb3087766b1c.png,261,143,383,261,122,118,red blood cell,14396,0.9672131147540983,1.0338983050847457
39076,/images/8f96ee1f-4ef7-4279-a610-316319bedcf9.png,824,1306,951,1426,127,120,red blood cell,15240,0.9448818897637795,1.0583333333333333
62426,/images/9af1ee02-87fd-42bc-963e-fa9ac3eb45bb.png,856,163,957,280,101,117,red blood cell,11817,1.1584158415841583,0.8632478632478633
53786,/images/76b24246-8571-4e7b-8815-b185414a2c51.png,1057,1044,1142,1129,85,85,red blood cell,7225,1.0,1.0
2891,/images/a1c140f9-75d7-42a3-b767-4c01a118892b.png,941,191,1051,327,110,136,red blood cell,14960,1.2363636363636363,0.8088235294117647
62318,/images/e0ff3476-226f-4125-b182-8e524d5503dd.png,535,723,619,820,84,97,red blood cell,8148,1.1547619047619047,0.865979381443299
28472,/images/c3042130-a6e2-458f-9fde-bb012f68f5f2.png,661,220,792,337,131,117,red blood cell,15327,0.8931297709923665,1.1196581196581197
46487,/images/21417261-475a-456f-b03f-57ac85a6e106.png,736,94,847,218,111,124,red blood cell,13764,1.117117117117117,0.8951612903225806
24975,/images/ed0bee2f-05e0-4392-8357-19750cec577c.png,236,99,361,205,125,106,red blood cell,13250,0.848,1.179245283018868
30383,/images/58d75854-be99-484e-89f0-4ab208fe07e0.png,649,142,744,237,95,95,red blood cell,9025,1.0,1.0
9130,/images/d3ed519e-2152-4e30-838d-a3ea23be512f.png,914,75,1035,194,121,119,red blood cell,14399,0.9834710743801653,1.0168067226890756
73347,/images/c890ee00-daa5-4b20-9cd5-930748ecc4e0.png,996,1006,1091,1113,95,107,red blood cell,10165,1.1263157894736842,0.8878504672897196
42168,/images/04c07425-57c7-415c-a0bc-36857bbd4049.png,533,480,661,601,128,121,red blood cell,15488,0.9453125,1.0578512396694215
8817,/images/ae17a099-18b5-4a42-a901-850ea056423e.png,584,1155,686,1254,102,99,red blood cell,10098,0.9705882352941176,1.0303030303030303
23669,/images/79d7a014-21ff-40f1-9ac4-a69839390654.png,966,1279,1069,1369,103,90,red blood cell,9270,0.8737864077669902,1.1444444444444444
31888,/images/f62d4fb6-df7c-446c-94a8-d5aede0b1e0c.png,494,865,603,983,109,118,red blood cell,12862,1.0825688073394495,0.923728813559322
64183,/images/2a91387a-d30f-418d-ac3a-f7cfa6836261.png,219,1150,331,1256,112,106,red blood cell,11872,0.9464285714285714,1.0566037735849056
54637,/images/6473ddb6-ad56-48a2-81e8-c7cb45f06825.png,993,420,1096,532,103,112,red blood cell,11536,1.087378640776699,0.9196428571428571
34163,/images/f1cda808-69a9-4d10-ba0a-6607c98e362d.png,1071,438,1172,551,101,113,red blood cell,11413,1.118811881188119,0.8938053097345132
75861,/images/3006096f-ceeb-42be-b69e-785179d7438b.png,177,1304,281,1411,104,107,red blood cell,11128,1.0288461538461537,0.9719626168224299
58024,/images/a7c91b63-b97c-4f4b-8d34-7ad2b08d7a17.png,67,224,167,334,100,110,red blood cell,11000,1.1,0.9090909090909091
32316,/images/1c406ce1-023b-47fc-a2cd-5ea2e255de65.png,115,0,226,113,111,113,red blood cell,12543,1.018018018018018,0.9823008849557522
43678,/images/a4851ed0-1499-4eae-9157-dcd34773254f.png,315,626,419,741,104,115,red blood cell,11960,1.1057692307692308,0.9043478260869565
74562,/images/bbedfcbe-9528-4ba9-9d86-4ebba7589ac5.png,979,565,1091,665,112,100,red blood cell,11200,0.8928571428571429,1.12
15013,/images/3003252a-2d2e-4687-ad30-9c38d68f1394.png,885,685,1006,806,121,121,red blood cell,14641,1.0,1.0
29711,/images/f25a2ac8-cb6e-4e05-a0cd-cc00ac47718a.png,271,353,396,497,125,144,red blood cell,18000,1.152,0.8680555555555556
63692,/images/d9c9479e-f1ea-4d6e-861f-843ff9a90d19.png,317,1405,399,1505,82,100,red blood cell,8200,1.2195121951219512,0.82
39046,/images/8f96ee1f-4ef7-4279-a610-316319bedcf9.png,29,18,129,120,100,102,red blood cell,10200,1.02,0.9803921568627451
18027,/images/0f0c949e-018a-4f3f-ab02-3704f49c7754.png,368,373,464,465,96,92,red blood cell,8832,0.9583333333333334,1.0434782608695652
46054,/images/72088c26-d2dd-4906-b791-b8947fc7fbe4.png,503,43,599,149,96,106,red blood cell,10176,1.1041666666666667,0.9056603773584906
58433,/images/7eae1169-e294-4594-8e03-1366d23ff2d1.png,542,600,648,699,106,99,red blood cell,10494,0.9339622641509434,1.0707070707070707
16010,/images/7e25ced3-5caf-47f8-ad0c-42946bd4468b.png,809,497,920,608,111,111,red blood cell,12321,1.0,1.0
17288,/images/3d302619-473d-4c5b-af43-8833ff94233f.png,738,1219,837,1317,99,98,red blood cell,9702,0.98989898989899,1.010204081632653
15436,/images/1b7f47fc-26cd-4273-b848-88a7cbfd9f85.png,398,1202,494,1308,96,106,red blood cell,10176,1.1041666666666667,0.9056603773584906
49158,/images/df3d98b9-3dd7-4107-8d4a-ae1b7f247793.png,683,356,779,460,96,104,red blood cell,9984,1.0833333333333333,0.9230769230769231
67657,/images/59542a24-b409-4c95-8608-d9691a741526.png,871,1529,955,1600,84,71,red blood cell,5964,0.8452380952380952,1.1830985915492958
39377,/images/fbcb2ef0-3c97-4d7a-8b96-0147c73f3941.png,1001,1449,1125,1570,124,121,red blood cell,15004,0.9758064516129032,1.024793388429752
66663,/images/b88fe674-fb9a-41d4-b100-cb1c86440d44.png,486,1194,590,1302,104,108,red blood cell,11232,1.0384615384615385,0.9629629629629629
44837,/images/83ec8923-6232-40d7-ba1f-a1b8bf7cb66c.png,535,705,644,808,109,103,red blood cell,11227,0.944954128440367,1.058252427184466
25082,/images/b02f6804-1697-4a5e-9be7-61931903ab55.png,810,1230,923,1363,113,133,red blood cell,15029,1.176991150442478,0.849624060150376
9037,/images/ef815e3a-02a6-4cf8-9262-45bc74c50b00.png,888,193,1002,318,114,125,red blood cell,14250,1.0964912280701755,0.912
21802,/images/f68ae8e9-e760-4106-88e0-4bdef2785f06.png,133,212,244,308,111,96,red blood cell,10656,0.8648648648648649,1.15625
21511,/images/7625dfc4-858a-4c8e-907c-8943d665e9a7.png,546,1281,640,1382,94,101,red blood cell,9494,1.074468085106383,0.9306930693069307
53508,/images/43158031-a335-4533-9c20-48bebba90123.png,250,1456,344,1555,94,99,red blood cell,9306,1.053191489361702,0.9494949494949495
76931,/images/25ddc1ca-d368-4fff-b1ad-1dbf1e7c97aa.png,143,1101,247,1206,104,105,red blood cell,10920,1.0096153846153846,0.9904761904761905
66555,/images/b87fb62d-2c36-4f68-aba9-37fcd7d46eef.png,360,514,485,624,125,110,red blood cell,13750,0.88,1.1363636363636365
35069,/images/67582df6-bf13-4c83-a531-1214692b70de.png,641,860,757,984,116,124,red blood cell,14384,1.0689655172413792,0.9354838709677419
51395,/images/b4f3b2a4-f4b9-48de-ac5d-0e681b77be27.png,971,800,1068,894,97,94,red blood cell,9118,0.9690721649484536,1.0319148936170213
25839,/images/14b68d86-ac7f-419d-b4a5-6b0b1d9aaa18.png,684,878,775,976,91,98,red blood cell,8918,1.0769230769230769,0.9285714285714286
23661,/images/79d7a014-21ff-40f1-9ac4-a69839390654.png,375,382,487,496,112,114,red blood cell,12768,1.0178571428571428,0.9824561403508771
14459,/images/3b13e20f-ec0d-44ec-b2f4-eaebfa09150e.png,1074,202,1189,321,115,119,red blood cell,13685,1.0347826086956522,0.9663865546218487
8375,/images/9a1cd456-310c-47b6-a1f8-0fbd8e33d1fd.png,716,205,825,327,109,122,red blood cell,13298,1.1192660550458715,0.8934426229508197
59407,/images/a7c3c52f-3b40-4c92-a212-df9462cf25d8.png,235,360,353,461,118,101,red blood cell,11918,0.8559322033898306,1.1683168316831682
40028,/images/8a4aadac-cf5c-4a79-b875-271b3fbfd230.png,467,1364,541,1452,74,88,red blood cell,6512,1.1891891891891893,0.8409090909090909
56119,/images/50d9fc90-8642-4bb6-91a7-0069a7e37392.png,136,961,242,1071,106,110,red blood cell,11660,1.0377358490566038,0.9636363636363636
36988,/images/b2e34f5f-904e-4473-9dc7-c6bc1ce12640.png,146,1147,231,1236,85,89,red blood cell,7565,1.0470588235294118,0.9550561797752809
37075,/images/b2e34f5f-904e-4473-9dc7-c6bc1ce12640.png,654,1285,752,1385,98,100,red blood cell,9800,1.0204081632653061,0.98
20858,/images/c2ec116f-f091-422c-926c-70b548a8f6ef.png,31,711,117,805,86,94,red blood cell,8084,1.0930232558139534,0.9148936170212766
25490,/images/f6ab936d-924b-4038-aa47-71b07c26b4e2.png,852,1296,969,1418,117,122,red blood cell,14274,1.0427350427350428,0.9590163934426229
46281,/images/815bf40c-371a-4d34-aa41-c549c8221881.png,670,489,801,596,131,107,red blood cell,14017,0.816793893129771,1.2242990654205608
7367,/images/89f10192-d3dd-4996-a571-4c851dbdc983.png,380,4,487,103,107,99,red blood cell,10593,0.9252336448598131,1.0808080808080809
73407,/images/58594235-0d32-4a4e-91cd-4c800eaaaa73.png,881,170,976,264,95,94,red blood cell,8930,0.9894736842105263,1.0106382978723405
41076,/images/e871f52c-77a6-4813-80d4-95bd97985f1a.png,808,1243,923,1345,115,102,red blood cell,11730,0.8869565217391304,1.1274509803921569
77763,/images/4849866a-73a2-4fcf-a407-2d0a25a09a89.png,548,1347,647,1432,99,85,red blood cell,8415,0.8585858585858586,1.1647058823529413
26857,/images/2518f6e4-29cc-4ae4-a914-b215a4c56099.png,260,613,359,713,99,100,red blood cell,9900,1.0101010101010102,0.99
50721,/images/6b4c79f5-b194-4586-be9f-e339c5af4188.png,471,1044,593,1161,122,117,red blood cell,14274,0.9590163934426229,1.0427350427350428
60293,/images/7abc0d26-dd66-4ef4-8c4e-4a661e589a7f.png,521,808,623,915,102,107,red blood cell,10914,1.0490196078431373,0.9532710280373832
68541,/images/32700bc7-7a86-49d3-aded-ccaaed4ddc5c.png,215,736,337,836,122,100,red blood cell,12200,0.819672131147541,1.22
52470,/images/a2a20600-f851-4db7-90f9-6f7be027c8b5.png,734,492,818,569,84,77,red blood cell,6468,0.9166666666666666,1.0909090909090908
66520,/images/b87fb62d-2c36-4f68-aba9-37fcd7d46eef.png,245,1183,345,1288,100,105,red blood cell,10500,1.05,0.9523809523809523
3463,/images/ad36bd67-594b-4f63-93e3-886af0bc618e.png,187,1223,297,1337,110,114,red blood cell,12540,1.0363636363636364,0.9649122807017544
47373,/images/477e541c-0519-4542-9b13-8ee7922644d3.png,106,327,206,432,100,105,red blood cell,10500,1.05,0.9523809523809523
29239,/images/6274fe0d-0d71-40be-b61b-f0bd5b5df1e2.png,338,466,434,565,96,99,red blood cell,9504,1.03125,0.9696969696969697
26274,/images/52767904-4cdc-4821-ba68-8cd0c28f9023.png,7,1299,124,1420,117,121,red blood cell,14157,1.0341880341880343,0.9669421487603306
9766,/images/3859deaf-6ae1-49a3-9051-898d0f0d7de6.png,539,1098,642,1209,103,111,red blood cell,11433,1.0776699029126213,0.9279279279279279
49763,/images/5e17f8e6-fd8d-426c-b444-1515d14f04b7.png,111,402,196,492,85,90,red blood cell,7650,1.0588235294117647,0.9444444444444444
13707,/images/0b04ec46-5119-4cda-8c35-c4e5b6f0eed0.png,931,320,1034,431,103,111,red blood cell,11433,1.0776699029126213,0.9279279279279279
55998,/images/4c460388-e0c1-4970-8527-c9e5b42bea49.png,515,753,634,859,119,106,red blood cell,12614,0.8907563025210085,1.1226415094339623
68684,/images/77e76e62-2c71-4b52-9b21-0d1bcde9f9bf.png,1031,386,1141,488,110,102,red blood cell,11220,0.9272727272727272,1.0784313725490196
66755,/images/334bf865-e3fb-4200-bd53-d9ff5808ed9f.png,645,846,735,928,90,82,red blood cell,7380,0.9111111111111111,1.0975609756097562
53102,/images/04a567df-5463-4043-81f1-d726223c19a9.png,553,744,664,836,111,92,red blood cell,10212,0.8288288288288288,1.2065217391304348
45203,/images/24879caf-a327-464c-9cd9-e0f3d9161079.png,222,1260,357,1372,135,112,red blood cell,15120,0.8296296296296296,1.2053571428571428
77951,/images/c691c8ef-d3c7-47b6-a941-f6a1089f21a9.png,713,487,808,584,95,97,red blood cell,9215,1.0210526315789474,0.979381443298969
50688,/images/6b4c79f5-b194-4586-be9f-e339c5af4188.png,892,1425,1016,1543,124,118,red blood cell,14632,0.9516129032258065,1.0508474576271187
55613,/images/c32b8bb8-c89d-4ae9-9c77-5b9356ca35a1.png,204,705,320,813,116,108,red blood cell,12528,0.9310344827586207,1.0740740740740742
21751,/images/f68ae8e9-e760-4106-88e0-4bdef2785f06.png,281,1424,370,1523,89,99,red blood cell,8811,1.1123595505617978,0.898989898989899
42625,/images/184b376b-03cb-4c2d-af51-fc1a62196293.png,128,1472,235,1581,107,109,red blood cell,11663,1.0186915887850467,0.981651376146789
77040,/images/637957ef-df75-4a7b-86d5-9f6e9c042ca2.png,465,342,570,458,105,116,red blood cell,12180,1.1047619047619048,0.9051724137931034
65279,/images/45ac9409-5537-44ed-90cd-5c8a1ae0e1e0.png,568,341,696,471,128,130,red blood cell,16640,1.015625,0.9846153846153847
50526,/images/e98ea067-82b5-4a0d-87bf-b4bbdc10ddab.png,384,951,481,1047,97,96,red blood cell,9312,0.9896907216494846,1.0104166666666667
10157,/images/09ecf7be-28e2-4531-b9e2-07e01c44097d.png,220,338,327,444,107,106,red blood cell,11342,0.9906542056074766,1.009433962264151
22589,/images/406e05f0-4444-414c-bb40-f4cb08e75ac9.png,965,349,1087,476,122,127,red blood cell,15494,1.040983606557377,0.9606299212598425
31927,/images/9eb66577-7857-43dc-a879-8f2c9d7f780f.png,308,1245,409,1350,101,105,red blood cell,10605,1.0396039603960396,0.9619047619047619
71506,/images/191071ab-6515-428c-9f05-8e4309542b75.png,763,1252,853,1357,90,105,red blood cell,9450,1.1666666666666667,0.8571428571428571
15091,/images/3a8f468f-f9de-46a8-a7c8-f2be239fa207.png,779,154,883,265,104,111,red blood cell,11544,1.0673076923076923,0.9369369369369369
17607,/images/70a95e58-ba60-4c1f-adcd-49c198dc2ba0.png,986,195,1084,311,98,116,red blood cell,11368,1.183673469387755,0.8448275862068966
70873,/images/bf002a25-6535-4621-be19-56d468be5413.png,731,709,839,819,108,110,red blood cell,11880,1.0185185185185186,0.9818181818181818
59672,/images/a2754679-68b0-40f4-be01-bafad5ac1261.png,330,508,413,607,83,99,red blood cell,8217,1.1927710843373494,0.8383838383838383
6736,/images/672e4ecf-a56b-462e-b83b-76f4efaa6634.png,338,397,441,514,103,117,red blood cell,12051,1.1359223300970873,0.8803418803418803
51931,/images/4f62b14e-c6f4-4155-8f50-881558f83fae.png,390,167,508,282,118,115,red blood cell,13570,0.9745762711864406,1.0260869565217392
6280,/images/f4a27dfd-4c52-459f-96b5-ee6b452a3395.png,202,245,335,377,133,132,red blood cell,17556,0.9924812030075187,1.0075757575757576
2736,/images/a89cace5-c818-4f23-a432-052b3433b81e.png,206,1125,332,1245,126,120,red blood cell,15120,0.9523809523809523,1.05
18120,/images/947348fe-4c70-468e-8009-3c14daeca69b.png,737,1119,857,1234,120,115,red blood cell,13800,0.9583333333333334,1.0434782608695652
3224,/images/96596a68-8c95-43f3-b74e-e9506c235144.png,366,213,468,317,102,104,red blood cell,10608,1.0196078431372548,0.9807692307692307
43647,/images/a4851ed0-1499-4eae-9157-dcd34773254f.png,442,1233,545,1351,103,118,red blood cell,12154,1.145631067961165,0.8728813559322034
15702,/images/3892b776-f49a-4368-b0fa-7e855e76ccec.png,542,43,650,159,108,116,red blood cell,12528,1.0740740740740742,0.9310344827586207
30012,/images/deeaa5b3-3895-4aec-a2ce-ed6404862cdf.png,1013,218,1124,325,111,107,red blood cell,11877,0.963963963963964,1.0373831775700935
38238,/images/b834cbf7-ff97-49d9-9561-566c9343735c.png,889,1114,1013,1242,124,128,red blood cell,15872,1.032258064516129,0.96875
68157,/images/5dec94a3-e3ca-4a58-9702-88e5a83ef612.png,405,294,488,382,83,88,red blood cell,7304,1.0602409638554218,0.9431818181818182
66583,/images/087f2c9c-188d-43cc-a94c-0eb8f10ac092.png,938,1148,1058,1247,120,99,red blood cell,11880,0.825,1.2121212121212122
37171,/images/d6942996-5664-4370-ad87-2bdcbd49ac16.png,654,384,766,503,112,119,red blood cell,13328,1.0625,0.9411764705882353
78760,/images/9174f910-3859-4839-8e30-2c3b25269322.png,781,1337,886,1443,105,106,red blood cell,11130,1.0095238095238095,0.9905660377358491
74863,/images/81edcae1-65bf-4752-b0e4-494376b71e49.png,676,1432,782,1532,106,100,red blood cell,10600,0.9433962264150944,1.06
38564,/images/c3ae7090-fc68-41b4-85a1-8d9bce9825a7.png,365,1139,476,1263,111,124,red blood cell,13764,1.117117117117117,0.8951612903225806
40722,/images/252071ac-e9f2-41d2-abbb-87ef01b8a997.png,372,316,481,423,109,107,red blood cell,11663,0.981651376146789,1.0186915887850467
73990,/images/99a21c5c-f5a7-4c07-9cb6-5dda2d388f48.png,915,859,1023,963,108,104,red blood cell,11232,0.9629629629629629,1.0384615384615385
74487,/images/cbb58718-6319-48db-b84b-78ac9b12ff89.png,95,1084,201,1194,106,110,red blood cell,11660,1.0377358490566038,0.9636363636363636
74235,/images/4e43fc22-dc08-4cde-b3ce-ce8a4f377c47.png,1056,573,1153,681,97,108,red blood cell,10476,1.1134020618556701,0.8981481481481481
41714,/images/67abb826-9b70-4459-8764-da76ecf35bfe.png,1041,502,1166,638,125,136,red blood cell,17000,1.088,0.9191176470588235
5800,/images/143f5959-5b6d-4f95-bcee-9e110450fc22.png,340,1399,450,1512,110,113,red blood cell,12430,1.0272727272727273,0.9734513274336283
9913,/images/b4261fa5-876d-48ea-b6da-ec7ca5b48fe2.png,305,1440,405,1544,100,104,red blood cell,10400,1.04,0.9615384615384616
23735,/images/6b2ff7ca-c5b3-415c-9481-7b14efc6d7ef.png,738,722,842,826,104,104,red blood cell,10816,1.0,1.0
2016,/images/bfefa21c-11e1-4dab-ac5d-8ff6f046d65f.png,711,374,826,483,115,109,red blood cell,12535,0.9478260869565217,1.055045871559633
8168,/images/694222bb-cddf-469a-9526-f873c6fba58e.png,798,1483,894,1588,96,105,red blood cell,10080,1.09375,0.9142857142857143
41225,/images/eed298b3-35f2-4127-88ad-0c4a9062207b.png,693,639,796,750,103,111,red blood cell,11433,1.0776699029126213,0.9279279279279279
22552,/images/bfe65b11-8aff-46aa-908b-1e989d25fdc4.png,964,322,1087,431,123,109,red blood cell,13407,0.8861788617886179,1.128440366972477
50412,/images/a2de1248-7bc0-44dc-b508-70a357eedd68.png,276,1305,391,1425,115,120,red blood cell,13800,1.0434782608695652,0.9583333333333334
76365,/images/3dad6483-ac30-4d2b-b045-9f24fe6ff75e.png,269,442,353,534,84,92,red blood cell,7728,1.0952380952380953,0.9130434782608695
46136,/images/72088c26-d2dd-4906-b791-b8947fc7fbe4.png,745,802,853,905,108,103,red blood cell,11124,0.9537037037037037,1.0485436893203883
11194,/images/6303f964-98ef-47c6-bb2d-283aa393f918.png,41,894,128,997,87,103,red blood cell,8961,1.1839080459770115,0.8446601941747572
10491,/images/46a2d369-4bea-4405-ac78-91bbe130b9a7.png,709,1237,814,1332,105,95,red blood cell,9975,0.9047619047619048,1.105263157894737
23905,/images/3d8fb5bf-3315-48fb-8ab1-802eafd550bc.png,289,540,384,638,95,98,red blood cell,9310,1.0315789473684212,0.9693877551020408
26578,/images/4935818a-7e7a-4f44-a3b6-b361d1abfe16.png,451,361,570,478,119,117,red blood cell,13923,0.9831932773109243,1.017094017094017
33055,/images/6231d81d-9e84-4a5a-8cb8-47c6a37a0176.png,512,480,620,580,108,100,red blood cell,10800,0.9259259259259259,1.08
289,/images/0dcca702-a4ef-4fb3-a940-9c0c140b21c7.png,374,605,466,714,92,109,red blood cell,10028,1.184782608695652,0.8440366972477065
75675,/images/50d7c6c9-3230-48fe-947c-7dcfd0aad710.png,161,341,281,440,120,99,red blood cell,11880,0.825,1.2121212121212122
34820,/images/4fc9a597-aaa8-43b0-ad1c-2eabbe442e84.png,1002,1382,1112,1495,110,113,red blood cell,12430,1.0272727272727273,0.9734513274336283
53009,/images/42e87148-a015-4148-923a-fb83016f64e7.png,47,169,158,280,111,111,red blood cell,12321,1.0,1.0
73653,/images/a51d6c18-f9e8-4714-9dbb-38e1577445f2.png,744,892,830,970,86,78,red blood cell,6708,0.9069767441860465,1.1025641025641026
25495,/images/f6ab936d-924b-4038-aa47-71b07c26b4e2.png,646,1253,761,1380,115,127,red blood cell,14605,1.1043478260869566,0.905511811023622
14027,/images/eaf4b781-b3aa-41ce-8c5e-287979b4e15a.png,726,618,841,731,115,113,red blood cell,12995,0.9826086956521739,1.0176991150442478
62854,/images/4b346035-b8c0-46ca-8fdb-a01b1421ee4a.png,462,259,576,372,114,113,red blood cell,12882,0.9912280701754386,1.008849557522124
12518,/images/8e4bdd0d-1c72-4836-ae3e-05e2e50e4983.png,479,436,583,536,104,100,red blood cell,10400,0.9615384615384616,1.04
72422,/images/a15e0fa8-2620-4f66-896e-175115c9dc3d.png,937,183,1039,301,102,118,red blood cell,12036,1.1568627450980393,0.864406779661017
63939,/images/5e974892-0ebe-4037-8427-ea8616d6d3b8.png,315,610,436,711,121,101,red blood cell,12221,0.8347107438016529,1.198019801980198
69008,/images/b5246b58-6f40-4c9e-8024-f49b0ed6bdbd.png,131,408,224,499,93,91,red blood cell,8463,0.978494623655914,1.021978021978022
57794,/images/c9ad92d4-b408-4506-916e-def47b2e6ed0.png,637,1175,743,1291,106,116,red blood cell,12296,1.0943396226415094,0.9137931034482759
76748,/images/3317d733-ec0d-45e6-b631-40457392f343.png,585,116,688,210,103,94,red blood cell,9682,0.912621359223301,1.0957446808510638
24407,/images/4d8a4ce8-0f9c-4f21-8844-4cf0e5514bbf.png,615,1006,715,1093,100,87,red blood cell,8700,0.87,1.1494252873563218
36845,/images/3de03fa2-3ad3-43fc-8435-b2a80bdd7550.png,190,780,296,897,106,117,red blood cell,12402,1.1037735849056605,0.905982905982906
41422,/images/c4494d4f-732f-431a-8a9d-62403f0b74fe.png,63,291,156,393,93,102,red blood cell,9486,1.096774193548387,0.9117647058823529
78888,/images/4d0a1598-e4dd-45c4-8a90-dd7c780fe1da.png,133,1376,232,1482,99,106,red blood cell,10494,1.0707070707070707,0.9339622641509434
8145,/images/694222bb-cddf-469a-9526-f873c6fba58e.png,332,444,416,542,84,98,red blood cell,8232,1.1666666666666667,0.8571428571428571
24912,/images/ed0bee2f-05e0-4392-8357-19750cec577c.png,233,727,322,820,89,93,red blood cell,8277,1.0449438202247192,0.956989247311828
2022,/images/bfefa21c-11e1-4dab-ac5d-8ff6f046d65f.png,168,82,296,201,128,119,red blood cell,15232,0.9296875,1.0756302521008403
68021,/images/bcaefb02-682a-41b9-acc7-e6cc010f5b30.png,607,1328,690,1405,83,77,red blood cell,6391,0.927710843373494,1.077922077922078
46960,/images/9e0e1928-d19a-4100-b093-0b962ac09e05.png,655,1408,747,1512,92,104,red blood cell,9568,1.1304347826086956,0.8846153846153846
30592,/images/f939782b-f5a2-40a3-9c22-6c6d7e18edc3.png,755,268,849,374,94,106,red blood cell,9964,1.127659574468085,0.8867924528301887
13214,/images/711f6b3f-cd63-46d1-834a-bc8e9aa9b43e.png,52,852,149,942,97,90,red blood cell,8730,0.9278350515463918,1.0777777777777777
63285,/images/43bc935a-f655-45e1-a64d-fcb8b78267a6.png,335,1104,442,1216,107,112,red blood cell,11984,1.0467289719626167,0.9553571428571429
29868,/images/9cdee92c-6267-4188-a41e-125bc0abb9ae.png,197,147,308,260,111,113,red blood cell,12543,1.018018018018018,0.9823008849557522
45296,/images/9e793460-d94c-47ac-b3a7-0d6ad86357da.png,905,579,1032,703,127,124,red blood cell,15748,0.9763779527559056,1.0241935483870968
38859,/images/d79b4e90-c45d-4f5d-a498-49c3e323c291.png,370,1367,464,1463,94,96,red blood cell,9024,1.0212765957446808,0.9791666666666666
47159,/images/3d1b889e-bb4a-4ee6-b899-974ee7d956a7.png,1024,149,1122,240,98,91,red blood cell,8918,0.9285714285714286,1.0769230769230769
58231,/images/319c9c52-f316-49f3-baad-4444ab19f85b.png,358,1356,470,1472,112,116,red blood cell,12992,1.0357142857142858,0.9655172413793104
69702,/images/f0713bee-2a71-4ced-b953-4041ea99496a.png,454,523,557,636,103,113,red blood cell,11639,1.0970873786407767,0.911504424778761
39555,/images/5a631871-2fc7-4a68-9c39-f3b9a0bf4a04.png,54,370,166,484,112,114,red blood cell,12768,1.0178571428571428,0.9824561403508771
746,/images/dcc1a193-7b74-44f8-ad8d-813751d8fa6b.png,167,237,280,339,113,102,red blood cell,11526,0.9026548672566371,1.107843137254902
29526,/images/8cc6fe77-5f2f-4670-b4ac-1b49550241a8.png,865,651,977,775,112,124,red blood cell,13888,1.1071428571428572,0.9032258064516129
61001,/images/3d1429ed-4619-41f7-8ff3-d698ad28034c.png,424,726,527,825,103,99,red blood cell,10197,0.9611650485436893,1.0404040404040404
62991,/images/f234a2de-f3c8-4521-a306-8cfdf52dd597.png,431,1065,519,1155,88,90,red blood cell,7920,1.0227272727272727,0.9777777777777777
40925,/images/550cf4ce-b641-44a3-8487-3e16d4049187.png,243,44,360,160,117,116,red blood cell,13572,0.9914529914529915,1.0086206896551724
51903,/images/d67398c5-8b0e-463f-a04e-8583c820786c.png,18,1162,114,1250,96,88,red blood cell,8448,0.9166666666666666,1.0909090909090908
5938,/images/e0e6b676-c39c-4542-8adf-de257a8e92e2.png,406,876,527,989,121,113,red blood cell,13673,0.9338842975206612,1.0707964601769913
72291,/images/ee57e743-a876-4f69-9fe5-bf5d01b44689.png,505,1300,595,1403,90,103,red blood cell,9270,1.1444444444444444,0.8737864077669902
30836,/images/93a306b8-594a-4c7f-8b4a-127fb6ad8f1a.png,867,900,973,1029,106,129,red blood cell,13674,1.2169811320754718,0.8217054263565892
13360,/images/a7f1bbb1-6058-4642-bd66-cfb90dce762e.png,750,615,856,718,106,103,red blood cell,10918,0.9716981132075472,1.029126213592233
59151,/images/4736f545-1f1f-4d77-9241-d69cbf4dae35.png,307,713,399,819,92,106,red blood cell,9752,1.1521739130434783,0.8679245283018868
17979,/images/eb77e4a9-acb0-4d83-8055-2c5fcaa54b45.png,780,416,855,494,75,78,red blood cell,5850,1.04,0.9615384615384616
74861,/images/81edcae1-65bf-4752-b0e4-494376b71e49.png,356,1161,448,1254,92,93,red blood cell,8556,1.0108695652173914,0.989247311827957
47953,/images/ab27173b-6e30-4957-bd68-29194328fd39.png,231,734,320,816,89,82,red blood cell,7298,0.9213483146067416,1.0853658536585367
27554,/images/715761a2-745e-4743-9849-956a034ad3c4.png,261,1105,367,1208,106,103,red blood cell,10918,0.9716981132075472,1.029126213592233
50483,/images/833b1d3e-d389-4d0f-8638-6aca5b89f917.png,318,764,423,879,105,115,red blood cell,12075,1.0952380952380953,0.9130434782608695
34125,/images/de5d19b7-e670-4ac7-843b-7ce7bcebdf45.png,935,361,1047,478,112,117,red blood cell,13104,1.0446428571428572,0.9572649572649573
42153,/images/04c07425-57c7-415c-a0bc-36857bbd4049.png,899,357,1003,478,104,121,red blood cell,12584,1.1634615384615385,0.859504132231405
63258,/images/d3283f5b-3b3a-40ea-800b-79960ca851cb.png,399,1439,515,1555,116,116,red blood cell,13456,1.0,1.0
43338,/images/36569710-a574-40be-ad42-897a6e74a128.png,980,979,1067,1085,87,106,red blood cell,9222,1.2183908045977012,0.8207547169811321
1040,/images/63d36d2c-43a9-49ac-9504-028b4968c860.png,206,111,317,221,111,110,red blood cell,12210,0.990990990990991,1.009090909090909
9797,/images/3859deaf-6ae1-49a3-9051-898d0f0d7de6.png,779,750,868,855,89,105,red blood cell,9345,1.1797752808988764,0.8476190476190476
13386,/images/a7f1bbb1-6058-4642-bd66-cfb90dce762e.png,876,1179,1005,1305,129,126,red blood cell,16254,0.9767441860465116,1.0238095238095237
24558,/images/c03d9b87-e19b-402b-ad86-b30d6e8aeb59.png,464,250,569,338,105,88,red blood cell,9240,0.8380952380952381,1.1931818181818181
67186,/images/be6fe358-dee1-4dcf-9b0d-5d8612aba577.png,983,213,1067,299,84,86,red blood cell,7224,1.0238095238095237,0.9767441860465116
32211,/images/f4722a74-35e7-42bd-8ef6-dfff04b9cd22.png,915,1376,1036,1497,121,121,red blood cell,14641,1.0,1.0
55380,/images/4fb83278-adc5-4424-9f45-b6d0db2955b6.png,201,265,295,354,94,89,red blood cell,8366,0.9468085106382979,1.0561797752808988
33849,/images/b9de8b1a-f96a-4eb5-bc05-84ad43a054f3.png,535,378,651,498,116,120,red blood cell,13920,1.0344827586206897,0.9666666666666667
782,/images/27fab82c-5bf0-426f-aeb9-47da829b6629.png,342,671,453,762,111,91,red blood cell,10101,0.8198198198198198,1.2197802197802199
60115,/images/ec60ab26-3343-4c5f-9667-cdae999c7d86.png,761,63,864,175,103,112,red blood cell,11536,1.087378640776699,0.9196428571428571
61169,/images/80da32ce-8c22-470e-9f35-558c5f7a5df9.png,367,806,459,915,92,109,red blood cell,10028,1.184782608695652,0.8440366972477065
51715,/images/592c941a-aa54-4971-b499-dc47356f80a3.png,282,1137,363,1218,81,81,red blood cell,6561,1.0,1.0
1345,/images/6d91d1f0-636b-4f5a-a526-7c17fc857190.png,969,604,1049,704,80,100,red blood cell,8000,1.25,0.8
2452,/images/fe851c88-692d-4199-87e0-d19d9c4eb591.png,505,532,588,629,83,97,red blood cell,8051,1.1686746987951808,0.8556701030927835
28739,/images/151f3af5-5e6e-4bcd-9389-4974fc68813e.png,796,1305,907,1419,111,114,red blood cell,12654,1.027027027027027,0.9736842105263158
29706,/images/f25a2ac8-cb6e-4e05-a0cd-cc00ac47718a.png,73,784,198,910,125,126,red blood cell,15750,1.008,0.9920634920634921
62115,/images/f5c51193-8a27-4ef3-83ad-771395d63caf.png,425,944,543,1043,118,99,red blood cell,11682,0.8389830508474576,1.1919191919191918
72744,/images/caeb2d62-1166-43f0-8eac-5b8fc48f02eb.png,915,390,1034,501,119,111,red blood cell,13209,0.9327731092436975,1.072072072072072
19000,/images/e9e78ff8-831b-46e9-9785-3eee9acbfcd8.png,228,818,338,914,110,96,red blood cell,10560,0.8727272727272727,1.1458333333333333
8583,/images/a6aa3b72-2970-4c78-b655-ea8dfe6e018c.png,742,1393,839,1496,97,103,red blood cell,9991,1.0618556701030928,0.941747572815534
20889,/images/c2ec116f-f091-422c-926c-70b548a8f6ef.png,53,1408,170,1508,117,100,red blood cell,11700,0.8547008547008547,1.17
24093,/images/505355c9-23bf-4f90-8ebc-6a7ef50964d0.png,243,309,346,412,103,103,red blood cell,10609,1.0,1.0
11232,/images/6303f964-98ef-47c6-bb2d-283aa393f918.png,523,126,628,228,105,102,red blood cell,10710,0.9714285714285714,1.0294117647058822
1263,/images/6d91d1f0-636b-4f5a-a526-7c17fc857190.png,461,1325,558,1423,97,98,red blood cell,9506,1.0103092783505154,0.9897959183673469
22978,/images/b687c30d-cf15-445c-b3f6-5aca86584708.png,433,1407,550,1516,117,109,red blood cell,12753,0.9316239316239316,1.073394495412844
41118,/images/2240b991-48f6-4c59-9b62-5a8b5e541fae.png,818,62,942,199,124,137,red blood cell,16988,1.1048387096774193,0.9051094890510949
74971,/images/b4c52960-bbee-439e-83dc-f89ddaade71b.png,645,322,745,424,100,102,red blood cell,10200,1.02,0.9803921568627451
49043,/images/df3d98b9-3dd7-4107-8d4a-ae1b7f247793.png,224,1265,349,1372,125,107,red blood cell,13375,0.856,1.1682242990654206
75593,/images/c35ee701-fde2-46b5-b178-1fe3f1ea7da2.png,69,889,185,993,116,104,red blood cell,12064,0.896551724137931,1.1153846153846154
43730,/images/ef83ed4c-2724-4d5f-8abe-1a18d25cea35.png,695,1367,801,1488,106,121,red blood cell,12826,1.1415094339622642,0.8760330578512396
23091,/images/be5bb7d0-7c3f-4bb9-8bb4-f8bc8d875943.png,725,993,836,1097,111,104,red blood cell,11544,0.9369369369369369,1.0673076923076923
34733,/images/6294153c-6db3-4f2b-a8ff-9c087225e737.png,913,341,1028,449,115,108,red blood cell,12420,0.9391304347826087,1.0648148148148149
454,/images/c6d97845-8ad2-4ab7-b385-66613628df5b.png,500,1250,625,1353,125,103,red blood cell,12875,0.824,1.2135922330097086
78382,/images/24115f58-a7d6-4022-a95a-86b515a78d3e.png,947,1487,1044,1599,97,112,red blood cell,10864,1.1546391752577319,0.8660714285714286
34622,/images/a0eedcb9-b85c-4612-b945-7e8227f53c35.png,286,1288,383,1391,97,103,red blood cell,9991,1.0618556701030928,0.941747572815534
73934,/images/2ae3e6e6-7482-4ab8-ad73-b530b5c2ee3b.png,63,751,156,832,93,81,red blood cell,7533,0.8709677419354839,1.1481481481481481
79072,/images/036e008f-07a1-4e92-899d-1822dc390ccb.png,982,311,1102,424,120,113,red blood cell,13560,0.9416666666666667,1.0619469026548674
66491,/images/5f66d20c-fbfe-44ec-a01b-8a09da24807e.png,477,1507,572,1598,95,91,red blood cell,8645,0.9578947368421052,1.043956043956044
22441,/images/f97c7c87-5e27-45ea-9f93-3285d74091de.png,495,1174,594,1276,99,102,red blood cell,10098,1.0303030303030303,0.9705882352941176
32695,/images/0154dd8e-72f8-4d78-a4dd-93e139577bd1.png,264,562,390,669,126,107,red blood cell,13482,0.8492063492063492,1.1775700934579438
54411,/images/22a464ef-c3da-4d56-b37e-e22e95d945e7.png,933,1030,1043,1148,110,118,red blood cell,12980,1.0727272727272728,0.9322033898305084
55419,/images/d67655e6-0a80-4a86-b552-1f5e85788377.png,448,904,543,999,95,95,red blood cell,9025,1.0,1.0
11317,/images/2f6224be-50d0-4e85-94ef-88315df561b6.png,393,186,495,293,102,107,red blood cell,10914,1.0490196078431373,0.9532710280373832
887,/images/dce55b59-c6c3-4693-aa75-6b348c8f52cd.png,768,1399,876,1504,108,105,red blood cell,11340,0.9722222222222222,1.0285714285714285
61358,/images/e16c0dab-780d-4035-872e-1bb91e49f9d2.png,464,856,563,965,99,109,red blood cell,10791,1.101010101010101,0.908256880733945
23111,/images/be5bb7d0-7c3f-4bb9-8bb4-f8bc8d875943.png,902,446,1008,539,106,93,red blood cell,9858,0.8773584905660378,1.1397849462365592
58977,/images/a0eeeb10-d0cb-48d9-8c22-2c3a3c908d00.png,949,290,1047,396,98,106,red blood cell,10388,1.0816326530612246,0.9245283018867925
37584,/images/205306da-0ed8-475a-ace6-f2f81d4be88a.png,988,661,1084,748,96,87,red blood cell,8352,0.90625,1.103448275862069
62384,/images/9af1ee02-87fd-42bc-963e-fa9ac3eb45bb.png,1029,16,1140,129,111,113,red blood cell,12543,1.018018018018018,0.9823008849557522
35879,/images/33068c1a-48f7-470b-8e49-e2f0888042e9.png,491,1431,593,1540,102,109,red blood cell,11118,1.0686274509803921,0.9357798165137615
12423,/images/cc94eabb-a3dc-4cfc-9fff-55c76b5b4a71.png,432,713,529,814,97,101,red blood cell,9797,1.041237113402062,0.9603960396039604
21896,/images/d57b3894-c912-47e8-b00a-e1a2a7aba644.png,964,1181,1074,1311,110,130,red blood cell,14300,1.1818181818181819,0.8461538461538461
19856,/images/b318889c-3c60-477c-b8f6-d18cb01a59df.png,1103,386,1198,487,95,101,red blood cell,9595,1.063157894736842,0.9405940594059405
65961,/images/25c6cfb1-01d0-4864-87f9-02b7593683c7.png,151,1470,245,1565,94,95,red blood cell,8930,1.0106382978723405,0.9894736842105263
55175,/images/29d4b75f-d400-4702-a9ac-e5a4ed1a1db1.png,402,947,490,1035,88,88,red blood cell,7744,1.0,1.0
77659,/images/07d15855-eb9b-46a9-b894-7cfe4d097826.png,199,7,295,108,96,101,red blood cell,9696,1.0520833333333333,0.9504950495049505
35304,/images/516bf1d5-5d00-4985-926c-3993e9bc3ff5.png,1047,1309,1187,1427,140,118,red blood cell,16520,0.8428571428571429,1.1864406779661016
52557,/images/0546d843-d778-4aca-b8b5-bfe23d7c87da.png,840,676,940,784,100,108,red blood cell,10800,1.08,0.9259259259259259
48545,/images/f3d84be2-8af0-4d62-9f72-23d3dc08cbbe.png,991,611,1113,717,122,106,red blood cell,12932,0.8688524590163934,1.150943396226415
74682,/images/5ccca8ee-abea-458a-a891-bedd31c3ddc3.png,64,97,167,196,103,99,red blood cell,10197,0.9611650485436893,1.0404040404040404
27056,/images/ec301f62-1302-4407-96f9-fcfe45c150ae.png,1061,257,1196,365,135,108,red blood cell,14580,0.8,1.25
3512,/images/ad36bd67-594b-4f63-93e3-886af0bc618e.png,473,865,575,990,102,125,red blood cell,12750,1.2254901960784315,0.816
14057,/images/eaf4b781-b3aa-41ce-8c5e-287979b4e15a.png,293,539,386,638,93,99,red blood cell,9207,1.064516129032258,0.9393939393939394
53183,/images/801296d9-3403-426f-859e-5c532858e025.png,1065,43,1198,172,133,129,red blood cell,17157,0.9699248120300752,1.0310077519379846
3973,/images/f09acb0c-b270-4e91-99f8-410adfa7f34a.png,966,614,1066,708,100,94,red blood cell,9400,0.94,1.0638297872340425
66714,/images/334bf865-e3fb-4200-bd53-d9ff5808ed9f.png,401,1412,507,1521,106,109,red blood cell,11554,1.028301886792453,0.9724770642201835
75475,/images/6c20abb2-c4bb-4de0-8774-03f4d30ce93d.png,854,373,984,495,130,122,red blood cell,15860,0.9384615384615385,1.0655737704918034
52254,/images/4903d9c7-de88-426a-b42d-a7e797e5ebcd.png,819,1472,919,1591,100,119,red blood cell,11900,1.19,0.8403361344537815
8452,/images/ae779806-6d01-4dc6-89df-294c368db6bc.png,271,432,379,567,108,135,red blood cell,14580,1.25,0.8
47274,/images/1dd3e6dd-343f-4cc9-b0ed-e4d27fb36f0a.png,75,1110,202,1238,127,128,red blood cell,16256,1.0078740157480315,0.9921875
15589,/images/169d541c-daed-468e-8b41-0f1abccdf319.png,690,18,818,124,128,106,red blood cell,13568,0.828125,1.2075471698113207
20499,/images/cbde7f7e-2458-4dda-9db2-3d5ccf950ced.png,494,607,630,737,136,130,red blood cell,17680,0.9558823529411765,1.0461538461538462
34846,/images/4fc9a597-aaa8-43b0-ad1c-2eabbe442e84.png,961,306,1061,397,100,91,red blood cell,9100,0.91,1.098901098901099
11225,/images/6303f964-98ef-47c6-bb2d-283aa393f918.png,140,183,228,260,88,77,red blood cell,6776,0.875,1.1428571428571428
8564,/images/a6aa3b72-2970-4c78-b655-ea8dfe6e018c.png,460,1017,582,1149,122,132,red blood cell,16104,1.0819672131147542,0.9242424242424242
58611,/images/a4d7a7e1-5ae1-486d-b6ee-c9af1476ccad.png,618,885,743,1003,125,118,red blood cell,14750,0.944,1.0593220338983051
32189,/images/07346d2e-a6e6-4dc0-95f1-9f7d8d7e3f66.png,238,114,335,208,97,94,red blood cell,9118,0.9690721649484536,1.0319148936170213
5607,/images/75c243e2-610d-4d5a-bc5a-4c53d99d9ae9.png,26,133,146,245,120,112,red blood cell,13440,0.9333333333333333,1.0714285714285714
72495,/images/22516db4-8687-4051-90c4-2bb1ca3204a5.png,796,1230,905,1361,109,131,red blood cell,14279,1.201834862385321,0.8320610687022901
43599,/images/e0ef520d-7b65-485d-9888-e6859f189f70.png,58,1241,184,1355,126,114,red blood cell,14364,0.9047619047619048,1.105263157894737
68792,/images/aa3ad405-828e-4986-8251-20fd981f34d3.png,447,699,563,818,116,119,red blood cell,13804,1.0258620689655173,0.9747899159663865
30588,/images/7d9c1422-6332-44e9-b134-3ac94f07b0f0.png,689,0,791,107,102,107,red blood cell,10914,1.0490196078431373,0.9532710280373832
37435,/images/c6530038-6d4e-49e1-8427-d1d3acc9fa21.png,67,272,184,381,117,109,red blood cell,12753,0.9316239316239316,1.073394495412844
27077,/images/ec301f62-1302-4407-96f9-fcfe45c150ae.png,270,292,383,389,113,97,red blood cell,10961,0.8584070796460177,1.1649484536082475
26333,/images/580210c2-a8ed-4720-b71c-a77945968abc.png,138,312,267,429,129,117,red blood cell,15093,0.9069767441860465,1.1025641025641026
29715,/images/f25a2ac8-cb6e-4e05-a0cd-cc00ac47718a.png,744,1347,865,1471,121,124,red blood cell,15004,1.024793388429752,0.9758064516129032
19950,/images/0ca25c88-457f-4f03-bbc1-98fb6663f1d1.png,184,1401,283,1489,99,88,red blood cell,8712,0.8888888888888888,1.125
14346,/images/f5eb7c5e-bd77-4638-ba9f-58d42f87476b.png,671,751,788,852,117,101,red blood cell,11817,0.8632478632478633,1.1584158415841583
54368,/images/19370afd-f897-47d8-bfae-c0d257bbf795.png,55,958,146,1054,91,96,red blood cell,8736,1.054945054945055,0.9479166666666666
14983,/images/5d1418d3-1559-4725-ad4a-9afb6eaecdfd.png,791,332,895,434,104,102,red blood cell,10608,0.9807692307692307,1.0196078431372548
24637,/images/30948737-0d0d-4b68-b9ab-50577e0fe026.png,383,415,515,549,132,134,red blood cell,17688,1.0151515151515151,0.9850746268656716
63931,/images/5e974892-0ebe-4037-8427-ea8616d6d3b8.png,16,933,105,1026,89,93,red blood cell,8277,1.0449438202247192,0.956989247311828
22216,/images/3d4d7ba7-6c7c-4ddd-b282-31fb5d80edb5.png,881,74,989,189,108,115,red blood cell,12420,1.0648148148148149,0.9391304347826087
22596,/images/406e05f0-4444-414c-bb40-f4cb08e75ac9.png,461,316,581,416,120,100,red blood cell,12000,0.8333333333333334,1.2
14335,/images/f5eb7c5e-bd77-4638-ba9f-58d42f87476b.png,320,951,444,1083,124,132,red blood cell,16368,1.064516129032258,0.9393939393939394
76510,/images/38c69905-8a4f-451a-8d0a-b855dc88dd16.png,389,737,485,837,96,100,red blood cell,9600,1.0416666666666667,0.96
26115,/images/27388ff2-4000-4c9a-a2e3-addc448a5f92.png,124,411,247,536,123,125,red blood cell,15375,1.016260162601626,0.984
19764,/images/68e69cfb-1a07-48d2-8abe-46b46fe264ed.png,848,295,960,405,112,110,red blood cell,12320,0.9821428571428571,1.018181818181818
29188,/images/6274fe0d-0d71-40be-b61b-f0bd5b5df1e2.png,946,928,1049,1017,103,89,red blood cell,9167,0.8640776699029126,1.1573033707865168
22044,/images/c5acd0ad-b0f2-478d-b0ad-5aa733aa7b32.png,391,106,520,238,129,132,red blood cell,17028,1.0232558139534884,0.9772727272727273
59871,/images/1519257c-e3e5-4474-908f-8665b3cf1258.png,993,826,1092,927,99,101,red blood cell,9999,1.02020202020202,0.9801980198019802
53302,/images/d8f7e159-b7e3-49e4-86e8-aed8c5fbcd97.png,1092,807,1180,901,88,94,red blood cell,8272,1.0681818181818181,0.9361702127659575
33416,/images/f632981c-1330-4078-8a12-691beb2dab02.png,659,515,764,620,105,105,red blood cell,11025,1.0,1.0
24625,/images/c03d9b87-e19b-402b-ad86-b30d6e8aeb59.png,255,1510,338,1600,83,90,red blood cell,7470,1.0843373493975903,0.9222222222222223
1767,/images/5f783f43-0090-4f8a-bd75-9562f4aa2dd5.png,932,807,1026,910,94,103,red blood cell,9682,1.0957446808510638,0.912621359223301
35469,/images/3722d213-f2a9-46d5-aa76-9183b443e455.png,25,828,147,948,122,120,red blood cell,14640,0.9836065573770492,1.0166666666666666
52279,/images/4903d9c7-de88-426a-b42d-a7e797e5ebcd.png,665,469,768,566,103,97,red blood cell,9991,0.941747572815534,1.0618556701030928
52077,/images/de6d3020-9347-473b-9146-8909627790f6.png,288,361,388,454,100,93,red blood cell,9300,0.93,1.075268817204301
39036,/images/79806898-0214-44bd-ba2c-b570e911be62.png,857,548,970,666,113,118,red blood cell,13334,1.0442477876106195,0.9576271186440678
15022,/images/3003252a-2d2e-4687-ad30-9c38d68f1394.png,323,1498,443,1597,120,99,red blood cell,11880,0.825,1.2121212121212122
59074,/images/5e2cea49-0823-49d1-83cf-8fd1559cdd93.png,227,989,331,1097,104,108,red blood cell,11232,1.0384615384615385,0.9629629629629629
22733,/images/8490c623-3d88-4532-baf5-0d266a45b16f.png,282,885,405,1000,123,115,red blood cell,14145,0.9349593495934959,1.0695652173913044
56761,/images/0dcbf2c9-f959-4703-a72b-f6a81e66c2ea.png,525,210,625,324,100,114,red blood cell,11400,1.14,0.8771929824561403
7895,/images/98c25ffe-c329-420a-bc22-b082f565eac9.png,757,950,885,1083,128,133,red blood cell,17024,1.0390625,0.9624060150375939
50361,/images/3d32a988-449d-4d58-b71f-abbfdc3f2fbc.png,985,887,1093,987,108,100,red blood cell,10800,0.9259259259259259,1.08
66032,/images/c8af0297-ce1f-40ea-bf44-9256dcdae4e9.png,701,170,814,287,113,117,red blood cell,13221,1.0353982300884956,0.9658119658119658
6285,/images/f4a27dfd-4c52-459f-96b5-ee6b452a3395.png,505,54,632,177,127,123,red blood cell,15621,0.968503937007874,1.032520325203252
71745,/images/093a831a-bf71-4333-bc06-942ae70cb164.png,844,1046,950,1166,106,120,red blood cell,12720,1.1320754716981132,0.8833333333333333
30215,/images/f81806a8-5883-446c-be78-f0145b12dbdd.png,391,1444,502,1548,111,104,red blood cell,11544,0.9369369369369369,1.0673076923076923
16520,/images/1315c2a4-0794-4dfa-a709-e2451723d2b6.png,235,231,352,373,117,142,red blood cell,16614,1.2136752136752136,0.823943661971831
25566,/images/f6ab936d-924b-4038-aa47-71b07c26b4e2.png,311,1466,426,1589,115,123,red blood cell,14145,1.0695652173913044,0.9349593495934959
2481,/images/a23f5539-bfe6-4885-9a0e-dba972475ea9.png,931,1228,1032,1328,101,100,red blood cell,10100,0.9900990099009901,1.01
65243,/images/45ac9409-5537-44ed-90cd-5c8a1ae0e1e0.png,643,1059,772,1184,129,125,red blood cell,16125,0.9689922480620154,1.032
5725,/images/d3dcdf92-9328-4796-adf4-918646877ba1.png,605,930,728,1051,123,121,red blood cell,14883,0.983739837398374,1.0165289256198347
29801,/images/7ef90770-6aeb-45eb-9744-49c5247dde30.png,854,1174,935,1268,81,94,red blood cell,7614,1.1604938271604939,0.8617021276595744
21973,/images/393df10a-5d64-476b-88f5-14ac56d6ed60.png,847,475,964,603,117,128,red blood cell,14976,1.0940170940170941,0.9140625
69576,/images/4a49841f-216c-4815-8140-b8762c4f6603.png,644,304,744,410,100,106,red blood cell,10600,1.06,0.9433962264150944
10571,/images/20d4f65e-6c63-433a-935c-d568d577967b.png,468,1255,564,1359,96,104,red blood cell,9984,1.0833333333333333,0.9230769230769231
58323,/images/319c9c52-f316-49f3-baad-4444ab19f85b.png,178,270,276,364,98,94,red blood cell,9212,0.9591836734693877,1.0425531914893618
76060,/images/4c7d2382-a962-4237-a053-955eea3decd8.png,760,409,848,496,88,87,red blood cell,7656,0.9886363636363636,1.0114942528735633
40975,/images/bbe65c18-8a56-4dfe-875c-94e124a84125.png,734,1375,846,1503,112,128,red blood cell,14336,1.1428571428571428,0.875
35066,/images/67582df6-bf13-4c83-a531-1214692b70de.png,616,323,733,437,117,114,red blood cell,13338,0.9743589743589743,1.0263157894736843
9559,/images/a18f122f-3a3e-4478-8ac4-91b83e050e65.png,609,589,728,715,119,126,red blood cell,14994,1.0588235294117647,0.9444444444444444
15090,/images/3a8f468f-f9de-46a8-a7c8-f2be239fa207.png,849,970,962,1084,113,114,red blood cell,12882,1.008849557522124,0.9912280701754386
79855,/images/a054a8e2-55f2-4508-97df-207f76b89be2.png,395,278,521,396,126,118,red blood cell,14868,0.9365079365079365,1.0677966101694916
6518,/images/640c4a52-3742-4f57-aee3-9e3dc0887622.png,585,1177,689,1269,104,92,red blood cell,9568,0.8846153846153846,1.1304347826086956
64116,/images/0d3c2521-da55-4df5-bf06-56b3bd4fb2fc.png,485,707,581,802,96,95,red blood cell,9120,0.9895833333333334,1.0105263157894737
21704,/images/81af1442-d835-46bf-b80b-a898dba3da1b.png,807,726,932,862,125,136,red blood cell,17000,1.088,0.9191176470588235
10202,/images/e3ea07d7-884a-412e-874a-40fd6b856736.png,450,80,559,206,109,126,red blood cell,13734,1.1559633027522935,0.8650793650793651
34434,/images/b4bde4e8-f48b-4ae2-be01-86d8c91d0af9.png,668,202,775,310,107,108,red blood cell,11556,1.0093457943925233,0.9907407407407407
63194,/images/f0804a5e-e7f5-4cf2-a5df-b65e66502bf1.png,62,1329,168,1417,106,88,red blood cell,9328,0.8301886792452831,1.2045454545454546
37585,/images/205306da-0ed8-475a-ace6-f2f81d4be88a.png,670,60,760,151,90,91,red blood cell,8190,1.011111111111111,0.989010989010989
30369,/images/58d75854-be99-484e-89f0-4ab208fe07e0.png,1022,622,1123,737,101,115,red blood cell,11615,1.1386138613861385,0.8782608695652174
17326,/images/3d302619-473d-4c5b-af43-8833ff94233f.png,864,405,970,520,106,115,red blood cell,12190,1.0849056603773586,0.9217391304347826
4501,/images/0f26699f-a776-4424-b092-27da9a1d12e2.png,981,107,1089,211,108,104,red blood cell,11232,0.9629629629629629,1.0384615384615385
33182,/images/6231d81d-9e84-4a5a-8cb8-47c6a37a0176.png,807,1292,905,1401,98,109,red blood cell,10682,1.1122448979591837,0.8990825688073395
24652,/images/30948737-0d0d-4b68-b9ab-50577e0fe026.png,721,333,822,433,101,100,red blood cell,10100,0.9900990099009901,1.01
10341,/images/affa429c-0315-4c18-a002-13bb3ecab259.png,831,1073,934,1194,103,121,red blood cell,12463,1.174757281553398,0.8512396694214877
53474,/images/43158031-a335-4533-9c20-48bebba90123.png,1079,1245,1176,1342,97,97,red blood cell,9409,1.0,1.0
74179,/images/4e43fc22-dc08-4cde-b3ce-ce8a4f377c47.png,865,702,961,819,96,117,red blood cell,11232,1.21875,0.8205128205128205
552,/images/67acd5bc-4658-4c6e-a9b9-cd8ea3a03418.png,153,687,275,803,122,116,red blood cell,14152,0.9508196721311475,1.0517241379310345
36728,/images/aa2dfa24-2dc3-4279-a232-f84780ace190.png,991,1020,1109,1134,118,114,red blood cell,13452,0.9661016949152542,1.0350877192982457
287,/images/0dcca702-a4ef-4fb3-a940-9c0c140b21c7.png,388,313,489,411,101,98,red blood cell,9898,0.9702970297029703,1.030612244897959
59707,/images/a2754679-68b0-40f4-be01-bafad5ac1261.png,731,1239,821,1335,90,96,red blood cell,8640,1.0666666666666667,0.9375
27626,/images/a0785022-e82b-4878-b9d4-19cb7b75213f.png,936,1424,1060,1536,124,112,red blood cell,13888,0.9032258064516129,1.1071428571428572
62824,/images/631340cc-cedf-4bca-a3d8-a0731a5482b4.png,194,576,294,691,100,115,red blood cell,11500,1.15,0.8695652173913043
74669,/images/5ccca8ee-abea-458a-a891-bedd31c3ddc3.png,304,71,422,169,118,98,red blood cell,11564,0.8305084745762712,1.2040816326530612
8193,/images/6bb4892c-27a9-4642-aba1-4b73f38f757c.png,676,805,787,902,111,97,red blood cell,10767,0.8738738738738738,1.1443298969072164
70622,/images/4ce5a070-9ede-4bb1-9ca2-1bae5746776b.png,664,608,788,722,124,114,red blood cell,14136,0.9193548387096774,1.087719298245614
42514,/images/29648565-fe28-4517-ba72-68df0c82c9c5.png,162,1089,265,1192,103,103,red blood cell,10609,1.0,1.0
61903,/images/f32b21ae-5ca7-490b-bc40-6db9396d933c.png,676,1229,763,1316,87,87,red blood cell,7569,1.0,1.0
56310,/images/6b473806-e936-4b19-98cf-a2b94cac35ff.png,685,1147,820,1284,135,137,red blood cell,18495,1.0148148148148148,0.9854014598540146
74697,/images/5ccca8ee-abea-458a-a891-bedd31c3ddc3.png,949,264,1047,367,98,103,red blood cell,10094,1.0510204081632653,0.9514563106796117
38780,/images/b426ef1d-4a59-4f90-b593-50226af60a60.png,1079,1340,1180,1453,101,113,red blood cell,11413,1.118811881188119,0.8938053097345132
13103,/images/711f6b3f-cd63-46d1-834a-bc8e9aa9b43e.png,779,782,888,880,109,98,red blood cell,10682,0.8990825688073395,1.1122448979591837
79403,/images/dcb21739-3c36-459d-b3cc-1be5871d6fe7.png,1082,708,1172,798,90,90,red blood cell,8100,1.0,1.0
10653,/images/20d4f65e-6c63-433a-935c-d568d577967b.png,379,470,481,585,102,115,red blood cell,11730,1.1274509803921569,0.8869565217391304
46124,/images/72088c26-d2dd-4906-b791-b8947fc7fbe4.png,405,116,496,217,91,101,red blood cell,9191,1.10989010989011,0.900990099009901
61398,/images/e16c0dab-780d-4035-872e-1bb91e49f9d2.png,347,60,440,169,93,109,red blood cell,10137,1.1720430107526882,0.8532110091743119
74741,/images/c53fd511-31bd-4901-baac-3b44891f6744.png,56,896,166,998,110,102,red blood cell,11220,0.9272727272727272,1.0784313725490196
65852,/images/daea4860-a296-4f6d-acef-996ab0882676.png,946,1269,1038,1346,92,77,red blood cell,7084,0.8369565217391305,1.1948051948051948
27718,/images/e3c1442a-717f-41dd-bf97-81e1233ac9fa.png,135,1168,240,1264,105,96,red blood cell,10080,0.9142857142857143,1.09375
33360,/images/f632981c-1330-4078-8a12-691beb2dab02.png,244,988,349,1085,105,97,red blood cell,10185,0.9238095238095239,1.0824742268041236
15758,/images/64113b22-03b1-4ab8-89ab-b2f32154fbbd.png,822,1282,929,1385,107,103,red blood cell,11021,0.9626168224299065,1.0388349514563107
52986,/images/e81bf478-27ff-458c-ac30-9e1f8480bc5c.png,574,0,679,99,105,99,red blood cell,10395,0.9428571428571428,1.0606060606060606
13219,/images/711f6b3f-cd63-46d1-834a-bc8e9aa9b43e.png,108,1314,206,1396,98,82,red blood cell,8036,0.8367346938775511,1.1951219512195121
23309,/images/e5731221-814c-4894-a44e-e46b71460fa4.png,1009,997,1120,1098,111,101,red blood cell,11211,0.9099099099099099,1.099009900990099
63504,/images/44b4a765-104e-4182-8871-e933c83c91ef.png,267,673,381,786,114,113,red blood cell,12882,0.9912280701754386,1.008849557522124
16974,/images/8eeb378e-90f0-47ea-ac1c-2a201eb8d090.png,103,1255,215,1369,112,114,red blood cell,12768,1.0178571428571428,0.9824561403508771
41931,/images/46a03374-64c7-49ac-81c9-c3d62542bbf3.png,1018,1103,1126,1197,108,94,red blood cell,10152,0.8703703703703703,1.148936170212766
78654,/images/fd1c4c7a-24bc-43f2-b84f-fee182207aee.png,1060,1379,1171,1487,111,108,red blood cell,11988,0.972972972972973,1.0277777777777777
30710,/images/8e0dfc1f-e3eb-4a3f-a1c4-249bdfbfaa27.png,1071,798,1184,921,113,123,red blood cell,13899,1.0884955752212389,0.9186991869918699
62731,/images/9e1b0217-0926-4fd1-bb9e-a815c05deb59.png,1088,655,1199,767,111,112,red blood cell,12432,1.009009009009009,0.9910714285714286
70430,/images/8cca114a-ed05-4b87-95b7-fae02487f08c.png,387,452,506,552,119,100,red blood cell,11900,0.8403361344537815,1.19
61766,/images/985627c9-7b85-40de-a106-eb9cc47b47cb.png,959,377,1058,478,99,101,red blood cell,9999,1.02020202020202,0.9801980198019802
10976,/images/c442e2d6-aaf9-417a-9905-4737a1115f33.png,834,872,957,984,123,112,red blood cell,13776,0.9105691056910569,1.0982142857142858
65978,/images/25c6cfb1-01d0-4864-87f9-02b7593683c7.png,477,969,569,1082,92,113,red blood cell,10396,1.2282608695652173,0.8141592920353983
51458,/images/baa87bf8-786c-444c-81e8-9fa0a41d8149.png,428,977,518,1071,90,94,red blood cell,8460,1.0444444444444445,0.9574468085106383
56058,/images/177a3141-fa93-426a-9b52-7da71547ce44.png,161,1516,256,1593,95,77,red blood cell,7315,0.8105263157894737,1.2337662337662338
69424,/images/fde0fd54-49cc-42e1-90c6-6b612cd062d8.png,947,1237,1048,1344,101,107,red blood cell,10807,1.0594059405940595,0.9439252336448598
76072,/images/4c7d2382-a962-4237-a053-955eea3decd8.png,27,595,131,723,104,128,red blood cell,13312,1.2307692307692308,0.8125
27631,/images/a0785022-e82b-4878-b9d4-19cb7b75213f.png,473,472,576,588,103,116,red blood cell,11948,1.1262135922330097,0.8879310344827587
52939,/images/e81bf478-27ff-458c-ac30-9e1f8480bc5c.png,429,1073,537,1170,108,97,red blood cell,10476,0.8981481481481481,1.1134020618556701
38628,/images/3b601a1b-26d8-4873-afcf-fdd1b1e0010c.png,158,1005,267,1123,109,118,red blood cell,12862,1.0825688073394495,0.923728813559322
49693,/images/9842445c-5899-4189-9f2e-3a3a179fdad3.png,662,990,780,1102,118,112,red blood cell,13216,0.9491525423728814,1.0535714285714286
69832,/images/2bd15b6e-fe2d-49f3-b394-940d024d1f91.png,574,933,654,1013,80,80,red blood cell,6400,1.0,1.0
10383,/images/46a2d369-4bea-4405-ac78-91bbe130b9a7.png,620,564,715,666,95,102,red blood cell,9690,1.0736842105263158,0.9313725490196079
55225,/images/8ad7ba46-5db8-4ba9-b3e0-3cac52f7efc3.png,944,711,1042,805,98,94,red blood cell,9212,0.9591836734693877,1.0425531914893618
35652,/images/45f18ac0-f097-4b20-a99d-8837cf488822.png,66,1013,184,1114,118,101,red blood cell,11918,0.8559322033898306,1.1683168316831682
56578,/images/a824b499-3736-4581-bbdc-be1b3b4cf756.png,982,1292,1073,1396,91,104,red blood cell,9464,1.1428571428571428,0.875
64080,/images/0d3c2521-da55-4df5-bf06-56b3bd4fb2fc.png,923,380,1031,486,108,106,red blood cell,11448,0.9814814814814815,1.0188679245283019
72934,/images/a20d0b4b-6e2e-4507-bc22-f321dedc4ed9.png,721,405,833,510,112,105,red blood cell,11760,0.9375,1.0666666666666667
2266,/images/fe851c88-692d-4199-87e0-d19d9c4eb591.png,1042,521,1142,605,100,84,red blood cell,8400,0.84,1.1904761904761905
24481,/images/109fbb82-bc3c-41ac-984d-e2da86202873.png,114,230,231,357,117,127,red blood cell,14859,1.0854700854700854,0.9212598425196851
8112,/images/694222bb-cddf-469a-9526-f873c6fba58e.png,128,50,219,144,91,94,red blood cell,8554,1.032967032967033,0.9680851063829787
55015,/images/7beee655-6156-43b8-b185-dbae0eaf7f45.png,299,1224,433,1354,134,130,red blood cell,17420,0.9701492537313433,1.0307692307692307
41390,/images/65e8b0cd-05d1-4c8d-8efd-24bf71df3167.png,592,1109,706,1236,114,127,red blood cell,14478,1.1140350877192982,0.8976377952755905
40667,/images/252071ac-e9f2-41d2-abbb-87ef01b8a997.png,838,940,935,1054,97,114,red blood cell,11058,1.175257731958763,0.8508771929824561
61285,/images/b3058064-d817-47dd-a8c4-cdb1f62374f8.png,897,1026,998,1131,101,105,red blood cell,10605,1.0396039603960396,0.9619047619047619
50355,/images/3d32a988-449d-4d58-b71f-abbfdc3f2fbc.png,832,476,930,565,98,89,red blood cell,8722,0.9081632653061225,1.101123595505618
68216,/images/ff1b23d0-3cef-459b-b81f-39bfcdb6526f.png,170,86,266,191,96,105,red blood cell,10080,1.09375,0.9142857142857143
46849,/images/63055d1b-5221-4c80-8b39-37ac069a1b5c.png,455,502,578,632,123,130,red blood cell,15990,1.056910569105691,0.9461538461538461
39071,/images/8f96ee1f-4ef7-4279-a610-316319bedcf9.png,585,398,712,537,127,139,red blood cell,17653,1.094488188976378,0.9136690647482014
67187,/images/be6fe358-dee1-4dcf-9b0d-5d8612aba577.png,375,1348,483,1453,108,105,red blood cell,11340,0.9722222222222222,1.0285714285714285
36777,/images/aa2dfa24-2dc3-4279-a232-f84780ace190.png,139,1457,248,1561,109,104,red blood cell,11336,0.9541284403669725,1.0480769230769231
32887,/images/e40000b4-1b26-42ce-909d-4715e04f0a6e.png,641,529,754,643,113,114,red blood cell,12882,1.008849557522124,0.9912280701754386
9493,/images/f1faab5f-3033-45ea-9673-8b816fea5ce8.png,633,1337,756,1450,123,113,red blood cell,13899,0.9186991869918699,1.0884955752212389
53095,/images/04a567df-5463-4043-81f1-d726223c19a9.png,599,1187,706,1288,107,101,red blood cell,10807,0.9439252336448598,1.0594059405940595
72189,/images/005e60b6-77b8-458c-b57c-bfe0c7e7df78.png,752,1050,848,1146,96,96,red blood cell,9216,1.0,1.0
38630,/images/3b601a1b-26d8-4873-afcf-fdd1b1e0010c.png,65,964,172,1079,107,115,red blood cell,12305,1.074766355140187,0.9304347826086956
74327,/images/8939e14b-fcdf-48b1-acb9-6514a2fc2fc0.png,971,285,1050,374,79,89,red blood cell,7031,1.1265822784810127,0.8876404494382022
343,/images/7c66d2fd-68ee-4628-b860-9d7ad25b2a80.png,724,1296,826,1409,102,113,red blood cell,11526,1.107843137254902,0.9026548672566371
34632,/images/a0eedcb9-b85c-4612-b945-7e8227f53c35.png,346,1336,448,1449,102,113,red blood cell,11526,1.107843137254902,0.9026548672566371
49992,/images/b1145408-feae-4637-b4cf-3e70b99cc62d.png,539,961,644,1071,105,110,red blood cell,11550,1.0476190476190477,0.9545454545454546
74100,/images/9fe8bdc8-847d-434e-93e5-ae14ff3b45e1.png,121,155,239,274,118,119,red blood cell,14042,1.0084745762711864,0.9915966386554622
22674,/images/4ab47131-c2ac-461f-b95c-ac19ce24edbd.png,399,341,510,444,111,103,red blood cell,11433,0.9279279279279279,1.0776699029126213
68147,/images/5dec94a3-e3ca-4a58-9702-88e5a83ef612.png,921,969,1012,1076,91,107,red blood cell,9737,1.1758241758241759,0.8504672897196262
34104,/images/de5d19b7-e670-4ac7-843b-7ce7bcebdf45.png,51,402,154,506,103,104,red blood cell,10712,1.0097087378640777,0.9903846153846154
39481,/images/5a631871-2fc7-4a68-9c39-f3b9a0bf4a04.png,465,1317,572,1432,107,115,red blood cell,12305,1.074766355140187,0.9304347826086956
35155,/images/bfc61c48-685d-470b-86b1-e4c7eb85c4fd.png,169,1144,290,1268,121,124,red blood cell,15004,1.024793388429752,0.9758064516129032
34910,/images/a4fbb9f2-9b75-4fdc-877d-2feaafac25b3.png,218,543,314,651,96,108,red blood cell,10368,1.125,0.8888888888888888
65403,/images/b523daee-317b-461d-bdc1-07b4add4d488.png,920,1299,1012,1401,92,102,red blood cell,9384,1.108695652173913,0.9019607843137255
42370,/images/1a27ebe9-93a1-4898-af69-f276057d4012.png,719,910,836,1040,117,130,red blood cell,15210,1.1111111111111112,0.9
70830,/images/b62d47f9-2ff5-4902-abdc-b3610acfc7ba.png,717,1,810,87,93,86,red blood cell,7998,0.9247311827956989,1.0813953488372092
58540,/images/7fd2d254-b062-4f3d-8970-687e73c5a00a.png,121,491,240,601,119,110,red blood cell,13090,0.9243697478991597,1.0818181818181818
69543,/images/664c570b-4822-413c-9724-11b1d91fac44.png,412,1512,503,1600,91,88,red blood cell,8008,0.967032967032967,1.0340909090909092
61257,/images/b3058064-d817-47dd-a8c4-cdb1f62374f8.png,728,1088,847,1197,119,109,red blood cell,12971,0.9159663865546218,1.091743119266055
10458,/images/46a2d369-4bea-4405-ac78-91bbe130b9a7.png,112,251,203,350,91,99,red blood cell,9009,1.0879120879120878,0.9191919191919192
20302,/images/98976666-9125-47fe-9601-43c41e58dfb4.png,608,189,719,297,111,108,red blood cell,11988,0.972972972972973,1.0277777777777777
3948,/images/f09acb0c-b270-4e91-99f8-410adfa7f34a.png,370,577,478,677,108,100,red blood cell,10800,0.9259259259259259,1.08
4945,/images/755e5bf8-e8e1-492b-a32f-f7d87cccaa40.png,435,204,553,320,118,116,red blood cell,13688,0.9830508474576272,1.0172413793103448
53587,/images/7c1cd7c7-7452-4428-a98e-dd7675c8ddea.png,1032,744,1139,832,107,88,red blood cell,9416,0.822429906542056,1.2159090909090908
7690,/images/9f959520-e15e-45c2-bc29-ef3c19154d1c.png,754,1338,852,1445,98,107,red blood cell,10486,1.0918367346938775,0.9158878504672897
75653,/images/50d7c6c9-3230-48fe-947c-7dcfd0aad710.png,662,396,754,504,92,108,red blood cell,9936,1.173913043478261,0.8518518518518519
40423,/images/db249e5a-4142-432c-8288-bacd10d7273d.png,893,940,978,1025,85,85,red blood cell,7225,1.0,1.0
7311,/images/89f10192-d3dd-4996-a571-4c851dbdc983.png,880,743,992,850,112,107,red blood cell,11984,0.9553571428571429,1.0467289719626167
14200,/images/c186dcd1-af61-455f-9619-1fdd8c881b06.png,525,974,651,1080,126,106,red blood cell,13356,0.8412698412698413,1.1886792452830188
50531,/images/e98ea067-82b5-4a0d-87bf-b4bbdc10ddab.png,300,474,402,578,102,104,red blood cell,10608,1.0196078431372548,0.9807692307692307
62703,/images/9e1b0217-0926-4fd1-bb9e-a815c05deb59.png,391,727,495,834,104,107,red blood cell,11128,1.0288461538461537,0.9719626168224299
31624,/images/0d7bf56f-3b5a-40bd-971c-2ca33dd89b2c.png,325,473,434,573,109,100,red blood cell,10900,0.9174311926605505,1.09
60452,/images/93b47b14-7f78-4b31-8897-d63a81fdab01.png,479,459,587,564,108,105,red blood cell,11340,0.9722222222222222,1.0285714285714285
58049,/images/a7c91b63-b97c-4f4b-8d34-7ad2b08d7a17.png,768,727,874,838,106,111,red blood cell,11766,1.0471698113207548,0.954954954954955
73409,/images/58594235-0d32-4a4e-91cd-4c800eaaaa73.png,169,956,279,1059,110,103,red blood cell,11330,0.9363636363636364,1.0679611650485437
54053,/images/d9345456-b76d-46cc-b81e-46d4a0a7b652.png,343,400,468,506,125,106,red blood cell,13250,0.848,1.179245283018868
26400,/images/d532e31c-10ce-4313-9a36-bd5e01230254.png,46,969,156,1094,110,125,red blood cell,13750,1.1363636363636365,0.88
66547,/images/b87fb62d-2c36-4f68-aba9-37fcd7d46eef.png,230,469,361,595,131,126,red blood cell,16506,0.9618320610687023,1.0396825396825398
3816,/images/3e764461-22ee-44d3-925d-cd658ff7d154.png,1048,1214,1167,1338,119,124,red blood cell,14756,1.0420168067226891,0.9596774193548387
3057,/images/5a386082-397f-4524-a6f9-c2b8efe5014d.png,32,766,141,885,109,119,red blood cell,12971,1.091743119266055,0.9159663865546218
13479,/images/370277f8-436b-4103-8210-b4feb5ab95ea.png,454,436,542,544,88,108,red blood cell,9504,1.2272727272727273,0.8148148148148148
40040,/images/8a4aadac-cf5c-4a79-b875-271b3fbfd230.png,240,1025,362,1128,122,103,red blood cell,12566,0.8442622950819673,1.1844660194174756
28809,/images/686ed568-d5f8-475e-81ad-edab9dd473a0.png,153,1123,248,1227,95,104,red blood cell,9880,1.0947368421052632,0.9134615384615384
45567,/images/e597f7ce-46c6-4dce-9063-50a2703fdd45.png,20,21,109,111,89,90,red blood cell,8010,1.0112359550561798,0.9888888888888889
40228,/images/ef1a9020-5e45-450d-a237-165114308592.png,408,91,519,208,111,117,red blood cell,12987,1.054054054054054,0.9487179487179487
1308,/images/6d91d1f0-636b-4f5a-a526-7c17fc857190.png,887,1012,978,1116,91,104,red blood cell,9464,1.1428571428571428,0.875
74299,/images/8939e14b-fcdf-48b1-acb9-6514a2fc2fc0.png,829,690,928,799,99,109,red blood cell,10791,1.101010101010101,0.908256880733945
22529,/images/bfe65b11-8aff-46aa-908b-1e989d25fdc4.png,1067,1257,1188,1361,121,104,red blood cell,12584,0.859504132231405,1.1634615384615385
77022,/images/637957ef-df75-4a7b-86d5-9f6e9c042ca2.png,939,1426,1052,1527,113,101,red blood cell,11413,0.8938053097345132,1.118811881188119
42437,/images/1a27ebe9-93a1-4898-af69-f276057d4012.png,888,1292,1013,1410,125,118,red blood cell,14750,0.944,1.0593220338983051
60010,/images/49288109-80e9-4ec8-96d1-26a0166b8883.png,263,1172,371,1285,108,113,red blood cell,12204,1.0462962962962963,0.9557522123893806
23648,/images/79d7a014-21ff-40f1-9ac4-a69839390654.png,589,127,681,233,92,106,red blood cell,9752,1.1521739130434783,0.8679245283018868
53002,/images/42e87148-a015-4148-923a-fb83016f64e7.png,703,837,814,952,111,115,red blood cell,12765,1.0360360360360361,0.9652173913043478
30452,/images/5955289d-19e5-45ef-a012-c8ea08ef45e2.png,979,294,1087,410,108,116,red blood cell,12528,1.0740740740740742,0.9310344827586207
26706,/images/c1423156-82b3-4dd3-8e74-08eb7ed8e1d6.png,739,1322,867,1442,128,120,red blood cell,15360,0.9375,1.0666666666666667
54478,/images/22a464ef-c3da-4d56-b37e-e22e95d945e7.png,774,1286,858,1383,84,97,red blood cell,8148,1.1547619047619047,0.865979381443299
6416,/images/1ecb0405-a6e9-4485-819e-2fbbf2b718aa.png,284,792,385,898,101,106,red blood cell,10706,1.0495049504950495,0.9528301886792453
77731,/images/4849866a-73a2-4fcf-a407-2d0a25a09a89.png,391,200,486,303,95,103,red blood cell,9785,1.0842105263157895,0.9223300970873787
41210,/images/eed298b3-35f2-4127-88ad-0c4a9062207b.png,407,298,520,406,113,108,red blood cell,12204,0.9557522123893806,1.0462962962962963
44861,/images/83ec8923-6232-40d7-ba1f-a1b8bf7cb66c.png,480,1079,577,1174,97,95,red blood cell,9215,0.979381443298969,1.0210526315789474
16052,/images/7e25ced3-5caf-47f8-ad0c-42946bd4468b.png,20,25,135,145,115,120,red blood cell,13800,1.0434782608695652,0.9583333333333334
41792,/images/28bd16ba-2bcf-46af-b889-41b78d2a50c0.png,176,1202,292,1316,116,114,red blood cell,13224,0.9827586206896551,1.0175438596491229
24347,/images/4d8a4ce8-0f9c-4f21-8844-4cf0e5514bbf.png,836,1288,921,1375,85,87,red blood cell,7395,1.0235294117647058,0.9770114942528736
9546,/images/a18f122f-3a3e-4478-8ac4-91b83e050e65.png,438,102,554,215,116,113,red blood cell,13108,0.9741379310344828,1.0265486725663717
75942,/images/034c8d57-04d5-4786-93a4-6ae8fde2c258.png,473,711,580,799,107,88,red blood cell,9416,0.822429906542056,1.2159090909090908
64544,/images/6ba5d0b8-cdc7-4266-9d78-db76faa312e9.png,6,369,106,470,100,101,red blood cell,10100,1.01,0.9900990099009901
50050,/images/b1145408-feae-4637-b4cf-3e70b99cc62d.png,259,330,379,452,120,122,red blood cell,14640,1.0166666666666666,0.9836065573770492
316,/images/0dcca702-a4ef-4fb3-a940-9c0c140b21c7.png,397,101,501,190,104,89,red blood cell,9256,0.8557692307692307,1.1685393258426966
35702,/images/4063945d-03fc-4ce3-a04c-17435dce8f91.png,202,867,333,977,131,110,red blood cell,14410,0.8396946564885496,1.190909090909091
35693,/images/4063945d-03fc-4ce3-a04c-17435dce8f91.png,267,1035,384,1131,117,96,red blood cell,11232,0.8205128205128205,1.21875
38042,/images/e3e9c2de-0a24-4c7e-8a69-3d3093d5bdab.png,751,497,855,592,104,95,red blood cell,9880,0.9134615384615384,1.0947368421052632
63561,/images/de0321fa-6f7d-4dd1-b96b-186701c3b1d9.png,748,318,862,436,114,118,red blood cell,13452,1.0350877192982457,0.9661016949152542
61006,/images/3d1429ed-4619-41f7-8ff3-d698ad28034c.png,551,684,651,776,100,92,red blood cell,9200,0.92,1.0869565217391304
53381,/images/f23ae29e-1bda-4784-b10c-d736757d39b8.png,831,230,951,337,120,107,red blood cell,12840,0.8916666666666667,1.1214953271028036
77655,/images/07d15855-eb9b-46a9-b894-7cfe4d097826.png,173,1353,268,1454,95,101,red blood cell,9595,1.063157894736842,0.9405940594059405
77891,/images/464055b6-3351-4636-a919-8be9840fb850.png,594,270,695,381,101,111,red blood cell,11211,1.099009900990099,0.9099099099099099
74534,/images/cbb58718-6319-48db-b84b-78ac9b12ff89.png,49,1298,135,1397,86,99,red blood cell,8514,1.1511627906976745,0.8686868686868687
17166,/images/dc3bdfe9-1565-4cda-9c4e-0979846dab60.png,541,285,637,385,96,100,red blood cell,9600,1.0416666666666667,0.96
38687,/images/b5acf759-1115-42f0-a753-656736192528.png,409,1480,553,1597,144,117,red blood cell,16848,0.8125,1.2307692307692308
3428,/images/fd1302e2-3cd2-4a1a-9c13-00f810a9c41b.png,52,981,148,1080,96,99,red blood cell,9504,1.03125,0.9696969696969697
41596,/images/0fcd1ebe-ee4a-40a0-b787-29cee18bfa1b.png,524,921,610,1012,86,91,red blood cell,7826,1.058139534883721,0.945054945054945
1243,/images/5ff7c0c8-d208-4e7d-958d-ca3c2260ff39.png,7,993,113,1098,106,105,red blood cell,11130,0.9905660377358491,1.0095238095238095
55166,/images/29d4b75f-d400-4702-a9ac-e5a4ed1a1db1.png,1072,691,1175,782,103,91,red blood cell,9373,0.883495145631068,1.1318681318681318
66453,/images/5f66d20c-fbfe-44ec-a01b-8a09da24807e.png,985,63,1078,162,93,99,red blood cell,9207,1.064516129032258,0.9393939393939394
76342,/images/3dad6483-ac30-4d2b-b045-9f24fe6ff75e.png,181,173,297,287,116,114,red blood cell,13224,0.9827586206896551,1.0175438596491229
7569,/images/071901eb-4c3f-404b-a747-3d0b9d0a5158.png,717,1200,815,1303,98,103,red blood cell,10094,1.0510204081632653,0.9514563106796117
9653,/images/d997337e-e4a8-4ef0-b8ba-975e6c43b62c.png,281,440,406,577,125,137,red blood cell,17125,1.096,0.9124087591240876
33717,/images/441d7843-b20b-4c10-84e3-e6d32621e880.png,664,98,776,205,112,107,red blood cell,11984,0.9553571428571429,1.0467289719626167
54208,/images/3b5a8060-dec6-4a83-b7f2-b604e4e69dfc.png,604,210,723,313,119,103,red blood cell,12257,0.865546218487395,1.1553398058252426
40546,/images/e3ade58d-086c-47fa-9120-76beacb45395.png,425,426,527,534,102,108,red blood cell,11016,1.0588235294117647,0.9444444444444444
10356,/images/affa429c-0315-4c18-a002-13bb3ecab259.png,1019,1142,1153,1253,134,111,red blood cell,14874,0.8283582089552238,1.2072072072072073
35695,/images/4063945d-03fc-4ce3-a04c-17435dce8f91.png,299,613,411,734,112,121,red blood cell,13552,1.0803571428571428,0.9256198347107438
50947,/images/ef8fcfa4-8466-4186-8c69-f5f4904eb489.png,670,711,769,798,99,87,red blood cell,8613,0.8787878787878788,1.1379310344827587
69032,/images/b5246b58-6f40-4c9e-8024-f49b0ed6bdbd.png,243,1029,361,1136,118,107,red blood cell,12626,0.9067796610169492,1.102803738317757
21225,/images/0ceb4539-5c4c-487d-9826-452a88b5d537.png,685,302,795,411,110,109,red blood cell,11990,0.990909090909091,1.0091743119266054
32556,/images/318de807-7232-4ab1-843e-a901547c0125.png,785,426,893,547,108,121,red blood cell,13068,1.1203703703703705,0.8925619834710744
3843,/images/3e764461-22ee-44d3-925d-cd658ff7d154.png,1027,208,1144,338,117,130,red blood cell,15210,1.1111111111111112,0.9
577,/images/065af549-320a-4862-b92a-8ef750d7b5fb.png,800,459,916,578,116,119,red blood cell,13804,1.0258620689655173,0.9747899159663865
34776,/images/4fc9a597-aaa8-43b0-ad1c-2eabbe442e84.png,911,1304,1033,1425,122,121,red blood cell,14762,0.9918032786885246,1.0082644628099173
59071,/images/5e2cea49-0823-49d1-83cf-8fd1559cdd93.png,738,219,857,336,119,117,red blood cell,13923,0.9831932773109243,1.017094017094017
40288,/images/eb86033f-4f1c-4e8c-ae84-e8e4c7e08626.png,885,1278,980,1379,95,101,red blood cell,9595,1.063157894736842,0.9405940594059405
19466,/images/a85cd1ae-0c94-4387-8305-84ab8d96d137.png,139,847,254,978,115,131,red blood cell,15065,1.1391304347826088,0.8778625954198473
52548,/images/d1144956-5a0c-4bd2-b67d-8498c82d6a12.png,515,1157,624,1250,109,93,red blood cell,10137,0.8532110091743119,1.1720430107526882
18921,/images/e9e78ff8-831b-46e9-9785-3eee9acbfcd8.png,434,232,540,334,106,102,red blood cell,10812,0.9622641509433962,1.0392156862745099
34479,/images/fa1f9f89-cecb-4972-842c-d14c632f89a9.png,985,1427,1108,1551,123,124,red blood cell,15252,1.008130081300813,0.9919354838709677
13241,/images/711f6b3f-cd63-46d1-834a-bc8e9aa9b43e.png,830,1045,921,1148,91,103,red blood cell,9373,1.1318681318681318,0.883495145631068
39656,/images/04d21589-b777-43c2-86b5-038cbf8c3a4e.png,499,1407,608,1516,109,109,red blood cell,11881,1.0,1.0
40628,/images/252071ac-e9f2-41d2-abbb-87ef01b8a997.png,491,1273,574,1360,83,87,red blood cell,7221,1.0481927710843373,0.9540229885057471
66253,/images/e8058bed-c362-4e1c-85dc-62f80f32938f.png,851,457,962,561,111,104,red blood cell,11544,0.9369369369369369,1.0673076923076923
53,/images/8d02117d-6c71-4e47-b50a-6cc8d5eb1d55.png,124,372,227,463,103,91,red blood cell,9373,0.883495145631068,1.1318681318681318
14847,/images/f8b6a868-60e9-4569-ae69-638a0c39834d.png,828,441,957,551,129,110,red blood cell,14190,0.8527131782945736,1.1727272727272726
38087,/images/907650b5-edae-471d-bc54-a825be3d3fac.png,50,826,167,947,117,121,red blood cell,14157,1.0341880341880343,0.9669421487603306
16548,/images/69565501-6e77-4f40-bd80-caa3dda34d8b.png,875,114,985,231,110,117,red blood cell,12870,1.0636363636363637,0.9401709401709402
28976,/images/b12ae3b1-613c-4c0e-9163-3c5cc314abf5.png,1088,659,1198,789,110,130,red blood cell,14300,1.1818181818181819,0.8461538461538461
12775,/images/b634137b-bc8b-4e88-b0e3-b536ad6e7e18.png,633,31,746,130,113,99,red blood cell,11187,0.8761061946902655,1.1414141414141414
54996,/images/7beee655-6156-43b8-b185-dbae0eaf7f45.png,488,846,605,963,117,117,red blood cell,13689,1.0,1.0
66675,/images/b88fe674-fb9a-41d4-b100-cb1c86440d44.png,762,824,873,920,111,96,red blood cell,10656,0.8648648648648649,1.15625
45994,/images/72088c26-d2dd-4906-b791-b8947fc7fbe4.png,805,1168,900,1280,95,112,red blood cell,10640,1.1789473684210525,0.8482142857142857
10123,/images/09ecf7be-28e2-4531-b9e2-07e01c44097d.png,607,1055,701,1144,94,89,red blood cell,8366,0.9468085106382979,1.0561797752808988
10982,/images/c442e2d6-aaf9-417a-9905-4737a1115f33.png,424,410,528,536,104,126,red blood cell,13104,1.2115384615384615,0.8253968253968254
76349,/images/3dad6483-ac30-4d2b-b045-9f24fe6ff75e.png,9,848,121,941,112,93,red blood cell,10416,0.8303571428571429,1.2043010752688172
37928,/images/56a57a8d-c9b9-432a-a3b0-32a09355806c.png,34,405,119,497,85,92,red blood cell,7820,1.0823529411764705,0.9239130434782609
57465,/images/00d04a90-80e5-4bce-9511-1b64eabb7a47.png,136,69,208,154,72,85,red blood cell,6120,1.1805555555555556,0.8470588235294118
57518,/images/00d04a90-80e5-4bce-9511-1b64eabb7a47.png,641,153,742,241,101,88,red blood cell,8888,0.8712871287128713,1.1477272727272727
55621,/images/c32b8bb8-c89d-4ae9-9c77-5b9356ca35a1.png,252,520,387,629,135,109,red blood cell,14715,0.8074074074074075,1.238532110091743
46772,/images/02fb5e19-6f94-4787-bb78-e550a29a3cbd.png,82,1037,179,1136,97,99,red blood cell,9603,1.0206185567010309,0.9797979797979798
6502,/images/640c4a52-3742-4f57-aee3-9e3dc0887622.png,309,267,427,364,118,97,red blood cell,11446,0.8220338983050848,1.2164948453608246
21177,/images/fb05b297-180a-4171-b633-09d5616d7534.png,60,500,154,597,94,97,red blood cell,9118,1.0319148936170213,0.9690721649484536
1230,/images/5ff7c0c8-d208-4e7d-958d-ca3c2260ff39.png,926,1418,1032,1547,106,129,red blood cell,13674,1.2169811320754718,0.8217054263565892
13700,/images/0b04ec46-5119-4cda-8c35-c4e5b6f0eed0.png,375,802,475,906,100,104,red blood cell,10400,1.04,0.9615384615384616
11445,/images/dca685a8-a609-45d8-93d7-da1e4165b9bd.png,311,1342,443,1466,132,124,red blood cell,16368,0.9393939393939394,1.064516129032258
24833,/images/93f7e207-0d8e-47f8-8258-09a0e03dbdd6.png,295,194,415,321,120,127,red blood cell,15240,1.0583333333333333,0.9448818897637795
16471,/images/9e5437c6-b0d3-473b-b7c3-8f5afeb90c7a.png,506,959,643,1087,137,128,red blood cell,17536,0.9343065693430657,1.0703125
62791,/images/631340cc-cedf-4bca-a3d8-a0731a5482b4.png,96,572,190,663,94,91,red blood cell,8554,0.9680851063829787,1.032967032967033
33344,/images/5721e41b-90ef-4851-8587-8dc71227ef90.png,779,588,896,727,117,139,red blood cell,16263,1.188034188034188,0.841726618705036
16783,/images/4823c1fe-a7f9-4b92-959f-0d9be09cd14b.png,487,674,572,771,85,97,red blood cell,8245,1.1411764705882352,0.8762886597938144
51400,/images/b4f3b2a4-f4b9-48de-ac5d-0e681b77be27.png,721,319,830,412,109,93,red blood cell,10137,0.8532110091743119,1.1720430107526882
2650,/images/a2ccbf70-e444-49a9-8b7e-9797a05220d8.png,790,828,916,959,126,131,red blood cell,16506,1.0396825396825398,0.9618320610687023
10872,/images/b78b88f0-154a-4b54-8aaf-85d37a42a0f9.png,36,611,157,735,121,124,red blood cell,15004,1.024793388429752,0.9758064516129032
75008,/images/9147a21d-0de2-4c04-88da-b788311696ac.png,590,994,709,1108,119,114,red blood cell,13566,0.957983193277311,1.043859649122807
39143,/images/7bde7de1-889b-4218-b0e1-e2c04f6a7986.png,293,435,389,512,96,77,red blood cell,7392,0.8020833333333334,1.2467532467532467
32721,/images/0154dd8e-72f8-4d78-a4dd-93e139577bd1.png,1012,6,1132,114,120,108,red blood cell,12960,0.9,1.1111111111111112
73802,/images/3eba916c-998b-40a7-993c-7ed916c2a04c.png,556,1025,668,1125,112,100,red blood cell,11200,0.8928571428571429,1.12
53379,/images/f23ae29e-1bda-4784-b10c-d736757d39b8.png,538,321,626,425,88,104,red blood cell,9152,1.1818181818181819,0.8461538461538461
26168,/images/04de27ff-0d36-4da3-a829-e93851d76981.png,526,1265,659,1395,133,130,red blood cell,17290,0.9774436090225563,1.023076923076923
29128,/images/4c13e22e-dfd1-4fa1-b373-be9d0c272c0f.png,754,1271,843,1364,89,93,red blood cell,8277,1.0449438202247192,0.956989247311828
4297,/images/882b91b7-5906-4091-bad4-688d4375eeb5.png,31,537,144,628,113,91,red blood cell,10283,0.8053097345132744,1.2417582417582418
61781,/images/985627c9-7b85-40de-a106-eb9cc47b47cb.png,24,161,107,262,83,101,red blood cell,8383,1.216867469879518,0.8217821782178217
62608,/images/f7a4334a-4332-4de8-b39b-22da907976f2.png,44,80,131,160,87,80,red blood cell,6960,0.9195402298850575,1.0875
48487,/images/9c4cb048-d64a-4b7f-84ff-ca28a8084fc7.png,522,1170,638,1283,116,113,red blood cell,13108,0.9741379310344828,1.0265486725663717
71859,/images/61575482-91e1-4db9-83c7-687b7ddbbfc4.png,666,1468,772,1572,106,104,red blood cell,11024,0.9811320754716981,1.0192307692307692
22130,/images/ca677c3c-083f-4d54-9dec-39f79f6a17d8.png,54,269,148,363,94,94,red blood cell,8836,1.0,1.0
79836,/images/a054a8e2-55f2-4508-97df-207f76b89be2.png,685,401,799,514,114,113,red blood cell,12882,0.9912280701754386,1.008849557522124
33848,/images/b9de8b1a-f96a-4eb5-bc05-84ad43a054f3.png,830,219,941,335,111,116,red blood cell,12876,1.045045045045045,0.9568965517241379
26322,/images/580210c2-a8ed-4720-b71c-a77945968abc.png,877,350,990,466,113,116,red blood cell,13108,1.0265486725663717,0.9741379310344828
70533,/images/8cca114a-ed05-4b87-95b7-fae02487f08c.png,103,1195,204,1285,101,90,red blood cell,9090,0.8910891089108911,1.1222222222222222
71611,/images/390ad256-e1ed-476a-9f14-2dc34e0da632.png,695,1142,812,1274,117,132,red blood cell,15444,1.1282051282051282,0.8863636363636364
50295,/images/3d32a988-449d-4d58-b71f-abbfdc3f2fbc.png,650,215,780,338,130,123,red blood cell,15990,0.9461538461538461,1.056910569105691
36244,/images/b2103776-9b32-4160-b4f0-0692deda19dc.png,111,1476,233,1584,122,108,red blood cell,13176,0.8852459016393442,1.1296296296296295
72971,/images/a20d0b4b-6e2e-4507-bc22-f321dedc4ed9.png,0,219,103,325,103,106,red blood cell,10918,1.029126213592233,0.9716981132075472
15278,/images/2d0f600d-f94e-4907-b712-52fb37d9ed52.png,198,698,309,815,111,117,red blood cell,12987,1.054054054054054,0.9487179487179487
61450,/images/7e837856-3519-4dc0-b357-4cdcfd30b4eb.png,692,218,824,346,132,128,red blood cell,16896,0.9696969696969697,1.03125
56207,/images/b600b38d-225b-46a5-b6f8-b607430f6a10.png,571,941,679,1065,108,124,red blood cell,13392,1.1481481481481481,0.8709677419354839
10497,/images/46a2d369-4bea-4405-ac78-91bbe130b9a7.png,2,1506,82,1595,80,89,red blood cell,7120,1.1125,0.898876404494382
20259,/images/c66cb6b2-1480-446a-a9d2-b8032a3de0d7.png,1071,551,1193,680,122,129,red blood cell,15738,1.0573770491803278,0.9457364341085271
48095,/images/05717db9-f1ef-4101-a9f7-7a007e83b1c9.png,631,68,733,177,102,109,red blood cell,11118,1.0686274509803921,0.9357798165137615
77851,/images/6bc7b53c-5a98-48ef-a9de-59a476707ea4.png,358,706,466,809,108,103,red blood cell,11124,0.9537037037037037,1.0485436893203883
8718,/images/92e4fd7b-79ef-49c2-a52b-9ef13dd720ef.png,693,947,799,1055,106,108,red blood cell,11448,1.0188679245283019,0.9814814814814815
61747,/images/985627c9-7b85-40de-a106-eb9cc47b47cb.png,830,830,942,938,112,108,red blood cell,12096,0.9642857142857143,1.037037037037037
51363,/images/b4f3b2a4-f4b9-48de-ac5d-0e681b77be27.png,124,862,245,974,121,112,red blood cell,13552,0.9256198347107438,1.0803571428571428
30319,/images/cecbf663-0751-4e7f-b298-770c88afc2c1.png,597,1266,693,1358,96,92,red blood cell,8832,0.9583333333333334,1.0434782608695652
7634,/images/21cc498b-8cb2-42ed-8f80-bfa27b86ef11.png,857,1141,968,1253,111,112,red blood cell,12432,1.009009009009009,0.9910714285714286
34656,/images/a0eedcb9-b85c-4612-b945-7e8227f53c35.png,537,433,635,519,98,86,red blood cell,8428,0.8775510204081632,1.1395348837209303
57166,/images/7c870293-2665-4a6b-a4fa-336959051dfc.png,100,653,212,768,112,115,red blood cell,12880,1.0267857142857142,0.9739130434782609
10433,/images/46a2d369-4bea-4405-ac78-91bbe130b9a7.png,1074,84,1176,191,102,107,red blood cell,10914,1.0490196078431373,0.9532710280373832
6431,/images/1ecb0405-a6e9-4485-819e-2fbbf2b718aa.png,993,255,1104,355,111,100,red blood cell,11100,0.9009009009009009,1.11
42907,/images/7d4c2160-317f-48d1-a60a-788ec300b3e8.png,332,608,457,728,125,120,red blood cell,15000,0.96,1.0416666666666667
51014,/images/cc275c45-7511-4070-84af-10b8ffebda53.png,210,1160,341,1302,131,142,red blood cell,18602,1.083969465648855,0.9225352112676056
21951,/images/d57b3894-c912-47e8-b00a-e1a2a7aba644.png,529,124,643,224,114,100,red blood cell,11400,0.8771929824561403,1.14
30548,/images/7d9c1422-6332-44e9-b134-3ac94f07b0f0.png,893,724,996,831,103,107,red blood cell,11021,1.0388349514563107,0.9626168224299065
26264,/images/52767904-4cdc-4821-ba68-8cd0c28f9023.png,518,1028,659,1164,141,136,red blood cell,19176,0.9645390070921985,1.036764705882353
76372,/images/3dad6483-ac30-4d2b-b045-9f24fe6ff75e.png,874,646,978,747,104,101,red blood cell,10504,0.9711538461538461,1.0297029702970297
11214,/images/6303f964-98ef-47c6-bb2d-283aa393f918.png,245,912,343,1008,98,96,red blood cell,9408,0.9795918367346939,1.0208333333333333
33276,/images/5721e41b-90ef-4851-8587-8dc71227ef90.png,847,715,951,826,104,111,red blood cell,11544,1.0673076923076923,0.9369369369369369
55230,/images/8ad7ba46-5db8-4ba9-b3e0-3cac52f7efc3.png,631,1334,721,1432,90,98,red blood cell,8820,1.0888888888888888,0.9183673469387755
31781,/images/63ed5931-d93e-4f9b-a6f3-152713cb560e.png,449,57,553,162,104,105,red blood cell,10920,1.0096153846153846,0.9904761904761905
38293,/images/674b0fd3-f247-4b7f-97f7-3e6c57c9ba9e.png,252,156,361,266,109,110,red blood cell,11990,1.0091743119266054,0.990909090909091
39812,/images/5c68070c-3391-4db6-8c01-94175105dbea.png,962,1332,1079,1446,117,114,red blood cell,13338,0.9743589743589743,1.0263157894736843
74343,/images/06a3effb-996c-4767-afd2-6aa3b697cb4e.png,565,368,676,478,111,110,red blood cell,12210,0.990990990990991,1.009090909090909
65424,/images/b523daee-317b-461d-bdc1-07b4add4d488.png,834,1462,962,1570,128,108,red blood cell,13824,0.84375,1.1851851851851851
65954,/images/25c6cfb1-01d0-4864-87f9-02b7593683c7.png,686,969,782,1084,96,115,red blood cell,11040,1.1979166666666667,0.8347826086956521
14451,/images/3b13e20f-ec0d-44ec-b2f4-eaebfa09150e.png,79,801,196,921,117,120,red blood cell,14040,1.0256410256410255,0.975
32498,/images/d31dd2c0-ae8e-4499-86bb-7cabb6e438b9.png,410,575,522,689,112,114,red blood cell,12768,1.0178571428571428,0.9824561403508771
59169,/images/4736f545-1f1f-4d77-9241-d69cbf4dae35.png,139,842,246,936,107,94,red blood cell,10058,0.8785046728971962,1.1382978723404256
17002,/images/57e1879e-4294-45e7-9c1b-627e8cca0271.png,696,819,818,952,122,133,red blood cell,16226,1.0901639344262295,0.9172932330827067
8183,/images/694222bb-cddf-469a-9526-f873c6fba58e.png,443,4,537,96,94,92,red blood cell,8648,0.9787234042553191,1.0217391304347827
39522,/images/5a631871-2fc7-4a68-9c39-f3b9a0bf4a04.png,492,190,603,293,111,103,red blood cell,11433,0.9279279279279279,1.0776699029126213
76556,/images/38c69905-8a4f-451a-8d0a-b855dc88dd16.png,992,1123,1077,1212,85,89,red blood cell,7565,1.0470588235294118,0.9550561797752809
76441,/images/34df8890-272d-423a-ae78-ff8d068d3306.png,363,1011,451,1115,88,104,red blood cell,9152,1.1818181818181819,0.8461538461538461
44931,/images/83ec8923-6232-40d7-ba1f-a1b8bf7cb66c.png,654,443,742,518,88,75,red blood cell,6600,0.8522727272727273,1.1733333333333333
11350,/images/2f6224be-50d0-4e85-94ef-88315df561b6.png,1049,938,1169,1070,120,132,red blood cell,15840,1.1,0.9090909090909091
76544,/images/38c69905-8a4f-451a-8d0a-b855dc88dd16.png,281,853,387,951,106,98,red blood cell,10388,0.9245283018867925,1.0816326530612246
3578,/images/25132962-ff5d-4737-995f-c54d8490539b.png,605,406,705,519,100,113,red blood cell,11300,1.13,0.8849557522123894
4430,/images/21ea4841-8998-4c04-b345-bc99cd8ecee6.png,474,241,583,340,109,99,red blood cell,10791,0.908256880733945,1.101010101010101
5773,/images/143f5959-5b6d-4f95-bcee-9e110450fc22.png,639,1156,748,1281,109,125,red blood cell,13625,1.146788990825688,0.872
13514,/images/370277f8-436b-4103-8210-b4feb5ab95ea.png,1033,100,1143,197,110,97,red blood cell,10670,0.8818181818181818,1.134020618556701
72047,/images/64b0e49a-0e48-447d-8872-c1dd255e7a21.png,1053,475,1175,587,122,112,red blood cell,13664,0.9180327868852459,1.0892857142857142
54750,/images/10891eed-b0f2-4dd0-90cb-da185f6761b2.png,618,567,698,655,80,88,red blood cell,7040,1.1,0.9090909090909091
72375,/images/a15e0fa8-2620-4f66-896e-175115c9dc3d.png,70,827,175,930,105,103,red blood cell,10815,0.9809523809523809,1.0194174757281553
22899,/images/be779f52-0bfa-4c01-a16f-b7f0bc92ed7c.png,31,1099,151,1225,120,126,red blood cell,15120,1.05,0.9523809523809523
65386,/images/24418314-f7a4-49fc-a03e-ec597ca6796e.png,703,526,829,635,126,109,red blood cell,13734,0.8650793650793651,1.1559633027522935
27385,/images/9f38055f-4fe6-47fd-a6dd-c0743db4eccf.png,832,809,937,921,105,112,red blood cell,11760,1.0666666666666667,0.9375
15930,/images/c7c1b873-0548-4a73-9618-f60912e164df.png,884,313,997,420,113,107,red blood cell,12091,0.9469026548672567,1.0560747663551402
8847,/images/91827f1a-9b04-4ef0-972c-12e90e60c516.png,265,1303,376,1419,111,116,red blood cell,12876,1.045045045045045,0.9568965517241379
34886,/images/a4fbb9f2-9b75-4fdc-877d-2feaafac25b3.png,595,1325,698,1432,103,107,red blood cell,11021,1.0388349514563107,0.9626168224299065
52509,/images/d1144956-5a0c-4bd2-b67d-8498c82d6a12.png,313,1031,423,1139,110,108,red blood cell,11880,0.9818181818181818,1.0185185185185186
16708,/images/d6352a03-ef81-421d-915e-226499555d20.png,413,1139,512,1250,99,111,red blood cell,10989,1.121212121212121,0.8918918918918919
1985,/images/b95ceeeb-8870-4492-9037-2091ff268c5a.png,755,259,887,393,132,134,red blood cell,17688,1.0151515151515151,0.9850746268656716
15788,/images/64113b22-03b1-4ab8-89ab-b2f32154fbbd.png,1083,887,1184,1011,101,124,red blood cell,12524,1.2277227722772277,0.8145161290322581
12666,/images/5a043d69-f435-46d4-8691-395c1602a76a.png,743,988,857,1098,114,110,red blood cell,12540,0.9649122807017544,1.0363636363636364
45638,/images/582e4b8b-404e-4b30-9df3-66f2afb3cdb3.png,116,825,232,927,116,102,red blood cell,11832,0.8793103448275862,1.1372549019607843
73473,/images/5f2b32bd-fdca-4d6f-b13a-ee9f83626c8d.png,261,247,366,344,105,97,red blood cell,10185,0.9238095238095239,1.0824742268041236
59279,/images/03c8da48-04b9-4520-b674-44a0ecd35688.png,247,1013,331,1106,84,93,red blood cell,7812,1.1071428571428572,0.9032258064516129
56321,/images/4372709c-f356-4906-be17-415384d916e8.png,802,1028,914,1140,112,112,red blood cell,12544,1.0,1.0
25223,/images/90171428-f208-428a-b40e-f57ee3bea457.png,1093,365,1190,476,97,111,red blood cell,10767,1.1443298969072164,0.8738738738738738
64813,/images/a74b6d6a-7e04-40ac-9292-d62f13f7ded3.png,420,559,509,648,89,89,red blood cell,7921,1.0,1.0
78271,/images/adff6e1d-ba9d-4c7b-a8fe-1ec458eaeeb8.png,671,344,772,432,101,88,red blood cell,8888,0.8712871287128713,1.1477272727272727
73643,/images/a51d6c18-f9e8-4714-9dbb-38e1577445f2.png,501,1488,601,1595,100,107,red blood cell,10700,1.07,0.9345794392523364
56424,/images/d75933ed-d26e-4d1f-bda3-96bc0d77fb36.png,395,930,502,1042,107,112,red blood cell,11984,1.0467289719626167,0.9553571428571429
58141,/images/d615b706-8f50-4d96-8de5-6858897528d0.png,497,657,607,777,110,120,red blood cell,13200,1.0909090909090908,0.9166666666666666
69476,/images/664c570b-4822-413c-9724-11b1d91fac44.png,875,609,973,707,98,98,red blood cell,9604,1.0,1.0
51124,/images/d64cd75a-df26-44d5-ac25-69061a4e4d57.png,939,659,1030,760,91,101,red blood cell,9191,1.10989010989011,0.900990099009901
8448,/images/ae779806-6d01-4dc6-89df-294c368db6bc.png,205,544,312,658,107,114,red blood cell,12198,1.0654205607476634,0.9385964912280702
19571,/images/883d9731-a04d-4f84-83c9-d3bef954759d.png,630,5,755,108,125,103,red blood cell,12875,0.824,1.2135922330097086
52213,/images/f4c00b8c-d675-4255-8277-ca65bd757f51.png,268,1368,360,1470,92,102,red blood cell,9384,1.108695652173913,0.9019607843137255
73909,/images/2ae3e6e6-7482-4ab8-ad73-b530b5c2ee3b.png,464,1144,562,1240,98,96,red blood cell,9408,0.9795918367346939,1.0208333333333333
78762,/images/9174f910-3859-4839-8e30-2c3b25269322.png,332,822,434,923,102,101,red blood cell,10302,0.9901960784313726,1.00990099009901
25097,/images/9e74feb8-017d-4d53-8896-9ebda4327dd1.png,263,727,362,825,99,98,red blood cell,9702,0.98989898989899,1.010204081632653
25615,/images/770b8ca4-8377-479b-9ad5-5455ec3b44f8.png,914,362,1026,489,112,127,red blood cell,14224,1.1339285714285714,0.8818897637795275
37905,/images/56a57a8d-c9b9-432a-a3b0-32a09355806c.png,321,461,421,548,100,87,red blood cell,8700,0.87,1.1494252873563218
43020,/images/6c7095cd-ab6b-4f53-bd94-905d0cc95840.png,178,96,272,212,94,116,red blood cell,10904,1.2340425531914894,0.8103448275862069
24178,/images/194aec70-41a5-4ac3-b22f-0b6eda91f730.png,946,77,1086,209,140,132,red blood cell,18480,0.9428571428571428,1.0606060606060606
32409,/images/3911fcd2-4e26-4ad9-aaf0-d1c5bf41defc.png,629,492,723,609,94,117,red blood cell,10998,1.2446808510638299,0.8034188034188035
45973,/images/72088c26-d2dd-4906-b791-b8947fc7fbe4.png,585,969,686,1070,101,101,red blood cell,10201,1.0,1.0
70330,/images/90246988-0d6d-4bf8-8a76-94107de4121e.png,685,19,775,118,90,99,red blood cell,8910,1.1,0.9090909090909091
74716,/images/5ccca8ee-abea-458a-a891-bedd31c3ddc3.png,0,473,105,571,105,98,red blood cell,10290,0.9333333333333333,1.0714285714285714
15062,/images/3003252a-2d2e-4687-ad30-9c38d68f1394.png,747,363,846,467,99,104,red blood cell,10296,1.0505050505050506,0.9519230769230769
76852,/images/2165fe38-b474-467d-be11-d1d728085efd.png,340,424,455,526,115,102,red blood cell,11730,0.8869565217391304,1.1274509803921569
1554,/images/0ac747cd-ff32-49bf-bc1a-3e9b7702ce9c.png,177,737,289,847,112,110,red blood cell,12320,0.9821428571428571,1.018181818181818
55068,/images/1f8f08ea-b5b3-4f68-94d4-3cc071b7dce8.png,198,645,294,740,96,95,red blood cell,9120,0.9895833333333334,1.0105263157894737
39723,/images/56adbb1e-96a8-40a5-a5a2-243c97ea889b.png,632,1318,758,1433,126,115,red blood cell,14490,0.9126984126984127,1.0956521739130434
77956,/images/c691c8ef-d3c7-47b6-a941-f6a1089f21a9.png,869,576,984,694,115,118,red blood cell,13570,1.0260869565217392,0.9745762711864406
45007,/images/13bab3c3-3f79-44d9-a287-0ae6d71eff31.png,622,930,725,1045,103,115,red blood cell,11845,1.116504854368932,0.8956521739130435
23451,/images/8757be1e-b832-407a-8e95-62abae485b24.png,483,1277,591,1397,108,120,red blood cell,12960,1.1111111111111112,0.9
28271,/images/036404d1-b9fc-497b-bbe1-f4d9c5ac3ce0.png,197,852,298,963,101,111,red blood cell,11211,1.099009900990099,0.9099099099099099
37715,/images/003a89b0-a095-417a-8dd6-f408339bbc68.png,517,1221,613,1327,96,106,red blood cell,10176,1.1041666666666667,0.9056603773584906
56633,/images/4adcaa26-aa1f-47b5-bdf0-18c9f814f576.png,260,142,365,249,105,107,red blood cell,11235,1.019047619047619,0.9813084112149533
41103,/images/e871f52c-77a6-4813-80d4-95bd97985f1a.png,1035,70,1152,188,117,118,red blood cell,13806,1.0085470085470085,0.9915254237288136
70376,/images/4876c9d0-b386-48fb-84e8-91bf87529161.png,625,197,722,292,97,95,red blood cell,9215,0.979381443298969,1.0210526315789474
45730,/images/584d62ed-4329-45dd-94ce-e929d8b2bb74.png,993,156,1096,245,103,89,red blood cell,9167,0.8640776699029126,1.1573033707865168
1609,/images/7094c11a-1e62-4f98-894e-d17d138a88e9.png,230,1292,350,1407,120,115,red blood cell,13800,0.9583333333333334,1.0434782608695652
3282,/images/b901c906-91be-48c4-88ec-2c527544a258.png,286,71,412,184,126,113,red blood cell,14238,0.8968253968253969,1.1150442477876106
46953,/images/9e0e1928-d19a-4100-b093-0b962ac09e05.png,658,1157,750,1259,92,102,red blood cell,9384,1.108695652173913,0.9019607843137255
65481,/images/da49db57-0c2f-4213-b322-c88c19fb9296.png,1069,1273,1166,1386,97,113,red blood cell,10961,1.1649484536082475,0.8584070796460177
19185,/images/bb795ddf-ce72-42d5-9006-124db4d5cf1c.png,15,1093,121,1200,106,107,red blood cell,11342,1.009433962264151,0.9906542056074766
45039,/images/13bab3c3-3f79-44d9-a287-0ae6d71eff31.png,731,942,834,1052,103,110,red blood cell,11330,1.0679611650485437,0.9363636363636364
38394,/images/674b0fd3-f247-4b7f-97f7-3e6c57c9ba9e.png,815,1421,920,1516,105,95,red blood cell,9975,0.9047619047619048,1.105263157894737
4323,/images/84041bf9-dace-4066-9fe0-52170d08f826.png,208,685,304,787,96,102,red blood cell,9792,1.0625,0.9411764705882353
19320,/images/b4d22412-a495-43a9-bec0-73a2322f8dad.png,146,843,238,933,92,90,red blood cell,8280,0.9782608695652174,1.0222222222222221
62788,/images/631340cc-cedf-4bca-a3d8-a0731a5482b4.png,838,1053,946,1165,108,112,red blood cell,12096,1.037037037037037,0.9642857142857143
74615,/images/bbedfcbe-9528-4ba9-9d86-4ebba7589ac5.png,326,815,432,900,106,85,red blood cell,9010,0.8018867924528302,1.2470588235294118
53582,/images/7c1cd7c7-7452-4428-a98e-dd7675c8ddea.png,95,1466,200,1576,105,110,red blood cell,11550,1.0476190476190477,0.9545454545454546
73439,/images/58594235-0d32-4a4e-91cd-4c800eaaaa73.png,613,1285,725,1394,112,109,red blood cell,12208,0.9732142857142857,1.0275229357798166
67459,/images/8e72e20e-e714-4db6-a1da-c05a409257d4.png,932,1164,1039,1270,107,106,red blood cell,11342,0.9906542056074766,1.009433962264151
53923,/images/540a5fee-175b-4b92-bf62-1ea9b59c86c6.png,221,1061,334,1176,113,115,red blood cell,12995,1.0176991150442478,0.9826086956521739
30696,/images/8e0dfc1f-e3eb-4a3f-a1c4-249bdfbfaa27.png,301,424,403,526,102,102,red blood cell,10404,1.0,1.0
38869,/images/d79b4e90-c45d-4f5d-a498-49c3e323c291.png,222,1438,334,1538,112,100,red blood cell,11200,0.8928571428571429,1.12
43742,/images/ef83ed4c-2724-4d5f-8abe-1a18d25cea35.png,997,566,1120,696,123,130,red blood cell,15990,1.056910569105691,0.9461538461538461
56229,/images/b600b38d-225b-46a5-b6f8-b607430f6a10.png,992,535,1104,642,112,107,red blood cell,11984,0.9553571428571429,1.0467289719626167
76789,/images/2165fe38-b474-467d-be11-d1d728085efd.png,657,257,766,356,109,99,red blood cell,10791,0.908256880733945,1.101010101010101
43904,/images/d7c7eb2c-2acd-4f86-8a5a-09ab3dd02d16.png,602,632,727,752,125,120,red blood cell,15000,0.96,1.0416666666666667
66762,/images/334bf865-e3fb-4200-bd53-d9ff5808ed9f.png,341,1270,456,1371,115,101,red blood cell,11615,0.8782608695652174,1.1386138613861385
41485,/images/c4494d4f-732f-431a-8a9d-62403f0b74fe.png,284,1008,372,1094,88,86,red blood cell,7568,0.9772727272727273,1.0232558139534884
74745,/images/c53fd511-31bd-4901-baac-3b44891f6744.png,714,40,815,136,101,96,red blood cell,9696,0.9504950495049505,1.0520833333333333
1420,/images/6d91d1f0-636b-4f5a-a526-7c17fc857190.png,558,1140,635,1228,77,88,red blood cell,6776,1.1428571428571428,0.875
45598,/images/e597f7ce-46c6-4dce-9063-50a2703fdd45.png,839,611,933,708,94,97,red blood cell,9118,1.0319148936170213,0.9690721649484536
47281,/images/1dd3e6dd-343f-4cc9-b0ed-e4d27fb36f0a.png,283,775,394,896,111,121,red blood cell,13431,1.09009009009009,0.9173553719008265
26557,/images/4935818a-7e7a-4f44-a3b6-b361d1abfe16.png,535,776,653,899,118,123,red blood cell,14514,1.0423728813559323,0.959349593495935
38627,/images/3b601a1b-26d8-4873-afcf-fdd1b1e0010c.png,371,1223,485,1325,114,102,red blood cell,11628,0.8947368421052632,1.1176470588235294
275,/images/0dcca702-a4ef-4fb3-a940-9c0c140b21c7.png,883,777,991,889,108,112,red blood cell,12096,1.037037037037037,0.9642857142857143
77501,/images/2d2e81f3-e329-4765-9ba1-2c95f12dc9f3.png,722,121,812,216,90,95,red blood cell,8550,1.0555555555555556,0.9473684210526315
9608,/images/239f17eb-a2e2-47e9-82e3-fa0d9a70fb9f.png,322,94,460,222,138,128,red blood cell,17664,0.927536231884058,1.078125
9464,/images/f1faab5f-3033-45ea-9673-8b816fea5ce8.png,585,99,699,226,114,127,red blood cell,14478,1.1140350877192982,0.8976377952755905
30296,/images/cecbf663-0751-4e7f-b298-770c88afc2c1.png,68,1130,166,1240,98,110,red blood cell,10780,1.1224489795918366,0.8909090909090909
70974,/images/deaa1931-5f97-45bf-8c00-be6ddeb37b9a.png,1012,1361,1118,1469,106,108,red blood cell,11448,1.0188679245283019,0.9814814814814815
65559,/images/01b38a56-13eb-447b-89ee-fc21cb40dcc1.png,1000,1138,1124,1251,124,113,red blood cell,14012,0.9112903225806451,1.0973451327433628
5866,/images/a30da226-b452-408a-a556-bfae4d521464.png,469,159,572,262,103,103,red blood cell,10609,1.0,1.0
78831,/images/19979a60-df80-4111-bf69-81a7e9c4dd0b.png,1093,291,1195,396,102,105,red blood cell,10710,1.0294117647058822,0.9714285714285714
5001,/images/2cc3c4ad-670f-41b6-8910-0704cbc192ef.png,331,491,427,594,96,103,red blood cell,9888,1.0729166666666667,0.9320388349514563
75905,/images/3006096f-ceeb-42be-b69e-785179d7438b.png,215,1209,316,1302,101,93,red blood cell,9393,0.9207920792079208,1.086021505376344
62577,/images/f7a4334a-4332-4de8-b39b-22da907976f2.png,913,1219,1008,1310,95,91,red blood cell,8645,0.9578947368421052,1.043956043956044
46037,/images/72088c26-d2dd-4906-b791-b8947fc7fbe4.png,132,460,233,566,101,106,red blood cell,10706,1.0495049504950495,0.9528301886792453
61322,/images/e16c0dab-780d-4035-872e-1bb91e49f9d2.png,881,1410,1000,1517,119,107,red blood cell,12733,0.8991596638655462,1.1121495327102804
51611,/images/d0347b49-8f98-4632-a384-1a4f57ac6374.png,180,231,286,342,106,111,red blood cell,11766,1.0471698113207548,0.954954954954955
70902,/images/bf002a25-6535-4621-be19-56d468be5413.png,922,303,1010,412,88,109,red blood cell,9592,1.2386363636363635,0.8073394495412844
8746,/images/29dc8176-dfe1-40e0-8247-2dc3c530057e.png,1013,444,1120,570,107,126,red blood cell,13482,1.1775700934579438,0.8492063492063492
24794,/images/530761d4-1931-44cd-b220-d60db0e228f9.png,407,1258,525,1396,118,138,red blood cell,16284,1.1694915254237288,0.855072463768116
66693,/images/b88fe674-fb9a-41d4-b100-cb1c86440d44.png,518,419,606,492,88,73,red blood cell,6424,0.8295454545454546,1.2054794520547945
11802,/images/082e1f81-4f49-44ad-b5bb-9dfc155b2ed8.png,233,1061,355,1187,122,126,red blood cell,15372,1.0327868852459017,0.9682539682539683
8658,/images/ea6b012a-3425-4bfc-a61d-88563aa2a264.png,534,1156,654,1276,120,120,red blood cell,14400,1.0,1.0
15686,/images/3892b776-f49a-4368-b0fa-7e855e76ccec.png,24,786,113,887,89,101,red blood cell,8989,1.1348314606741574,0.8811881188118812
40611,/images/252071ac-e9f2-41d2-abbb-87ef01b8a997.png,105,153,204,256,99,103,red blood cell,10197,1.0404040404040404,0.9611650485436893
49075,/images/df3d98b9-3dd7-4107-8d4a-ae1b7f247793.png,267,483,359,594,92,111,red blood cell,10212,1.2065217391304348,0.8288288288288288
48761,/images/fed6ba05-36a5-45dc-a4e1-9baa7de2c622.png,999,219,1114,317,115,98,red blood cell,11270,0.8521739130434782,1.1734693877551021
59946,/images/f0fe292d-85ae-4c3a-a676-037dde2594e6.png,484,324,610,445,126,121,red blood cell,15246,0.9603174603174603,1.0413223140495869
22631,/images/4ab47131-c2ac-461f-b95c-ac19ce24edbd.png,768,867,875,962,107,95,red blood cell,10165,0.8878504672897196,1.1263157894736842
10166,/images/09ecf7be-28e2-4531-b9e2-07e01c44097d.png,601,1348,707,1463,106,115,red blood cell,12190,1.0849056603773586,0.9217391304347826
5246,/images/729733ff-a349-4a96-b636-ccabe7d7e167.png,923,910,1007,1003,84,93,red blood cell,7812,1.1071428571428572,0.9032258064516129
24810,/images/65054b19-5c6a-4870-99a9-eef994721d3a.png,892,762,1015,876,123,114,red blood cell,14022,0.926829268292683,1.0789473684210527
74556,/images/bbedfcbe-9528-4ba9-9d86-4ebba7589ac5.png,492,63,611,173,119,110,red blood cell,13090,0.9243697478991597,1.0818181818181818
77883,/images/464055b6-3351-4636-a919-8be9840fb850.png,701,91,831,202,130,111,red blood cell,14430,0.8538461538461538,1.1711711711711712
38755,/images/b426ef1d-4a59-4f90-b593-50226af60a60.png,404,670,503,773,99,103,red blood cell,10197,1.0404040404040404,0.9611650485436893
30393,/images/58d75854-be99-484e-89f0-4ab208fe07e0.png,878,888,982,994,104,106,red blood cell,11024,1.0192307692307692,0.9811320754716981
19442,/images/5487faad-24a7-46b6-92d8-479d3a8d229f.png,267,725,363,821,96,96,red blood cell,9216,1.0,1.0
12858,/images/b10ea12f-cd36-4f2c-994a-67d1665269ab.png,711,393,804,494,93,101,red blood cell,9393,1.086021505376344,0.9207920792079208
33032,/images/6231d81d-9e84-4a5a-8cb8-47c6a37a0176.png,706,834,783,930,77,96,red blood cell,7392,1.2467532467532467,0.8020833333333334
62445,/images/7dfbfeaf-e3b1-4159-8dcd-d7f731280ac8.png,557,1094,672,1206,115,112,red blood cell,12880,0.9739130434782609,1.0267857142857142
6789,/images/672e4ecf-a56b-462e-b83b-76f4efaa6634.png,320,1106,442,1231,122,125,red blood cell,15250,1.0245901639344261,0.976
77344,/images/3ff98212-7c2a-46cd-afb7-34a2479bed07.png,954,1091,1082,1208,128,117,red blood cell,14976,0.9140625,1.0940170940170941
23822,/images/eeb06e39-482b-443d-8cf6-b9b5c763df78.png,917,555,1042,692,125,137,red blood cell,17125,1.096,0.9124087591240876
15905,/images/c7c1b873-0548-4a73-9618-f60912e164df.png,316,1093,400,1188,84,95,red blood cell,7980,1.130952380952381,0.8842105263157894
37028,/images/b2e34f5f-904e-4473-9dc7-c6bc1ce12640.png,368,592,462,690,94,98,red blood cell,9212,1.0425531914893618,0.9591836734693877
75709,/images/d12c5f45-6b20-46d6-a66f-c5a4683c25b3.png,949,431,1052,529,103,98,red blood cell,10094,0.9514563106796117,1.0510204081632653
19437,/images/5487faad-24a7-46b6-92d8-479d3a8d229f.png,910,142,1036,246,126,104,red blood cell,13104,0.8253968253968254,1.2115384615384615
64466,/images/34a70114-d3e3-4351-b8db-f6caab17e743.png,233,1017,338,1113,105,96,red blood cell,10080,0.9142857142857143,1.09375
48697,/images/03359d4d-69cb-4146-8286-ca7399366f97.png,585,1282,707,1383,122,101,red blood cell,12322,0.8278688524590164,1.2079207920792079
17267,/images/471f75c6-bd5d-4c20-bcc1-258e836f4d69.png,1084,1348,1198,1451,114,103,red blood cell,11742,0.9035087719298246,1.1067961165048543
9313,/images/261562a8-ffd8-4e0e-919b-22e267000b74.png,173,1,291,118,118,117,red blood cell,13806,0.9915254237288136,1.0085470085470085
33004,/images/6231d81d-9e84-4a5a-8cb8-47c6a37a0176.png,390,1075,485,1168,95,93,red blood cell,8835,0.9789473684210527,1.021505376344086
44743,/images/ccb4b13d-ab20-4222-892f-5adf70249aaa.png,393,283,521,404,128,121,red blood cell,15488,0.9453125,1.0578512396694215
9480,/images/f1faab5f-3033-45ea-9673-8b816fea5ce8.png,874,692,984,795,110,103,red blood cell,11330,0.9363636363636364,1.0679611650485437
65195,/images/50715879-2300-4dba-8f4a-3314ff8cfcce.png,104,1415,211,1529,107,114,red blood cell,12198,1.0654205607476634,0.9385964912280702
76559,/images/38c69905-8a4f-451a-8d0a-b855dc88dd16.png,762,1465,848,1556,86,91,red blood cell,7826,1.058139534883721,0.945054945054945
19788,/images/68e69cfb-1a07-48d2-8abe-46b46fe264ed.png,681,1419,802,1527,121,108,red blood cell,13068,0.8925619834710744,1.1203703703703705
32228,/images/f4722a74-35e7-42bd-8ef6-dfff04b9cd22.png,95,1055,222,1165,127,110,red blood cell,13970,0.8661417322834646,1.1545454545454545
142,/images/6b14c855-8561-417c-97a4-63fa552842fd.png,480,1173,586,1290,106,117,red blood cell,12402,1.1037735849056605,0.905982905982906
27667,/images/18dbe7c4-89d2-42a6-a969-1e951ab313b1.png,902,514,1005,607,103,93,red blood cell,9579,0.9029126213592233,1.10752688172043
60406,/images/8d5d5c22-2f75-4fe1-9ea3-03a3c7b92ea9.png,383,363,488,466,105,103,red blood cell,10815,0.9809523809523809,1.0194174757281553
42637,/images/3abbc4d3-1d7e-40c9-9963-33732da7cc50.png,236,804,358,919,122,115,red blood cell,14030,0.9426229508196722,1.0608695652173914
21424,/images/b701b5c5-b922-4315-b12a-aac4ec65ee8b.png,659,1218,776,1343,117,125,red blood cell,14625,1.0683760683760684,0.936
1163,/images/4411fea2-d785-4eeb-80c6-c739ab6114c4.png,954,594,1052,714,98,120,red blood cell,11760,1.2244897959183674,0.8166666666666667
40168,/images/b34e65f6-c32e-42f1-a437-4a037c75a231.png,1006,1006,1113,1110,107,104,red blood cell,11128,0.9719626168224299,1.0288461538461537
48625,/images/55836297-fc8e-4e00-9767-0d12b86e4604.png,625,127,724,248,99,121,red blood cell,11979,1.2222222222222223,0.8181818181818182
37284,/images/2fdbd9bc-bbaf-44c2-b40c-d193709639fa.png,1014,517,1118,635,104,118,red blood cell,12272,1.1346153846153846,0.8813559322033898
28064,/images/f1f9df6d-c4cb-4b42-9ca2-8fb47b1b0e91.png,206,1173,316,1281,110,108,red blood cell,11880,0.9818181818181818,1.0185185185185186
59826,/images/acb16781-11ad-4327-874a-5c9c35dcb085.png,399,252,492,357,93,105,red blood cell,9765,1.1290322580645162,0.8857142857142857
50967,/images/ef8fcfa4-8466-4186-8c69-f5f4904eb489.png,540,1479,640,1578,100,99,red blood cell,9900,0.99,1.0101010101010102
76964,/images/51e86aa9-caa0-4297-94e8-34a57d7f7e36.png,535,370,634,467,99,97,red blood cell,9603,0.9797979797979798,1.0206185567010309
53184,/images/801296d9-3403-426f-859e-5c532858e025.png,971,489,1088,604,117,115,red blood cell,13455,0.9829059829059829,1.017391304347826
14026,/images/eaf4b781-b3aa-41ce-8c5e-287979b4e15a.png,505,1186,594,1275,89,89,red blood cell,7921,1.0,1.0
7838,/images/1493d140-c9d5-4c3a-9caf-3eafb290a49b.png,496,265,604,379,108,114,red blood cell,12312,1.0555555555555556,0.9473684210526315
50301,/images/3d32a988-449d-4d58-b71f-abbfdc3f2fbc.png,764,850,866,950,102,100,red blood cell,10200,0.9803921568627451,1.02
72770,/images/caeb2d62-1166-43f0-8eac-5b8fc48f02eb.png,919,1321,1016,1429,97,108,red blood cell,10476,1.1134020618556701,0.8981481481481481
33186,/images/877d5e7f-19b6-40e7-81bd-c92f25e72503.png,975,817,1091,940,116,123,red blood cell,14268,1.0603448275862069,0.943089430894309
77606,/images/f20a4fcf-ea8e-4c14-883d-d26a9e08ce25.png,689,1486,809,1599,120,113,red blood cell,13560,0.9416666666666667,1.0619469026548674
14058,/images/eaf4b781-b3aa-41ce-8c5e-287979b4e15a.png,973,516,1074,615,101,99,red blood cell,9999,0.9801980198019802,1.02020202020202
22723,/images/4ab47131-c2ac-461f-b95c-ac19ce24edbd.png,1054,1123,1177,1234,123,111,red blood cell,13653,0.9024390243902439,1.1081081081081081
5113,/images/a777e78c-ad1f-4380-9ab2-b4f9f32b2d78.png,1012,931,1123,1041,111,110,red blood cell,12210,0.990990990990991,1.009090909090909
53553,/images/7c1cd7c7-7452-4428-a98e-dd7675c8ddea.png,290,818,398,914,108,96,red blood cell,10368,0.8888888888888888,1.125
47647,/images/4b3a49bc-8536-4760-9553-440a6f64db37.png,321,1186,432,1305,111,119,red blood cell,13209,1.072072072072072,0.9327731092436975
26809,/images/2518f6e4-29cc-4ae4-a914-b215a4c56099.png,91,618,201,749,110,131,red blood cell,14410,1.190909090909091,0.8396946564885496
13495,/images/370277f8-436b-4103-8210-b4feb5ab95ea.png,57,517,156,608,99,91,red blood cell,9009,0.9191919191919192,1.0879120879120878
56988,/images/003d1cdc-0aec-430b-90e0-f4d82135b1ac.png,792,932,902,1053,110,121,red blood cell,13310,1.1,0.9090909090909091
68540,/images/32700bc7-7a86-49d3-aded-ccaaed4ddc5c.png,302,317,416,422,114,105,red blood cell,11970,0.9210526315789473,1.0857142857142856
55528,/images/a27b451d-44a6-4740-861a-9e7e99915563.png,82,11,187,136,105,125,red blood cell,13125,1.1904761904761905,0.84
42844,/images/7029feb3-9ffe-46e4-9883-6a9df84f7b62.png,517,662,605,750,88,88,red blood cell,7744,1.0,1.0
4136,/images/d3b79739-aea2-4804-8c7a-183b7ed07de3.png,23,580,129,684,106,104,red blood cell,11024,0.9811320754716981,1.0192307692307692
14897,/images/3090a362-1f3d-49e9-a76e-ce76ff9c2276.png,781,36,868,124,87,88,red blood cell,7656,1.0114942528735633,0.9886363636363636
47515,/images/adff132d-3af0-4cef-942c-58fc09729bee.png,449,779,563,904,114,125,red blood cell,14250,1.0964912280701755,0.912
45473,/images/e4eea7ea-8989-46a9-9c98-25a178146b28.png,489,741,576,828,87,87,red blood cell,7569,1.0,1.0
52197,/images/f4c00b8c-d675-4255-8277-ca65bd757f51.png,19,735,115,830,96,95,red blood cell,9120,0.9895833333333334,1.0105263157894737
65508,/images/da49db57-0c2f-4213-b322-c88c19fb9296.png,173,199,275,321,102,122,red blood cell,12444,1.196078431372549,0.8360655737704918
71503,/images/191071ab-6515-428c-9f05-8e4309542b75.png,900,1154,1020,1289,120,135,red blood cell,16200,1.125,0.8888888888888888
50812,/images/db0a1123-0b35-48d7-8337-3b1ebd6af0cc.png,7,1317,124,1434,117,117,red blood cell,13689,1.0,1.0
39231,/images/2aeb7b85-7df9-4a63-8d37-2eecaaa190e7.png,982,1185,1082,1288,100,103,red blood cell,10300,1.03,0.970873786407767
63876,/images/5e974892-0ebe-4037-8427-ea8616d6d3b8.png,42,1015,162,1121,120,106,red blood cell,12720,0.8833333333333333,1.1320754716981132
19419,/images/5487faad-24a7-46b6-92d8-479d3a8d229f.png,1047,171,1146,265,99,94,red blood cell,9306,0.9494949494949495,1.053191489361702
28479,/images/c3042130-a6e2-458f-9fde-bb012f68f5f2.png,280,408,389,528,109,120,red blood cell,13080,1.1009174311926606,0.9083333333333333
15752,/images/64113b22-03b1-4ab8-89ab-b2f32154fbbd.png,791,71,909,187,118,116,red blood cell,13688,0.9830508474576272,1.0172413793103448
14784,/images/1fdf99d1-a494-4174-bcd7-efbe457ab899.png,302,383,415,492,113,109,red blood cell,12317,0.9646017699115044,1.036697247706422
62919,/images/4b346035-b8c0-46ca-8fdb-a01b1421ee4a.png,0,832,101,935,101,103,red blood cell,10403,1.0198019801980198,0.9805825242718447
39144,/images/7bde7de1-889b-4218-b0e1-e2c04f6a7986.png,1105,744,1199,837,94,93,red blood cell,8742,0.9893617021276596,1.010752688172043
77856,/images/6bc7b53c-5a98-48ef-a9de-59a476707ea4.png,485,1203,573,1289,88,86,red blood cell,7568,0.9772727272727273,1.0232558139534884
61020,/images/3d1429ed-4619-41f7-8ff3-d698ad28034c.png,1014,688,1115,808,101,120,red blood cell,12120,1.188118811881188,0.8416666666666667
75366,/images/468c261d-f5d8-423f-883e-48af2bbbc5d1.png,578,983,683,1087,105,104,red blood cell,10920,0.9904761904761905,1.0096153846153846
68907,/images/bbaa004f-05dc-4cb8-8768-e148085bb0f9.png,398,1036,499,1137,101,101,red blood cell,10201,1.0,1.0
34555,/images/3af90874-59f3-4f0c-a7e6-cc889e80c605.png,665,85,791,206,126,121,red blood cell,15246,0.9603174603174603,1.0413223140495869
6006,/images/97eff653-3908-4e66-931f-eab36bc336c8.png,785,949,907,1065,122,116,red blood cell,14152,0.9508196721311475,1.0517241379310345
26612,/images/5893e081-04f2-4e33-9851-bed5f0e4d333.png,860,907,985,1015,125,108,red blood cell,13500,0.864,1.1574074074074074
55537,/images/a27b451d-44a6-4740-861a-9e7e99915563.png,190,72,291,173,101,101,red blood cell,10201,1.0,1.0
4757,/images/3fa1a4e3-c80d-49da-8f7b-a1abb0424f48.png,19,1141,127,1235,108,94,red blood cell,10152,0.8703703703703703,1.148936170212766
4709,/images/b91b1641-ee06-44d8-94cc-24cdb583cc37.png,1034,695,1146,818,112,123,red blood cell,13776,1.0982142857142858,0.9105691056910569
29151,/images/cfab01d3-0616-4efb-9290-11f0fd8bf5a3.png,80,1456,201,1588,121,132,red blood cell,15972,1.0909090909090908,0.9166666666666666
55142,/images/29d4b75f-d400-4702-a9ac-e5a4ed1a1db1.png,666,756,776,872,110,116,red blood cell,12760,1.0545454545454545,0.9482758620689655
54390,/images/22a464ef-c3da-4d56-b37e-e22e95d945e7.png,161,453,259,536,98,83,red blood cell,8134,0.8469387755102041,1.180722891566265
3705,/images/dacf7e3f-1d8c-42a0-8539-3abe3971c956.png,87,1170,207,1294,120,124,red blood cell,14880,1.0333333333333334,0.967741935483871
58339,/images/50f2f514-6c8e-4c79-b3b3-0be56dd0b78b.png,163,533,283,654,120,121,red blood cell,14520,1.0083333333333333,0.9917355371900827
56587,/images/a824b499-3736-4581-bbdc-be1b3b4cf756.png,784,1352,878,1435,94,83,red blood cell,7802,0.8829787234042553,1.1325301204819278
78465,/images/72029aca-f0bc-477f-b790-f345f86228ce.png,87,1037,183,1142,96,105,red blood cell,10080,1.09375,0.9142857142857143
15654,/images/84d7545e-c3a8-4b1f-9a39-36aab78c8699.png,976,831,1088,940,112,109,red blood cell,12208,0.9732142857142857,1.0275229357798166
27279,/images/9f38055f-4fe6-47fd-a6dd-c0743db4eccf.png,428,469,535,574,107,105,red blood cell,11235,0.9813084112149533,1.019047619047619
30509,/images/5955289d-19e5-45ef-a012-c8ea08ef45e2.png,690,973,796,1098,106,125,red blood cell,13250,1.179245283018868,0.848
3337,/images/b1100ae1-0ac8-4fc2-b0ff-8819f7fbe724.png,755,1097,870,1197,115,100,red blood cell,11500,0.8695652173913043,1.15
48561,/images/f3d84be2-8af0-4d62-9f72-23d3dc08cbbe.png,899,1299,1014,1408,115,109,red blood cell,12535,0.9478260869565217,1.055045871559633
19086,/images/6e39fb0a-aa41-4b16-b783-7589e97bf289.png,878,420,994,541,116,121,red blood cell,14036,1.043103448275862,0.9586776859504132
27378,/images/9f38055f-4fe6-47fd-a6dd-c0743db4eccf.png,519,1047,620,1138,101,91,red blood cell,9191,0.900990099009901,1.10989010989011
48818,/images/fed6ba05-36a5-45dc-a4e1-9baa7de2c622.png,580,700,688,787,108,87,red blood cell,9396,0.8055555555555556,1.2413793103448276
71375,/images/bcb447c9-5d37-414f-a513-d7076b04a532.png,534,1171,648,1279,114,108,red blood cell,12312,0.9473684210526315,1.0555555555555556
70752,/images/8ab5c462-045e-4b59-b53a-9b2bc3ed2487.png,727,1363,815,1447,88,84,red blood cell,7392,0.9545454545454546,1.0476190476190477
69238,/images/f274b784-b995-4a7e-a2c2-6cc31c24c4b4.png,1004,141,1094,229,90,88,red blood cell,7920,0.9777777777777777,1.0227272727272727
63064,/images/6afd8203-d61a-4e9b-a4cf-dcb53a16b57c.png,295,558,403,666,108,108,red blood cell,11664,1.0,1.0
18364,/images/39cc33be-d752-40fe-b7a8-2e69a3517205.png,475,1478,576,1577,101,99,red blood cell,9999,0.9801980198019802,1.02020202020202
21858,/images/9b3fd401-dab0-440f-8498-eb3cc9ffa970.png,766,1296,862,1388,96,92,red blood cell,8832,0.9583333333333334,1.0434782608695652
51564,/images/d0347b49-8f98-4632-a384-1a4f57ac6374.png,1032,1187,1137,1294,105,107,red blood cell,11235,1.019047619047619,0.9813084112149533
20464,/images/b809b407-7b69-4334-873d-d6c49135f04a.png,675,405,790,524,115,119,red blood cell,13685,1.0347826086956522,0.9663865546218487
28697,/images/151f3af5-5e6e-4bcd-9389-4974fc68813e.png,379,700,496,802,117,102,red blood cell,11934,0.8717948717948718,1.1470588235294117
76807,/images/2165fe38-b474-467d-be11-d1d728085efd.png,340,1320,458,1435,118,115,red blood cell,13570,0.9745762711864406,1.0260869565217392
47697,/images/4b3a49bc-8536-4760-9553-440a6f64db37.png,679,685,795,779,116,94,red blood cell,10904,0.8103448275862069,1.2340425531914894
48976,/images/df3d98b9-3dd7-4107-8d4a-ae1b7f247793.png,177,873,285,971,108,98,red blood cell,10584,0.9074074074074074,1.1020408163265305
76334,/images/3dad6483-ac30-4d2b-b045-9f24fe6ff75e.png,360,1302,459,1406,99,104,red blood cell,10296,1.0505050505050506,0.9519230769230769
23172,/images/c94a5851-b846-4fde-8c89-05bec3a8ac53.png,1097,32,1191,131,94,99,red blood cell,9306,1.053191489361702,0.9494949494949495
34887,/images/a4fbb9f2-9b75-4fdc-877d-2feaafac25b3.png,571,1187,691,1292,120,105,red blood cell,12600,0.875,1.1428571428571428
64342,/images/0a7bfa8a-ee52-4f7a-b9c5-2919ecfa93ef.png,886,164,1003,270,117,106,red blood cell,12402,0.905982905982906,1.1037735849056605
54756,/images/10891eed-b0f2-4dd0-90cb-da185f6761b2.png,8,89,117,200,109,111,red blood cell,12099,1.018348623853211,0.9819819819819819
68205,/images/ff1b23d0-3cef-459b-b81f-39bfcdb6526f.png,326,249,447,369,121,120,red blood cell,14520,0.9917355371900827,1.0083333333333333
73590,/images/a51d6c18-f9e8-4714-9dbb-38e1577445f2.png,84,1437,191,1540,107,103,red blood cell,11021,0.9626168224299065,1.0388349514563107
52036,/images/6c3f81d7-5670-46bd-9eaa-9b426413abb7.png,510,1249,625,1360,115,111,red blood cell,12765,0.9652173913043478,1.0360360360360361
64409,/images/0a7bfa8a-ee52-4f7a-b9c5-2919ecfa93ef.png,4,60,88,164,84,104,red blood cell,8736,1.2380952380952381,0.8076923076923077
4584,/images/98efca97-37d2-4459-aca6-375ecc0c4539.png,367,1018,481,1128,114,110,red blood cell,12540,0.9649122807017544,1.0363636363636364
23725,/images/79d7a014-21ff-40f1-9ac4-a69839390654.png,446,1339,532,1442,86,103,red blood cell,8858,1.197674418604651,0.8349514563106796
35245,/images/a9159b11-ba49-4885-902e-00c8d5095b98.png,40,1112,141,1199,101,87,red blood cell,8787,0.8613861386138614,1.160919540229885
24062,/images/5107dcb7-164f-4e10-bbff-822b39b76efc.png,497,52,607,158,110,106,red blood cell,11660,0.9636363636363636,1.0377358490566038
72073,/images/64b0e49a-0e48-447d-8872-c1dd255e7a21.png,317,174,400,263,83,89,red blood cell,7387,1.072289156626506,0.9325842696629213
3940,/images/f09acb0c-b270-4e91-99f8-410adfa7f34a.png,375,980,480,1073,105,93,red blood cell,9765,0.8857142857142857,1.1290322580645162
62421,/images/9af1ee02-87fd-42bc-963e-fa9ac3eb45bb.png,389,1022,464,1110,75,88,red blood cell,6600,1.1733333333333333,0.8522727272727273
45042,/images/13bab3c3-3f79-44d9-a287-0ae6d71eff31.png,202,1360,316,1495,114,135,red blood cell,15390,1.1842105263157894,0.8444444444444444
67675,/images/2b128a1a-95ed-408b-b9f8-8795cc814d80.png,920,778,1035,889,115,111,red blood cell,12765,0.9652173913043478,1.0360360360360361
41807,/images/28bd16ba-2bcf-46af-b889-41b78d2a50c0.png,765,434,876,551,111,117,red blood cell,12987,1.054054054054054,0.9487179487179487
40072,/images/6fd30823-3b77-40c9-ba5d-e1eda9660674.png,731,108,840,238,109,130,red blood cell,14170,1.1926605504587156,0.8384615384615385
3440,/images/ad36bd67-594b-4f63-93e3-886af0bc618e.png,1013,631,1117,734,104,103,red blood cell,10712,0.9903846153846154,1.0097087378640777
628,/images/e61e6af2-7f8b-47b0-bbe7-acb2ed0299ab.png,131,535,261,652,130,117,red blood cell,15210,0.9,1.1111111111111112
4715,/images/b91b1641-ee06-44d8-94cc-24cdb583cc37.png,151,42,282,153,131,111,red blood cell,14541,0.8473282442748091,1.1801801801801801
10906,/images/1380f9b4-bf54-4492-90c3-743c7aa8898b.png,408,309,527,412,119,103,red blood cell,12257,0.865546218487395,1.1553398058252426
33754,/images/441d7843-b20b-4c10-84e3-e6d32621e880.png,637,1147,725,1241,88,94,red blood cell,8272,1.0681818181818181,0.9361702127659575
48796,/images/fed6ba05-36a5-45dc-a4e1-9baa7de2c622.png,306,70,411,175,105,105,red blood cell,11025,1.0,1.0
55302,/images/4fb83278-adc5-4424-9f45-b6d0db2955b6.png,623,1062,720,1159,97,97,red blood cell,9409,1.0,1.0
42120,/images/c63f190a-e860-44fc-a2db-7980e1c80519.png,714,1051,842,1159,128,108,red blood cell,13824,0.84375,1.1851851851851851
15100,/images/3a8f468f-f9de-46a8-a7c8-f2be239fa207.png,852,530,957,620,105,90,red blood cell,9450,0.8571428571428571,1.1666666666666667
25704,/images/c118ff18-f9f2-4617-bddb-dc4091fb8f5f.png,866,57,977,155,111,98,red blood cell,10878,0.8828828828828829,1.1326530612244898
65827,/images/daea4860-a296-4f6d-acef-996ab0882676.png,527,931,625,1048,98,117,red blood cell,11466,1.1938775510204083,0.8376068376068376
57571,/images/8190ec37-9a5e-419f-89ed-fbfb079370db.png,447,378,550,482,103,104,red blood cell,10712,1.0097087378640777,0.9903846153846154
53779,/images/76b24246-8571-4e7b-8815-b185414a2c51.png,234,297,321,387,87,90,red blood cell,7830,1.0344827586206897,0.9666666666666667
9422,/images/e3a4b3e7-9500-4b6c-a402-b6d3f45e714b.png,160,967,277,1079,117,112,red blood cell,13104,0.9572649572649573,1.0446428571428572
65786,/images/daea4860-a296-4f6d-acef-996ab0882676.png,432,440,543,544,111,104,red blood cell,11544,0.9369369369369369,1.0673076923076923
18167,/images/947348fe-4c70-468e-8009-3c14daeca69b.png,450,1502,562,1594,112,92,red blood cell,10304,0.8214285714285714,1.2173913043478262
35451,/images/3722d213-f2a9-46d5-aa76-9183b443e455.png,410,213,528,331,118,118,red blood cell,13924,1.0,1.0
17375,/images/04018590-4e66-4cb9-ad2d-83570f1b29ae.png,237,570,348,699,111,129,red blood cell,14319,1.162162162162162,0.8604651162790697
26105,/images/27388ff2-4000-4c9a-a2e3-addc448a5f92.png,495,856,630,982,135,126,red blood cell,17010,0.9333333333333333,1.0714285714285714
64365,/images/0a7bfa8a-ee52-4f7a-b9c5-2919ecfa93ef.png,769,691,868,801,99,110,red blood cell,10890,1.1111111111111112,0.9
57629,/images/d32022fa-e492-4b31-a776-9435cfdef6d6.png,212,306,328,417,116,111,red blood cell,12876,0.9568965517241379,1.045045045045045
70082,/images/b8339d7b-85ec-48d0-83e8-c8f831070459.png,611,776,702,881,91,105,red blood cell,9555,1.1538461538461537,0.8666666666666667
47431,/images/3e753a44-3264-438c-8389-a7822e4a84cc.png,388,1447,515,1578,127,131,red blood cell,16637,1.031496062992126,0.9694656488549618
46877,/images/9e0e1928-d19a-4100-b093-0b962ac09e05.png,353,892,447,990,94,98,red blood cell,9212,1.0425531914893618,0.9591836734693877
24176,/images/194aec70-41a5-4ac3-b22f-0b6eda91f730.png,14,125,127,244,113,119,red blood cell,13447,1.0530973451327434,0.9495798319327731
27980,/images/c4d34e35-4db2-41de-ba77-1a94aa9ef788.png,618,1025,724,1143,106,118,red blood cell,12508,1.1132075471698113,0.8983050847457628
49477,/images/9f33e0ea-065b-4703-9df9-15829b891860.png,721,1271,843,1374,122,103,red blood cell,12566,0.8442622950819673,1.1844660194174756
10914,/images/1380f9b4-bf54-4492-90c3-743c7aa8898b.png,446,506,567,624,121,118,red blood cell,14278,0.9752066115702479,1.0254237288135593
42293,/images/ca734448-0d52-42fa-b41c-17b2939e58ae.png,214,88,327,202,113,114,red blood cell,12882,1.008849557522124,0.9912280701754386
50080,/images/e98baeb2-aa58-4cce-8c61-66685dd2b239.png,293,270,416,391,123,121,red blood cell,14883,0.983739837398374,1.0165289256198347
72092,/images/64b0e49a-0e48-447d-8872-c1dd255e7a21.png,282,1021,365,1115,83,94,red blood cell,7802,1.1325301204819278,0.8829787234042553
66785,/images/334bf865-e3fb-4200-bd53-d9ff5808ed9f.png,1018,698,1116,794,98,96,red blood cell,9408,0.9795918367346939,1.0208333333333333
63032,/images/6afd8203-d61a-4e9b-a4cf-dcb53a16b57c.png,172,1097,293,1205,121,108,red blood cell,13068,0.8925619834710744,1.1203703703703705
28501,/images/dc4270fb-e5c2-414f-96e9-6769ba1d77e4.png,376,726,488,843,112,117,red blood cell,13104,1.0446428571428572,0.9572649572649573
4489,/images/0f26699f-a776-4424-b092-27da9a1d12e2.png,651,1118,760,1214,109,96,red blood cell,10464,0.8807339449541285,1.1354166666666667
73730,/images/f11d05e4-538a-4024-8711-b08a4ce3c540.png,773,510,863,598,90,88,red blood cell,7920,0.9777777777777777,1.0227272727272727
58851,/images/434523fd-d4d9-4961-a7c2-d71d6ae68e13.png,55,1128,161,1224,106,96,red blood cell,10176,0.9056603773584906,1.1041666666666667
68405,/images/040112be-3c8d-49aa-93f1-522f94a592ff.png,662,942,765,1049,103,107,red blood cell,11021,1.0388349514563107,0.9626168224299065
51937,/images/4f62b14e-c6f4-4155-8f50-881558f83fae.png,74,522,165,619,91,97,red blood cell,8827,1.065934065934066,0.9381443298969072
46481,/images/21417261-475a-456f-b03f-57ac85a6e106.png,28,382,134,496,106,114,red blood cell,12084,1.0754716981132075,0.9298245614035088
32961,/images/d1924af6-7512-4ccc-9c6b-adbbaa8db41f.png,17,327,115,446,98,119,red blood cell,11662,1.2142857142857142,0.8235294117647058
1815,/images/5f783f43-0090-4f8a-bd75-9562f4aa2dd5.png,336,356,436,468,100,112,red blood cell,11200,1.12,0.8928571428571429
38538,/images/c3ae7090-fc68-41b4-85a1-8d9bce9825a7.png,129,939,245,1069,116,130,red blood cell,15080,1.1206896551724137,0.8923076923076924
74568,/images/bbedfcbe-9528-4ba9-9d86-4ebba7589ac5.png,1016,320,1133,433,117,113,red blood cell,13221,0.9658119658119658,1.0353982300884956
43530,/images/2d857091-efcd-41c0-ba3f-226de90445c4.png,597,1259,697,1379,100,120,red blood cell,12000,1.2,0.8333333333333334
53178,/images/801296d9-3403-426f-859e-5c532858e025.png,418,790,520,912,102,122,red blood cell,12444,1.196078431372549,0.8360655737704918
30515,/images/5955289d-19e5-45ef-a012-c8ea08ef45e2.png,1070,340,1185,439,115,99,red blood cell,11385,0.8608695652173913,1.1616161616161615
69194,/images/f274b784-b995-4a7e-a2c2-6cc31c24c4b4.png,210,864,328,973,118,109,red blood cell,12862,0.923728813559322,1.0825688073394495
55524,/images/43072c64-4c08-47cd-ae8a-b74d31f80008.png,368,556,453,644,85,88,red blood cell,7480,1.035294117647059,0.9659090909090909
78666,/images/fd1c4c7a-24bc-43f2-b84f-fee182207aee.png,773,189,878,302,105,113,red blood cell,11865,1.0761904761904761,0.9292035398230089
32914,/images/e40000b4-1b26-42ce-909d-4715e04f0a6e.png,52,234,186,346,134,112,red blood cell,15008,0.835820895522388,1.1964285714285714
14965,/images/5d1418d3-1559-4725-ad4a-9afb6eaecdfd.png,958,441,1065,549,107,108,red blood cell,11556,1.0093457943925233,0.9907407407407407
16691,/images/d6352a03-ef81-421d-915e-226499555d20.png,810,1439,930,1560,120,121,red blood cell,14520,1.0083333333333333,0.9917355371900827
820,/images/27fab82c-5bf0-426f-aeb9-47da829b6629.png,970,1132,1082,1235,112,103,red blood cell,11536,0.9196428571428571,1.087378640776699
60558,/images/58065a0c-d4c5-40fd-bcdc-037f61788482.png,639,114,762,232,123,118,red blood cell,14514,0.959349593495935,1.0423728813559323
75732,/images/d12c5f45-6b20-46d6-a66f-c5a4683c25b3.png,518,468,620,564,102,96,red blood cell,9792,0.9411764705882353,1.0625
674,/images/e61e6af2-7f8b-47b0-bbe7-acb2ed0299ab.png,118,706,212,796,94,90,red blood cell,8460,0.9574468085106383,1.0444444444444445
55500,/images/43072c64-4c08-47cd-ae8a-b74d31f80008.png,158,1024,272,1117,114,93,red blood cell,10602,0.8157894736842105,1.2258064516129032
27547,/images/715761a2-745e-4743-9849-956a034ad3c4.png,185,1415,307,1524,122,109,red blood cell,13298,0.8934426229508197,1.1192660550458715
63063,/images/6afd8203-d61a-4e9b-a4cf-dcb53a16b57c.png,156,967,259,1061,103,94,red blood cell,9682,0.912621359223301,1.0957446808510638
76680,/images/3317d733-ec0d-45e6-b631-40457392f343.png,621,683,736,786,115,103,red blood cell,11845,0.8956521739130435,1.116504854368932
26372,/images/ef1419e0-3a3a-458a-b3b2-7efddac50404.png,856,748,968,854,112,106,red blood cell,11872,0.9464285714285714,1.0566037735849056
64385,/images/0a7bfa8a-ee52-4f7a-b9c5-2919ecfa93ef.png,555,249,650,344,95,95,red blood cell,9025,1.0,1.0
76186,/images/07a96126-482e-4beb-b42a-0cb59e505372.png,947,412,1070,527,123,115,red blood cell,14145,0.9349593495934959,1.0695652173913044
24244,/images/bb3ae957-0f6d-4615-bfe5-24fbca50b459.png,866,1377,990,1489,124,112,red blood cell,13888,0.9032258064516129,1.1071428571428572
67300,/images/49c4dbd3-6269-4d4c-9648-a2146c57bab1.png,230,38,325,147,95,109,red blood cell,10355,1.1473684210526316,0.8715596330275229
22635,/images/4ab47131-c2ac-461f-b95c-ac19ce24edbd.png,195,415,307,535,112,120,red blood cell,13440,1.0714285714285714,0.9333333333333333
62280,/images/e0ff3476-226f-4125-b182-8e524d5503dd.png,1005,1151,1103,1247,98,96,red blood cell,9408,0.9795918367346939,1.0208333333333333
3988,/images/f09acb0c-b270-4e91-99f8-410adfa7f34a.png,413,865,507,968,94,103,red blood cell,9682,1.0957446808510638,0.912621359223301
49260,/images/989d86a1-6d76-4089-85cf-2f2ca0a8456c.png,865,257,971,366,106,109,red blood cell,11554,1.028301886792453,0.9724770642201835
16243,/images/acdc6e12-73d9-44ba-be8c-2a56aaffef4f.png,714,277,823,388,109,111,red blood cell,12099,1.018348623853211,0.9819819819819819
9335,/images/261562a8-ffd8-4e0e-919b-22e267000b74.png,187,370,270,460,83,90,red blood cell,7470,1.0843373493975903,0.9222222222222223
21388,/images/5077f87d-a19f-494c-b911-14ccb03bd230.png,663,510,791,614,128,104,red blood cell,13312,0.8125,1.2307692307692308
28003,/images/c4d34e35-4db2-41de-ba77-1a94aa9ef788.png,713,967,830,1080,117,113,red blood cell,13221,0.9658119658119658,1.0353982300884956
27763,/images/e3c1442a-717f-41dd-bf97-81e1233ac9fa.png,1074,1112,1200,1237,126,125,red blood cell,15750,0.9920634920634921,1.008
18390,/images/39cc33be-d752-40fe-b7a8-2e69a3517205.png,494,35,598,149,104,114,red blood cell,11856,1.0961538461538463,0.9122807017543859
30184,/images/a1669b59-fe09-4fe6-ba9f-06bec6725502.png,542,72,641,178,99,106,red blood cell,10494,1.0707070707070707,0.9339622641509434
32335,/images/a6526894-e290-482d-ac43-f1df34864817.png,363,1022,475,1139,112,117,red blood cell,13104,1.0446428571428572,0.9572649572649573
72771,/images/caeb2d62-1166-43f0-8eac-5b8fc48f02eb.png,998,1150,1100,1254,102,104,red blood cell,10608,1.0196078431372548,0.9807692307692307
41717,/images/67abb826-9b70-4459-8764-da76ecf35bfe.png,918,1146,1042,1274,124,128,red blood cell,15872,1.032258064516129,0.96875
35236,/images/a9159b11-ba49-4885-902e-00c8d5095b98.png,987,650,1077,743,90,93,red blood cell,8370,1.0333333333333334,0.967741935483871
72964,/images/a20d0b4b-6e2e-4507-bc22-f321dedc4ed9.png,492,1172,566,1260,74,88,red blood cell,6512,1.1891891891891893,0.8409090909090909
66731,/images/334bf865-e3fb-4200-bd53-d9ff5808ed9f.png,854,80,950,179,96,99,red blood cell,9504,1.03125,0.9696969696969697
60224,/images/214f1d15-a081-476e-992d-6c3a77f03d59.png,895,1075,981,1174,86,99,red blood cell,8514,1.1511627906976745,0.8686868686868687
77965,/images/c691c8ef-d3c7-47b6-a941-f6a1089f21a9.png,852,94,955,201,103,107,red blood cell,11021,1.0388349514563107,0.9626168224299065
74623,/images/bbedfcbe-9528-4ba9-9d86-4ebba7589ac5.png,1101,29,1199,113,98,84,red blood cell,8232,0.8571428571428571,1.1666666666666667
31045,/images/9c48fdf4-621d-4f40-bcd7-6a28cd530de7.png,320,332,433,453,113,121,red blood cell,13673,1.0707964601769913,0.9338842975206612
50524,/images/e98ea067-82b5-4a0d-87bf-b4bbdc10ddab.png,571,1026,679,1129,108,103,red blood cell,11124,0.9537037037037037,1.0485436893203883
1170,/images/4411fea2-d785-4eeb-80c6-c739ab6114c4.png,479,292,590,413,111,121,red blood cell,13431,1.09009009009009,0.9173553719008265
67002,/images/3b4440f7-a69b-4042-a9d0-d6958abcdf4e.png,910,874,1013,957,103,83,red blood cell,8549,0.8058252427184466,1.2409638554216869
52545,/images/d1144956-5a0c-4bd2-b67d-8498c82d6a12.png,800,73,892,166,92,93,red blood cell,8556,1.0108695652173914,0.989247311827957
43893,/images/679ae89f-4a02-4301-862e-1d844cc66cbf.png,110,413,250,533,140,120,red blood cell,16800,0.8571428571428571,1.1666666666666667
17922,/images/eb77e4a9-acb0-4d83-8055-2c5fcaa54b45.png,1073,1302,1185,1417,112,115,red blood cell,12880,1.0267857142857142,0.9739130434782609
43146,/images/c5db0fc0-b96c-496e-90b4-f9fb1b85b28e.png,993,1070,1099,1166,106,96,red blood cell,10176,0.9056603773584906,1.1041666666666667
19546,/images/2c1eaf87-3fd3-4803-92b8-23bab40bf28c.png,1066,1155,1197,1282,131,127,red blood cell,16637,0.9694656488549618,1.031496062992126
34341,/images/1a48cbc1-5423-47e5-8ca5-2ab4f83a05a5.png,345,1116,471,1228,126,112,red blood cell,14112,0.8888888888888888,1.125
10431,/images/46a2d369-4bea-4405-ac78-91bbe130b9a7.png,1048,230,1149,332,101,102,red blood cell,10302,1.00990099009901,0.9901960784313726
23235,/images/3dcd4f1b-ce43-4a34-b1ed-076bb42963b1.png,219,70,320,173,101,103,red blood cell,10403,1.0198019801980198,0.9805825242718447
62885,/images/4b346035-b8c0-46ca-8fdb-a01b1421ee4a.png,595,397,697,500,102,103,red blood cell,10506,1.0098039215686274,0.9902912621359223
49669,/images/9842445c-5899-4189-9f2e-3a3a179fdad3.png,401,897,509,1004,108,107,red blood cell,11556,0.9907407407407407,1.0093457943925233
62413,/images/9af1ee02-87fd-42bc-963e-fa9ac3eb45bb.png,1098,1342,1194,1455,96,113,red blood cell,10848,1.1770833333333333,0.8495575221238938
62123,/images/a63fa2c7-3ec8-4bb7-bde6-a39e09d2f806.png,77,781,190,895,113,114,red blood cell,12882,1.008849557522124,0.9912280701754386
7197,/images/56551792-4aa1-4301-9f8f-8bfebcd20050.png,995,992,1112,1105,117,113,red blood cell,13221,0.9658119658119658,1.0353982300884956
64667,/images/6dfafdf1-f588-4e80-8cf8-0126e1bf7af9.png,234,1484,332,1599,98,115,red blood cell,11270,1.1734693877551021,0.8521739130434782
48841,/images/fed6ba05-36a5-45dc-a4e1-9baa7de2c622.png,529,1236,619,1339,90,103,red blood cell,9270,1.1444444444444444,0.8737864077669902
74039,/images/fe436c09-b680-4f4c-8faf-aa10a55a335b.png,1063,421,1166,519,103,98,red blood cell,10094,0.9514563106796117,1.0510204081632653
5736,/images/21a50e4c-b750-46b5-801f-5429ede7dea9.png,640,1094,781,1213,141,119,red blood cell,16779,0.8439716312056738,1.184873949579832
45141,/images/2596eb32-1323-41e9-8c0f-64819abcfc73.png,172,534,296,648,124,114,red blood cell,14136,0.9193548387096774,1.087719298245614
2934,/images/00a02700-2ea2-4590-9e15-ffc9160fd3de.png,141,837,257,954,116,117,red blood cell,13572,1.0086206896551724,0.9914529914529915
4259,/images/882b91b7-5906-4091-bad4-688d4375eeb5.png,57,1037,160,1146,103,109,red blood cell,11227,1.058252427184466,0.944954128440367
62065,/images/7f528918-27d4-421f-ab57-0cf9c693e697.png,689,120,803,230,114,110,red blood cell,12540,0.9649122807017544,1.0363636363636364
55646,/images/c32b8bb8-c89d-4ae9-9c77-5b9356ca35a1.png,51,1121,161,1231,110,110,red blood cell,12100,1.0,1.0
16843,/images/4823c1fe-a7f9-4b92-959f-0d9be09cd14b.png,210,30,306,110,96,80,red blood cell,7680,0.8333333333333334,1.2
70398,/images/4876c9d0-b386-48fb-84e8-91bf87529161.png,645,1058,736,1138,91,80,red blood cell,7280,0.8791208791208791,1.1375
28897,/images/686ed568-d5f8-475e-81ad-edab9dd473a0.png,932,196,1017,283,85,87,red blood cell,7395,1.0235294117647058,0.9770114942528736
25399,/images/fbb1b44c-d75a-4550-a6c0-0eb62b96bfce.png,739,92,854,214,115,122,red blood cell,14030,1.0608695652173914,0.9426229508196722
5874,/images/a30da226-b452-408a-a556-bfae4d521464.png,290,317,392,427,102,110,red blood cell,11220,1.0784313725490196,0.9272727272727272
65263,/images/45ac9409-5537-44ed-90cd-5c8a1ae0e1e0.png,86,73,215,177,129,104,red blood cell,13416,0.8062015503875969,1.2403846153846154
48301,/images/6fa2b30f-9b89-46ac-9b79-c0bc105d4271.png,1084,960,1188,1068,104,108,red blood cell,11232,1.0384615384615385,0.9629629629629629
45259,/images/9e793460-d94c-47ac-b3a7-0d6ad86357da.png,1035,993,1150,1103,115,110,red blood cell,12650,0.9565217391304348,1.0454545454545454
43362,/images/36569710-a574-40be-ad42-897a6e74a128.png,774,1254,875,1367,101,113,red blood cell,11413,1.118811881188119,0.8938053097345132
64348,/images/0a7bfa8a-ee52-4f7a-b9c5-2919ecfa93ef.png,596,1090,677,1185,81,95,red blood cell,7695,1.1728395061728396,0.8526315789473684
77869,/images/464055b6-3351-4636-a919-8be9840fb850.png,513,594,612,693,99,99,red blood cell,9801,1.0,1.0
70441,/images/8cca114a-ed05-4b87-95b7-fae02487f08c.png,53,578,149,681,96,103,red blood cell,9888,1.0729166666666667,0.9320388349514563
7059,/images/8be185e7-2a1a-441c-a5c7-b50a9eb926cb.png,1022,420,1130,511,108,91,red blood cell,9828,0.8425925925925926,1.1868131868131868
49875,/images/5e17f8e6-fd8d-426c-b444-1515d14f04b7.png,149,404,244,505,95,101,red blood cell,9595,1.063157894736842,0.9405940594059405
63616,/images/d9c9479e-f1ea-4d6e-861f-843ff9a90d19.png,511,206,623,319,112,113,red blood cell,12656,1.0089285714285714,0.9911504424778761
70561,/images/8cca114a-ed05-4b87-95b7-fae02487f08c.png,228,1301,331,1404,103,103,red blood cell,10609,1.0,1.0
59317,/images/03c8da48-04b9-4520-b674-44a0ecd35688.png,512,614,616,707,104,93,red blood cell,9672,0.8942307692307693,1.118279569892473
58529,/images/5cac6ddf-c8c6-45de-bce0-a1db64b14fb5.png,492,620,580,711,88,91,red blood cell,8008,1.0340909090909092,0.967032967032967
6259,/images/f4a27dfd-4c52-459f-96b5-ee6b452a3395.png,224,1365,360,1485,136,120,red blood cell,16320,0.8823529411764706,1.1333333333333333
66615,/images/087f2c9c-188d-43cc-a94c-0eb8f10ac092.png,587,677,675,774,88,97,red blood cell,8536,1.1022727272727273,0.9072164948453608
45015,/images/13bab3c3-3f79-44d9-a287-0ae6d71eff31.png,767,500,885,606,118,106,red blood cell,12508,0.8983050847457628,1.1132075471698113
50120,/images/e98baeb2-aa58-4cce-8c61-66685dd2b239.png,894,600,1001,720,107,120,red blood cell,12840,1.1214953271028036,0.8916666666666667
22368,/images/78c35732-7e31-4153-842e-55ab1cd656f6.png,966,537,1068,635,102,98,red blood cell,9996,0.9607843137254902,1.0408163265306123
76272,/images/1574565f-f45b-4160-947e-25ce1a81aaca.png,290,411,410,538,120,127,red blood cell,15240,1.0583333333333333,0.9448818897637795
71025,/images/59daa25e-85d6-42f2-8f39-cc9f9d5d252e.png,226,775,346,892,120,117,red blood cell,14040,0.975,1.0256410256410255
38814,/images/d0d3ae45-b434-4869-a518-427320ebe62d.png,385,147,492,279,107,132,red blood cell,14124,1.233644859813084,0.8106060606060606
26359,/images/ef1419e0-3a3a-458a-b3b2-7efddac50404.png,239,661,343,781,104,120,red blood cell,12480,1.1538461538461537,0.8666666666666667
51398,/images/b4f3b2a4-f4b9-48de-ac5d-0e681b77be27.png,562,421,671,542,109,121,red blood cell,13189,1.110091743119266,0.9008264462809917
53719,/images/6f67a66b-56ec-4c36-ae7c-f250d3b86a23.png,286,1335,371,1438,85,103,red blood cell,8755,1.2117647058823529,0.8252427184466019
79426,/images/dcb21739-3c36-459d-b3cc-1be5871d6fe7.png,662,1034,748,1118,86,84,red blood cell,7224,0.9767441860465116,1.0238095238095237
52864,/images/58f7e1da-3478-48f4-958c-e9b1cb8696aa.png,1051,700,1173,814,122,114,red blood cell,13908,0.9344262295081968,1.0701754385964912
2039,/images/bfefa21c-11e1-4dab-ac5d-8ff6f046d65f.png,466,1122,577,1254,111,132,red blood cell,14652,1.1891891891891893,0.8409090909090909
49191,/images/a9daf82a-a46d-4296-bd72-2c374ed0a193.png,150,1426,242,1525,92,99,red blood cell,9108,1.076086956521739,0.9292929292929293
78988,/images/6144887d-a1c1-46db-91a1-f7ff5bf8c8a5.png,964,299,1050,379,86,80,red blood cell,6880,0.9302325581395349,1.075
8000,/images/694222bb-cddf-469a-9526-f873c6fba58e.png,475,380,583,481,108,101,red blood cell,10908,0.9351851851851852,1.0693069306930694
32117,/images/9258fe22-6406-4d00-b6f0-3f9492925405.png,510,511,626,642,116,131,red blood cell,15196,1.1293103448275863,0.8854961832061069
6589,/images/640c4a52-3742-4f57-aee3-9e3dc0887622.png,578,713,665,814,87,101,red blood cell,8787,1.160919540229885,0.8613861386138614
5019,/images/b7d0ae11-a393-4aec-8f68-6ba07147f78a.png,71,220,191,343,120,123,red blood cell,14760,1.025,0.975609756097561
62087,/images/7f528918-27d4-421f-ab57-0cf9c693e697.png,234,413,367,529,133,116,red blood cell,15428,0.8721804511278195,1.146551724137931
12410,/images/3b55c42f-ad59-422f-ba99-4f4f4ca9cb2e.png,892,974,974,1068,82,94,red blood cell,7708,1.146341463414634,0.8723404255319149
34821,/images/4fc9a597-aaa8-43b0-ad1c-2eabbe442e84.png,708,1405,843,1533,135,128,red blood cell,17280,0.9481481481481482,1.0546875
80057,/images/99e979d4-ee97-4d7f-9da6-00bead40db4d.png,626,40,729,145,103,105,red blood cell,10815,1.0194174757281553,0.9809523809523809
71572,/images/b9c6db13-ca3a-4937-8ecf-e537047ed858.png,1093,503,1195,613,102,110,red blood cell,11220,1.0784313725490196,0.9272727272727272
27917,/images/46f5bd4f-8bea-48d1-a1da-4dea28e3b814.png,505,761,647,888,142,127,red blood cell,18034,0.8943661971830986,1.1181102362204725
62451,/images/7dfbfeaf-e3b1-4159-8dcd-d7f731280ac8.png,389,279,477,375,88,96,red blood cell,8448,1.0909090909090908,0.9166666666666666
71075,/images/2dbf6f69-e020-4948-9e49-4b33edb7cebd.png,593,824,701,937,108,113,red blood cell,12204,1.0462962962962963,0.9557522123893806
29952,/images/deeaa5b3-3895-4aec-a2ce-ed6404862cdf.png,611,1161,733,1291,122,130,red blood cell,15860,1.0655737704918034,0.9384615384615385
44466,/images/b6573be3-9e04-49c3-9f48-6a145d065363.png,497,1409,604,1522,107,113,red blood cell,12091,1.0560747663551402,0.9469026548672567
60399,/images/8d5d5c22-2f75-4fe1-9ea3-03a3c7b92ea9.png,406,1363,526,1477,120,114,red blood cell,13680,0.95,1.0526315789473684
61379,/images/e16c0dab-780d-4035-872e-1bb91e49f9d2.png,457,24,572,132,115,108,red blood cell,12420,0.9391304347826087,1.0648148148148149
1518,/images/0ac747cd-ff32-49bf-bc1a-3e9b7702ce9c.png,210,510,317,608,107,98,red blood cell,10486,0.9158878504672897,1.0918367346938775
472,/images/f65a1633-9935-4984-a285-a60d30aa1707.png,570,160,677,285,107,125,red blood cell,13375,1.1682242990654206,0.856
12032,/images/b234b6ea-b54d-470c-8461-ba7f4a024796.png,382,469,506,599,124,130,red blood cell,16120,1.0483870967741935,0.9538461538461539
50469,/images/a2de1248-7bc0-44dc-b508-70a357eedd68.png,886,365,997,456,111,91,red blood cell,10101,0.8198198198198198,1.2197802197802199
40324,/images/eb86033f-4f1c-4e8c-ae84-e8e4c7e08626.png,242,526,334,625,92,99,red blood cell,9108,1.076086956521739,0.9292929292929293
32707,/images/0154dd8e-72f8-4d78-a4dd-93e139577bd1.png,263,659,374,779,111,120,red blood cell,13320,1.0810810810810811,0.925
21371,/images/5077f87d-a19f-494c-b911-14ccb03bd230.png,957,892,1057,990,100,98,red blood cell,9800,0.98,1.0204081632653061
7090,/images/8be185e7-2a1a-441c-a5c7-b50a9eb926cb.png,913,1441,1013,1534,100,93,red blood cell,9300,0.93,1.075268817204301
78261,/images/adff6e1d-ba9d-4c7b-a8fe-1ec458eaeeb8.png,104,733,221,827,117,94,red blood cell,10998,0.8034188034188035,1.2446808510638299
33229,/images/877d5e7f-19b6-40e7-81bd-c92f25e72503.png,358,919,488,1040,130,121,red blood cell,15730,0.9307692307692308,1.0743801652892562
6684,/images/95fea6d8-413f-421e-b331-5d51c31df150.png,177,1406,303,1510,126,104,red blood cell,13104,0.8253968253968254,1.2115384615384615
76668,/images/3317d733-ec0d-45e6-b631-40457392f343.png,359,1204,464,1309,105,105,red blood cell,11025,1.0,1.0
52255,/images/4903d9c7-de88-426a-b42d-a7e797e5ebcd.png,894,389,991,486,97,97,red blood cell,9409,1.0,1.0
29916,/images/f2a8a483-b254-43aa-817f-7d525adb8911.png,938,491,1056,618,118,127,red blood cell,14986,1.076271186440678,0.9291338582677166
13420,/images/370277f8-436b-4103-8210-b4feb5ab95ea.png,185,358,292,459,107,101,red blood cell,10807,0.9439252336448598,1.0594059405940595
74751,/images/c53fd511-31bd-4901-baac-3b44891f6744.png,1010,1132,1125,1239,115,107,red blood cell,12305,0.9304347826086956,1.074766355140187
41671,/images/0fcd1ebe-ee4a-40a0-b787-29cee18bfa1b.png,544,1129,633,1225,89,96,red blood cell,8544,1.0786516853932584,0.9270833333333334
20931,/images/c2ec116f-f091-422c-926c-70b548a8f6ef.png,958,900,1054,1004,96,104,red blood cell,9984,1.0833333333333333,0.9230769230769231
68803,/images/aa3ad405-828e-4986-8251-20fd981f34d3.png,175,136,281,253,106,117,red blood cell,12402,1.1037735849056605,0.905982905982906
55981,/images/4c460388-e0c1-4970-8527-c9e5b42bea49.png,339,76,471,189,132,113,red blood cell,14916,0.8560606060606061,1.168141592920354
55671,/images/c32b8bb8-c89d-4ae9-9c77-5b9356ca35a1.png,60,956,163,1060,103,104,red blood cell,10712,1.0097087378640777,0.9903846153846154
8972,/images/ef815e3a-02a6-4cf8-9262-45bc74c50b00.png,237,389,341,497,104,108,red blood cell,11232,1.0384615384615385,0.9629629629629629
17882,/images/eb77e4a9-acb0-4d83-8055-2c5fcaa54b45.png,935,1376,1045,1502,110,126,red blood cell,13860,1.1454545454545455,0.873015873015873
11664,/images/0ed416f9-7c20-4829-9016-559e4009568e.png,1049,603,1147,716,98,113,red blood cell,11074,1.153061224489796,0.8672566371681416
69788,/images/2bd15b6e-fe2d-49f3-b394-940d024d1f91.png,8,475,103,575,95,100,red blood cell,9500,1.0526315789473684,0.95
49895,/images/5e17f8e6-fd8d-426c-b444-1515d14f04b7.png,85,635,190,722,105,87,red blood cell,9135,0.8285714285714286,1.206896551724138
11263,/images/6303f964-98ef-47c6-bb2d-283aa393f918.png,300,270,409,377,109,107,red blood cell,11663,0.981651376146789,1.0186915887850467
27046,/images/ec301f62-1302-4407-96f9-fcfe45c150ae.png,181,478,305,595,124,117,red blood cell,14508,0.9435483870967742,1.0598290598290598
4744,/images/3fa1a4e3-c80d-49da-8f7b-a1abb0424f48.png,449,50,543,160,94,110,red blood cell,10340,1.1702127659574468,0.8545454545454545
3552,/images/25132962-ff5d-4737-995f-c54d8490539b.png,308,340,406,456,98,116,red blood cell,11368,1.183673469387755,0.8448275862068966
1872,/images/8855c685-5a8c-4967-a356-942ed89e3471.png,600,403,731,515,131,112,red blood cell,14672,0.8549618320610687,1.1696428571428572
16904,/images/f5419bc0-4415-41b6-b832-5326cfcc534b.png,763,1178,889,1304,126,126,red blood cell,15876,1.0,1.0
25301,/images/587e5464-d70b-4279-8562-010279f6efbd.png,585,744,706,857,121,113,red blood cell,13673,0.9338842975206612,1.0707964601769913
69736,/images/2bd15b6e-fe2d-49f3-b394-940d024d1f91.png,819,132,911,223,92,91,red blood cell,8372,0.9891304347826086,1.010989010989011
51952,/images/4f62b14e-c6f4-4155-8f50-881558f83fae.png,735,245,838,353,103,108,red blood cell,11124,1.0485436893203883,0.9537037037037037
17086,/images/883b726a-f61c-4382-9f1b-2fff302beba6.png,1052,204,1168,325,116,121,red blood cell,14036,1.043103448275862,0.9586776859504132
62487,/images/7dfbfeaf-e3b1-4159-8dcd-d7f731280ac8.png,1016,72,1104,176,88,104,red blood cell,9152,1.1818181818181819,0.8461538461538461
75046,/images/073c10c9-5749-44b5-b08b-1be556a960f0.png,110,725,215,832,105,107,red blood cell,11235,1.019047619047619,0.9813084112149533
55383,/images/4fb83278-adc5-4424-9f45-b6d0db2955b6.png,331,619,421,716,90,97,red blood cell,8730,1.0777777777777777,0.9278350515463918
72429,/images/a15e0fa8-2620-4f66-896e-175115c9dc3d.png,804,1083,917,1175,113,92,red blood cell,10396,0.8141592920353983,1.2282608695652173
60809,/images/0ab56f9a-846d-49e2-a617-c6cc477fdfad.png,937,883,1060,982,123,99,red blood cell,12177,0.8048780487804879,1.2424242424242424
15988,/images/c7c1b873-0548-4a73-9618-f60912e164df.png,665,229,752,306,87,77,red blood cell,6699,0.8850574712643678,1.12987012987013
20829,/images/c2ec116f-f091-422c-926c-70b548a8f6ef.png,685,1140,791,1258,106,118,red blood cell,12508,1.1132075471698113,0.8983050847457628
71471,/images/191071ab-6515-428c-9f05-8e4309542b75.png,703,564,809,672,106,108,red blood cell,11448,1.0188679245283019,0.9814814814814815
52597,/images/0546d843-d778-4aca-b8b5-bfe23d7c87da.png,88,206,196,306,108,100,red blood cell,10800,0.9259259259259259,1.08
30864,/images/fbc1f360-4382-48bb-a32e-3f5f2f9dbe57.png,131,1299,245,1416,114,117,red blood cell,13338,1.0263157894736843,0.9743589743589743
29570,/images/42845335-4ab2-4963-806d-0985d1382a31.png,844,826,942,929,98,103,red blood cell,10094,1.0510204081632653,0.9514563106796117
67132,/images/4272cbd7-5b0a-4bf7-b690-dee1c128f07b.png,516,467,610,574,94,107,red blood cell,10058,1.1382978723404256,0.8785046728971962
79410,/images/dcb21739-3c36-459d-b3cc-1be5871d6fe7.png,1060,73,1148,159,88,86,red blood cell,7568,0.9772727272727273,1.0232558139534884
8933,/images/04628a94-b674-469b-aff6-b476b70df87d.png,906,1246,1013,1368,107,122,red blood cell,13054,1.1401869158878504,0.8770491803278688
39625,/images/04d21589-b777-43c2-86b5-038cbf8c3a4e.png,558,391,671,498,113,107,red blood cell,12091,0.9469026548672567,1.0560747663551402
55193,/images/9c5f48c0-0544-4c0c-92b4-59b7d7b7814c.png,681,1432,808,1544,127,112,red blood cell,14224,0.8818897637795275,1.1339285714285714
7222,/images/89f10192-d3dd-4996-a571-4c851dbdc983.png,629,965,725,1063,96,98,red blood cell,9408,1.0208333333333333,0.9795918367346939
10837,/images/2a02cec2-a09b-483a-ad38-14359a763fa4.png,715,725,821,817,106,92,red blood cell,9752,0.8679245283018868,1.1521739130434783
6238,/images/effd6334-516f-4d48-9f3c-5272a99780fb.png,905,616,1022,744,117,128,red blood cell,14976,1.0940170940170941,0.9140625
34352,/images/1a48cbc1-5423-47e5-8ca5-2ab4f83a05a5.png,283,1310,380,1422,97,112,red blood cell,10864,1.1546391752577319,0.8660714285714286
12175,/images/87d6343b-70dd-4cdd-939f-d3ac0ca2e700.png,673,221,794,338,121,117,red blood cell,14157,0.9669421487603306,1.0341880341880343
54495,/images/db871d17-28fd-4ceb-b421-e4e4afa0a7a0.png,863,974,979,1092,116,118,red blood cell,13688,1.0172413793103448,0.9830508474576272
72304,/images/ee57e743-a876-4f69-9fe5-bf5d01b44689.png,584,1143,680,1253,96,110,red blood cell,10560,1.1458333333333333,0.8727272727272727
64391,/images/0a7bfa8a-ee52-4f7a-b9c5-2919ecfa93ef.png,486,1269,572,1350,86,81,red blood cell,6966,0.9418604651162791,1.0617283950617284
78632,/images/3612aa3b-2906-44a6-9c80-6144511a35ce.png,494,1474,589,1564,95,90,red blood cell,8550,0.9473684210526315,1.0555555555555556
19351,/images/a302a6fa-f635-4ade-b72b-b6f3c2a34ec9.png,251,1024,370,1141,119,117,red blood cell,13923,0.9831932773109243,1.017094017094017
9993,/images/b9ccf7ca-953f-4832-9575-5e70b2a8c224.png,886,171,988,278,102,107,red blood cell,10914,1.0490196078431373,0.9532710280373832
35674,/images/4063945d-03fc-4ce3-a04c-17435dce8f91.png,662,277,779,396,117,119,red blood cell,13923,1.017094017094017,0.9831932773109243
17309,/images/3d302619-473d-4c5b-af43-8833ff94233f.png,971,1438,1072,1555,101,117,red blood cell,11817,1.1584158415841583,0.8632478632478633
1631,/images/7094c11a-1e62-4f98-894e-d17d138a88e9.png,203,325,334,430,131,105,red blood cell,13755,0.8015267175572519,1.2476190476190476
71305,/images/bcb447c9-5d37-414f-a513-d7076b04a532.png,1075,1036,1182,1140,107,104,red blood cell,11128,0.9719626168224299,1.0288461538461537
33991,/images/701206c5-aaac-4b99-9cc0-4a6854359457.png,345,737,454,841,109,104,red blood cell,11336,0.9541284403669725,1.0480769230769231
59315,/images/03c8da48-04b9-4520-b674-44a0ecd35688.png,739,39,820,113,81,74,red blood cell,5994,0.9135802469135802,1.0945945945945945
35138,/images/a6ba808f-ec60-42a5-ad91-7b32412ab708.png,420,197,567,330,147,133,red blood cell,19551,0.9047619047619048,1.105263157894737
53819,/images/f24c8fe0-a534-44cf-9995-b2b314d945ba.png,104,464,228,571,124,107,red blood cell,13268,0.8629032258064516,1.158878504672897
69916,/images/9edba799-e169-46cd-b100-c9f8fc7a8c7d.png,218,784,322,894,104,110,red blood cell,11440,1.0576923076923077,0.9454545454545454
33756,/images/441d7843-b20b-4c10-84e3-e6d32621e880.png,678,213,762,315,84,102,red blood cell,8568,1.2142857142857142,0.8235294117647058
47932,/images/ab27173b-6e30-4957-bd68-29194328fd39.png,693,1013,814,1115,121,102,red blood cell,12342,0.8429752066115702,1.1862745098039216
17904,/images/eb77e4a9-acb0-4d83-8055-2c5fcaa54b45.png,1029,362,1139,463,110,101,red blood cell,11110,0.9181818181818182,1.0891089108910892
14559,/images/458cb2e9-5a7f-437c-ac5d-a56f98a3efdf.png,372,1195,464,1304,92,109,red blood cell,10028,1.184782608695652,0.8440366972477065
46368,/images/fcc2b245-f47f-447f-8527-275b0005677c.png,855,256,968,377,113,121,red blood cell,13673,1.0707964601769913,0.9338842975206612
66053,/images/c8af0297-ce1f-40ea-bf44-9256dcdae4e9.png,147,995,264,1113,117,118,red blood cell,13806,1.0085470085470085,0.9915254237288136
6369,/images/f06ba705-5509-479b-8067-127ffb37c5b6.png,947,531,1055,649,108,118,red blood cell,12744,1.0925925925925926,0.9152542372881356
36800,/images/dfac6c92-8f0f-429a-8caf-9b7732bf78da.png,844,1316,942,1408,98,92,red blood cell,9016,0.9387755102040817,1.065217391304348
3444,/images/ad36bd67-594b-4f63-93e3-886af0bc618e.png,231,469,348,566,117,97,red blood cell,11349,0.8290598290598291,1.2061855670103092
4734,/images/3fa1a4e3-c80d-49da-8f7b-a1abb0424f48.png,914,790,997,873,83,83,red blood cell,6889,1.0,1.0
77936,/images/c691c8ef-d3c7-47b6-a941-f6a1089f21a9.png,751,1266,850,1365,99,99,red blood cell,9801,1.0,1.0
51102,/images/4748ba2b-6771-41d9-93a5-af9ccd559261.png,907,629,1060,765,153,136,red blood cell,20808,0.8888888888888888,1.125
7142,/images/56551792-4aa1-4301-9f8f-8bfebcd20050.png,175,184,298,297,123,113,red blood cell,13899,0.9186991869918699,1.0884955752212389
78238,/images/adff6e1d-ba9d-4c7b-a8fe-1ec458eaeeb8.png,787,521,879,609,92,88,red blood cell,8096,0.9565217391304348,1.0454545454545454
27441,/images/50d52637-f5e0-4d0d-aaee-4a29f044cf74.png,558,1056,670,1174,112,118,red blood cell,13216,1.0535714285714286,0.9491525423728814
44345,/images/415409ac-97b3-4cd9-b203-11ef00662352.png,685,319,808,431,123,112,red blood cell,13776,0.9105691056910569,1.0982142857142858
13529,/images/370277f8-436b-4103-8210-b4feb5ab95ea.png,889,325,985,405,96,80,red blood cell,7680,0.8333333333333334,1.2
74409,/images/06a3effb-996c-4767-afd2-6aa3b697cb4e.png,70,739,164,836,94,97,red blood cell,9118,1.0319148936170213,0.9690721649484536
77354,/images/3ff98212-7c2a-46cd-afb7-34a2479bed07.png,595,917,683,1027,88,110,red blood cell,9680,1.25,0.8
22887,/images/be779f52-0bfa-4c01-a16f-b7f0bc92ed7c.png,76,126,194,259,118,133,red blood cell,15694,1.1271186440677967,0.8872180451127819
7014,/images/c776eb78-3323-4571-b39f-7ffc73ae63ce.png,1101,915,1200,1008,99,93,red blood cell,9207,0.9393939393939394,1.064516129032258
8209,/images/6bb4892c-27a9-4642-aba1-4b73f38f757c.png,667,1340,793,1463,126,123,red blood cell,15498,0.9761904761904762,1.024390243902439
15969,/images/c7c1b873-0548-4a73-9618-f60912e164df.png,295,1271,379,1367,84,96,red blood cell,8064,1.1428571428571428,0.875
13407,/images/a7f1bbb1-6058-4642-bd66-cfb90dce762e.png,379,1277,518,1423,139,146,red blood cell,20294,1.0503597122302157,0.952054794520548
5898,/images/a30da226-b452-408a-a556-bfae4d521464.png,457,1196,583,1311,126,115,red blood cell,14490,0.9126984126984127,1.0956521739130434
59487,/images/a7c3c52f-3b40-4c92-a212-df9462cf25d8.png,316,1295,406,1394,90,99,red blood cell,8910,1.1,0.9090909090909091
41962,/images/46a03374-64c7-49ac-81c9-c3d62542bbf3.png,134,861,235,971,101,110,red blood cell,11110,1.0891089108910892,0.9181818181818182
37698,/images/003a89b0-a095-417a-8dd6-f408339bbc68.png,563,537,687,660,124,123,red blood cell,15252,0.9919354838709677,1.008130081300813
27320,/images/9f38055f-4fe6-47fd-a6dd-c0743db4eccf.png,1033,713,1127,805,94,92,red blood cell,8648,0.9787234042553191,1.0217391304347827
30950,/images/533c47c9-02a6-419b-961b-81797f022f6c.png,983,415,1092,543,109,128,red blood cell,13952,1.1743119266055047,0.8515625
20670,/images/e6d7c5e1-43fc-4712-86d5-aa70252b978f.png,27,1180,158,1286,131,106,red blood cell,13886,0.8091603053435115,1.2358490566037736
29653,/images/b85fc640-de49-4f7e-afc0-978ff020f2e2.png,665,1083,765,1200,100,117,red blood cell,11700,1.17,0.8547008547008547
61905,/images/f32b21ae-5ca7-490b-bc40-6db9396d933c.png,952,263,1059,370,107,107,red blood cell,11449,1.0,1.0
103,/images/10be6380-cbbb-4886-8b9e-ff56b1710576.png,728,55,833,159,105,104,red blood cell,10920,0.9904761904761905,1.0096153846153846
67741,/images/48e2f0bd-2164-40c3-af43-1f2708359978.png,112,355,206,447,94,92,red blood cell,8648,0.9787234042553191,1.0217391304347827
6645,/images/95fea6d8-413f-421e-b331-5d51c31df150.png,450,1133,587,1249,137,116,red blood cell,15892,0.8467153284671532,1.1810344827586208
6802,/images/e36cb882-c6d0-4467-812e-d18c169a9a47.png,856,75,973,188,117,113,red blood cell,13221,0.9658119658119658,1.0353982300884956
5889,/images/a30da226-b452-408a-a556-bfae4d521464.png,266,841,380,961,114,120,red blood cell,13680,1.0526315789473684,0.95
27509,/images/f5869ba8-6253-426b-93f3-82af59a86144.png,858,1254,937,1349,79,95,red blood cell,7505,1.2025316455696202,0.8315789473684211
35776,/images/bb2042c5-35e1-43cc-8171-7de81b764361.png,722,1138,823,1234,101,96,red blood cell,9696,0.9504950495049505,1.0520833333333333
18234,/images/947348fe-4c70-468e-8009-3c14daeca69b.png,1056,1244,1140,1339,84,95,red blood cell,7980,1.130952380952381,0.8842105263157894
8575,/images/a6aa3b72-2970-4c78-b655-ea8dfe6e018c.png,782,582,885,679,103,97,red blood cell,9991,0.941747572815534,1.0618556701030928
18743,/images/f6f8a69a-3fd2-4684-ac77-3e83ea0fb36d.png,472,353,577,468,105,115,red blood cell,12075,1.0952380952380953,0.9130434782608695
57904,/images/09bcedaa-e007-4692-a13f-ab02c3f872c4.png,173,1060,284,1171,111,111,red blood cell,12321,1.0,1.0
67481,/images/8e72e20e-e714-4db6-a1da-c05a409257d4.png,772,1275,870,1379,98,104,red blood cell,10192,1.0612244897959184,0.9423076923076923
57515,/images/00d04a90-80e5-4bce-9511-1b64eabb7a47.png,183,1133,260,1213,77,80,red blood cell,6160,1.0389610389610389,0.9625
38874,/images/d79b4e90-c45d-4f5d-a498-49c3e323c291.png,702,578,806,678,104,100,red blood cell,10400,0.9615384615384616,1.04
57550,/images/8190ec37-9a5e-419f-89ed-fbfb079370db.png,553,970,653,1063,100,93,red blood cell,9300,0.93,1.075268817204301
60838,/images/0ab56f9a-846d-49e2-a617-c6cc477fdfad.png,92,939,174,1020,82,81,red blood cell,6642,0.9878048780487805,1.0123456790123457
16621,/images/a27858ef-6533-413e-bc75-cc54690261a2.png,132,731,253,851,121,120,red blood cell,14520,0.9917355371900827,1.0083333333333333
42940,/images/ff37dd9b-2e3c-444d-9d29-6db186cfa2fb.png,992,1137,1108,1254,116,117,red blood cell,13572,1.0086206896551724,0.9914529914529915
22827,/images/72105bb0-8e39-48be-b7f7-5b32f047b99e.png,278,1358,396,1469,118,111,red blood cell,13098,0.940677966101695,1.063063063063063
78785,/images/9174f910-3859-4839-8e30-2c3b25269322.png,726,782,819,871,93,89,red blood cell,8277,0.956989247311828,1.0449438202247192
28730,/images/151f3af5-5e6e-4bcd-9389-4974fc68813e.png,771,1273,892,1396,121,123,red blood cell,14883,1.0165289256198347,0.983739837398374
42271,/images/ca734448-0d52-42fa-b41c-17b2939e58ae.png,937,1364,1025,1438,88,74,red blood cell,6512,0.8409090909090909,1.1891891891891893
18235,/images/947348fe-4c70-468e-8009-3c14daeca69b.png,1077,731,1164,834,87,103,red blood cell,8961,1.1839080459770115,0.8446601941747572
25438,/images/5f742392-278d-461c-a848-08def2c28878.png,396,669,515,786,119,117,red blood cell,13923,0.9831932773109243,1.017094017094017
25348,/images/c52f8cc8-afd7-441c-9f1f-18b6e16d79cf.png,198,996,313,1133,115,137,red blood cell,15755,1.191304347826087,0.8394160583941606
15253,/images/dd7142e4-2d86-4170-a41f-e825743e8907.png,618,1348,729,1484,111,136,red blood cell,15096,1.2252252252252251,0.8161764705882353
71264,/images/445d0db9-e830-4ceb-a845-b23d819e6097.png,512,1252,614,1352,102,100,red blood cell,10200,0.9803921568627451,1.02
34795,/images/4fc9a597-aaa8-43b0-ad1c-2eabbe442e84.png,553,84,676,209,123,125,red blood cell,15375,1.016260162601626,0.984
3257,/images/b901c906-91be-48c4-88ec-2c527544a258.png,648,1421,772,1549,124,128,red blood cell,15872,1.032258064516129,0.96875
42395,/images/1a27ebe9-93a1-4898-af69-f276057d4012.png,238,796,360,919,122,123,red blood cell,15006,1.0081967213114753,0.991869918699187
47907,/images/ab27173b-6e30-4957-bd68-29194328fd39.png,656,1478,768,1591,112,113,red blood cell,12656,1.0089285714285714,0.9911504424778761
50510,/images/79f2fbab-169d-4062-820d-3dfd12f062c8.png,493,232,633,347,140,115,red blood cell,16100,0.8214285714285714,1.2173913043478262
58577,/images/7fd2d254-b062-4f3d-8970-687e73c5a00a.png,430,862,545,991,115,129,red blood cell,14835,1.1217391304347826,0.8914728682170543
29859,/images/9cdee92c-6267-4188-a41e-125bc0abb9ae.png,606,1285,737,1406,131,121,red blood cell,15851,0.9236641221374046,1.0826446280991735
65142,/images/5e042380-6ef2-496f-8231-0ca550fbfa71.png,544,811,647,909,103,98,red blood cell,10094,0.9514563106796117,1.0510204081632653
31115,/images/9c48fdf4-621d-4f40-bcd7-6a28cd530de7.png,66,1147,184,1268,118,121,red blood cell,14278,1.0254237288135593,0.9752066115702479
77717,/images/4849866a-73a2-4fcf-a407-2d0a25a09a89.png,839,777,946,883,107,106,red blood cell,11342,0.9906542056074766,1.009433962264151
12968,/images/b10ea12f-cd36-4f2c-994a-67d1665269ab.png,644,39,745,146,101,107,red blood cell,10807,1.0594059405940595,0.9439252336448598
44777,/images/6795acae-e84d-4e97-b9a1-b4f4f0a72cfd.png,937,277,1044,372,107,95,red blood cell,10165,0.8878504672897196,1.1263157894736842
58536,/images/5cac6ddf-c8c6-45de-bce0-a1db64b14fb5.png,1122,263,1200,355,78,92,red blood cell,7176,1.1794871794871795,0.8478260869565217
14538,/images/458cb2e9-5a7f-437c-ac5d-a56f98a3efdf.png,619,358,710,448,91,90,red blood cell,8190,0.989010989010989,1.011111111111111
46240,/images/815bf40c-371a-4d34-aa41-c549c8221881.png,985,290,1100,418,115,128,red blood cell,14720,1.1130434782608696,0.8984375
46409,/images/bbecf1a8-a728-4c83-87f8-4dfbac0a1e03.png,825,564,924,672,99,108,red blood cell,10692,1.0909090909090908,0.9166666666666666
25905,/images/4811fdf2-d7e8-475e-a840-45dda5282bf3.png,504,1488,616,1599,112,111,red blood cell,12432,0.9910714285714286,1.009009009009009
7010,/images/c776eb78-3323-4571-b39f-7ffc73ae63ce.png,302,1395,402,1501,100,106,red blood cell,10600,1.06,0.9433962264150944
50230,/images/3d32a988-449d-4d58-b71f-abbfdc3f2fbc.png,333,98,427,186,94,88,red blood cell,8272,0.9361702127659575,1.0681818181818181
56288,/images/6b473806-e936-4b19-98cf-a2b94cac35ff.png,35,1386,136,1494,101,108,red blood cell,10908,1.0693069306930694,0.9351851851851852
9410,/images/e3a4b3e7-9500-4b6c-a402-b6d3f45e714b.png,1069,1362,1187,1473,118,111,red blood cell,13098,0.940677966101695,1.063063063063063
26281,/images/52767904-4cdc-4821-ba68-8cd0c28f9023.png,904,1298,1031,1415,127,117,red blood cell,14859,0.9212598425196851,1.0854700854700854
60409,/images/8d5d5c22-2f75-4fe1-9ea3-03a3c7b92ea9.png,665,295,762,390,97,95,red blood cell,9215,0.979381443298969,1.0210526315789474
19373,/images/a302a6fa-f635-4ade-b72b-b6f3c2a34ec9.png,13,523,132,626,119,103,red blood cell,12257,0.865546218487395,1.1553398058252426
47143,/images/3d1b889e-bb4a-4ee6-b899-974ee7d956a7.png,736,235,832,328,96,93,red blood cell,8928,0.96875,1.032258064516129
44058,/images/8b494b40-cab5-49d3-893d-c805000fbe88.png,281,857,399,959,118,102,red blood cell,12036,0.864406779661017,1.1568627450980393
22685,/images/4ab47131-c2ac-461f-b95c-ac19ce24edbd.png,518,419,616,526,98,107,red blood cell,10486,1.0918367346938775,0.9158878504672897
57064,/images/9e82c996-2cfa-418d-9482-8ee23e9d0a5d.png,527,371,637,508,110,137,red blood cell,15070,1.2454545454545454,0.8029197080291971
53767,/images/76b24246-8571-4e7b-8815-b185414a2c51.png,673,204,776,302,103,98,red blood cell,10094,0.9514563106796117,1.0510204081632653
17731,/images/b5143aae-6e98-4dc6-b546-980cb472de67.png,665,1400,794,1529,129,129,red blood cell,16641,1.0,1.0
10402,/images/46a2d369-4bea-4405-ac78-91bbe130b9a7.png,46,340,148,430,102,90,red blood cell,9180,0.8823529411764706,1.1333333333333333
8561,/images/a6aa3b72-2970-4c78-b655-ea8dfe6e018c.png,205,582,303,676,98,94,red blood cell,9212,0.9591836734693877,1.0425531914893618
62446,/images/7dfbfeaf-e3b1-4159-8dcd-d7f731280ac8.png,291,749,407,856,116,107,red blood cell,12412,0.9224137931034483,1.0841121495327102
39040,/images/8f96ee1f-4ef7-4279-a610-316319bedcf9.png,995,788,1108,890,113,102,red blood cell,11526,0.9026548672566371,1.107843137254902
21605,/images/49efc89d-9cba-44f7-8257-7f911b73f68a.png,1,1353,92,1453,91,100,red blood cell,9100,1.098901098901099,0.91
76607,/images/4184a235-d209-4151-86e9-6c77e7938dab.png,148,297,238,386,90,89,red blood cell,8010,0.9888888888888889,1.0112359550561798
27295,/images/9f38055f-4fe6-47fd-a6dd-c0743db4eccf.png,464,151,574,250,110,99,red blood cell,10890,0.9,1.1111111111111112
8739,/images/29dc8176-dfe1-40e0-8247-2dc3c530057e.png,559,348,674,467,115,119,red blood cell,13685,1.0347826086956522,0.9663865546218487
12378,/images/3b55c42f-ad59-422f-ba99-4f4f4ca9cb2e.png,347,542,436,644,89,102,red blood cell,9078,1.146067415730337,0.8725490196078431
70191,/images/b338766f-19b9-4874-bcc5-ae22b3c533e6.png,171,1074,278,1170,107,96,red blood cell,10272,0.897196261682243,1.1145833333333333
78346,/images/24115f58-a7d6-4022-a95a-86b515a78d3e.png,1020,595,1129,701,109,106,red blood cell,11554,0.9724770642201835,1.028301886792453
35509,/images/3e33ee12-ef02-4287-8318-7ad3b284a617.png,35,1294,140,1401,105,107,red blood cell,11235,1.019047619047619,0.9813084112149533
29398,/images/b4e5e08d-6427-46f3-aca8-a4df165a151d.png,676,372,780,472,104,100,red blood cell,10400,0.9615384615384616,1.04
38150,/images/33bdb7b5-ad5b-4a73-bbc2-3350f8c2ac0c.png,28,1470,148,1572,120,102,red blood cell,12240,0.85,1.1764705882352942
24844,/images/93f7e207-0d8e-47f8-8258-09a0e03dbdd6.png,944,149,1063,271,119,122,red blood cell,14518,1.0252100840336134,0.9754098360655737
76694,/images/3317d733-ec0d-45e6-b631-40457392f343.png,479,1472,598,1588,119,116,red blood cell,13804,0.9747899159663865,1.0258620689655173
45703,/images/584d62ed-4329-45dd-94ce-e929d8b2bb74.png,311,1084,400,1179,89,95,red blood cell,8455,1.0674157303370786,0.9368421052631579
46576,/images/edd09b2e-2673-4405-8ac0-e476e003e96a.png,796,43,928,179,132,136,red blood cell,17952,1.0303030303030303,0.9705882352941176
22033,/images/c5acd0ad-b0f2-478d-b0ad-5aa733aa7b32.png,440,1066,557,1183,117,117,red blood cell,13689,1.0,1.0
76828,/images/2165fe38-b474-467d-be11-d1d728085efd.png,238,991,345,1101,107,110,red blood cell,11770,1.02803738317757,0.9727272727272728
5567,/images/eb6e8684-b84e-483d-b835-f59286d2516b.png,1092,1173,1199,1295,107,122,red blood cell,13054,1.1401869158878504,0.8770491803278688
188,/images/13099edb-35d9-438f-b093-2cf2ebf9d255.png,462,190,561,293,99,103,red blood cell,10197,1.0404040404040404,0.9611650485436893
54422,/images/22a464ef-c3da-4d56-b37e-e22e95d945e7.png,631,515,744,615,113,100,red blood cell,11300,0.8849557522123894,1.13
54157,/images/c415532c-4cce-4580-9fcd-623c172a1abd.png,242,279,360,392,118,113,red blood cell,13334,0.9576271186440678,1.0442477876106195
73896,/images/2ae3e6e6-7482-4ab8-ad73-b530b5c2ee3b.png,30,187,131,283,101,96,red blood cell,9696,0.9504950495049505,1.0520833333333333
70858,/images/bf002a25-6535-4621-be19-56d468be5413.png,714,1483,805,1574,91,91,red blood cell,8281,1.0,1.0
44476,/images/b6573be3-9e04-49c3-9f48-6a145d065363.png,734,75,850,200,116,125,red blood cell,14500,1.0775862068965518,0.928
57588,/images/8190ec37-9a5e-419f-89ed-fbfb079370db.png,248,790,339,882,91,92,red blood cell,8372,1.010989010989011,0.9891304347826086
48554,/images/f3d84be2-8af0-4d62-9f72-23d3dc08cbbe.png,460,303,595,448,135,145,red blood cell,19575,1.0740740740740742,0.9310344827586207
22436,/images/f97c7c87-5e27-45ea-9f93-3285d74091de.png,656,1219,748,1321,92,102,red blood cell,9384,1.108695652173913,0.9019607843137255
40461,/images/db249e5a-4142-432c-8288-bacd10d7273d.png,165,986,250,1074,85,88,red blood cell,7480,1.035294117647059,0.9659090909090909
27501,/images/f5869ba8-6253-426b-93f3-82af59a86144.png,736,845,850,969,114,124,red blood cell,14136,1.087719298245614,0.9193548387096774
21726,/images/f68ae8e9-e760-4106-88e0-4bdef2785f06.png,505,1219,620,1339,115,120,red blood cell,13800,1.0434782608695652,0.9583333333333334
27497,/images/f5869ba8-6253-426b-93f3-82af59a86144.png,492,652,606,763,114,111,red blood cell,12654,0.9736842105263158,1.027027027027027
61829,/images/5f300fd1-7eec-41ac-bbd1-0f4a943c757c.png,438,1423,555,1539,117,116,red blood cell,13572,0.9914529914529915,1.0086206896551724
63359,/images/9f4bc3b4-abb0-4bcb-baa8-ec9f25e2b9c6.png,1079,1044,1196,1140,117,96,red blood cell,11232,0.8205128205128205,1.21875
57803,/images/c9ad92d4-b408-4506-916e-def47b2e6ed0.png,178,1293,277,1412,99,119,red blood cell,11781,1.202020202020202,0.8319327731092437
50183,/images/4cccfcf0-cac9-46f0-870c-0eabfdc781ba.png,404,408,535,545,131,137,red blood cell,17947,1.0458015267175573,0.9562043795620438
31343,/images/04fb49a2-07b8-4cdf-b6f7-df5c3688e5f8.png,516,125,622,240,106,115,red blood cell,12190,1.0849056603773586,0.9217391304347826
63587,/images/de0321fa-6f7d-4dd1-b96b-186701c3b1d9.png,221,1418,330,1523,109,105,red blood cell,11445,0.963302752293578,1.0380952380952382
58278,/images/319c9c52-f316-49f3-baad-4444ab19f85b.png,18,246,116,357,98,111,red blood cell,10878,1.1326530612244898,0.8828828828828829
34655,/images/a0eedcb9-b85c-4612-b945-7e8227f53c35.png,334,342,435,442,101,100,red blood cell,10100,0.9900990099009901,1.01
53434,/images/766d5547-8dd2-4c8d-b78e-3007f83932e8.png,82,1264,182,1358,100,94,red blood cell,9400,0.94,1.0638297872340425
54062,/images/d9345456-b76d-46cc-b81e-46d4a0a7b652.png,159,708,267,820,108,112,red blood cell,12096,1.037037037037037,0.9642857142857143
52932,/images/abb2f9d6-26fa-4328-983c-959ef6717c05.png,846,801,927,877,81,76,red blood cell,6156,0.9382716049382716,1.0657894736842106
45135,/images/56fbae44-4677-47f8-9c3a-22dac043c115.png,2,215,122,323,120,108,red blood cell,12960,0.9,1.1111111111111112
18154,/images/947348fe-4c70-468e-8009-3c14daeca69b.png,934,10,1056,108,122,98,red blood cell,11956,0.8032786885245902,1.2448979591836735
63336,/images/9f4bc3b4-abb0-4bcb-baa8-ec9f25e2b9c6.png,270,1291,378,1403,108,112,red blood cell,12096,1.037037037037037,0.9642857142857143
59569,/images/6bfe6a90-8a69-4171-8e7f-42dc9417c6d9.png,168,1013,247,1104,79,91,red blood cell,7189,1.1518987341772151,0.8681318681318682
47832,/images/5a105b89-c592-4d78-b208-7db6c6572752.png,1083,1231,1199,1342,116,111,red blood cell,12876,0.9568965517241379,1.045045045045045
26049,/images/71925778-a26e-483e-a07c-f3aaf740122a.png,308,1119,432,1242,124,123,red blood cell,15252,0.9919354838709677,1.008130081300813
61873,/images/f32b21ae-5ca7-490b-bc40-6db9396d933c.png,1073,818,1165,921,92,103,red blood cell,9476,1.1195652173913044,0.8932038834951457
40687,/images/252071ac-e9f2-41d2-abbb-87ef01b8a997.png,391,629,478,722,87,93,red blood cell,8091,1.0689655172413792,0.9354838709677419
71996,/images/6ad3efc9-4392-4cee-98a5-186564a96373.png,562,623,676,715,114,92,red blood cell,10488,0.8070175438596491,1.2391304347826086
48670,/images/03359d4d-69cb-4146-8286-ca7399366f97.png,606,1099,736,1222,130,123,red blood cell,15990,0.9461538461538461,1.056910569105691
14910,/images/3090a362-1f3d-49e9-a76e-ce76ff9c2276.png,869,100,965,212,96,112,red blood cell,10752,1.1666666666666667,0.8571428571428571
19819,/images/d67fb447-4dd7-4a82-a305-2b70927b69bb.png,878,740,981,846,103,106,red blood cell,10918,1.029126213592233,0.9716981132075472
27432,/images/50d52637-f5e0-4d0d-aaee-4a29f044cf74.png,1015,408,1146,518,131,110,red blood cell,14410,0.8396946564885496,1.190909090909091
4720,/images/3fa1a4e3-c80d-49da-8f7b-a1abb0424f48.png,520,1108,631,1223,111,115,red blood cell,12765,1.0360360360360361,0.9652173913043478
24243,/images/bb3ae957-0f6d-4615-bfe5-24fbca50b459.png,323,695,438,815,115,120,red blood cell,13800,1.0434782608695652,0.9583333333333334
16469,/images/9e5437c6-b0d3-473b-b7c3-8f5afeb90c7a.png,903,962,1033,1080,130,118,red blood cell,15340,0.9076923076923077,1.1016949152542372
60610,/images/724e0c34-32cd-41f1-ae37-586038bc67ab.png,758,909,866,1017,108,108,red blood cell,11664,1.0,1.0
50357,/images/3d32a988-449d-4d58-b71f-abbfdc3f2fbc.png,313,763,402,855,89,92,red blood cell,8188,1.0337078651685394,0.967391304347826
56170,/images/137d540f-d71e-47e8-bd9b-6cd0a6433c33.png,157,530,275,643,118,113,red blood cell,13334,0.9576271186440678,1.0442477876106195
63906,/images/5e974892-0ebe-4037-8427-ea8616d6d3b8.png,1006,994,1123,1098,117,104,red blood cell,12168,0.8888888888888888,1.125
38586,/images/f8b14fc4-dd6b-4ad0-a96d-c62845f48681.png,989,1333,1087,1443,98,110,red blood cell,10780,1.1224489795918366,0.8909090909090909
45517,/images/94b5a9a1-1c88-4400-aca4-3d56f543fc4a.png,436,1457,549,1575,113,118,red blood cell,13334,1.0442477876106195,0.9576271186440678
21965,/images/393df10a-5d64-476b-88f5-14ac56d6ed60.png,913,793,1034,910,121,117,red blood cell,14157,0.9669421487603306,1.0341880341880343
71553,/images/b9c6db13-ca3a-4937-8ecf-e537047ed858.png,815,440,940,561,125,121,red blood cell,15125,0.968,1.0330578512396693
26742,/images/2518f6e4-29cc-4ae4-a914-b215a4c56099.png,582,764,701,872,119,108,red blood cell,12852,0.907563025210084,1.1018518518518519
43414,/images/367663b2-5d09-4020-ab0a-c2200e7a1c8c.png,1026,1254,1116,1349,90,95,red blood cell,8550,1.0555555555555556,0.9473684210526315
36336,/images/4a0a05e1-11ad-4bfc-bfa3-adf3b9bd0b56.png,600,601,711,717,111,116,red blood cell,12876,1.045045045045045,0.9568965517241379
67972,/images/bcaefb02-682a-41b9-acc7-e6cc010f5b30.png,1045,1373,1130,1469,85,96,red blood cell,8160,1.1294117647058823,0.8854166666666666
64021,/images/03cbfcf2-8da6-462c-b30d-16d63357371f.png,230,1337,342,1433,112,96,red blood cell,10752,0.8571428571428571,1.1666666666666667
40924,/images/550cf4ce-b641-44a3-8487-3e16d4049187.png,458,845,562,950,104,105,red blood cell,10920,1.0096153846153846,0.9904761904761905
11392,/images/2f6224be-50d0-4e85-94ef-88315df561b6.png,4,541,111,652,107,111,red blood cell,11877,1.0373831775700935,0.963963963963964
3118,/images/14efbfc8-39f6-4599-9994-a8cc95605b9c.png,583,331,705,443,122,112,red blood cell,13664,0.9180327868852459,1.0892857142857142
55607,/images/c32b8bb8-c89d-4ae9-9c77-5b9356ca35a1.png,345,54,450,164,105,110,red blood cell,11550,1.0476190476190477,0.9545454545454546
20292,/images/98976666-9125-47fe-9601-43c41e58dfb4.png,14,205,137,326,123,121,red blood cell,14883,0.983739837398374,1.0165289256198347
40153,/images/b34e65f6-c32e-42f1-a437-4a037c75a231.png,332,853,434,958,102,105,red blood cell,10710,1.0294117647058822,0.9714285714285714
40758,/images/252071ac-e9f2-41d2-abbb-87ef01b8a997.png,651,1380,745,1483,94,103,red blood cell,9682,1.0957446808510638,0.912621359223301
79847,/images/a054a8e2-55f2-4508-97df-207f76b89be2.png,983,380,1111,489,128,109,red blood cell,13952,0.8515625,1.1743119266055047
48257,/images/71204a6d-814e-44b6-9cee-7b979f478021.png,667,871,779,978,112,107,red blood cell,11984,0.9553571428571429,1.0467289719626167
55491,/images/43072c64-4c08-47cd-ae8a-b74d31f80008.png,823,1213,938,1317,115,104,red blood cell,11960,0.9043478260869565,1.1057692307692308
48143,/images/913099c5-8085-4908-bf4b-1f098bbfcf66.png,461,846,586,964,125,118,red blood cell,14750,0.944,1.0593220338983051
515,/images/67acd5bc-4658-4c6e-a9b9-cd8ea3a03418.png,94,578,218,696,124,118,red blood cell,14632,0.9516129032258065,1.0508474576271187
70508,/images/8cca114a-ed05-4b87-95b7-fae02487f08c.png,517,238,623,362,106,124,red blood cell,13144,1.169811320754717,0.8548387096774194
60404,/images/8d5d5c22-2f75-4fe1-9ea3-03a3c7b92ea9.png,542,1474,648,1573,106,99,red blood cell,10494,0.9339622641509434,1.0707070707070707
75117,/images/7fdc8be8-7579-4a5c-b369-8a07ee0a8b7d.png,566,656,657,749,91,93,red blood cell,8463,1.021978021978022,0.978494623655914
62182,/images/a72cd558-b7ac-4bf2-a344-2ce6c73a354e.png,360,453,465,553,105,100,red blood cell,10500,0.9523809523809523,1.05
4093,/images/d3b79739-aea2-4804-8c7a-183b7ed07de3.png,454,1413,569,1524,115,111,red blood cell,12765,0.9652173913043478,1.0360360360360361
51424,/images/b4f3b2a4-f4b9-48de-ac5d-0e681b77be27.png,245,91,336,185,91,94,red blood cell,8554,1.032967032967033,0.9680851063829787
51056,/images/93f40356-5676-45d3-8e83-8028708c93ba.png,349,1205,469,1321,120,116,red blood cell,13920,0.9666666666666667,1.0344827586206897
24348,/images/4d8a4ce8-0f9c-4f21-8844-4cf0e5514bbf.png,397,1185,514,1296,117,111,red blood cell,12987,0.9487179487179487,1.054054054054054
4171,/images/ac3358f1-ef9a-4ccc-b66c-da5e47e352e0.png,843,236,951,340,108,104,red blood cell,11232,0.9629629629629629,1.0384615384615385
18574,/images/c22f7031-9cf8-48ce-b03b-1b12d0db4951.png,533,921,645,1020,112,99,red blood cell,11088,0.8839285714285714,1.1313131313131313
34746,/images/6294153c-6db3-4f2b-a8ff-9c087225e737.png,1013,919,1150,1033,137,114,red blood cell,15618,0.8321167883211679,1.2017543859649122
48809,/images/fed6ba05-36a5-45dc-a4e1-9baa7de2c622.png,1063,565,1163,657,100,92,red blood cell,9200,0.92,1.0869565217391304
76124,/images/16244280-6c74-47d3-b544-9fd6831a6bf9.png,355,1224,453,1332,98,108,red blood cell,10584,1.1020408163265305,0.9074074074074074
65237,/images/45ac9409-5537-44ed-90cd-5c8a1ae0e1e0.png,314,802,415,906,101,104,red blood cell,10504,1.0297029702970297,0.9711538461538461
56131,/images/50d9fc90-8642-4bb6-91a7-0069a7e37392.png,320,985,425,1102,105,117,red blood cell,12285,1.1142857142857143,0.8974358974358975
68903,/images/6347dd6a-cfdf-4cb5-bc50-cff5403cfecb.png,565,1477,697,1599,132,122,red blood cell,16104,0.9242424242424242,1.0819672131147542
42198,/images/b618e87e-6059-496f-b0f6-e158f676a1fb.png,1082,674,1198,794,116,120,red blood cell,13920,1.0344827586206897,0.9666666666666667
29244,/images/6274fe0d-0d71-40be-b61b-f0bd5b5df1e2.png,220,939,300,1029,80,90,red blood cell,7200,1.125,0.8888888888888888
53756,/images/76b24246-8571-4e7b-8815-b185414a2c51.png,774,219,870,320,96,101,red blood cell,9696,1.0520833333333333,0.9504950495049505
57352,/images/a88a48b6-f85c-45c1-b42f-79716c8463f1.png,72,1027,175,1131,103,104,red blood cell,10712,1.0097087378640777,0.9903846153846154
1386,/images/6d91d1f0-636b-4f5a-a526-7c17fc857190.png,523,1490,631,1588,108,98,red blood cell,10584,0.9074074074074074,1.1020408163265305
36201,/images/17c06a23-bb77-49cb-9ffb-fbfc75fcc715.png,935,1223,1045,1333,110,110,red blood cell,12100,1.0,1.0
41043,/images/e871f52c-77a6-4813-80d4-95bd97985f1a.png,216,1280,342,1412,126,132,red blood cell,16632,1.0476190476190477,0.9545454545454546
41890,/images/783ae4ad-6a35-4b3c-b19f-754974b67b2d.png,366,385,468,486,102,101,red blood cell,10302,0.9901960784313726,1.00990099009901
4746,/images/3fa1a4e3-c80d-49da-8f7b-a1abb0424f48.png,636,840,734,956,98,116,red blood cell,11368,1.183673469387755,0.8448275862068966
76193,/images/07a96126-482e-4beb-b42a-0cb59e505372.png,1082,522,1194,631,112,109,red blood cell,12208,0.9732142857142857,1.0275229357798166
48961,/images/5dec0204-af81-44ef-a942-8a173669c123.png,336,1082,441,1176,105,94,red blood cell,9870,0.8952380952380953,1.1170212765957446
26127,/images/27388ff2-4000-4c9a-a2e3-addc448a5f92.png,986,656,1118,787,132,131,red blood cell,17292,0.9924242424242424,1.0076335877862594
7352,/images/89f10192-d3dd-4996-a571-4c851dbdc983.png,100,1136,201,1257,101,121,red blood cell,12221,1.198019801980198,0.8347107438016529
59240,/images/03c8da48-04b9-4520-b674-44a0ecd35688.png,1048,948,1156,1074,108,126,red blood cell,13608,1.1666666666666667,0.8571428571428571
62076,/images/7f528918-27d4-421f-ab57-0cf9c693e697.png,528,71,645,191,117,120,red blood cell,14040,1.0256410256410255,0.975
29109,/images/4c13e22e-dfd1-4fa1-b373-be9d0c272c0f.png,603,192,702,288,99,96,red blood cell,9504,0.9696969696969697,1.03125
11745,/images/082e1f81-4f49-44ad-b5bb-9dfc155b2ed8.png,427,503,534,610,107,107,red blood cell,11449,1.0,1.0
75828,/images/c4c7ed75-dbdf-4bb6-b6ba-718903cf7264.png,891,1289,1023,1429,132,140,red blood cell,18480,1.0606060606060606,0.9428571428571428
69764,/images/2bd15b6e-fe2d-49f3-b394-940d024d1f91.png,1062,836,1147,938,85,102,red blood cell,8670,1.2,0.8333333333333334
72845,/images/31435107-c77d-42f8-a619-75cba6a5161b.png,339,1250,443,1339,104,89,red blood cell,9256,0.8557692307692307,1.1685393258426966
47665,/images/4b3a49bc-8536-4760-9553-440a6f64db37.png,22,16,132,137,110,121,red blood cell,13310,1.1,0.9090909090909091
68842,/images/aa3ad405-828e-4986-8251-20fd981f34d3.png,139,799,241,910,102,111,red blood cell,11322,1.088235294117647,0.918918918918919
7918,/images/9af4b8ae-c912-41fd-b4c0-34864c75360f.png,783,109,875,207,92,98,red blood cell,9016,1.065217391304348,0.9387755102040817
79247,/images/05ac7b2a-6a77-4464-926b-8570f7c01693.png,187,959,285,1062,98,103,red blood cell,10094,1.0510204081632653,0.9514563106796117
74515,/images/cbb58718-6319-48db-b84b-78ac9b12ff89.png,45,242,131,318,86,76,red blood cell,6536,0.8837209302325582,1.131578947368421
68334,/images/0f735cca-051c-4048-a1fa-cb36f389e12f.png,548,579,674,684,126,105,red blood cell,13230,0.8333333333333334,1.2
9945,/images/b9ccf7ca-953f-4832-9575-5e70b2a8c224.png,253,590,350,696,97,106,red blood cell,10282,1.092783505154639,0.9150943396226415
40429,/images/db249e5a-4142-432c-8288-bacd10d7273d.png,1061,1195,1157,1301,96,106,red blood cell,10176,1.1041666666666667,0.9056603773584906
50258,/images/3d32a988-449d-4d58-b71f-abbfdc3f2fbc.png,839,580,949,686,110,106,red blood cell,11660,0.9636363636363636,1.0377358490566038
78314,/images/24115f58-a7d6-4022-a95a-86b515a78d3e.png,41,1075,135,1172,94,97,red blood cell,9118,1.0319148936170213,0.9690721649484536
62821,/images/631340cc-cedf-4bca-a3d8-a0731a5482b4.png,820,113,916,208,96,95,red blood cell,9120,0.9895833333333334,1.0105263157894737
35055,/images/67582df6-bf13-4c83-a531-1214692b70de.png,321,537,434,653,113,116,red blood cell,13108,1.0265486725663717,0.9741379310344828
34688,/images/8d989997-038c-4924-b2d3-d02629a7cdf5.png,252,627,366,759,114,132,red blood cell,15048,1.1578947368421053,0.8636363636363636
31826,/images/f62d4fb6-df7c-446c-94a8-d5aede0b1e0c.png,969,423,1092,539,123,116,red blood cell,14268,0.943089430894309,1.0603448275862069
54582,/images/59dc7da9-35d1-421e-a61b-1e9637bfbfa1.png,1071,148,1176,247,105,99,red blood cell,10395,0.9428571428571428,1.0606060606060606
48068,/images/1d4f06e1-9c9b-487e-84cd-e7e50cc754da.png,492,1435,605,1546,113,111,red blood cell,12543,0.9823008849557522,1.018018018018018
48343,/images/6fa2b30f-9b89-46ac-9b79-c0bc105d4271.png,169,344,298,471,129,127,red blood cell,16383,0.9844961240310077,1.015748031496063
24576,/images/c03d9b87-e19b-402b-ad86-b30d6e8aeb59.png,331,593,423,699,92,106,red blood cell,9752,1.1521739130434783,0.8679245283018868
33586,/images/00c8364b-8c85-4502-bcfe-64736fe76815.png,378,916,478,1016,100,100,red blood cell,10000,1.0,1.0
56617,/images/a824b499-3736-4581-bbdc-be1b3b4cf756.png,874,868,978,982,104,114,red blood cell,11856,1.0961538461538463,0.9122807017543859
42616,/images/184b376b-03cb-4c2d-af51-fc1a62196293.png,254,340,344,441,90,101,red blood cell,9090,1.1222222222222222,0.8910891089108911
60055,/images/e63e1607-f344-43d6-a0d8-e10cf2e5054a.png,385,1445,514,1565,129,120,red blood cell,15480,0.9302325581395349,1.075
6479,/images/640c4a52-3742-4f57-aee3-9e3dc0887622.png,849,708,958,807,109,99,red blood cell,10791,0.908256880733945,1.101010101010101
25117,/images/9e74feb8-017d-4d53-8896-9ebda4327dd1.png,46,1316,142,1421,96,105,red blood cell,10080,1.09375,0.9142857142857143
37403,/images/08f5a524-0554-49c2-83a8-ae9a6d51e8fd.png,533,1137,636,1250,103,113,red blood cell,11639,1.0970873786407767,0.911504424778761
33931,/images/1a332b2c-9d49-4ff2-810c-5633d2314527.png,264,310,383,450,119,140,red blood cell,16660,1.1764705882352942,0.85
79303,/images/05ac7b2a-6a77-4464-926b-8570f7c01693.png,538,277,620,373,82,96,red blood cell,7872,1.170731707317073,0.8541666666666666
36387,/images/4a0a05e1-11ad-4bfc-bfa3-adf3b9bd0b56.png,222,828,344,949,122,121,red blood cell,14762,0.9918032786885246,1.0082644628099173
69958,/images/089c9744-f906-41d8-908d-1e37919a8658.png,73,1319,183,1438,110,119,red blood cell,13090,1.0818181818181818,0.9243697478991597
29467,/images/8cc6fe77-5f2f-4670-b4ac-1b49550241a8.png,675,118,766,215,91,97,red blood cell,8827,1.065934065934066,0.9381443298969072
40522,/images/e3ade58d-086c-47fa-9120-76beacb45395.png,635,438,748,551,113,113,red blood cell,12769,1.0,1.0
43018,/images/6c7095cd-ab6b-4f53-bd94-905d0cc95840.png,1016,767,1133,890,117,123,red blood cell,14391,1.0512820512820513,0.9512195121951219
36918,/images/b2e34f5f-904e-4473-9dc7-c6bc1ce12640.png,403,1401,512,1511,109,110,red blood cell,11990,1.0091743119266054,0.990909090909091
40009,/images/8271d0d8-9985-43eb-94b3-c702adca139f.png,266,637,396,760,130,123,red blood cell,15990,0.9461538461538461,1.056910569105691
34214,/images/4767bfcc-fe87-4962-8c40-6ce8d9363cdf.png,684,71,792,196,108,125,red blood cell,13500,1.1574074074074074,0.864
43057,/images/340a1727-0df7-4e6f-9c0e-9c5deddbfca2.png,588,1006,702,1106,114,100,red blood cell,11400,0.8771929824561403,1.14
50933,/images/ef8fcfa4-8466-4186-8c69-f5f4904eb489.png,118,995,236,1112,118,117,red blood cell,13806,0.9915254237288136,1.0085470085470085
70428,/images/8cca114a-ed05-4b87-95b7-fae02487f08c.png,558,415,659,513,101,98,red blood cell,9898,0.9702970297029703,1.030612244897959
55639,/images/c32b8bb8-c89d-4ae9-9c77-5b9356ca35a1.png,772,267,885,379,113,112,red blood cell,12656,0.9911504424778761,1.0089285714285714
67550,/images/45902b63-be9a-49ae-9ede-3a8015671bc4.png,805,1401,905,1511,100,110,red blood cell,11000,1.1,0.9090909090909091
74421,/images/06a3effb-996c-4767-afd2-6aa3b697cb4e.png,646,1516,737,1600,91,84,red blood cell,7644,0.9230769230769231,1.0833333333333333
29024,/images/4c13e22e-dfd1-4fa1-b373-be9d0c272c0f.png,790,671,907,766,117,95,red blood cell,11115,0.811965811965812,1.231578947368421
50992,/images/ef8fcfa4-8466-4186-8c69-f5f4904eb489.png,381,1484,485,1598,104,114,red blood cell,11856,1.0961538461538463,0.9122807017543859
55002,/images/7beee655-6156-43b8-b185-dbae0eaf7f45.png,70,68,201,192,131,124,red blood cell,16244,0.9465648854961832,1.0564516129032258
32876,/images/e40000b4-1b26-42ce-909d-4715e04f0a6e.png,832,829,963,937,131,108,red blood cell,14148,0.8244274809160306,1.212962962962963
5199,/images/16a51468-9f93-45df-9ae2-5a74c25c5a4b.png,665,542,772,653,107,111,red blood cell,11877,1.0373831775700935,0.963963963963964
72313,/images/ee57e743-a876-4f69-9fe5-bf5d01b44689.png,904,1120,1004,1222,100,102,red blood cell,10200,1.02,0.9803921568627451
28086,/images/f1f9df6d-c4cb-4b42-9ca2-8fb47b1b0e91.png,134,883,251,1003,117,120,red blood cell,14040,1.0256410256410255,0.975
66455,/images/5f66d20c-fbfe-44ec-a01b-8a09da24807e.png,1017,1077,1112,1165,95,88,red blood cell,8360,0.9263157894736842,1.0795454545454546
54442,/images/22a464ef-c3da-4d56-b37e-e22e95d945e7.png,899,146,978,232,79,86,red blood cell,6794,1.0886075949367089,0.9186046511627907
1582,/images/0ac747cd-ff32-49bf-bc1a-3e9b7702ce9c.png,539,624,638,718,99,94,red blood cell,9306,0.9494949494949495,1.053191489361702
53194,/images/d8f7e159-b7e3-49e4-86e8-aed8c5fbcd97.png,554,1388,673,1487,119,99,red blood cell,11781,0.8319327731092437,1.202020202020202
16112,/images/66557580-fd38-4d4b-80d8-88611ecc78c6.png,594,713,725,839,131,126,red blood cell,16506,0.9618320610687023,1.0396825396825398
42865,/images/a7b6894d-eeea-4ed5-bc0e-785d6c6da8df.png,616,963,736,1091,120,128,red blood cell,15360,1.0666666666666667,0.9375
21932,/images/d57b3894-c912-47e8-b00a-e1a2a7aba644.png,120,943,232,1063,112,120,red blood cell,13440,1.0714285714285714,0.9333333333333333
25741,/images/1f8edb2a-40bc-4beb-aa6b-884d2473df0f.png,857,1166,965,1279,108,113,red blood cell,12204,1.0462962962962963,0.9557522123893806
36495,/images/bd856928-96ee-4fc4-a377-f2fc4e84448b.png,801,296,900,407,99,111,red blood cell,10989,1.121212121212121,0.8918918918918919
65885,/images/d7581cb0-7a12-471d-a3d8-68dcea362213.png,864,1033,972,1151,108,118,red blood cell,12744,1.0925925925925926,0.9152542372881356
38943,/images/5939f341-a886-4f63-ae87-2219d000a1d4.png,557,500,674,634,117,134,red blood cell,15678,1.1452991452991452,0.8731343283582089
61250,/images/b3058064-d817-47dd-a8c4-cdb1f62374f8.png,11,917,127,1041,116,124,red blood cell,14384,1.0689655172413792,0.9354838709677419
67398,/images/266180ed-77a3-4284-8292-50a49fc47fce.png,759,21,845,109,86,88,red blood cell,7568,1.0232558139534884,0.9772727272727273
31862,/images/f62d4fb6-df7c-446c-94a8-d5aede0b1e0c.png,262,504,380,622,118,118,red blood cell,13924,1.0,1.0
49682,/images/9842445c-5899-4189-9f2e-3a3a179fdad3.png,195,869,316,975,121,106,red blood cell,12826,0.8760330578512396,1.1415094339622642
49187,/images/a9daf82a-a46d-4296-bd72-2c374ed0a193.png,894,135,1009,261,115,126,red blood cell,14490,1.0956521739130434,0.9126984126984127
61646,/images/a3c0a876-be12-4ede-8aed-18b32a64401b.png,635,838,741,944,106,106,red blood cell,11236,1.0,1.0
34035,/images/1012abf2-cb05-4337-86c5-513ec4ca904d.png,1040,724,1129,813,89,89,red blood cell,7921,1.0,1.0
19932,/images/0ca25c88-457f-4f03-bbc1-98fb6663f1d1.png,739,1020,836,1133,97,113,red blood cell,10961,1.1649484536082475,0.8584070796460177
60111,/images/ec60ab26-3343-4c5f-9667-cdae999c7d86.png,335,774,455,889,120,115,red blood cell,13800,0.9583333333333334,1.0434782608695652
40858,/images/bf20d04d-ff8a-4910-91d7-94054c267d1b.png,215,551,343,679,128,128,red blood cell,16384,1.0,1.0
7181,/images/56551792-4aa1-4301-9f8f-8bfebcd20050.png,717,1222,840,1344,123,122,red blood cell,15006,0.991869918699187,1.0081967213114753
46313,/images/e11515b4-9527-4c23-a0ba-43719bacca0d.png,995,125,1095,239,100,114,red blood cell,11400,1.14,0.8771929824561403
72484,/images/22516db4-8687-4051-90c4-2bb1ca3204a5.png,839,1120,942,1222,103,102,red blood cell,10506,0.9902912621359223,1.0098039215686274
68814,/images/aa3ad405-828e-4986-8251-20fd981f34d3.png,254,781,360,891,106,110,red blood cell,11660,1.0377358490566038,0.9636363636363636
67520,/images/45902b63-be9a-49ae-9ede-3a8015671bc4.png,31,1316,145,1429,114,113,red blood cell,12882,0.9912280701754386,1.008849557522124
59174,/images/4736f545-1f1f-4d77-9241-d69cbf4dae35.png,1068,974,1155,1058,87,84,red blood cell,7308,0.9655172413793104,1.0357142857142858
76509,/images/38c69905-8a4f-451a-8d0a-b855dc88dd16.png,533,1125,621,1217,88,92,red blood cell,8096,1.0454545454545454,0.9565217391304348
26744,/images/2518f6e4-29cc-4ae4-a914-b215a4c56099.png,452,925,576,1065,124,140,red blood cell,17360,1.1290322580645162,0.8857142857142857
1717,/images/5f783f43-0090-4f8a-bd75-9562f4aa2dd5.png,903,597,996,688,93,91,red blood cell,8463,0.978494623655914,1.021978021978022
40222,/images/ef1a9020-5e45-450d-a237-165114308592.png,723,156,852,281,129,125,red blood cell,16125,0.9689922480620154,1.032
60239,/images/abf4cf2a-4532-4772-9f0f-9e123cc1713d.png,828,583,942,698,114,115,red blood cell,13110,1.0087719298245614,0.991304347826087
58858,/images/434523fd-d4d9-4961-a7c2-d71d6ae68e13.png,643,698,733,790,90,92,red blood cell,8280,1.0222222222222221,0.9782608695652174
31294,/images/31c749e8-18d1-4105-b7e6-8319cceddae0.png,925,136,1038,245,113,109,red blood cell,12317,0.9646017699115044,1.036697247706422
38324,/images/674b0fd3-f247-4b7f-97f7-3e6c57c9ba9e.png,1010,22,1102,121,92,99,red blood cell,9108,1.076086956521739,0.9292929292929293
13349,/images/a7f1bbb1-6058-4642-bd66-cfb90dce762e.png,1031,1394,1141,1509,110,115,red blood cell,12650,1.0454545454545454,0.9565217391304348
49538,/images/9f33e0ea-065b-4703-9df9-15829b891860.png,73,744,200,869,127,125,red blood cell,15875,0.984251968503937,1.016
79533,/images/161978c3-3a05-47a5-9fee-be7d25693eae.png,1030,800,1127,888,97,88,red blood cell,8536,0.9072164948453608,1.1022727272727273
36850,/images/3de03fa2-3ad3-43fc-8435-b2a80bdd7550.png,116,431,227,549,111,118,red blood cell,13098,1.063063063063063,0.940677966101695
4727,/images/3fa1a4e3-c80d-49da-8f7b-a1abb0424f48.png,1001,1228,1111,1340,110,112,red blood cell,12320,1.018181818181818,0.9821428571428571
74203,/images/4e43fc22-dc08-4cde-b3ce-ce8a4f377c47.png,112,1456,215,1568,103,112,red blood cell,11536,1.087378640776699,0.9196428571428571
55601,/images/c32b8bb8-c89d-4ae9-9c77-5b9356ca35a1.png,142,219,267,327,125,108,red blood cell,13500,0.864,1.1574074074074074
34441,/images/b4bde4e8-f48b-4ae2-be01-86d8c91d0af9.png,617,1396,719,1493,102,97,red blood cell,9894,0.9509803921568627,1.0515463917525774
54555,/images/59dc7da9-35d1-421e-a61b-1e9637bfbfa1.png,629,1191,745,1311,116,120,red blood cell,13920,1.0344827586206897,0.9666666666666667
59142,/images/4736f545-1f1f-4d77-9241-d69cbf4dae35.png,663,290,761,381,98,91,red blood cell,8918,0.9285714285714286,1.0769230769230769
58664,/images/a4d7a7e1-5ae1-486d-b6ee-c9af1476ccad.png,1054,1217,1158,1324,104,107,red blood cell,11128,1.0288461538461537,0.9719626168224299
49928,/images/05804cf0-f854-4099-97c2-df287f7c8a8c.png,576,869,692,979,116,110,red blood cell,12760,0.9482758620689655,1.0545454545454545
41539,/images/0fcd1ebe-ee4a-40a0-b787-29cee18bfa1b.png,153,312,253,421,100,109,red blood cell,10900,1.09,0.9174311926605505
42388,/images/1a27ebe9-93a1-4898-af69-f276057d4012.png,822,955,948,1066,126,111,red blood cell,13986,0.8809523809523809,1.135135135135135
74349,/images/06a3effb-996c-4767-afd2-6aa3b697cb4e.png,443,359,553,482,110,123,red blood cell,13530,1.1181818181818182,0.8943089430894309
47158,/images/3d1b889e-bb4a-4ee6-b899-974ee7d956a7.png,925,523,1032,635,107,112,red blood cell,11984,1.0467289719626167,0.9553571428571429
46728,/images/da111ca5-520f-4ea8-97ad-ae5fce58ee91.png,763,617,853,720,90,103,red blood cell,9270,1.1444444444444444,0.8737864077669902
6652,/images/95fea6d8-413f-421e-b331-5d51c31df150.png,381,1472,481,1561,100,89,red blood cell,8900,0.89,1.1235955056179776
71561,/images/b9c6db13-ca3a-4937-8ecf-e537047ed858.png,748,562,872,681,124,119,red blood cell,14756,0.9596774193548387,1.0420168067226891
18770,/images/cc882eae-a341-4783-bd19-8bdedf798538.png,1016,1122,1120,1227,104,105,red blood cell,10920,1.0096153846153846,0.9904761904761905
46562,/images/edd09b2e-2673-4405-8ac0-e476e003e96a.png,994,1353,1126,1485,132,132,red blood cell,17424,1.0,1.0
49973,/images/05804cf0-f854-4099-97c2-df287f7c8a8c.png,53,179,185,285,132,106,red blood cell,13992,0.803030303030303,1.2452830188679245
52983,/images/e81bf478-27ff-458c-ac30-9e1f8480bc5c.png,224,247,331,354,107,107,red blood cell,11449,1.0,1.0
12919,/images/b10ea12f-cd36-4f2c-994a-67d1665269ab.png,0,210,119,323,119,113,red blood cell,13447,0.9495798319327731,1.0530973451327434
65003,/images/ff3b9d4d-373c-48ef-a75a-d23e2c2ade87.png,567,309,664,411,97,102,red blood cell,9894,1.0515463917525774,0.9509803921568627
53237,/images/d8f7e159-b7e3-49e4-86e8-aed8c5fbcd97.png,551,634,653,740,102,106,red blood cell,10812,1.0392156862745099,0.9622641509433962
56201,/images/137d540f-d71e-47e8-bd9b-6cd0a6433c33.png,1,583,105,688,104,105,red blood cell,10920,1.0096153846153846,0.9904761904761905
37280,/images/2fdbd9bc-bbaf-44c2-b40c-d193709639fa.png,995,722,1114,859,119,137,red blood cell,16303,1.1512605042016806,0.8686131386861314
2319,/images/fe851c88-692d-4199-87e0-d19d9c4eb591.png,435,771,540,873,105,102,red blood cell,10710,0.9714285714285714,1.0294117647058822
12427,/images/cc94eabb-a3dc-4cfc-9fff-55c76b5b4a71.png,575,1422,661,1521,86,99,red blood cell,8514,1.1511627906976745,0.8686868686868687
4375,/images/84041bf9-dace-4066-9fe0-52170d08f826.png,926,1087,1018,1192,92,105,red blood cell,9660,1.141304347826087,0.8761904761904762
20170,/images/df49578a-60d4-4a3b-9ee0-79d9d59bc72a.png,1018,172,1161,316,143,144,red blood cell,20592,1.006993006993007,0.9930555555555556
79659,/images/a4409217-be11-4478-90a5-b406057d154d.png,594,1310,694,1403,100,93,red blood cell,9300,0.93,1.075268817204301
75104,/images/073c10c9-5749-44b5-b08b-1be556a960f0.png,656,564,777,665,121,101,red blood cell,12221,0.8347107438016529,1.198019801980198
17217,/images/471f75c6-bd5d-4c20-bcc1-258e836f4d69.png,828,22,925,126,97,104,red blood cell,10088,1.0721649484536082,0.9326923076923077
6762,/images/672e4ecf-a56b-462e-b83b-76f4efaa6634.png,245,1229,338,1330,93,101,red blood cell,9393,1.086021505376344,0.9207920792079208
39104,/images/7bde7de1-889b-4218-b0e1-e2c04f6a7986.png,181,299,274,399,93,100,red blood cell,9300,1.075268817204301,0.93
79227,/images/eb0173a3-7e5e-4f53-8124-03d9d6317844.png,173,1181,272,1283,99,102,red blood cell,10098,1.0303030303030303,0.9705882352941176
5588,/images/75c243e2-610d-4d5a-bc5a-4c53d99d9ae9.png,922,639,1048,755,126,116,red blood cell,14616,0.9206349206349206,1.0862068965517242
72473,/images/a15e0fa8-2620-4f66-896e-175115c9dc3d.png,91,1088,180,1180,89,92,red blood cell,8188,1.0337078651685394,0.967391304347826
26340,/images/580210c2-a8ed-4720-b71c-a77945968abc.png,569,791,681,912,112,121,red blood cell,13552,1.0803571428571428,0.9256198347107438
8940,/images/04628a94-b674-469b-aff6-b476b70df87d.png,748,55,865,185,117,130,red blood cell,15210,1.1111111111111112,0.9
78060,/images/105af41b-13cc-4ad1-8a1f-8bc4d47cdd94.png,534,1103,648,1221,114,118,red blood cell,13452,1.0350877192982457,0.9661016949152542
22517,/images/bfe65b11-8aff-46aa-908b-1e989d25fdc4.png,40,895,141,1016,101,121,red blood cell,12221,1.198019801980198,0.8347107438016529
36898,/images/b2e34f5f-904e-4473-9dc7-c6bc1ce12640.png,756,364,865,469,109,105,red blood cell,11445,0.963302752293578,1.0380952380952382
53336,/images/d8f7e159-b7e3-49e4-86e8-aed8c5fbcd97.png,329,372,421,487,92,115,red blood cell,10580,1.25,0.8
20293,/images/98976666-9125-47fe-9601-43c41e58dfb4.png,938,1394,1044,1518,106,124,red blood cell,13144,1.169811320754717,0.8548387096774194
57970,/images/7942691b-6376-4c75-ae8a-ddf65454dcb2.png,1029,1190,1143,1305,114,115,red blood cell,13110,1.0087719298245614,0.991304347826087
29611,/images/42845335-4ab2-4963-806d-0985d1382a31.png,45,864,167,991,122,127,red blood cell,15494,1.040983606557377,0.9606299212598425
77172,/images/fe691faa-3bc7-475e-b558-aa8fe7b795bc.png,576,62,689,158,113,96,red blood cell,10848,0.8495575221238938,1.1770833333333333
11621,/images/37e072a6-000d-4773-8d9f-d66b60ace668.png,402,890,519,1010,117,120,red blood cell,14040,1.0256410256410255,0.975
40798,/images/252071ac-e9f2-41d2-abbb-87ef01b8a997.png,1120,1042,1198,1132,78,90,red blood cell,7020,1.1538461538461537,0.8666666666666667
51224,/images/ad8731b7-0dae-4983-9dc6-dec31767d761.png,1094,1077,1187,1178,93,101,red blood cell,9393,1.086021505376344,0.9207920792079208
9873,/images/3859deaf-6ae1-49a3-9051-898d0f0d7de6.png,183,244,276,334,93,90,red blood cell,8370,0.967741935483871,1.0333333333333334
75232,/images/61dfc937-a428-44b4-94fb-d682bdb8dff0.png,948,784,1043,897,95,113,red blood cell,10735,1.1894736842105262,0.8407079646017699
54665,/images/6473ddb6-ad56-48a2-81e8-c7cb45f06825.png,107,1045,204,1145,97,100,red blood cell,9700,1.0309278350515463,0.97
19264,/images/b4d22412-a495-43a9-bec0-73a2322f8dad.png,60,1085,146,1181,86,96,red blood cell,8256,1.1162790697674418,0.8958333333333334
64515,/images/6ba5d0b8-cdc7-4266-9d78-db76faa312e9.png,150,532,248,650,98,118,red blood cell,11564,1.2040816326530612,0.8305084745762712
63143,/images/d82c657e-5678-41da-9a6e-3ad29430b759.png,280,1135,370,1241,90,106,red blood cell,9540,1.1777777777777778,0.8490566037735849
56976,/images/a93c35ba-1690-4358-8837-669bcd850bb7.png,4,993,110,1101,106,108,red blood cell,11448,1.0188679245283019,0.9814814814814815
7609,/images/21cc498b-8cb2-42ed-8f80-bfa27b86ef11.png,483,906,597,1022,114,116,red blood cell,13224,1.0175438596491229,0.9827586206896551
23464,/images/8757be1e-b832-407a-8e95-62abae485b24.png,769,745,875,852,106,107,red blood cell,11342,1.009433962264151,0.9906542056074766
12737,/images/b634137b-bc8b-4e88-b0e3-b536ad6e7e18.png,1034,248,1146,346,112,98,red blood cell,10976,0.875,1.1428571428571428
7800,/images/e726dac6-f962-449c-acff-4dd56847b685.png,166,1365,293,1478,127,113,red blood cell,14351,0.889763779527559,1.1238938053097345
47152,/images/3d1b889e-bb4a-4ee6-b899-974ee7d956a7.png,795,542,907,648,112,106,red blood cell,11872,0.9464285714285714,1.0566037735849056
9738,/images/3859deaf-6ae1-49a3-9051-898d0f0d7de6.png,907,797,1017,903,110,106,red blood cell,11660,0.9636363636363636,1.0377358490566038
5196,/images/16a51468-9f93-45df-9ae2-5a74c25c5a4b.png,481,1387,602,1500,121,113,red blood cell,13673,0.9338842975206612,1.0707964601769913
55600,/images/c32b8bb8-c89d-4ae9-9c77-5b9356ca35a1.png,55,766,176,883,121,117,red blood cell,14157,0.9669421487603306,1.0341880341880343
49224,/images/a9daf82a-a46d-4296-bd72-2c374ed0a193.png,374,288,482,402,108,114,red blood cell,12312,1.0555555555555556,0.9473684210526315
45629,/images/582e4b8b-404e-4b30-9df3-66f2afb3cdb3.png,568,1315,689,1431,121,116,red blood cell,14036,0.9586776859504132,1.043103448275862
41318,/images/2374ae5b-c2df-4db5-afea-c54180aa22e3.png,843,773,929,859,86,86,red blood cell,7396,1.0,1.0
19247,/images/b4d22412-a495-43a9-bec0-73a2322f8dad.png,759,71,862,160,103,89,red blood cell,9167,0.8640776699029126,1.1573033707865168
69131,/images/de2b8835-552c-4f01-98b7-67bc4910062e.png,1051,461,1145,570,94,109,red blood cell,10246,1.1595744680851063,0.8623853211009175
55301,/images/4fb83278-adc5-4424-9f45-b6d0db2955b6.png,109,173,216,279,107,106,red blood cell,11342,0.9906542056074766,1.009433962264151
14262,/images/6382976c-ee87-4916-b798-4ef1373b2df0.png,332,1233,436,1330,104,97,red blood cell,10088,0.9326923076923077,1.0721649484536082
21668,/images/66183740-e1e5-43c9-8539-a87028bb3621.png,15,901,120,992,105,91,red blood cell,9555,0.8666666666666667,1.1538461538461537
45348,/images/e4eea7ea-8989-46a9-9c98-25a178146b28.png,801,949,914,1054,113,105,red blood cell,11865,0.9292035398230089,1.0761904761904761
8970,/images/ef815e3a-02a6-4cf8-9262-45bc74c50b00.png,642,1122,762,1240,120,118,red blood cell,14160,0.9833333333333333,1.0169491525423728
41333,/images/a065c50b-341d-4803-b4b0-0fe8f04fdbb5.png,124,824,242,935,118,111,red blood cell,13098,0.940677966101695,1.063063063063063
65437,/images/b523daee-317b-461d-bdc1-07b4add4d488.png,143,1334,254,1446,111,112,red blood cell,12432,1.009009009009009,0.9910714285714286
28850,/images/686ed568-d5f8-475e-81ad-edab9dd473a0.png,571,633,659,724,88,91,red blood cell,8008,1.0340909090909092,0.967032967032967
67118,/images/4272cbd7-5b0a-4bf7-b690-dee1c128f07b.png,950,854,1058,973,108,119,red blood cell,12852,1.1018518518518519,0.907563025210084
55990,/images/4c460388-e0c1-4970-8527-c9e5b42bea49.png,327,329,443,437,116,108,red blood cell,12528,0.9310344827586207,1.0740740740740742
75666,/images/50d7c6c9-3230-48fe-947c-7dcfd0aad710.png,335,1226,436,1337,101,111,red blood cell,11211,1.099009900990099,0.9099099099099099
76714,/images/3317d733-ec0d-45e6-b631-40457392f343.png,1031,226,1132,330,101,104,red blood cell,10504,1.0297029702970297,0.9711538461538461
25983,/images/e683144c-0465-43a2-86b1-3cf52599d5e0.png,556,1187,667,1296,111,109,red blood cell,12099,0.9819819819819819,1.018348623853211
59524,/images/6bfe6a90-8a69-4171-8e7f-42dc9417c6d9.png,215,1140,313,1240,98,100,red blood cell,9800,1.0204081632653061,0.98
40149,/images/b34e65f6-c32e-42f1-a437-4a037c75a231.png,310,292,424,404,114,112,red blood cell,12768,0.9824561403508771,1.0178571428571428
71158,/images/4fac16e1-8e62-499b-a66b-c4c890372914.png,380,687,487,806,107,119,red blood cell,12733,1.1121495327102804,0.8991596638655462
75157,/images/7fdc8be8-7579-4a5c-b369-8a07ee0a8b7d.png,963,522,1054,627,91,105,red blood cell,9555,1.1538461538461537,0.8666666666666667
45275,/images/9e793460-d94c-47ac-b3a7-0d6ad86357da.png,320,339,441,462,121,123,red blood cell,14883,1.0165289256198347,0.983739837398374
42068,/images/46a03374-64c7-49ac-81c9-c3d62542bbf3.png,532,887,617,960,85,73,red blood cell,6205,0.8588235294117647,1.1643835616438356
2263,/images/fe851c88-692d-4199-87e0-d19d9c4eb591.png,140,1056,225,1144,85,88,red blood cell,7480,1.035294117647059,0.9659090909090909
43077,/images/340a1727-0df7-4e6f-9c0e-9c5deddbfca2.png,1002,641,1109,749,107,108,red blood cell,11556,1.0093457943925233,0.9907407407407407
29920,/images/f2a8a483-b254-43aa-817f-7d525adb8911.png,1005,799,1136,915,131,116,red blood cell,15196,0.8854961832061069,1.1293103448275863
30132,/images/81c3c8f0-d5a9-4dda-afd5-e86f6afd9424.png,712,1061,815,1174,103,113,red blood cell,11639,1.0970873786407767,0.911504424778761
69705,/images/f0713bee-2a71-4ced-b953-4041ea99496a.png,991,285,1092,387,101,102,red blood cell,10302,1.00990099009901,0.9901960784313726
76390,/images/3dad6483-ac30-4d2b-b045-9f24fe6ff75e.png,966,170,1066,278,100,108,red blood cell,10800,1.08,0.9259259259259259
29271,/images/6274fe0d-0d71-40be-b61b-f0bd5b5df1e2.png,260,919,343,996,83,77,red blood cell,6391,0.927710843373494,1.077922077922078
26618,/images/5893e081-04f2-4e33-9851-bed5f0e4d333.png,998,41,1124,166,126,125,red blood cell,15750,0.9920634920634921,1.008
48770,/images/fed6ba05-36a5-45dc-a4e1-9baa7de2c622.png,791,784,893,874,102,90,red blood cell,9180,0.8823529411764706,1.1333333333333333
14695,/images/4e2873dd-651e-4ecc-ac70-7335cf21a469.png,614,1023,716,1134,102,111,red blood cell,11322,1.088235294117647,0.918918918918919
75364,/images/468c261d-f5d8-423f-883e-48af2bbbc5d1.png,688,801,803,917,115,116,red blood cell,13340,1.008695652173913,0.9913793103448276
70311,/images/90246988-0d6d-4bf8-8a76-94107de4121e.png,410,1134,513,1234,103,100,red blood cell,10300,0.970873786407767,1.03
13609,/images/d47cd049-d78b-4ba3-a7d4-399be4dd1dde.png,938,605,1058,737,120,132,red blood cell,15840,1.1,0.9090909090909091
15675,/images/3892b776-f49a-4368-b0fa-7e855e76ccec.png,880,1352,981,1459,101,107,red blood cell,10807,1.0594059405940595,0.9439252336448598
79763,/images/03b9d6ad-39ca-4097-a98b-77f02b3c00a7.png,658,1366,743,1451,85,85,red blood cell,7225,1.0,1.0
6509,/images/640c4a52-3742-4f57-aee3-9e3dc0887622.png,366,966,473,1072,107,106,red blood cell,11342,0.9906542056074766,1.009433962264151
45224,/images/b7a0d235-2217-43b4-aeff-cde4ccaf6789.png,494,783,609,883,115,100,red blood cell,11500,0.8695652173913043,1.15
55164,/images/29d4b75f-d400-4702-a9ac-e5a4ed1a1db1.png,1084,142,1169,224,85,82,red blood cell,6970,0.9647058823529412,1.0365853658536586
63746,/images/06401963-8b02-46c5-ab2a-3d70bd01623f.png,193,1148,289,1253,96,105,red blood cell,10080,1.09375,0.9142857142857143
35044,/images/67582df6-bf13-4c83-a531-1214692b70de.png,461,107,578,219,117,112,red blood cell,13104,0.9572649572649573,1.0446428571428572
51651,/images/592c941a-aa54-4971-b499-dc47356f80a3.png,406,930,524,1049,118,119,red blood cell,14042,1.0084745762711864,0.9915966386554622
32732,/images/eef2ac0b-42de-4bc3-a3c3-d5fcd597fbe4.png,603,1375,710,1466,107,91,red blood cell,9737,0.8504672897196262,1.1758241758241759
60098,/images/e63e1607-f344-43d6-a0d8-e10cf2e5054a.png,176,1472,295,1597,119,125,red blood cell,14875,1.050420168067227,0.952
46025,/images/72088c26-d2dd-4906-b791-b8947fc7fbe4.png,99,1241,218,1362,119,121,red blood cell,14399,1.0168067226890756,0.9834710743801653
34905,/images/a4fbb9f2-9b75-4fdc-877d-2feaafac25b3.png,52,1111,150,1211,98,100,red blood cell,9800,1.0204081632653061,0.98
60957,/images/5397d8e2-bb09-42e7-9861-65ffad0fe94e.png,675,882,784,992,109,110,red blood cell,11990,1.0091743119266054,0.990909090909091
32247,/images/f4722a74-35e7-42bd-8ef6-dfff04b9cd22.png,977,595,1085,709,108,114,red blood cell,12312,1.0555555555555556,0.9473684210526315
42680,/images/3abbc4d3-1d7e-40c9-9963-33732da7cc50.png,366,1194,469,1305,103,111,red blood cell,11433,1.0776699029126213,0.9279279279279279
56570,/images/a824b499-3736-4581-bbdc-be1b3b4cf756.png,61,183,166,285,105,102,red blood cell,10710,0.9714285714285714,1.0294117647058822
16647,/images/bc377041-e098-45c4-9651-2b1ea90d1d7e.png,239,1422,350,1522,111,100,red blood cell,11100,0.9009009009009009,1.11
63576,/images/de0321fa-6f7d-4dd1-b96b-186701c3b1d9.png,1045,402,1185,529,140,127,red blood cell,17780,0.9071428571428571,1.1023622047244095
57919,/images/09bcedaa-e007-4692-a13f-ab02c3f872c4.png,208,388,329,508,121,120,red blood cell,14520,0.9917355371900827,1.0083333333333333
56461,/images/d75933ed-d26e-4d1f-bda3-96bc0d77fb36.png,941,1017,1030,1112,89,95,red blood cell,8455,1.0674157303370786,0.9368421052631579
26694,/images/c1423156-82b3-4dd3-8e74-08eb7ed8e1d6.png,7,1431,117,1536,110,105,red blood cell,11550,0.9545454545454546,1.0476190476190477
35619,/images/45f18ac0-f097-4b20-a99d-8837cf488822.png,1059,842,1190,980,131,138,red blood cell,18078,1.0534351145038168,0.9492753623188406
10769,/images/fac4b0e2-6b52-4c0e-b762-4fa65d552856.png,938,503,1038,621,100,118,red blood cell,11800,1.18,0.847457627118644
24615,/images/c03d9b87-e19b-402b-ad86-b30d6e8aeb59.png,257,740,376,852,119,112,red blood cell,13328,0.9411764705882353,1.0625
69281,/images/f274b784-b995-4a7e-a2c2-6cc31c24c4b4.png,184,1505,270,1598,86,93,red blood cell,7998,1.0813953488372092,0.9247311827956989
63035,/images/6afd8203-d61a-4e9b-a4cf-dcb53a16b57c.png,182,1351,308,1458,126,107,red blood cell,13482,0.8492063492063492,1.1775700934579438
40211,/images/ef1a9020-5e45-450d-a237-165114308592.png,627,928,763,1041,136,113,red blood cell,15368,0.8308823529411765,1.2035398230088497
28588,/images/dbdfad64-110c-421f-a1c7-f68fd9e82d67.png,684,1038,784,1143,100,105,red blood cell,10500,1.05,0.9523809523809523
8305,/images/65e3d6a6-012c-4b40-9a42-83078eb85e31.png,991,836,1072,925,81,89,red blood cell,7209,1.0987654320987654,0.9101123595505618
63920,/images/5e974892-0ebe-4037-8427-ea8616d6d3b8.png,657,493,755,597,98,104,red blood cell,10192,1.0612244897959184,0.9423076923076923
16815,/images/4823c1fe-a7f9-4b92-959f-0d9be09cd14b.png,989,969,1100,1078,111,109,red blood cell,12099,0.9819819819819819,1.018348623853211
56724,/images/b3606d0e-6fe5-478a-bb4b-64d7c4889d86.png,842,826,947,920,105,94,red blood cell,9870,0.8952380952380953,1.1170212765957446
47114,/images/3d1b889e-bb4a-4ee6-b899-974ee7d956a7.png,394,881,497,990,103,109,red blood cell,11227,1.058252427184466,0.944954128440367
56846,/images/a588091c-5e4c-4e61-914d-e96f3ee3e505.png,169,1023,260,1123,91,100,red blood cell,9100,1.098901098901099,0.91
78929,/images/4d0a1598-e4dd-45c4-8a90-dd7c780fe1da.png,1067,1248,1161,1335,94,87,red blood cell,8178,0.925531914893617,1.0804597701149425
12735,/images/b634137b-bc8b-4e88-b0e3-b536ad6e7e18.png,299,297,418,399,119,102,red blood cell,12138,0.8571428571428571,1.1666666666666667
78323,/images/24115f58-a7d6-4022-a95a-86b515a78d3e.png,1044,944,1147,1058,103,114,red blood cell,11742,1.1067961165048543,0.9035087719298246
31746,/images/ab59c9e4-3e50-48b9-874d-060d317410cc.png,614,1149,731,1282,117,133,red blood cell,15561,1.1367521367521367,0.8796992481203008
31107,/images/9c48fdf4-621d-4f40-bcd7-6a28cd530de7.png,400,1234,501,1341,101,107,red blood cell,10807,1.0594059405940595,0.9439252336448598
50923,/images/ef8fcfa4-8466-4186-8c69-f5f4904eb489.png,162,784,282,907,120,123,red blood cell,14760,1.025,0.975609756097561
33251,/images/877d5e7f-19b6-40e7-81bd-c92f25e72503.png,1085,918,1194,1027,109,109,red blood cell,11881,1.0,1.0
13521,/images/370277f8-436b-4103-8210-b4feb5ab95ea.png,62,633,188,745,126,112,red blood cell,14112,0.8888888888888888,1.125
43757,/images/ef83ed4c-2724-4d5f-8abe-1a18d25cea35.png,538,329,665,444,127,115,red blood cell,14605,0.905511811023622,1.1043478260869566
40207,/images/ef1a9020-5e45-450d-a237-165114308592.png,711,1357,840,1480,129,123,red blood cell,15867,0.9534883720930233,1.048780487804878
39535,/images/5a631871-2fc7-4a68-9c39-f3b9a0bf4a04.png,207,370,312,468,105,98,red blood cell,10290,0.9333333333333333,1.0714285714285714
11218,/images/6303f964-98ef-47c6-bb2d-283aa393f918.png,372,491,460,574,88,83,red blood cell,7304,0.9431818181818182,1.0602409638554218
17515,/images/56077789-8580-41b4-89d6-deea227e5c60.png,670,385,816,507,146,122,red blood cell,17812,0.8356164383561644,1.1967213114754098
36144,/images/749df49e-5212-49ea-9e88-7d66f258f1df.png,845,623,969,731,124,108,red blood cell,13392,0.8709677419354839,1.1481481481481481
52488,/images/d1144956-5a0c-4bd2-b67d-8498c82d6a12.png,266,837,389,958,123,121,red blood cell,14883,0.983739837398374,1.0165289256198347
42623,/images/184b376b-03cb-4c2d-af51-fc1a62196293.png,850,1263,950,1374,100,111,red blood cell,11100,1.11,0.9009009009009009
48550,/images/f3d84be2-8af0-4d62-9f72-23d3dc08cbbe.png,789,759,923,880,134,121,red blood cell,16214,0.9029850746268657,1.1074380165289257
79446,/images/a2fc0093-8645-43c7-bdee-ec8ca9484815.png,53,1022,166,1144,113,122,red blood cell,13786,1.079646017699115,0.9262295081967213
34087,/images/de5d19b7-e670-4ac7-843b-7ce7bcebdf45.png,856,457,970,578,114,121,red blood cell,13794,1.0614035087719298,0.9421487603305785
36368,/images/4a0a05e1-11ad-4bfc-bfa3-adf3b9bd0b56.png,354,370,458,475,104,105,red blood cell,10920,1.0096153846153846,0.9904761904761905
36302,/images/81fed4a1-9d48-4938-90c9-c8bf3f5e6b1f.png,660,502,790,633,130,131,red blood cell,17030,1.0076923076923077,0.9923664122137404
55817,/images/68f34a9c-f73d-4238-8f55-4b05a8a2154c.png,238,766,319,850,81,84,red blood cell,6804,1.037037037037037,0.9642857142857143
42703,/images/3abbc4d3-1d7e-40c9-9963-33732da7cc50.png,460,942,571,1040,111,98,red blood cell,10878,0.8828828828828829,1.1326530612244898
17625,/images/70a95e58-ba60-4c1f-adcd-49c198dc2ba0.png,1082,49,1179,144,97,95,red blood cell,9215,0.979381443298969,1.0210526315789474
22792,/images/8490c623-3d88-4532-baf5-0d266a45b16f.png,562,300,664,402,102,102,red blood cell,10404,1.0,1.0
15348,/images/2d0f600d-f94e-4907-b712-52fb37d9ed52.png,883,1403,992,1502,109,99,red blood cell,10791,0.908256880733945,1.101010101010101
65091,/images/5e042380-6ef2-496f-8231-0ca550fbfa71.png,888,1206,970,1303,82,97,red blood cell,7954,1.1829268292682926,0.845360824742268
47582,/images/06cd484f-e864-4fee-8819-688b45eed98e.png,775,612,900,738,125,126,red blood cell,15750,1.008,0.9920634920634921
38200,/images/1d9d4dac-66f9-4c87-b714-d723d5b15fa9.png,879,882,996,1004,117,122,red blood cell,14274,1.0427350427350428,0.9590163934426229
34466,/images/b4bde4e8-f48b-4ae2-be01-86d8c91d0af9.png,984,78,1079,191,95,113,red blood cell,10735,1.1894736842105262,0.8407079646017699
20472,/images/b809b407-7b69-4334-873d-d6c49135f04a.png,706,1277,828,1395,122,118,red blood cell,14396,0.9672131147540983,1.0338983050847457
1711,/images/5f783f43-0090-4f8a-bd75-9562f4aa2dd5.png,4,493,113,600,109,107,red blood cell,11663,0.981651376146789,1.0186915887850467
33267,/images/5721e41b-90ef-4851-8587-8dc71227ef90.png,342,1283,448,1398,106,115,red blood cell,12190,1.0849056603773586,0.9217391304347826
12859,/images/b10ea12f-cd36-4f2c-994a-67d1665269ab.png,675,853,798,959,123,106,red blood cell,13038,0.8617886178861789,1.1603773584905661
76288,/images/1574565f-f45b-4160-947e-25ce1a81aaca.png,583,1281,682,1386,99,105,red blood cell,10395,1.0606060606060606,0.9428571428571428
31319,/images/31c749e8-18d1-4105-b7e6-8319cceddae0.png,116,1423,243,1533,127,110,red blood cell,13970,0.8661417322834646,1.1545454545454545
50249,/images/3d32a988-449d-4d58-b71f-abbfdc3f2fbc.png,592,1282,714,1398,122,116,red blood cell,14152,0.9508196721311475,1.0517241379310345
56080,/images/ffb7be9a-65df-4f0b-99ae-cfd34e81cd34.png,958,87,1063,193,105,106,red blood cell,11130,1.0095238095238095,0.9905660377358491
77116,/images/dd6f047e-af73-43df-9c46-354534fc20e0.png,583,118,677,232,94,114,red blood cell,10716,1.2127659574468086,0.8245614035087719
54740,/images/10891eed-b0f2-4dd0-90cb-da185f6761b2.png,468,1317,576,1413,108,96,red blood cell,10368,0.8888888888888888,1.125
6438,/images/1ecb0405-a6e9-4485-819e-2fbbf2b718aa.png,552,699,661,819,109,120,red blood cell,13080,1.1009174311926606,0.9083333333333333
40340,/images/eb86033f-4f1c-4e8c-ae84-e8e4c7e08626.png,22,1244,126,1345,104,101,red blood cell,10504,0.9711538461538461,1.0297029702970297
20683,/images/e6d7c5e1-43fc-4712-86d5-aa70252b978f.png,872,517,986,629,114,112,red blood cell,12768,0.9824561403508771,1.0178571428571428
18150,/images/947348fe-4c70-468e-8009-3c14daeca69b.png,219,700,332,798,113,98,red blood cell,11074,0.8672566371681416,1.153061224489796
53859,/images/540a5fee-175b-4b92-bf62-1ea9b59c86c6.png,169,315,286,425,117,110,red blood cell,12870,0.9401709401709402,1.0636363636363637
38690,/images/b5acf759-1115-42f0-a753-656736192528.png,1075,1100,1199,1218,124,118,red blood cell,14632,0.9516129032258065,1.0508474576271187
30405,/images/58d75854-be99-484e-89f0-4ab208fe07e0.png,154,1449,251,1545,97,96,red blood cell,9312,0.9896907216494846,1.0104166666666667
37401,/images/08f5a524-0554-49c2-83a8-ae9a6d51e8fd.png,675,1326,780,1426,105,100,red blood cell,10500,0.9523809523809523,1.05
50223,/images/3d32a988-449d-4d58-b71f-abbfdc3f2fbc.png,129,1053,239,1150,110,97,red blood cell,10670,0.8818181818181818,1.134020618556701
57626,/images/d32022fa-e492-4b31-a776-9435cfdef6d6.png,870,242,988,349,118,107,red blood cell,12626,0.9067796610169492,1.102803738317757
1614,/images/7094c11a-1e62-4f98-894e-d17d138a88e9.png,1028,836,1162,966,134,130,red blood cell,17420,0.9701492537313433,1.0307692307692307
67169,/images/be6fe358-dee1-4dcf-9b0d-5d8612aba577.png,54,350,169,462,115,112,red blood cell,12880,0.9739130434782609,1.0267857142857142
58838,/images/434523fd-d4d9-4961-a7c2-d71d6ae68e13.png,1071,1424,1168,1529,97,105,red blood cell,10185,1.0824742268041236,0.9238095238095239
18715,/images/f6f8a69a-3fd2-4684-ac77-3e83ea0fb36d.png,855,345,968,458,113,113,red blood cell,12769,1.0,1.0
70822,/images/b62d47f9-2ff5-4902-abdc-b3610acfc7ba.png,63,1298,145,1380,82,82,red blood cell,6724,1.0,1.0
49014,/images/df3d98b9-3dd7-4107-8d4a-ae1b7f247793.png,1076,60,1176,161,100,101,red blood cell,10100,1.01,0.9900990099009901
38032,/images/e3e9c2de-0a24-4c7e-8a69-3d3093d5bdab.png,670,1486,778,1584,108,98,red blood cell,10584,0.9074074074074074,1.1020408163265305
28920,/images/b12ae3b1-613c-4c0e-9163-3c5cc314abf5.png,480,830,593,945,113,115,red blood cell,12995,1.0176991150442478,0.9826086956521739
16083,/images/7e25ced3-5caf-47f8-ad0c-42946bd4468b.png,942,1097,1054,1226,112,129,red blood cell,14448,1.1517857142857142,0.8682170542635659
20867,/images/c2ec116f-f091-422c-926c-70b548a8f6ef.png,1061,1148,1167,1253,106,105,red blood cell,11130,0.9905660377358491,1.0095238095238095
67818,/images/04de3a31-fc09-40be-9c2c-9830c57f809d.png,347,523,461,650,114,127,red blood cell,14478,1.1140350877192982,0.8976377952755905
67251,/images/5f491efd-a21c-4a80-aaba-70b8876238ac.png,550,1182,637,1283,87,101,red blood cell,8787,1.160919540229885,0.8613861386138614
63122,/images/d82c657e-5678-41da-9a6e-3ad29430b759.png,343,786,457,898,114,112,red blood cell,12768,0.9824561403508771,1.0178571428571428
36161,/images/749df49e-5212-49ea-9e88-7d66f258f1df.png,872,287,990,402,118,115,red blood cell,13570,0.9745762711864406,1.0260869565217392
71864,/images/61575482-91e1-4db9-83c7-687b7ddbbfc4.png,691,864,801,981,110,117,red blood cell,12870,1.0636363636363637,0.9401709401709402
56865,/images/a588091c-5e4c-4e61-914d-e96f3ee3e505.png,530,1111,634,1209,104,98,red blood cell,10192,0.9423076923076923,1.0612244897959184
66503,/images/b87fb62d-2c36-4f68-aba9-37fcd7d46eef.png,295,1415,417,1527,122,112,red blood cell,13664,0.9180327868852459,1.0892857142857142
269,/images/0dcca702-a4ef-4fb3-a940-9c0c140b21c7.png,763,119,886,238,123,119,red blood cell,14637,0.967479674796748,1.0336134453781514
57764,/images/5c037ffc-f515-48b3-b231-c110fbd2b8ca.png,496,1468,587,1564,91,96,red blood cell,8736,1.054945054945055,0.9479166666666666
30737,/images/8e0dfc1f-e3eb-4a3f-a1c4-249bdfbfaa27.png,856,1131,967,1254,111,123,red blood cell,13653,1.1081081081081081,0.9024390243902439
5065,/images/b7f1a1eb-c150-4456-9c47-e7db8a5cb77a.png,927,229,1037,356,110,127,red blood cell,13970,1.1545454545454545,0.8661417322834646
16419,/images/e474a20b-2769-48f1-a520-4f6ef5a0dbf5.png,385,1076,489,1185,104,109,red blood cell,11336,1.0480769230769231,0.9541284403669725
72943,/images/a20d0b4b-6e2e-4507-bc22-f321dedc4ed9.png,802,540,879,628,77,88,red blood cell,6776,1.1428571428571428,0.875
32555,/images/318de807-7232-4ab1-843e-a901547c0125.png,897,586,1014,697,117,111,red blood cell,12987,0.9487179487179487,1.054054054054054
74691,/images/5ccca8ee-abea-458a-a891-bedd31c3ddc3.png,115,904,213,1012,98,108,red blood cell,10584,1.1020408163265305,0.9074074074074074
60454,/images/93b47b14-7f78-4b31-8897-d63a81fdab01.png,552,352,669,462,117,110,red blood cell,12870,0.9401709401709402,1.0636363636363637
40515,/images/e3ade58d-086c-47fa-9120-76beacb45395.png,956,632,1078,744,122,112,red blood cell,13664,0.9180327868852459,1.0892857142857142
66151,/images/191f87a4-6f2d-49e7-bba0-08e3aa78ddaf.png,462,1503,556,1598,94,95,red blood cell,8930,1.0106382978723405,0.9894736842105263
23134,/images/c94a5851-b846-4fde-8c89-05bec3a8ac53.png,640,1466,764,1580,124,114,red blood cell,14136,0.9193548387096774,1.087719298245614
40493,/images/e3ade58d-086c-47fa-9120-76beacb45395.png,275,296,386,410,111,114,red blood cell,12654,1.027027027027027,0.9736842105263158
18202,/images/947348fe-4c70-468e-8009-3c14daeca69b.png,238,293,350,395,112,102,red blood cell,11424,0.9107142857142857,1.0980392156862746
53500,/images/43158031-a335-4533-9c20-48bebba90123.png,105,957,196,1049,91,92,red blood cell,8372,1.010989010989011,0.9891304347826086
60929,/images/11b72c7b-5c52-44b7-adb7-21eacc25e441.png,449,1115,536,1206,87,91,red blood cell,7917,1.0459770114942528,0.9560439560439561
72043,/images/64b0e49a-0e48-447d-8872-c1dd255e7a21.png,639,935,743,1044,104,109,red blood cell,11336,1.0480769230769231,0.9541284403669725
53507,/images/43158031-a335-4533-9c20-48bebba90123.png,663,1033,745,1124,82,91,red blood cell,7462,1.1097560975609757,0.9010989010989011
51167,/images/d64cd75a-df26-44d5-ac25-69061a4e4d57.png,874,1358,964,1441,90,83,red blood cell,7470,0.9222222222222223,1.0843373493975903
25622,/images/770b8ca4-8377-479b-9ad5-5455ec3b44f8.png,1054,469,1168,565,114,96,red blood cell,10944,0.8421052631578947,1.1875
63505,/images/44b4a765-104e-4182-8871-e933c83c91ef.png,837,659,964,773,127,114,red blood cell,14478,0.8976377952755905,1.1140350877192982
13138,/images/711f6b3f-cd63-46d1-834a-bc8e9aa9b43e.png,83,705,196,829,113,124,red blood cell,14012,1.0973451327433628,0.9112903225806451
75448,/images/468c261d-f5d8-423f-883e-48af2bbbc5d1.png,817,615,893,701,76,86,red blood cell,6536,1.131578947368421,0.8837209302325582
6493,/images/640c4a52-3742-4f57-aee3-9e3dc0887622.png,747,994,850,1086,103,92,red blood cell,9476,0.8932038834951457,1.1195652173913044
61035,/images/3d1429ed-4619-41f7-8ff3-d698ad28034c.png,364,1267,465,1389,101,122,red blood cell,12322,1.2079207920792079,0.8278688524590164
31801,/images/63ed5931-d93e-4f9b-a6f3-152713cb560e.png,613,669,739,780,126,111,red blood cell,13986,0.8809523809523809,1.135135135135135
71452,/images/bcb447c9-5d37-414f-a513-d7076b04a532.png,37,1225,123,1310,86,85,red blood cell,7310,0.9883720930232558,1.011764705882353
29923,/images/f2a8a483-b254-43aa-817f-7d525adb8911.png,839,85,947,192,108,107,red blood cell,11556,0.9907407407407407,1.0093457943925233
79031,/images/6144887d-a1c1-46db-91a1-f7ff5bf8c8a5.png,649,1507,736,1594,87,87,red blood cell,7569,1.0,1.0
36138,/images/749df49e-5212-49ea-9e88-7d66f258f1df.png,981,1399,1102,1510,121,111,red blood cell,13431,0.9173553719008265,1.09009009009009
59526,/images/6bfe6a90-8a69-4171-8e7f-42dc9417c6d9.png,164,485,258,581,94,96,red blood cell,9024,1.0212765957446808,0.9791666666666666
34225,/images/4767bfcc-fe87-4962-8c40-6ce8d9363cdf.png,194,396,316,525,122,129,red blood cell,15738,1.0573770491803278,0.9457364341085271
43348,/images/36569710-a574-40be-ad42-897a6e74a128.png,533,349,625,454,92,105,red blood cell,9660,1.141304347826087,0.8761904761904762
2688,/images/a89cace5-c818-4f23-a432-052b3433b81e.png,1016,212,1117,301,101,89,red blood cell,8989,0.8811881188118812,1.1348314606741574
23809,/images/eeb06e39-482b-443d-8cf6-b9b5c763df78.png,319,1035,425,1145,106,110,red blood cell,11660,1.0377358490566038,0.9636363636363636
3424,/images/fd1302e2-3cd2-4a1a-9c13-00f810a9c41b.png,972,126,1075,248,103,122,red blood cell,12566,1.1844660194174756,0.8442622950819673
21132,/images/fb05b297-180a-4171-b633-09d5616d7534.png,174,408,280,509,106,101,red blood cell,10706,0.9528301886792453,1.0495049504950495
16131,/images/66557580-fd38-4d4b-80d8-88611ecc78c6.png,728,1088,856,1216,128,128,red blood cell,16384,1.0,1.0
66749,/images/334bf865-e3fb-4200-bd53-d9ff5808ed9f.png,66,1271,178,1378,112,107,red blood cell,11984,0.9553571428571429,1.0467289719626167
69641,/images/4a49841f-216c-4815-8140-b8762c4f6603.png,900,1369,999,1462,99,93,red blood cell,9207,0.9393939393939394,1.064516129032258
11737,/images/082e1f81-4f49-44ad-b5bb-9dfc155b2ed8.png,171,490,276,595,105,105,red blood cell,11025,1.0,1.0
15132,/images/3a8f468f-f9de-46a8-a7c8-f2be239fa207.png,613,613,709,715,96,102,red blood cell,9792,1.0625,0.9411764705882353
45221,/images/b7a0d235-2217-43b4-aeff-cde4ccaf6789.png,108,1193,239,1330,131,137,red blood cell,17947,1.0458015267175573,0.9562043795620438
62060,/images/7f528918-27d4-421f-ab57-0cf9c693e697.png,107,1138,224,1243,117,105,red blood cell,12285,0.8974358974358975,1.1142857142857143
4234,/images/ac3358f1-ef9a-4ccc-b66c-da5e47e352e0.png,638,1026,757,1150,119,124,red blood cell,14756,1.0420168067226891,0.9596774193548387
74395,/images/06a3effb-996c-4767-afd2-6aa3b697cb4e.png,788,692,878,790,90,98,red blood cell,8820,1.0888888888888888,0.9183673469387755
15960,/images/c7c1b873-0548-4a73-9618-f60912e164df.png,62,629,153,725,91,96,red blood cell,8736,1.054945054945055,0.9479166666666666
65510,/images/da49db57-0c2f-4213-b322-c88c19fb9296.png,857,402,963,513,106,111,red blood cell,11766,1.0471698113207548,0.954954954954955
30202,/images/a1669b59-fe09-4fe6-ba9f-06bec6725502.png,1024,59,1150,174,126,115,red blood cell,14490,0.9126984126984127,1.0956521739130434
21911,/images/d57b3894-c912-47e8-b00a-e1a2a7aba644.png,376,97,475,199,99,102,red blood cell,10098,1.0303030303030303,0.9705882352941176
54816,/images/b6364a57-72a9-43f3-8d02-9f53a992dc95.png,819,250,921,362,102,112,red blood cell,11424,1.0980392156862746,0.9107142857142857
27809,/images/e3c1442a-717f-41dd-bf97-81e1233ac9fa.png,199,2,299,96,100,94,red blood cell,9400,0.94,1.0638297872340425
17188,/images/471f75c6-bd5d-4c20-bcc1-258e836f4d69.png,1065,671,1189,788,124,117,red blood cell,14508,0.9435483870967742,1.0598290598290598
25916,/images/4811fdf2-d7e8-475e-a840-45dda5282bf3.png,1074,181,1184,293,110,112,red blood cell,12320,1.018181818181818,0.9821428571428571
66571,/images/087f2c9c-188d-43cc-a94c-0eb8f10ac092.png,115,932,212,1023,97,91,red blood cell,8827,0.9381443298969072,1.065934065934066
65674,/images/397f37bc-a3a4-4257-9430-c8fc5716f8b1.png,219,338,324,455,105,117,red blood cell,12285,1.1142857142857143,0.8974358974358975
9656,/images/d997337e-e4a8-4ef0-b8ba-975e6c43b62c.png,872,70,1001,195,129,125,red blood cell,16125,0.9689922480620154,1.032
39865,/images/af2e63a3-9fde-46aa-a867-81c5c259d1dc.png,608,1001,711,1098,103,97,red blood cell,9991,0.941747572815534,1.0618556701030928
44515,/images/b6573be3-9e04-49c3-9f48-6a145d065363.png,53,585,186,702,133,117,red blood cell,15561,0.8796992481203008,1.1367521367521367
80046,/images/38d1b930-dd97-4248-9160-e9389a1a8dd7.png,700,1057,846,1186,146,129,red blood cell,18834,0.8835616438356164,1.1317829457364341
1805,/images/5f783f43-0090-4f8a-bd75-9562f4aa2dd5.png,999,52,1104,156,105,104,red blood cell,10920,0.9904761904761905,1.0096153846153846
45143,/images/2596eb32-1323-41e9-8c0f-64819abcfc73.png,290,36,399,142,109,106,red blood cell,11554,0.9724770642201835,1.028301886792453
18920,/images/e9e78ff8-831b-46e9-9785-3eee9acbfcd8.png,705,803,799,904,94,101,red blood cell,9494,1.074468085106383,0.9306930693069307
53491,/images/43158031-a335-4533-9c20-48bebba90123.png,563,1145,662,1244,99,99,red blood cell,9801,1.0,1.0
78562,/images/c5084fb8-2b62-464c-8a77-1a07ea653266.png,123,604,249,729,126,125,red blood cell,15750,0.9920634920634921,1.008
28205,/images/c244166d-12ca-445f-9ed9-a13d9caa412f.png,538,1056,647,1176,109,120,red blood cell,13080,1.1009174311926606,0.9083333333333333
34546,/images/3af90874-59f3-4f0c-a7e6-cc889e80c605.png,746,623,874,748,128,125,red blood cell,16000,0.9765625,1.024
31529,/images/3130f950-8345-4315-9711-92f7af3f5c14.png,207,643,337,774,130,131,red blood cell,17030,1.0076923076923077,0.9923664122137404
5020,/images/b7d0ae11-a393-4aec-8f68-6ba07147f78a.png,141,915,270,1042,129,127,red blood cell,16383,0.9844961240310077,1.015748031496063
43336,/images/36569710-a574-40be-ad42-897a6e74a128.png,507,1500,603,1589,96,89,red blood cell,8544,0.9270833333333334,1.0786516853932584
43014,/images/6c7095cd-ab6b-4f53-bd94-905d0cc95840.png,357,408,485,533,128,125,red blood cell,16000,0.9765625,1.024
73078,/images/f39e2289-fedd-4d12-9e64-ffdafb89247e.png,518,1128,613,1225,95,97,red blood cell,9215,1.0210526315789474,0.979381443298969
42825,/images/7029feb3-9ffe-46e4-9883-6a9df84f7b62.png,887,330,1007,452,120,122,red blood cell,14640,1.0166666666666666,0.9836065573770492
38232,/images/1d9d4dac-66f9-4c87-b714-d723d5b15fa9.png,266,523,380,647,114,124,red blood cell,14136,1.087719298245614,0.9193548387096774
3642,/images/8bd71314-e38a-4670-bb25-5cd6c9acb595.png,512,679,618,781,106,102,red blood cell,10812,0.9622641509433962,1.0392156862745099
39607,/images/04d21589-b777-43c2-86b5-038cbf8c3a4e.png,1073,888,1192,1015,119,127,red blood cell,15113,1.0672268907563025,0.937007874015748
11594,/images/b4dc3088-3fe2-4688-be24-70664a64e022.png,597,686,725,801,128,115,red blood cell,14720,0.8984375,1.1130434782608696
35836,/images/027ab174-e47a-44f8-b85b-372449eeb7d8.png,619,1151,720,1257,101,106,red blood cell,10706,1.0495049504950495,0.9528301886792453
43467,/images/5a539312-6cfa-43e6-8d5d-db883f343ad9.png,384,947,493,1083,109,136,red blood cell,14824,1.2477064220183487,0.8014705882352942
74520,/images/cbb58718-6319-48db-b84b-78ac9b12ff89.png,99,1264,209,1387,110,123,red blood cell,13530,1.1181818181818182,0.8943089430894309
66658,/images/b88fe674-fb9a-41d4-b100-cb1c86440d44.png,375,1320,471,1415,96,95,red blood cell,9120,0.9895833333333334,1.0105263157894737
25870,/images/461a3ed6-039f-4a70-97cf-c474ecf51ccd.png,774,682,881,806,107,124,red blood cell,13268,1.158878504672897,0.8629032258064516
4885,/images/61cd8c7d-394d-42d3-9ed4-e09559110bed.png,554,1180,679,1287,125,107,red blood cell,13375,0.856,1.1682242990654206
78184,/images/2bed2796-75a9-4d93-bb2d-e3ccbe1a5cbe.png,323,1118,429,1219,106,101,red blood cell,10706,0.9528301886792453,1.0495049504950495
25386,/images/fbb1b44c-d75a-4550-a6c0-0eb62b96bfce.png,532,1,656,119,124,118,red blood cell,14632,0.9516129032258065,1.0508474576271187
27733,/images/e3c1442a-717f-41dd-bf97-81e1233ac9fa.png,188,1258,282,1365,94,107,red blood cell,10058,1.1382978723404256,0.8785046728971962
70801,/images/b62d47f9-2ff5-4902-abdc-b3610acfc7ba.png,658,858,746,951,88,93,red blood cell,8184,1.0568181818181819,0.946236559139785
32853,/images/2a6370b0-08f1-4c11-a639-265d4419c9a3.png,440,725,558,835,118,110,red blood cell,12980,0.9322033898305084,1.0727272727272728
61275,/images/b3058064-d817-47dd-a8c4-cdb1f62374f8.png,960,62,1060,167,100,105,red blood cell,10500,1.05,0.9523809523809523
38278,/images/b834cbf7-ff97-49d9-9561-566c9343735c.png,369,289,494,402,125,113,red blood cell,14125,0.904,1.1061946902654867
22321,/images/49b03a6e-6b26-4a96-a061-e05647a02138.png,111,1444,208,1542,97,98,red blood cell,9506,1.0103092783505154,0.9897959183673469
61616,/images/a3c0a876-be12-4ede-8aed-18b32a64401b.png,318,65,446,184,128,119,red blood cell,15232,0.9296875,1.0756302521008403
28807,/images/686ed568-d5f8-475e-81ad-edab9dd473a0.png,761,638,869,748,108,110,red blood cell,11880,1.0185185185185186,0.9818181818181818
55299,/images/4fb83278-adc5-4424-9f45-b6d0db2955b6.png,626,304,727,402,101,98,red blood cell,9898,0.9702970297029703,1.030612244897959
57305,/images/aaade430-4c49-4038-97b7-f8cdd937db57.png,710,1435,830,1547,120,112,red blood cell,13440,0.9333333333333333,1.0714285714285714
67626,/images/59542a24-b409-4c95-8608-d9691a741526.png,375,920,459,1016,84,96,red blood cell,8064,1.1428571428571428,0.875
14656,/images/9d155086-acf5-4c86-a9e1-94b587c46e87.png,83,599,175,693,92,94,red blood cell,8648,1.0217391304347827,0.9787234042553191
45333,/images/e4eea7ea-8989-46a9-9c98-25a178146b28.png,129,1051,235,1149,106,98,red blood cell,10388,0.9245283018867925,1.0816326530612246
68556,/images/32700bc7-7a86-49d3-aded-ccaaed4ddc5c.png,50,1445,184,1562,134,117,red blood cell,15678,0.8731343283582089,1.1452991452991452
36749,/images/aa2dfa24-2dc3-4279-a232-f84780ace190.png,453,1027,570,1142,117,115,red blood cell,13455,0.9829059829059829,1.017391304347826
10533,/images/46a2d369-4bea-4405-ac78-91bbe130b9a7.png,1072,1383,1168,1479,96,96,red blood cell,9216,1.0,1.0
61656,/images/a3c0a876-be12-4ede-8aed-18b32a64401b.png,420,1144,513,1236,93,92,red blood cell,8556,0.989247311827957,1.0108695652173914
77865,/images/6bc7b53c-5a98-48ef-a9de-59a476707ea4.png,618,1255,712,1352,94,97,red blood cell,9118,1.0319148936170213,0.9690721649484536
59423,/images/a7c3c52f-3b40-4c92-a212-df9462cf25d8.png,236,1105,334,1213,98,108,red blood cell,10584,1.1020408163265305,0.9074074074074074
74002,/images/99a21c5c-f5a7-4c07-9cb6-5dda2d388f48.png,826,806,934,924,108,118,red blood cell,12744,1.0925925925925926,0.9152542372881356
14733,/images/1fdf99d1-a494-4174-bcd7-efbe457ab899.png,422,848,536,975,114,127,red blood cell,14478,1.1140350877192982,0.8976377952755905
56009,/images/177a3141-fa93-426a-9b52-7da71547ce44.png,881,1279,996,1378,115,99,red blood cell,11385,0.8608695652173913,1.1616161616161615
33934,/images/1a332b2c-9d49-4ff2-810c-5633d2314527.png,452,258,550,375,98,117,red blood cell,11466,1.1938775510204083,0.8376068376068376
15400,/images/1b7f47fc-26cd-4273-b848-88a7cbfd9f85.png,351,789,456,883,105,94,red blood cell,9870,0.8952380952380953,1.1170212765957446
63659,/images/d9c9479e-f1ea-4d6e-861f-843ff9a90d19.png,593,1466,695,1564,102,98,red blood cell,9996,0.9607843137254902,1.0408163265306123
29652,/images/b85fc640-de49-4f7e-afc0-978ff020f2e2.png,34,13,158,119,124,106,red blood cell,13144,0.8548387096774194,1.169811320754717
32364,/images/a6526894-e290-482d-ac43-f1df34864817.png,526,857,640,984,114,127,red blood cell,14478,1.1140350877192982,0.8976377952755905
32200,/images/07346d2e-a6e6-4dc0-95f1-9f7d8d7e3f66.png,768,623,891,756,123,133,red blood cell,16359,1.08130081300813,0.924812030075188
31071,/images/9c48fdf4-621d-4f40-bcd7-6a28cd530de7.png,16,121,118,223,102,102,red blood cell,10404,1.0,1.0
55156,/images/29d4b75f-d400-4702-a9ac-e5a4ed1a1db1.png,266,290,375,387,109,97,red blood cell,10573,0.8899082568807339,1.1237113402061856
19928,/images/0ca25c88-457f-4f03-bbc1-98fb6663f1d1.png,874,206,1002,336,128,130,red blood cell,16640,1.015625,0.9846153846153847
14010,/images/eaf4b781-b3aa-41ce-8c5e-287979b4e15a.png,867,639,968,737,101,98,red blood cell,9898,0.9702970297029703,1.030612244897959
62284,/images/e0ff3476-226f-4125-b182-8e524d5503dd.png,163,598,253,707,90,109,red blood cell,9810,1.211111111111111,0.8256880733944955
73435,/images/58594235-0d32-4a4e-91cd-4c800eaaaa73.png,520,1214,628,1323,108,109,red blood cell,11772,1.0092592592592593,0.9908256880733946
311,/images/0dcca702-a4ef-4fb3-a940-9c0c140b21c7.png,642,479,762,582,120,103,red blood cell,12360,0.8583333333333333,1.1650485436893203
3651,/images/8bd71314-e38a-4670-bb25-5cd6c9acb595.png,199,25,332,134,133,109,red blood cell,14497,0.8195488721804511,1.2201834862385321
738,/images/dcc1a193-7b74-44f8-ad8d-813751d8fa6b.png,502,711,610,810,108,99,red blood cell,10692,0.9166666666666666,1.0909090909090908
28698,/images/151f3af5-5e6e-4bcd-9389-4974fc68813e.png,977,988,1082,1089,105,101,red blood cell,10605,0.9619047619047619,1.0396039603960396
73978,/images/99a21c5c-f5a7-4c07-9cb6-5dda2d388f48.png,119,852,228,969,109,117,red blood cell,12753,1.073394495412844,0.9316239316239316
30731,/images/8e0dfc1f-e3eb-4a3f-a1c4-249bdfbfaa27.png,33,805,155,928,122,123,red blood cell,15006,1.0081967213114753,0.991869918699187
56963,/images/a93c35ba-1690-4358-8837-669bcd850bb7.png,63,441,186,555,123,114,red blood cell,14022,0.926829268292683,1.0789473684210527
14576,/images/b8410821-a42b-47d0-8bcf-c2fc82e4e2d5.png,195,882,304,984,109,102,red blood cell,11118,0.9357798165137615,1.0686274509803921
15622,/images/84d7545e-c3a8-4b1f-9a39-36aab78c8699.png,417,695,530,801,113,106,red blood cell,11978,0.9380530973451328,1.0660377358490567
73175,/images/85546330-4efd-43e2-87aa-d53a30220bfc.png,407,1198,497,1304,90,106,red blood cell,9540,1.1777777777777778,0.8490566037735849
74220,/images/4e43fc22-dc08-4cde-b3ce-ce8a4f377c47.png,565,474,650,565,85,91,red blood cell,7735,1.0705882352941176,0.9340659340659341
76366,/images/3dad6483-ac30-4d2b-b045-9f24fe6ff75e.png,93,593,209,696,116,103,red blood cell,11948,0.8879310344827587,1.1262135922330097
76901,/images/25ddc1ca-d368-4fff-b1ad-1dbf1e7c97aa.png,715,834,818,942,103,108,red blood cell,11124,1.0485436893203883,0.9537037037037037
39505,/images/5a631871-2fc7-4a68-9c39-f3b9a0bf4a04.png,10,848,112,947,102,99,red blood cell,10098,0.9705882352941176,1.0303030303030303
7638,/images/21cc498b-8cb2-42ed-8f80-bfa27b86ef11.png,25,1118,154,1239,129,121,red blood cell,15609,0.937984496124031,1.0661157024793388
60975,/images/5397d8e2-bb09-42e7-9861-65ffad0fe94e.png,277,1143,395,1271,118,128,red blood cell,15104,1.0847457627118644,0.921875
26032,/images/612bdd3c-da43-4321-a76b-c73c614928d1.png,404,6,539,138,135,132,red blood cell,17820,0.9777777777777777,1.0227272727272727
49976,/images/05804cf0-f854-4099-97c2-df287f7c8a8c.png,325,1335,437,1445,112,110,red blood cell,12320,0.9821428571428571,1.018181818181818
69163,/images/de2b8835-552c-4f01-98b7-67bc4910062e.png,383,1407,475,1495,92,88,red blood cell,8096,0.9565217391304348,1.0454545454545454
43107,/images/340a1727-0df7-4e6f-9c0e-9c5deddbfca2.png,766,0,877,116,111,116,red blood cell,12876,1.045045045045045,0.9568965517241379
16436,/images/e474a20b-2769-48f1-a520-4f6ef5a0dbf5.png,687,1090,777,1189,90,99,red blood cell,8910,1.1,0.9090909090909091
9299,/images/261562a8-ffd8-4e0e-919b-22e267000b74.png,780,585,896,702,116,117,red blood cell,13572,1.0086206896551724,0.9914529914529915
38774,/images/b426ef1d-4a59-4f90-b593-50226af60a60.png,1089,165,1194,266,105,101,red blood cell,10605,0.9619047619047619,1.0396039603960396
15019,/images/3003252a-2d2e-4687-ad30-9c38d68f1394.png,387,937,505,1052,118,115,red blood cell,13570,0.9745762711864406,1.0260869565217392
12399,/images/3b55c42f-ad59-422f-ba99-4f4f4ca9cb2e.png,608,1500,700,1591,92,91,red blood cell,8372,0.9891304347826086,1.010989010989011
6923,/images/a9feccda-18f2-405e-9aa1-409fa1f49fe4.png,661,964,756,1057,95,93,red blood cell,8835,0.9789473684210527,1.021505376344086
77159,/images/fe691faa-3bc7-475e-b558-aa8fe7b795bc.png,387,1266,483,1375,96,109,red blood cell,10464,1.1354166666666667,0.8807339449541285
33073,/images/6231d81d-9e84-4a5a-8cb8-47c6a37a0176.png,890,228,999,327,109,99,red blood cell,10791,0.908256880733945,1.101010101010101
8389,/images/9a1cd456-310c-47b6-a1f8-0fbd8e33d1fd.png,427,1480,531,1600,104,120,red blood cell,12480,1.1538461538461537,0.8666666666666667
6796,/images/e36cb882-c6d0-4467-812e-d18c169a9a47.png,601,781,718,910,117,129,red blood cell,15093,1.1025641025641026,0.9069767441860465
9862,/images/3859deaf-6ae1-49a3-9051-898d0f0d7de6.png,361,1260,450,1367,89,107,red blood cell,9523,1.202247191011236,0.8317757009345794
9584,/images/239f17eb-a2e2-47e9-82e3-fa0d9a70fb9f.png,520,1252,651,1376,131,124,red blood cell,16244,0.9465648854961832,1.0564516129032258
36825,/images/dfac6c92-8f0f-429a-8caf-9b7732bf78da.png,840,1003,943,1102,103,99,red blood cell,10197,0.9611650485436893,1.0404040404040404
65398,/images/24418314-f7a4-49fc-a03e-ec597ca6796e.png,29,1344,113,1448,84,104,red blood cell,8736,1.2380952380952381,0.8076923076923077
14009,/images/eaf4b781-b3aa-41ce-8c5e-287979b4e15a.png,855,1255,965,1362,110,107,red blood cell,11770,0.9727272727272728,1.02803738317757
55498,/images/43072c64-4c08-47cd-ae8a-b74d31f80008.png,968,1230,1093,1339,125,109,red blood cell,13625,0.872,1.146788990825688
4751,/images/3fa1a4e3-c80d-49da-8f7b-a1abb0424f48.png,598,1435,703,1543,105,108,red blood cell,11340,1.0285714285714285,0.9722222222222222
23930,/images/3d8fb5bf-3315-48fb-8ab1-802eafd550bc.png,953,1440,1072,1543,119,103,red blood cell,12257,0.865546218487395,1.1553398058252426
47020,/images/9ebd623d-5534-4dd9-bff8-cdedf322db35.png,242,107,331,212,89,105,red blood cell,9345,1.1797752808988764,0.8476190476190476
19939,/images/0ca25c88-457f-4f03-bbc1-98fb6663f1d1.png,207,952,295,1058,88,106,red blood cell,9328,1.2045454545454546,0.8301886792452831
25196,/images/90171428-f208-428a-b40e-f57ee3bea457.png,1093,233,1196,323,103,90,red blood cell,9270,0.8737864077669902,1.1444444444444444
68089,/images/29d40b60-cde1-45b5-b403-692437a77ac1.png,408,679,528,785,120,106,red blood cell,12720,0.8833333333333333,1.1320754716981132
10006,/images/b9ccf7ca-953f-4832-9575-5e70b2a8c224.png,533,992,650,1114,117,122,red blood cell,14274,1.0427350427350428,0.9590163934426229
45975,/images/72088c26-d2dd-4906-b791-b8947fc7fbe4.png,431,339,535,448,104,109,red blood cell,11336,1.0480769230769231,0.9541284403669725
2237,/images/5bf91ff9-80df-49c0-9c3e-599357d95530.png,56,979,186,1106,130,127,red blood cell,16510,0.9769230769230769,1.0236220472440944
43061,/images/340a1727-0df7-4e6f-9c0e-9c5deddbfca2.png,923,852,1052,984,129,132,red blood cell,17028,1.0232558139534884,0.9772727272727273
73789,/images/3eba916c-998b-40a7-993c-7ed916c2a04c.png,850,127,971,229,121,102,red blood cell,12342,0.8429752066115702,1.1862745098039216
3644,/images/8bd71314-e38a-4670-bb25-5cd6c9acb595.png,568,136,681,263,113,127,red blood cell,14351,1.1238938053097345,0.889763779527559
65840,/images/daea4860-a296-4f6d-acef-996ab0882676.png,576,162,679,252,103,90,red blood cell,9270,0.8737864077669902,1.1444444444444444
74388,/images/06a3effb-996c-4767-afd2-6aa3b697cb4e.png,1074,1254,1159,1347,85,93,red blood cell,7905,1.0941176470588236,0.9139784946236559
21688,/images/81af1442-d835-46bf-b80b-a898dba3da1b.png,989,33,1111,152,122,119,red blood cell,14518,0.9754098360655737,1.0252100840336134
49188,/images/a9daf82a-a46d-4296-bd72-2c374ed0a193.png,270,1248,368,1353,98,105,red blood cell,10290,1.0714285714285714,0.9333333333333333
78608,/images/c5084fb8-2b62-464c-8a77-1a07ea653266.png,3,932,124,1037,121,105,red blood cell,12705,0.8677685950413223,1.1523809523809523
13454,/images/370277f8-436b-4103-8210-b4feb5ab95ea.png,313,891,413,989,100,98,red blood cell,9800,0.98,1.0204081632653061
73381,/images/c890ee00-daa5-4b20-9cd5-930748ecc4e0.png,312,527,413,613,101,86,red blood cell,8686,0.8514851485148515,1.1744186046511629
63246,/images/d3283f5b-3b3a-40ea-800b-79960ca851cb.png,217,1286,324,1414,107,128,red blood cell,13696,1.1962616822429906,0.8359375
72235,/images/7d4d0646-26b5-46fa-ab25-452d986e887b.png,768,1421,858,1514,90,93,red blood cell,8370,1.0333333333333334,0.967741935483871
31260,/images/db7c5ec1-fefe-4e9d-83c1-da8fb982f1e2.png,432,1296,553,1397,121,101,red blood cell,12221,0.8347107438016529,1.198019801980198
61044,/images/6e86206f-dafe-4c28-bacc-7b83b2d40f0c.png,488,99,597,200,109,101,red blood cell,11009,0.926605504587156,1.0792079207920793
33725,/images/441d7843-b20b-4c10-84e3-e6d32621e880.png,85,827,191,912,106,85,red blood cell,9010,0.8018867924528302,1.2470588235294118
72366,/images/ee57e743-a876-4f69-9fe5-bf5d01b44689.png,1081,1506,1166,1598,85,92,red blood cell,7820,1.0823529411764705,0.9239130434782609
58568,/images/7fd2d254-b062-4f3d-8970-687e73c5a00a.png,673,39,785,171,112,132,red blood cell,14784,1.1785714285714286,0.8484848484848485
27737,/images/e3c1442a-717f-41dd-bf97-81e1233ac9fa.png,821,826,920,923,99,97,red blood cell,9603,0.9797979797979798,1.0206185567010309
25921,/images/4811fdf2-d7e8-475e-a840-45dda5282bf3.png,120,405,227,525,107,120,red blood cell,12840,1.1214953271028036,0.8916666666666667
66715,/images/334bf865-e3fb-4200-bd53-d9ff5808ed9f.png,591,979,689,1074,98,95,red blood cell,9310,0.9693877551020408,1.0315789473684212
4001,/images/a5e05ba8-0c19-41e3-92d5-10e42a03b85e.png,315,1387,421,1488,106,101,red blood cell,10706,0.9528301886792453,1.0495049504950495
9204,/images/6e7ed596-1b76-4998-8147-a846d53d91c5.png,534,1385,667,1512,133,127,red blood cell,16891,0.9548872180451128,1.047244094488189
70749,/images/8ab5c462-045e-4b59-b53a-9b2bc3ed2487.png,518,576,609,664,91,88,red blood cell,8008,0.967032967032967,1.0340909090909092
61448,/images/7e837856-3519-4dc0-b357-4cdcfd30b4eb.png,502,498,600,602,98,104,red blood cell,10192,1.0612244897959184,0.9423076923076923
36563,/images/21f001d6-f568-4ea4-82da-fab54c77c419.png,706,1497,816,1586,110,89,red blood cell,9790,0.8090909090909091,1.2359550561797752
77701,/images/07d15855-eb9b-46a9-b894-7cfe4d097826.png,426,138,495,224,69,86,red blood cell,5934,1.2463768115942029,0.8023255813953488
8400,/images/ae779806-6d01-4dc6-89df-294c368db6bc.png,17,381,139,505,122,124,red blood cell,15128,1.0163934426229508,0.9838709677419355
39379,/images/fbcb2ef0-3c97-4d7a-8b96-0147c73f3941.png,996,754,1100,862,104,108,red blood cell,11232,1.0384615384615385,0.9629629629629629
37131,/images/d6942996-5664-4370-ad87-2bdcbd49ac16.png,470,747,583,867,113,120,red blood cell,13560,1.0619469026548674,0.9416666666666667
45310,/images/9e793460-d94c-47ac-b3a7-0d6ad86357da.png,185,1485,263,1576,78,91,red blood cell,7098,1.1666666666666667,0.8571428571428571
60876,/images/11b72c7b-5c52-44b7-adb7-21eacc25e441.png,515,994,623,1097,108,103,red blood cell,11124,0.9537037037037037,1.0485436893203883
15841,/images/c7c1b873-0548-4a73-9618-f60912e164df.png,587,1431,670,1524,83,93,red blood cell,7719,1.1204819277108433,0.8924731182795699
26064,/images/71925778-a26e-483e-a07c-f3aaf740122a.png,163,503,298,622,135,119,red blood cell,16065,0.8814814814814815,1.134453781512605
1207,/images/5ff7c0c8-d208-4e7d-958d-ca3c2260ff39.png,926,1043,1049,1161,123,118,red blood cell,14514,0.959349593495935,1.0423728813559323
73408,/images/58594235-0d32-4a4e-91cd-4c800eaaaa73.png,465,1116,575,1221,110,105,red blood cell,11550,0.9545454545454546,1.0476190476190477
36639,/images/21f001d6-f568-4ea4-82da-fab54c77c419.png,832,1141,930,1248,98,107,red blood cell,10486,1.0918367346938775,0.9158878504672897
50190,/images/4cccfcf0-cac9-46f0-870c-0eabfdc781ba.png,453,1078,546,1191,93,113,red blood cell,10509,1.2150537634408602,0.8230088495575221
70805,/images/b62d47f9-2ff5-4902-abdc-b3610acfc7ba.png,759,568,864,691,105,123,red blood cell,12915,1.1714285714285715,0.8536585365853658
57576,/images/8190ec37-9a5e-419f-89ed-fbfb079370db.png,1061,788,1174,892,113,104,red blood cell,11752,0.9203539823008849,1.0865384615384615
45309,/images/9e793460-d94c-47ac-b3a7-0d6ad86357da.png,233,1215,362,1325,129,110,red blood cell,14190,0.8527131782945736,1.1727272727272726
40850,/images/bf20d04d-ff8a-4910-91d7-94054c267d1b.png,845,924,964,1043,119,119,red blood cell,14161,1.0,1.0
20660,/images/d09eed76-e09b-4d90-b8f0-5a801beae41c.png,28,1272,146,1371,118,99,red blood cell,11682,0.8389830508474576,1.1919191919191918
20500,/images/cbde7f7e-2458-4dda-9db2-3d5ccf950ced.png,128,448,247,571,119,123,red blood cell,14637,1.0336134453781514,0.967479674796748
63736,/images/06401963-8b02-46c5-ab2a-3d70bd01623f.png,374,1125,467,1224,93,99,red blood cell,9207,1.064516129032258,0.9393939393939394
43204,/images/fe1ee954-ba71-47b3-954a-d20ab940cd7b.png,92,471,212,592,120,121,red blood cell,14520,1.0083333333333333,0.9917355371900827
19967,/images/8e69098c-fae0-47a3-8833-c2bfdfb1a416.png,983,1279,1101,1399,118,120,red blood cell,14160,1.0169491525423728,0.9833333333333333
19547,/images/2c1eaf87-3fd3-4803-92b8-23bab40bf28c.png,30,196,158,319,128,123,red blood cell,15744,0.9609375,1.0406504065040652
57224,/images/ca5e6a15-ba65-48ea-8913-2d986e71bf3a.png,91,690,193,782,102,92,red blood cell,9384,0.9019607843137255,1.108695652173913
52362,/images/a2a20600-f851-4db7-90f9-6f7be027c8b5.png,1076,1324,1158,1411,82,87,red blood cell,7134,1.0609756097560976,0.9425287356321839
54772,/images/10891eed-b0f2-4dd0-90cb-da185f6761b2.png,384,620,489,741,105,121,red blood cell,12705,1.1523809523809523,0.8677685950413223
14602,/images/c649e1cb-4029-4433-b231-d67d68f7391a.png,144,644,238,748,94,104,red blood cell,9776,1.1063829787234043,0.9038461538461539
35219,/images/a9159b11-ba49-4885-902e-00c8d5095b98.png,699,105,815,225,116,120,red blood cell,13920,1.0344827586206897,0.9666666666666667
5067,/images/b7f1a1eb-c150-4456-9c47-e7db8a5cb77a.png,951,854,1072,976,121,122,red blood cell,14762,1.0082644628099173,0.9918032786885246
79200,/images/eb0173a3-7e5e-4f53-8124-03d9d6317844.png,1071,287,1165,382,94,95,red blood cell,8930,1.0106382978723405,0.9894736842105263
21043,/images/c680004e-6ee2-43d7-877c-edc9b5ebeecc.png,39,223,172,334,133,111,red blood cell,14763,0.8345864661654135,1.1981981981981982
51260,/images/216f9d43-6869-4ba1-9106-4f5ea6aac223.png,359,97,451,203,92,106,red blood cell,9752,1.1521739130434783,0.8679245283018868
72088,/images/64b0e49a-0e48-447d-8872-c1dd255e7a21.png,301,335,384,428,83,93,red blood cell,7719,1.1204819277108433,0.8924731182795699
3461,/images/ad36bd67-594b-4f63-93e3-886af0bc618e.png,361,1161,480,1280,119,119,red blood cell,14161,1.0,1.0
22332,/images/49b03a6e-6b26-4a96-a061-e05647a02138.png,39,571,120,665,81,94,red blood cell,7614,1.1604938271604939,0.8617021276595744
78165,/images/2bed2796-75a9-4d93-bb2d-e3ccbe1a5cbe.png,766,498,870,599,104,101,red blood cell,10504,0.9711538461538461,1.0297029702970297
56362,/images/4372709c-f356-4906-be17-415384d916e8.png,338,808,453,900,115,92,red blood cell,10580,0.8,1.25
25493,/images/f6ab936d-924b-4038-aa47-71b07c26b4e2.png,365,721,447,816,82,95,red blood cell,7790,1.1585365853658536,0.8631578947368421
27863,/images/948c94ad-395c-41f4-9a68-8a1dcb76888c.png,391,268,483,376,92,108,red blood cell,9936,1.173913043478261,0.8518518518518519
25098,/images/9e74feb8-017d-4d53-8896-9ebda4327dd1.png,942,136,1051,236,109,100,red blood cell,10900,0.9174311926605505,1.09
36216,/images/17c06a23-bb77-49cb-9ffb-fbfc75fcc715.png,1028,700,1147,810,119,110,red blood cell,13090,0.9243697478991597,1.0818181818181818
28833,/images/686ed568-d5f8-475e-81ad-edab9dd473a0.png,516,522,607,622,91,100,red blood cell,9100,1.098901098901099,0.91
26521,/images/b2f05937-b965-4c4b-b86e-f50e95d9d691.png,589,486,724,614,135,128,red blood cell,17280,0.9481481481481482,1.0546875
77297,/images/07a80340-f65e-4f58-9317-94bb6ebd5a28.png,904,75,998,154,94,79,red blood cell,7426,0.8404255319148937,1.1898734177215189
45553,/images/e597f7ce-46c6-4dce-9063-50a2703fdd45.png,415,181,510,272,95,91,red blood cell,8645,0.9578947368421052,1.043956043956044
68707,/images/77e76e62-2c71-4b52-9b21-0d1bcde9f9bf.png,546,170,662,301,116,131,red blood cell,15196,1.1293103448275863,0.8854961832061069
21609,/images/66183740-e1e5-43c9-8539-a87028bb3621.png,650,940,743,1037,93,97,red blood cell,9021,1.043010752688172,0.9587628865979382
63303,/images/43bc935a-f655-45e1-a64d-fcb8b78267a6.png,680,278,776,386,96,108,red blood cell,10368,1.125,0.8888888888888888
54112,/images/d9345456-b76d-46cc-b81e-46d4a0a7b652.png,692,1064,766,1146,74,82,red blood cell,6068,1.1081081081081081,0.9024390243902439
53004,/images/42e87148-a015-4148-923a-fb83016f64e7.png,389,110,480,212,91,102,red blood cell,9282,1.120879120879121,0.8921568627450981
57059,/images/9e82c996-2cfa-418d-9482-8ee23e9d0a5d.png,79,1295,191,1395,112,100,red blood cell,11200,0.8928571428571429,1.12
77113,/images/dd6f047e-af73-43df-9c46-354534fc20e0.png,114,485,224,612,110,127,red blood cell,13970,1.1545454545454545,0.8661417322834646
45685,/images/584d62ed-4329-45dd-94ce-e929d8b2bb74.png,740,382,837,475,97,93,red blood cell,9021,0.9587628865979382,1.043010752688172
42876,/images/a7b6894d-eeea-4ed5-bc0e-785d6c6da8df.png,625,835,747,965,122,130,red blood cell,15860,1.0655737704918034,0.9384615384615385
67110,/images/4272cbd7-5b0a-4bf7-b690-dee1c128f07b.png,161,1390,243,1473,82,83,red blood cell,6806,1.0121951219512195,0.9879518072289156
30707,/images/8e0dfc1f-e3eb-4a3f-a1c4-249bdfbfaa27.png,702,1039,816,1150,114,111,red blood cell,12654,0.9736842105263158,1.027027027027027
72677,/images/6ab870ba-b24b-49a9-9570-8eafe63aa74e.png,899,1347,995,1432,96,85,red blood cell,8160,0.8854166666666666,1.1294117647058823
52435,/images/a2a20600-f851-4db7-90f9-6f7be027c8b5.png,467,446,533,526,66,80,red blood cell,5280,1.2121212121212122,0.825
76853,/images/2165fe38-b474-467d-be11-d1d728085efd.png,1040,1113,1151,1218,111,105,red blood cell,11655,0.9459459459459459,1.0571428571428572
18122,/images/947348fe-4c70-468e-8009-3c14daeca69b.png,272,1481,391,1584,119,103,red blood cell,12257,0.865546218487395,1.1553398058252426
10084,/images/d1617cf7-eb56-42ee-85af-66c4748753c0.png,377,963,500,1081,123,118,red blood cell,14514,0.959349593495935,1.0423728813559323
54651,/images/6473ddb6-ad56-48a2-81e8-c7cb45f06825.png,552,843,653,955,101,112,red blood cell,11312,1.108910891089109,0.9017857142857143
62732,/images/9e1b0217-0926-4fd1-bb9e-a815c05deb59.png,452,152,538,251,86,99,red blood cell,8514,1.1511627906976745,0.8686868686868687
47656,/images/4b3a49bc-8536-4760-9553-440a6f64db37.png,459,758,569,864,110,106,red blood cell,11660,0.9636363636363636,1.0377358490566038
20487,/images/b809b407-7b69-4334-873d-d6c49135f04a.png,896,693,1010,812,114,119,red blood cell,13566,1.043859649122807,0.957983193277311
71379,/images/bcb447c9-5d37-414f-a513-d7076b04a532.png,643,185,735,284,92,99,red blood cell,9108,1.076086956521739,0.9292929292929293
76906,/images/25ddc1ca-d368-4fff-b1ad-1dbf1e7c97aa.png,930,272,1038,387,108,115,red blood cell,12420,1.0648148148148149,0.9391304347826087
18791,/images/cc882eae-a341-4783-bd19-8bdedf798538.png,150,1123,256,1215,106,92,red blood cell,9752,0.8679245283018868,1.1521739130434783
16440,/images/e474a20b-2769-48f1-a520-4f6ef5a0dbf5.png,237,1291,333,1394,96,103,red blood cell,9888,1.0729166666666667,0.9320388349514563
8483,/images/e234ce8b-4ec4-4d93-9068-d7854d77ddf4.png,614,1438,745,1555,131,117,red blood cell,15327,0.8931297709923665,1.1196581196581197
77522,/images/2d2e81f3-e329-4765-9ba1-2c95f12dc9f3.png,133,1270,235,1375,102,105,red blood cell,10710,1.0294117647058822,0.9714285714285714
983,/images/a8cb75ba-3f2f-40d8-8bc7-c79ebd1b9603.png,806,1065,924,1192,118,127,red blood cell,14986,1.076271186440678,0.9291338582677166
69339,/images/2ac343e4-c889-47c1-8fe2-461b626def76.png,846,1275,952,1399,106,124,red blood cell,13144,1.169811320754717,0.8548387096774194
11073,/images/85a4d82e-cfb7-4983-b272-626c9e8c7583.png,603,513,722,630,119,117,red blood cell,13923,0.9831932773109243,1.017094017094017
16025,/images/7e25ced3-5caf-47f8-ad0c-42946bd4468b.png,316,952,431,1065,115,113,red blood cell,12995,0.9826086956521739,1.0176991150442478
35025,/images/67582df6-bf13-4c83-a531-1214692b70de.png,401,651,512,760,111,109,red blood cell,12099,0.9819819819819819,1.018348623853211
63222,/images/d3283f5b-3b3a-40ea-800b-79960ca851cb.png,603,355,722,477,119,122,red blood cell,14518,1.0252100840336134,0.9754098360655737
32360,/images/a6526894-e290-482d-ac43-f1df34864817.png,176,383,294,504,118,121,red blood cell,14278,1.0254237288135593,0.9752066115702479
37020,/images/b2e34f5f-904e-4473-9dc7-c6bc1ce12640.png,249,169,348,275,99,106,red blood cell,10494,1.0707070707070707,0.9339622641509434
28365,/images/34e024a5-5698-42d4-972f-fee234b4bd64.png,519,93,632,197,113,104,red blood cell,11752,0.9203539823008849,1.0865384615384615
55616,/images/c32b8bb8-c89d-4ae9-9c77-5b9356ca35a1.png,976,470,1066,571,90,101,red blood cell,9090,1.1222222222222222,0.8910891089108911
23080,/images/be5bb7d0-7c3f-4bb9-8bb4-f8bc8d875943.png,443,123,569,249,126,126,red blood cell,15876,1.0,1.0
10992,/images/c442e2d6-aaf9-417a-9905-4737a1115f33.png,921,463,1039,581,118,118,red blood cell,13924,1.0,1.0
49140,/images/df3d98b9-3dd7-4107-8d4a-ae1b7f247793.png,1017,905,1104,996,87,91,red blood cell,7917,1.0459770114942528,0.9560439560439561
35218,/images/a9159b11-ba49-4885-902e-00c8d5095b98.png,1008,1003,1102,1107,94,104,red blood cell,9776,1.1063829787234043,0.9038461538461539
52052,/images/de6d3020-9347-473b-9146-8909627790f6.png,426,1250,545,1354,119,104,red blood cell,12376,0.8739495798319328,1.1442307692307692
33181,/images/6231d81d-9e84-4a5a-8cb8-47c6a37a0176.png,907,1316,987,1406,80,90,red blood cell,7200,1.125,0.8888888888888888
72512,/images/22516db4-8687-4051-90c4-2bb1ca3204a5.png,773,268,868,362,95,94,red blood cell,8930,0.9894736842105263,1.0106382978723405
58828,/images/434523fd-d4d9-4961-a7c2-d71d6ae68e13.png,71,642,166,746,95,104,red blood cell,9880,1.0947368421052632,0.9134615384615384
31324,/images/31c749e8-18d1-4105-b7e6-8319cceddae0.png,948,1038,1063,1160,115,122,red blood cell,14030,1.0608695652173914,0.9426229508196722
2695,/images/a89cace5-c818-4f23-a432-052b3433b81e.png,650,634,750,737,100,103,red blood cell,10300,1.03,0.970873786407767
58157,/images/d615b706-8f50-4d96-8de5-6858897528d0.png,638,746,747,853,109,107,red blood cell,11663,0.981651376146789,1.0186915887850467
43584,/images/e0ef520d-7b65-485d-9888-e6859f189f70.png,184,1481,306,1599,122,118,red blood cell,14396,0.9672131147540983,1.0338983050847457
46688,/images/da111ca5-520f-4ea8-97ad-ae5fce58ee91.png,935,928,1031,1020,96,92,red blood cell,8832,0.9583333333333334,1.0434782608695652
72542,/images/01b99da8-b66b-464b-a7ee-1cadab8db18b.png,377,584,469,686,92,102,red blood cell,9384,1.108695652173913,0.9019607843137255
49858,/images/5e17f8e6-fd8d-426c-b444-1515d14f04b7.png,988,519,1083,597,95,78,red blood cell,7410,0.8210526315789474,1.2179487179487178
33747,/images/441d7843-b20b-4c10-84e3-e6d32621e880.png,884,11,996,110,112,99,red blood cell,11088,0.8839285714285714,1.1313131313131313
16269,/images/d5009906-bce1-4353-90b4-f4c79362f4cf.png,454,728,574,859,120,131,red blood cell,15720,1.0916666666666666,0.916030534351145
62766,/images/e1937e32-85d5-4cd8-bb4a-b9cf8ee7ceeb.png,1025,1456,1111,1550,86,94,red blood cell,8084,1.0930232558139534,0.9148936170212766
66996,/images/3b4440f7-a69b-4042-a9d0-d6958abcdf4e.png,663,636,764,741,101,105,red blood cell,10605,1.0396039603960396,0.9619047619047619
31872,/images/f62d4fb6-df7c-446c-94a8-d5aede0b1e0c.png,633,413,766,520,133,107,red blood cell,14231,0.8045112781954887,1.2429906542056075
37548,/images/205306da-0ed8-475a-ace6-f2f81d4be88a.png,218,849,323,952,105,103,red blood cell,10815,0.9809523809523809,1.0194174757281553
61480,/images/7e837856-3519-4dc0-b357-4cdcfd30b4eb.png,658,882,743,986,85,104,red blood cell,8840,1.223529411764706,0.8173076923076923
72488,/images/22516db4-8687-4051-90c4-2bb1ca3204a5.png,241,651,357,776,116,125,red blood cell,14500,1.0775862068965518,0.928
26326,/images/580210c2-a8ed-4720-b71c-a77945968abc.png,699,323,813,439,114,116,red blood cell,13224,1.0175438596491229,0.9827586206896551
73400,/images/c890ee00-daa5-4b20-9cd5-930748ecc4e0.png,3,1061,94,1163,91,102,red blood cell,9282,1.120879120879121,0.8921568627450981
19047,/images/6e39fb0a-aa41-4b16-b783-7589e97bf289.png,624,692,751,810,127,118,red blood cell,14986,0.9291338582677166,1.076271186440678
17369,/images/04018590-4e66-4cb9-ad2d-83570f1b29ae.png,334,1195,440,1310,106,115,red blood cell,12190,1.0849056603773586,0.9217391304347826
36814,/images/dfac6c92-8f0f-429a-8caf-9b7732bf78da.png,1063,1244,1182,1372,119,128,red blood cell,15232,1.0756302521008403,0.9296875
49353,/images/28c96a4a-4549-4761-99e4-ace4ea7e7ac9.png,20,775,145,897,125,122,red blood cell,15250,0.976,1.0245901639344261
13392,/images/a7f1bbb1-6058-4642-bd66-cfb90dce762e.png,701,1069,824,1187,123,118,red blood cell,14514,0.959349593495935,1.0423728813559323
30242,/images/f81806a8-5883-446c-be78-f0145b12dbdd.png,330,412,443,545,113,133,red blood cell,15029,1.176991150442478,0.849624060150376
54278,/images/3b5a8060-dec6-4a83-b7f2-b604e4e69dfc.png,565,830,681,949,116,119,red blood cell,13804,1.0258620689655173,0.9747899159663865
50116,/images/e98baeb2-aa58-4cce-8c61-66685dd2b239.png,96,516,219,662,123,146,red blood cell,17958,1.1869918699186992,0.8424657534246576
10537,/images/46a2d369-4bea-4405-ac78-91bbe130b9a7.png,556,528,638,610,82,82,red blood cell,6724,1.0,1.0
21072,/images/c680004e-6ee2-43d7-877c-edc9b5ebeecc.png,805,27,897,131,92,104,red blood cell,9568,1.1304347826086956,0.8846153846153846
37049,/images/b2e34f5f-904e-4473-9dc7-c6bc1ce12640.png,1015,786,1104,882,89,96,red blood cell,8544,1.0786516853932584,0.9270833333333334
61356,/images/e16c0dab-780d-4035-872e-1bb91e49f9d2.png,461,632,562,726,101,94,red blood cell,9494,0.9306930693069307,1.074468085106383
74535,/images/cbb58718-6319-48db-b84b-78ac9b12ff89.png,9,1120,110,1219,101,99,red blood cell,9999,0.9801980198019802,1.02020202020202
24470,/images/b78ba2c8-ecb3-45b2-9cda-2c8088fa95d1.png,934,398,1048,517,114,119,red blood cell,13566,1.043859649122807,0.957983193277311
17139,/images/dc3bdfe9-1565-4cda-9c4e-0979846dab60.png,1086,1069,1196,1186,110,117,red blood cell,12870,1.0636363636363637,0.9401709401709402
25402,/images/5f742392-278d-461c-a848-08def2c28878.png,903,1079,1008,1187,105,108,red blood cell,11340,1.0285714285714285,0.9722222222222222
16311,/images/d5009906-bce1-4353-90b4-f4c79362f4cf.png,913,571,1018,686,105,115,red blood cell,12075,1.0952380952380953,0.9130434782608695
46856,/images/63055d1b-5221-4c80-8b39-37ac069a1b5c.png,700,1159,813,1268,113,109,red blood cell,12317,0.9646017699115044,1.036697247706422
21162,/images/fb05b297-180a-4171-b633-09d5616d7534.png,543,17,666,153,123,136,red blood cell,16728,1.1056910569105691,0.9044117647058824
15699,/images/3892b776-f49a-4368-b0fa-7e855e76ccec.png,89,1136,174,1220,85,84,red blood cell,7140,0.9882352941176471,1.0119047619047619
25135,/images/9e74feb8-017d-4d53-8896-9ebda4327dd1.png,1047,1238,1159,1355,112,117,red blood cell,13104,1.0446428571428572,0.9572649572649573
27524,/images/f5869ba8-6253-426b-93f3-82af59a86144.png,60,859,190,987,130,128,red blood cell,16640,0.9846153846153847,1.015625
25509,/images/f6ab936d-924b-4038-aa47-71b07c26b4e2.png,590,101,711,230,121,129,red blood cell,15609,1.0661157024793388,0.937984496124031
46957,/images/9e0e1928-d19a-4100-b093-0b962ac09e05.png,582,1499,685,1585,103,86,red blood cell,8858,0.8349514563106796,1.197674418604651
40996,/images/bbe65c18-8a56-4dfe-875c-94e124a84125.png,454,747,595,866,141,119,red blood cell,16779,0.8439716312056738,1.184873949579832
58461,/images/5cac6ddf-c8c6-45de-bce0-a1db64b14fb5.png,326,852,431,956,105,104,red blood cell,10920,0.9904761904761905,1.0096153846153846
32951,/images/d1924af6-7512-4ccc-9c6b-adbbaa8db41f.png,373,923,477,1030,104,107,red blood cell,11128,1.0288461538461537,0.9719626168224299
11267,/images/6303f964-98ef-47c6-bb2d-283aa393f918.png,240,512,332,612,92,100,red blood cell,9200,1.0869565217391304,0.92
28079,/images/f1f9df6d-c4cb-4b42-9ca2-8fb47b1b0e91.png,259,1074,368,1186,109,112,red blood cell,12208,1.0275229357798166,0.9732142857142857
21182,/images/fb05b297-180a-4171-b633-09d5616d7534.png,88,706,171,794,83,88,red blood cell,7304,1.0602409638554218,0.9431818181818182
5527,/images/eb6e8684-b84e-483d-b835-f59286d2516b.png,612,634,721,748,109,114,red blood cell,12426,1.0458715596330275,0.956140350877193
36225,/images/c3209548-7f7c-4afd-b47c-b42a72b1ebf7.png,1037,550,1162,667,125,117,red blood cell,14625,0.936,1.0683760683760684
33984,/images/701206c5-aaac-4b99-9cc0-4a6854359457.png,691,1243,820,1360,129,117,red blood cell,15093,0.9069767441860465,1.1025641025641026
31283,/images/db7c5ec1-fefe-4e9d-83c1-da8fb982f1e2.png,830,302,937,411,107,109,red blood cell,11663,1.0186915887850467,0.981651376146789
30290,/images/cecbf663-0751-4e7f-b298-770c88afc2c1.png,1002,1340,1135,1477,133,137,red blood cell,18221,1.0300751879699248,0.9708029197080292
18332,/images/9ca20b10-e2fd-4bd2-93ef-78298f763ed5.png,719,126,828,242,109,116,red blood cell,12644,1.0642201834862386,0.9396551724137931
59970,/images/f0fe292d-85ae-4c3a-a676-037dde2594e6.png,22,218,141,345,119,127,red blood cell,15113,1.0672268907563025,0.937007874015748
71348,/images/bcb447c9-5d37-414f-a513-d7076b04a532.png,121,21,222,123,101,102,red blood cell,10302,1.00990099009901,0.9901960784313726
40052,/images/6fd30823-3b77-40c9-ba5d-e1eda9660674.png,19,679,144,800,125,121,red blood cell,15125,0.968,1.0330578512396693
31153,/images/1976cd04-d24f-457c-b423-7e4cdb05de9e.png,166,229,285,353,119,124,red blood cell,14756,1.0420168067226891,0.9596774193548387
35442,/images/002f20ad-2ace-499c-9335-c9080bc3e6b5.png,97,843,217,945,120,102,red blood cell,12240,0.85,1.1764705882352942
78630,/images/3612aa3b-2906-44a6-9c80-6144511a35ce.png,516,1073,649,1207,133,134,red blood cell,17822,1.0075187969924813,0.9925373134328358
62026,/images/bdb5d571-27bc-4a42-ae45-aa5a9af40a81.png,785,1141,878,1239,93,98,red blood cell,9114,1.053763440860215,0.9489795918367347
38354,/images/674b0fd3-f247-4b7f-97f7-3e6c57c9ba9e.png,736,1285,825,1394,89,109,red blood cell,9701,1.2247191011235956,0.8165137614678899
47737,/images/afbb264e-ff60-443a-83f5-49d09be1b835.png,752,1386,876,1492,124,106,red blood cell,13144,0.8548387096774194,1.169811320754717
70658,/images/7521ec48-57b5-48a8-a5d6-8280ad5da19c.png,102,667,205,788,103,121,red blood cell,12463,1.174757281553398,0.8512396694214877
33421,/images/244ac6fa-8a92-4214-9cf4-ae0811d9ec7e.png,412,351,509,458,97,107,red blood cell,10379,1.1030927835051547,0.9065420560747663
68456,/images/040112be-3c8d-49aa-93f1-522f94a592ff.png,815,978,907,1077,92,99,red blood cell,9108,1.076086956521739,0.9292929292929293
15553,/images/169d541c-daed-468e-8b41-0f1abccdf319.png,914,808,1029,908,115,100,red blood cell,11500,0.8695652173913043,1.15
23409,/images/8757be1e-b832-407a-8e95-62abae485b24.png,947,1162,1061,1304,114,142,red blood cell,16188,1.2456140350877194,0.8028169014084507
54160,/images/c415532c-4cce-4580-9fcd-623c172a1abd.png,18,1211,102,1305,84,94,red blood cell,7896,1.119047619047619,0.8936170212765957
27027,/images/ec301f62-1302-4407-96f9-fcfe45c150ae.png,932,364,1048,466,116,102,red blood cell,11832,0.8793103448275862,1.1372549019607843
11661,/images/0ed416f9-7c20-4829-9016-559e4009568e.png,254,641,371,760,117,119,red blood cell,13923,1.017094017094017,0.9831932773109243
44352,/images/415409ac-97b3-4cd9-b203-11ef00662352.png,882,502,1016,619,134,117,red blood cell,15678,0.8731343283582089,1.1452991452991452
12419,/images/cc94eabb-a3dc-4cfc-9fff-55c76b5b4a71.png,505,1114,610,1221,105,107,red blood cell,11235,1.019047619047619,0.9813084112149533
75350,/images/9ec1dcec-87c2-4aca-8e6b-0db3cd05509c.png,271,1178,366,1256,95,78,red blood cell,7410,0.8210526315789474,1.2179487179487178
68872,/images/6347dd6a-cfdf-4cb5-bc50-cff5403cfecb.png,954,780,1073,893,119,113,red blood cell,13447,0.9495798319327731,1.0530973451327434
61836,/images/5f300fd1-7eec-41ac-bbd1-0f4a943c757c.png,635,900,737,1015,102,115,red blood cell,11730,1.1274509803921569,0.8869565217391304
75583,/images/c35ee701-fde2-46b5-b178-1fe3f1ea7da2.png,522,801,633,904,111,103,red blood cell,11433,0.9279279279279279,1.0776699029126213
40699,/images/252071ac-e9f2-41d2-abbb-87ef01b8a997.png,12,1481,104,1579,92,98,red blood cell,9016,1.065217391304348,0.9387755102040817
43423,/images/367663b2-5d09-4020-ab0a-c2200e7a1c8c.png,941,816,1047,927,106,111,red blood cell,11766,1.0471698113207548,0.954954954954955
30478,/images/5955289d-19e5-45ef-a012-c8ea08ef45e2.png,612,1236,730,1350,118,114,red blood cell,13452,0.9661016949152542,1.0350877192982457
38656,/images/b5acf759-1115-42f0-a753-656736192528.png,973,1124,1095,1251,122,127,red blood cell,15494,1.040983606557377,0.9606299212598425
39570,/images/5a631871-2fc7-4a68-9c39-f3b9a0bf4a04.png,635,146,744,269,109,123,red blood cell,13407,1.128440366972477,0.8861788617886179
16866,/images/4823c1fe-a7f9-4b92-959f-0d9be09cd14b.png,1028,933,1120,1031,92,98,red blood cell,9016,1.065217391304348,0.9387755102040817
5083,/images/b7f1a1eb-c150-4456-9c47-e7db8a5cb77a.png,1090,1459,1200,1584,110,125,red blood cell,13750,1.1363636363636365,0.88
52140,/images/94d9fa50-d3e4-4eaf-acfc-92e7f2ed9ea5.png,993,191,1099,307,106,116,red blood cell,12296,1.0943396226415094,0.9137931034482759
68306,/images/0f735cca-051c-4048-a1fa-cb36f389e12f.png,307,548,420,661,113,113,red blood cell,12769,1.0,1.0
53306,/images/d8f7e159-b7e3-49e4-86e8-aed8c5fbcd97.png,974,1148,1063,1243,89,95,red blood cell,8455,1.0674157303370786,0.9368421052631579
40022,/images/8a4aadac-cf5c-4a79-b875-271b3fbfd230.png,58,1168,158,1289,100,121,red blood cell,12100,1.21,0.8264462809917356
7347,/images/89f10192-d3dd-4996-a571-4c851dbdc983.png,912,1124,1013,1223,101,99,red blood cell,9999,0.9801980198019802,1.02020202020202
37590,/images/205306da-0ed8-475a-ace6-f2f81d4be88a.png,869,784,953,869,84,85,red blood cell,7140,1.0119047619047619,0.9882352941176471
61833,/images/5f300fd1-7eec-41ac-bbd1-0f4a943c757c.png,259,1449,369,1571,110,122,red blood cell,13420,1.1090909090909091,0.9016393442622951
3457,/images/ad36bd67-594b-4f63-93e3-886af0bc618e.png,68,538,177,649,109,111,red blood cell,12099,1.018348623853211,0.9819819819819819
42159,/images/04c07425-57c7-415c-a0bc-36857bbd4049.png,780,1401,898,1528,118,127,red blood cell,14986,1.076271186440678,0.9291338582677166
77757,/images/4849866a-73a2-4fcf-a407-2d0a25a09a89.png,888,1460,977,1561,89,101,red blood cell,8989,1.1348314606741574,0.8811881188118812
9740,/images/3859deaf-6ae1-49a3-9051-898d0f0d7de6.png,820,862,907,961,87,99,red blood cell,8613,1.1379310344827587,0.8787878787878788
48987,/images/df3d98b9-3dd7-4107-8d4a-ae1b7f247793.png,435,46,535,154,100,108,red blood cell,10800,1.08,0.9259259259259259
42662,/images/3abbc4d3-1d7e-40c9-9963-33732da7cc50.png,498,911,609,1020,111,109,red blood cell,12099,0.9819819819819819,1.018348623853211
53320,/images/d8f7e159-b7e3-49e4-86e8-aed8c5fbcd97.png,686,656,782,757,96,101,red blood cell,9696,1.0520833333333333,0.9504950495049505
51692,/images/592c941a-aa54-4971-b499-dc47356f80a3.png,902,372,1004,470,102,98,red blood cell,9996,0.9607843137254902,1.0408163265306123
44676,/images/8002cb71-0f25-4fa4-a46f-b49e5aeded0c.png,802,1124,914,1219,112,95,red blood cell,10640,0.8482142857142857,1.1789473684210525
5978,/images/97eff653-3908-4e66-931f-eab36bc336c8.png,885,72,1019,199,134,127,red blood cell,17018,0.9477611940298507,1.0551181102362204
35924,/images/f8242b97-b8d5-48b5-b808-0b0f75a5de97.png,773,184,882,279,109,95,red blood cell,10355,0.8715596330275229,1.1473684210526316
56582,/images/a824b499-3736-4581-bbdc-be1b3b4cf756.png,533,1110,650,1233,117,123,red blood cell,14391,1.0512820512820513,0.9512195121951219
55484,/images/43072c64-4c08-47cd-ae8a-b74d31f80008.png,365,1329,469,1423,104,94,red blood cell,9776,0.9038461538461539,1.1063829787234043
39118,/images/7bde7de1-889b-4218-b0e1-e2c04f6a7986.png,168,207,262,301,94,94,red blood cell,8836,1.0,1.0
7418,/images/76dbce7f-dc3e-4a29-b1fe-ab9dce583080.png,533,1459,647,1582,114,123,red blood cell,14022,1.0789473684210527,0.926829268292683
16310,/images/d5009906-bce1-4353-90b4-f4c79362f4cf.png,732,1471,855,1597,123,126,red blood cell,15498,1.024390243902439,0.9761904761904762
37935,/images/56a57a8d-c9b9-432a-a3b0-32a09355806c.png,841,569,937,674,96,105,red blood cell,10080,1.09375,0.9142857142857143
30219,/images/f81806a8-5883-446c-be78-f0145b12dbdd.png,489,531,617,641,128,110,red blood cell,14080,0.859375,1.1636363636363636
51516,/images/6afb3717-f197-4668-929a-4fab389ae6e8.png,47,147,177,271,130,124,red blood cell,16120,0.9538461538461539,1.0483870967741935
30761,/images/8e0dfc1f-e3eb-4a3f-a1c4-249bdfbfaa27.png,785,1272,915,1398,130,126,red blood cell,16380,0.9692307692307692,1.0317460317460319
51469,/images/baa87bf8-786c-444c-81e8-9fa0a41d8149.png,773,1428,892,1544,119,116,red blood cell,13804,0.9747899159663865,1.0258620689655173
68113,/images/5dec94a3-e3ca-4a58-9702-88e5a83ef612.png,1019,1043,1134,1138,115,95,red blood cell,10925,0.8260869565217391,1.2105263157894737
25038,/images/ed0bee2f-05e0-4392-8357-19750cec577c.png,443,1124,530,1204,87,80,red blood cell,6960,0.9195402298850575,1.0875
51898,/images/d67398c5-8b0e-463f-a04e-8583c820786c.png,193,284,273,378,80,94,red blood cell,7520,1.175,0.851063829787234
23896,/images/c17523c5-90a0-4a6b-9b33-2b4a6cf58d36.png,442,1177,553,1289,111,112,red blood cell,12432,1.009009009009009,0.9910714285714286
43118,/images/c5db0fc0-b96c-496e-90b4-f9fb1b85b28e.png,748,493,872,602,124,109,red blood cell,13516,0.8790322580645161,1.1376146788990826
19045,/images/6e39fb0a-aa41-4b16-b783-7589e97bf289.png,725,1002,827,1124,102,122,red blood cell,12444,1.196078431372549,0.8360655737704918
41256,/images/eed298b3-35f2-4127-88ad-0c4a9062207b.png,1091,314,1189,435,98,121,red blood cell,11858,1.2346938775510203,0.8099173553719008
77937,/images/c691c8ef-d3c7-47b6-a941-f6a1089f21a9.png,842,1236,937,1327,95,91,red blood cell,8645,0.9578947368421052,1.043956043956044
27337,/images/9f38055f-4fe6-47fd-a6dd-c0743db4eccf.png,279,1076,391,1189,112,113,red blood cell,12656,1.0089285714285714,0.9911504424778761
24158,/images/1d4cdf2e-79a0-41e9-aabe-e437a190dfc4.png,404,1369,525,1481,121,112,red blood cell,13552,0.9256198347107438,1.0803571428571428
8922,/images/04628a94-b674-469b-aff6-b476b70df87d.png,151,1415,250,1534,99,119,red blood cell,11781,1.202020202020202,0.8319327731092437
50663,/images/c956e531-6805-4fe1-b61c-8b96a9815a77.png,219,1450,318,1566,99,116,red blood cell,11484,1.1717171717171717,0.853448275862069
36861,/images/3de03fa2-3ad3-43fc-8435-b2a80bdd7550.png,175,98,272,193,97,95,red blood cell,9215,0.979381443298969,1.0210526315789474
28858,/images/686ed568-d5f8-475e-81ad-edab9dd473a0.png,192,1023,300,1123,108,100,red blood cell,10800,0.9259259259259259,1.08
22853,/images/95d5e689-c1d1-4ae8-a659-cc20c62a99f0.png,604,47,720,159,116,112,red blood cell,12992,0.9655172413793104,1.0357142857142858
38592,/images/f8b14fc4-dd6b-4ad0-a96d-c62845f48681.png,535,1247,658,1370,123,123,red blood cell,15129,1.0,1.0
44853,/images/83ec8923-6232-40d7-ba1f-a1b8bf7cb66c.png,686,984,775,1079,89,95,red blood cell,8455,1.0674157303370786,0.9368421052631579
44407,/images/edd3862f-04e1-49cf-97dd-ca566d17e71a.png,795,394,918,514,123,120,red blood cell,14760,0.975609756097561,1.025
24520,/images/109fbb82-bc3c-41ac-984d-e2da86202873.png,537,164,651,297,114,133,red blood cell,15162,1.1666666666666667,0.8571428571428571
27050,/images/ec301f62-1302-4407-96f9-fcfe45c150ae.png,618,1197,741,1319,123,122,red blood cell,15006,0.991869918699187,1.0081967213114753
54686,/images/6473ddb6-ad56-48a2-81e8-c7cb45f06825.png,326,1482,422,1569,96,87,red blood cell,8352,0.90625,1.103448275862069
46002,/images/72088c26-d2dd-4906-b791-b8947fc7fbe4.png,862,837,951,932,89,95,red blood cell,8455,1.0674157303370786,0.9368421052631579
19432,/images/5487faad-24a7-46b6-92d8-479d3a8d229f.png,121,1488,215,1582,94,94,red blood cell,8836,1.0,1.0
59725,/images/f77d7469-d083-4c2d-a4ea-5a9ff162e3e2.png,440,446,535,542,95,96,red blood cell,9120,1.0105263157894737,0.9895833333333334
34240,/images/259da25f-40f3-4d37-bca9-a9c807af1547.png,642,908,756,1034,114,126,red blood cell,14364,1.105263157894737,0.9047619047619048
41514,/images/2f3ebec8-ef64-420d-9aa0-c2fcadc27d74.png,732,404,839,510,107,106,red blood cell,11342,0.9906542056074766,1.009433962264151
68593,/images/31653d0f-c4e6-4e12-8005-518c2de34687.png,870,997,968,1100,98,103,red blood cell,10094,1.0510204081632653,0.9514563106796117
63700,/images/06401963-8b02-46c5-ab2a-3d70bd01623f.png,1068,655,1178,761,110,106,red blood cell,11660,0.9636363636363636,1.0377358490566038
22901,/images/be779f52-0bfa-4c01-a16f-b7f0bc92ed7c.png,1072,28,1174,118,102,90,red blood cell,9180,0.8823529411764706,1.1333333333333333
58527,/images/5cac6ddf-c8c6-45de-bce0-a1db64b14fb5.png,422,1243,530,1339,108,96,red blood cell,10368,0.8888888888888888,1.125
42189,/images/04c07425-57c7-415c-a0bc-36857bbd4049.png,1064,573,1197,690,133,117,red blood cell,15561,0.8796992481203008,1.1367521367521367
35348,/images/452482bc-24a3-413e-ba03-fad4c9d61f3c.png,295,734,401,831,106,97,red blood cell,10282,0.9150943396226415,1.092783505154639
29510,/images/8cc6fe77-5f2f-4670-b4ac-1b49550241a8.png,495,1427,605,1547,110,120,red blood cell,13200,1.0909090909090908,0.9166666666666666
66150,/images/191f87a4-6f2d-49e7-bba0-08e3aa78ddaf.png,952,66,1043,159,91,93,red blood cell,8463,1.021978021978022,0.978494623655914
13462,/images/370277f8-436b-4103-8210-b4feb5ab95ea.png,369,1317,462,1424,93,107,red blood cell,9951,1.1505376344086022,0.8691588785046729
76759,/images/2165fe38-b474-467d-be11-d1d728085efd.png,278,726,385,832,107,106,red blood cell,11342,0.9906542056074766,1.009433962264151
1599,/images/7094c11a-1e62-4f98-894e-d17d138a88e9.png,489,1383,605,1506,116,123,red blood cell,14268,1.0603448275862069,0.943089430894309
4974,/images/2cc3c4ad-670f-41b6-8910-0704cbc192ef.png,421,303,524,400,103,97,red blood cell,9991,0.941747572815534,1.0618556701030928
69578,/images/4a49841f-216c-4815-8140-b8762c4f6603.png,86,398,200,509,114,111,red blood cell,12654,0.9736842105263158,1.027027027027027
73244,/images/67a4fb91-6f38-4ca2-8f20-6b2f5f1b29a7.png,1069,886,1176,993,107,107,red blood cell,11449,1.0,1.0
72701,/images/6ab870ba-b24b-49a9-9570-8eafe63aa74e.png,1091,626,1195,742,104,116,red blood cell,12064,1.1153846153846154,0.896551724137931
50123,/images/e98baeb2-aa58-4cce-8c61-66685dd2b239.png,875,1263,978,1383,103,120,red blood cell,12360,1.1650485436893203,0.8583333333333333
16656,/images/bc377041-e098-45c4-9651-2b1ea90d1d7e.png,327,804,449,940,122,136,red blood cell,16592,1.1147540983606556,0.8970588235294118
17076,/images/883b726a-f61c-4382-9f1b-2fff302beba6.png,321,961,427,1058,106,97,red blood cell,10282,0.9150943396226415,1.092783505154639
35830,/images/bb2042c5-35e1-43cc-8171-7de81b764361.png,1004,432,1092,533,88,101,red blood cell,8888,1.1477272727272727,0.8712871287128713
51829,/images/f07174a5-f799-4286-ac43-5b0f5c5777ac.png,710,209,798,301,88,92,red blood cell,8096,1.0454545454545454,0.9565217391304348
44751,/images/ccb4b13d-ab20-4222-892f-5adf70249aaa.png,158,86,275,216,117,130,red blood cell,15210,1.1111111111111112,0.9
34372,/images/1a48cbc1-5423-47e5-8ca5-2ab4f83a05a5.png,592,93,694,216,102,123,red blood cell,12546,1.2058823529411764,0.8292682926829268
11096,/images/98175327-da9e-4e0c-8912-ee68490a4672.png,775,1437,886,1539,111,102,red blood cell,11322,0.918918918918919,1.088235294117647
78607,/images/c5084fb8-2b62-464c-8a77-1a07ea653266.png,705,380,824,481,119,101,red blood cell,12019,0.8487394957983193,1.1782178217821782
58061,/images/a7c91b63-b97c-4f4b-8d34-7ad2b08d7a17.png,427,1178,517,1271,90,93,red blood cell,8370,1.0333333333333334,0.967741935483871
63838,/images/6013bff0-dc4b-4bde-9409-0f6139c3495c.png,934,1128,1044,1231,110,103,red blood cell,11330,0.9363636363636364,1.0679611650485437
47866,/images/ab27173b-6e30-4957-bd68-29194328fd39.png,479,280,587,397,108,117,red blood cell,12636,1.0833333333333333,0.9230769230769231
5192,/images/16a51468-9f93-45df-9ae2-5a74c25c5a4b.png,920,1387,1012,1484,92,97,red blood cell,8924,1.0543478260869565,0.9484536082474226
45249,/images/b7a0d235-2217-43b4-aeff-cde4ccaf6789.png,746,600,858,709,112,109,red blood cell,12208,0.9732142857142857,1.0275229357798166
44181,/images/8b494b40-cab5-49d3-893d-c805000fbe88.png,412,613,533,720,121,107,red blood cell,12947,0.8842975206611571,1.1308411214953271
27893,/images/948c94ad-395c-41f4-9a68-8a1dcb76888c.png,233,1430,347,1548,114,118,red blood cell,13452,1.0350877192982457,0.9661016949152542
65588,/images/01b38a56-13eb-447b-89ee-fc21cb40dcc1.png,759,31,868,136,109,105,red blood cell,11445,0.963302752293578,1.0380952380952382
22496,/images/dd60b6a7-c545-45b9-8250-d1633aa1ac75.png,171,380,276,503,105,123,red blood cell,12915,1.1714285714285715,0.8536585365853658
12821,/images/b634137b-bc8b-4e88-b0e3-b536ad6e7e18.png,0,151,109,268,109,117,red blood cell,12753,1.073394495412844,0.9316239316239316
65276,/images/45ac9409-5537-44ed-90cd-5c8a1ae0e1e0.png,329,1186,442,1297,113,111,red blood cell,12543,0.9823008849557522,1.018018018018018
10526,/images/46a2d369-4bea-4405-ac78-91bbe130b9a7.png,263,754,357,850,94,96,red blood cell,9024,1.0212765957446808,0.9791666666666666
59863,/images/1519257c-e3e5-4474-908f-8665b3cf1258.png,88,15,188,122,100,107,red blood cell,10700,1.07,0.9345794392523364
75004,/images/9147a21d-0de2-4c04-88da-b788311696ac.png,625,237,744,353,119,116,red blood cell,13804,0.9747899159663865,1.0258620689655173
60286,/images/7abc0d26-dd66-4ef4-8c4e-4a661e589a7f.png,765,408,866,504,101,96,red blood cell,9696,0.9504950495049505,1.0520833333333333
64954,/images/dec61ae1-5037-4c3a-8952-15371becca7d.png,628,1142,713,1231,85,89,red blood cell,7565,1.0470588235294118,0.9550561797752809
40478,/images/db249e5a-4142-432c-8288-bacd10d7273d.png,573,962,654,1063,81,101,red blood cell,8181,1.2469135802469136,0.801980198019802
58115,/images/e9916e11-9be6-4dec-9df6-2e7d1a8e1735.png,360,133,465,242,105,109,red blood cell,11445,1.0380952380952382,0.963302752293578
45892,/images/939ad732-d7c5-4339-b087-4335b49d6a3c.png,382,1183,487,1304,105,121,red blood cell,12705,1.1523809523809523,0.8677685950413223
20826,/images/c2ec116f-f091-422c-926c-70b548a8f6ef.png,513,1003,608,1106,95,103,red blood cell,9785,1.0842105263157895,0.9223300970873787
28584,/images/dbdfad64-110c-421f-a1c7-f68fd9e82d67.png,306,1471,439,1591,133,120,red blood cell,15960,0.9022556390977443,1.1083333333333334
68189,/images/ff1b23d0-3cef-459b-b81f-39bfcdb6526f.png,892,121,997,231,105,110,red blood cell,11550,1.0476190476190477,0.9545454545454546
49238,/images/989d86a1-6d76-4089-85cf-2f2ca0a8456c.png,905,710,1018,835,113,125,red blood cell,14125,1.1061946902654867,0.904
30851,/images/fbc1f360-4382-48bb-a32e-3f5f2f9dbe57.png,457,103,555,214,98,111,red blood cell,10878,1.1326530612244898,0.8828828828828829
28963,/images/b12ae3b1-613c-4c0e-9163-3c5cc314abf5.png,469,1090,581,1194,112,104,red blood cell,11648,0.9285714285714286,1.0769230769230769
79891,/images/a054a8e2-55f2-4508-97df-207f76b89be2.png,423,150,533,254,110,104,red blood cell,11440,0.9454545454545454,1.0576923076923077
3416,/images/fd1302e2-3cd2-4a1a-9c13-00f810a9c41b.png,179,544,293,648,114,104,red blood cell,11856,0.9122807017543859,1.0961538461538463
30322,/images/cecbf663-0751-4e7f-b298-770c88afc2c1.png,945,575,1054,680,109,105,red blood cell,11445,0.963302752293578,1.0380952380952382
78628,/images/3612aa3b-2906-44a6-9c80-6144511a35ce.png,331,465,427,567,96,102,red blood cell,9792,1.0625,0.9411764705882353
49938,/images/05804cf0-f854-4099-97c2-df287f7c8a8c.png,842,1451,960,1574,118,123,red blood cell,14514,1.0423728813559323,0.959349593495935
40645,/images/252071ac-e9f2-41d2-abbb-87ef01b8a997.png,680,282,758,374,78,92,red blood cell,7176,1.1794871794871795,0.8478260869565217
12304,/images/3b55c42f-ad59-422f-ba99-4f4f4ca9cb2e.png,801,270,896,374,95,104,red blood cell,9880,1.0947368421052632,0.9134615384615384
14269,/images/6382976c-ee87-4916-b798-4ef1373b2df0.png,941,1129,1045,1222,104,93,red blood cell,9672,0.8942307692307693,1.118279569892473
14399,/images/f5eb7c5e-bd77-4638-ba9f-58d42f87476b.png,396,318,514,439,118,121,red blood cell,14278,1.0254237288135593,0.9752066115702479
21585,/images/49efc89d-9cba-44f7-8257-7f911b73f68a.png,326,1267,428,1370,102,103,red blood cell,10506,1.0098039215686274,0.9902912621359223
21300,/images/8dace03a-10c4-4d59-bcd9-a2c314c5df33.png,166,854,276,984,110,130,red blood cell,14300,1.1818181818181819,0.8461538461538461
72690,/images/6ab870ba-b24b-49a9-9570-8eafe63aa74e.png,160,978,258,1070,98,92,red blood cell,9016,0.9387755102040817,1.065217391304348
28287,/images/ffd59802-46c6-4b58-80fe-e534e39781a7.png,619,1317,732,1426,113,109,red blood cell,12317,0.9646017699115044,1.036697247706422
74970,/images/b4c52960-bbee-439e-83dc-f89ddaade71b.png,935,1339,1040,1454,105,115,red blood cell,12075,1.0952380952380953,0.9130434782608695
4402,/images/84041bf9-dace-4066-9fe0-52170d08f826.png,1016,96,1110,190,94,94,red blood cell,8836,1.0,1.0
36539,/images/21f001d6-f568-4ea4-82da-fab54c77c419.png,704,1137,818,1246,114,109,red blood cell,12426,0.956140350877193,1.0458715596330275
5366,/images/716273ea-19c4-49af-8604-df587b295eca.png,457,1451,585,1580,128,129,red blood cell,16512,1.0078125,0.9922480620155039
74241,/images/4e43fc22-dc08-4cde-b3ce-ce8a4f377c47.png,946,673,1031,771,85,98,red blood cell,8330,1.1529411764705881,0.8673469387755102
20411,/images/781d4bea-c6a9-4b36-ae10-ba9e328c87fe.png,356,695,460,819,104,124,red blood cell,12896,1.1923076923076923,0.8387096774193549
15567,/images/169d541c-daed-468e-8b41-0f1abccdf319.png,858,1425,956,1543,98,118,red blood cell,11564,1.2040816326530612,0.8305084745762712
60612,/images/724e0c34-32cd-41f1-ae37-586038bc67ab.png,608,1376,707,1472,99,96,red blood cell,9504,0.9696969696969697,1.03125
14639,/images/9d155086-acf5-4c86-a9e1-94b587c46e87.png,522,145,651,264,129,119,red blood cell,15351,0.9224806201550387,1.084033613445378
2767,/images/a89cace5-c818-4f23-a432-052b3433b81e.png,2,1198,109,1315,107,117,red blood cell,12519,1.0934579439252337,0.9145299145299145
60329,/images/1c87b997-a8e6-48ca-bf40-19b9a7fd6a96.png,66,454,185,561,119,107,red blood cell,12733,0.8991596638655462,1.1121495327102804
23141,/images/c94a5851-b846-4fde-8c89-05bec3a8ac53.png,1067,118,1194,239,127,121,red blood cell,15367,0.952755905511811,1.0495867768595042
33524,/images/795d0331-da56-4d45-a58a-54803408ffd9.png,736,513,852,624,116,111,red blood cell,12876,0.9568965517241379,1.045045045045045
40743,/images/252071ac-e9f2-41d2-abbb-87ef01b8a997.png,293,560,411,656,118,96,red blood cell,11328,0.8135593220338984,1.2291666666666667
54437,/images/22a464ef-c3da-4d56-b37e-e22e95d945e7.png,621,366,705,460,84,94,red blood cell,7896,1.119047619047619,0.8936170212765957
79704,/images/03b9d6ad-39ca-4097-a98b-77f02b3c00a7.png,590,317,687,416,97,99,red blood cell,9603,1.0206185567010309,0.9797979797979798
24603,/images/c03d9b87-e19b-402b-ad86-b30d6e8aeb59.png,860,509,971,622,111,113,red blood cell,12543,1.018018018018018,0.9823008849557522
66795,/images/334bf865-e3fb-4200-bd53-d9ff5808ed9f.png,267,492,342,578,75,86,red blood cell,6450,1.1466666666666667,0.872093023255814
42608,/images/184b376b-03cb-4c2d-af51-fc1a62196293.png,148,169,248,273,100,104,red blood cell,10400,1.04,0.9615384615384616
1382,/images/6d91d1f0-636b-4f5a-a526-7c17fc857190.png,368,1461,457,1543,89,82,red blood cell,7298,0.9213483146067416,1.0853658536585367
71786,/images/093a831a-bf71-4333-bc06-942ae70cb164.png,290,78,407,190,117,112,red blood cell,13104,0.9572649572649573,1.0446428571428572
45240,/images/b7a0d235-2217-43b4-aeff-cde4ccaf6789.png,813,121,922,235,109,114,red blood cell,12426,1.0458715596330275,0.956140350877193
10546,/images/9fbf38ab-44b9-4096-a818-603017a4300e.png,802,1048,948,1182,146,134,red blood cell,19564,0.9178082191780822,1.0895522388059702
69247,/images/f274b784-b995-4a7e-a2c2-6cc31c24c4b4.png,709,592,807,707,98,115,red blood cell,11270,1.1734693877551021,0.8521739130434782
33615,/images/00c8364b-8c85-4502-bcfe-64736fe76815.png,427,654,533,770,106,116,red blood cell,12296,1.0943396226415094,0.9137931034482759
3945,/images/f09acb0c-b270-4e91-99f8-410adfa7f34a.png,1061,1361,1150,1461,89,100,red blood cell,8900,1.1235955056179776,0.89
24647,/images/30948737-0d0d-4b68-b9ab-50577e0fe026.png,76,984,200,1091,124,107,red blood cell,13268,0.8629032258064516,1.158878504672897
50595,/images/e98ea067-82b5-4a0d-87bf-b4bbdc10ddab.png,404,1115,494,1221,90,106,red blood cell,9540,1.1777777777777778,0.8490566037735849
77270,/images/07a80340-f65e-4f58-9317-94bb6ebd5a28.png,852,920,945,1015,93,95,red blood cell,8835,1.021505376344086,0.9789473684210527
35906,/images/33068c1a-48f7-470b-8e49-e2f0888042e9.png,615,1205,743,1337,128,132,red blood cell,16896,1.03125,0.9696969696969697
72982,/images/2bd26501-2fbc-4c1a-bef0-4ad57e02b4d0.png,583,165,686,267,103,102,red blood cell,10506,0.9902912621359223,1.0098039215686274
32258,/images/f4722a74-35e7-42bd-8ef6-dfff04b9cd22.png,336,631,442,744,106,113,red blood cell,11978,1.0660377358490567,0.9380530973451328
43988,/images/de81bf7a-7a56-437f-a068-4d9c3e01134c.png,828,1071,938,1164,110,93,red blood cell,10230,0.8454545454545455,1.1827956989247312
78313,/images/24115f58-a7d6-4022-a95a-86b515a78d3e.png,761,1243,863,1356,102,113,red blood cell,11526,1.107843137254902,0.9026548672566371
62610,/images/f7a4334a-4332-4de8-b39b-22da907976f2.png,845,890,954,993,109,103,red blood cell,11227,0.944954128440367,1.058252427184466
61007,/images/3d1429ed-4619-41f7-8ff3-d698ad28034c.png,737,1232,853,1329,116,97,red blood cell,11252,0.8362068965517241,1.1958762886597938
54847,/images/b6364a57-72a9-43f3-8d02-9f53a992dc95.png,305,1303,390,1394,85,91,red blood cell,7735,1.0705882352941176,0.9340659340659341
13647,/images/1e86933d-6a5a-4a3c-a0f2-ca22afd767b3.png,997,50,1100,165,103,115,red blood cell,11845,1.116504854368932,0.8956521739130435
68800,/images/aa3ad405-828e-4986-8251-20fd981f34d3.png,1014,318,1122,433,108,115,red blood cell,12420,1.0648148148148149,0.9391304347826087
38090,/images/907650b5-edae-471d-bc54-a825be3d3fac.png,869,1168,986,1292,117,124,red blood cell,14508,1.0598290598290598,0.9435483870967742
75518,/images/fa4f8d1a-cb3a-4722-a566-6c7072f30606.png,902,1472,1009,1577,107,105,red blood cell,11235,0.9813084112149533,1.019047619047619
78310,/images/24115f58-a7d6-4022-a95a-86b515a78d3e.png,198,592,286,686,88,94,red blood cell,8272,1.0681818181818181,0.9361702127659575
72642,/images/a63ce82f-f3d1-4818-9035-d3d230e5f686.png,285,113,379,194,94,81,red blood cell,7614,0.8617021276595744,1.1604938271604939
45557,/images/e597f7ce-46c6-4dce-9063-50a2703fdd45.png,902,739,994,832,92,93,red blood cell,8556,1.0108695652173914,0.989247311827957
53655,/images/7bcd3735-3134-46d1-8ca2-d4379f2d51c0.png,745,1256,837,1360,92,104,red blood cell,9568,1.1304347826086956,0.8846153846153846
38533,/images/c3ae7090-fc68-41b4-85a1-8d9bce9825a7.png,327,647,441,769,114,122,red blood cell,13908,1.0701754385964912,0.9344262295081968
78020,/images/c691c8ef-d3c7-47b6-a941-f6a1089f21a9.png,181,1475,272,1575,91,100,red blood cell,9100,1.098901098901099,0.91
36525,/images/bd856928-96ee-4fc4-a377-f2fc4e84448b.png,231,1335,335,1437,104,102,red blood cell,10608,0.9807692307692307,1.0196078431372548
65101,/images/5e042380-6ef2-496f-8231-0ca550fbfa71.png,1078,456,1190,565,112,109,red blood cell,12208,0.9732142857142857,1.0275229357798166
17402,/images/6f4ffe7b-395f-41ea-ad61-df5e0cbd531c.png,588,534,704,644,116,110,red blood cell,12760,0.9482758620689655,1.0545454545454545
18962,/images/e9e78ff8-831b-46e9-9785-3eee9acbfcd8.png,1049,478,1145,576,96,98,red blood cell,9408,1.0208333333333333,0.9795918367346939
61101,/images/80da32ce-8c22-470e-9f35-558c5f7a5df9.png,801,1195,910,1300,109,105,red blood cell,11445,0.963302752293578,1.0380952380952382
1456,/images/5f17d2fb-22fa-4aa6-9dad-6a1d50c03815.png,272,224,391,340,119,116,red blood cell,13804,0.9747899159663865,1.0258620689655173
50294,/images/3d32a988-449d-4d58-b71f-abbfdc3f2fbc.png,405,1401,494,1493,89,92,red blood cell,8188,1.0337078651685394,0.967391304347826
30676,/images/f939782b-f5a2-40a3-9c22-6c6d7e18edc3.png,521,241,628,351,107,110,red blood cell,11770,1.02803738317757,0.9727272727272728
40301,/images/eb86033f-4f1c-4e8c-ae84-e8e4c7e08626.png,923,936,1022,1041,99,105,red blood cell,10395,1.0606060606060606,0.9428571428571428
16354,/images/69569ecf-cfa1-4ddd-9342-b22c23387fdb.png,892,864,1017,983,125,119,red blood cell,14875,0.952,1.050420168067227
63137,/images/d82c657e-5678-41da-9a6e-3ad29430b759.png,519,222,628,328,109,106,red blood cell,11554,0.9724770642201835,1.028301886792453
13070,/images/9691c57a-ccf8-47f9-a8e9-9a324974585b.png,274,631,380,722,106,91,red blood cell,9646,0.8584905660377359,1.164835164835165
52881,/images/abb2f9d6-26fa-4328-983c-959ef6717c05.png,314,1014,428,1127,114,113,red blood cell,12882,0.9912280701754386,1.008849557522124
68045,/images/e2e68cb3-0588-40bb-95b4-356f9cacffc3.png,523,1006,648,1124,125,118,red blood cell,14750,0.944,1.0593220338983051
21106,/images/fb05b297-180a-4171-b633-09d5616d7534.png,247,1351,350,1454,103,103,red blood cell,10609,1.0,1.0
36322,/images/81fed4a1-9d48-4938-90c9-c8bf3f5e6b1f.png,780,1246,903,1395,123,149,red blood cell,18327,1.2113821138211383,0.825503355704698
72143,/images/64b0e49a-0e48-447d-8872-c1dd255e7a21.png,864,1493,966,1598,102,105,red blood cell,10710,1.0294117647058822,0.9714285714285714
18840,/images/d1b48634-9ad5-46e8-b816-42d1d97c93cd.png,975,1055,1090,1168,115,113,red blood cell,12995,0.9826086956521739,1.0176991150442478
20164,/images/df49578a-60d4-4a3b-9ee0-79d9d59bc72a.png,22,1227,147,1370,125,143,red blood cell,17875,1.144,0.8741258741258742
61406,/images/e16c0dab-780d-4035-872e-1bb91e49f9d2.png,856,329,967,423,111,94,red blood cell,10434,0.8468468468468469,1.1808510638297873
61094,/images/80da32ce-8c22-470e-9f35-558c5f7a5df9.png,996,867,1095,965,99,98,red blood cell,9702,0.98989898989899,1.010204081632653
71743,/images/093a831a-bf71-4333-bc06-942ae70cb164.png,602,1444,717,1544,115,100,red blood cell,11500,0.8695652173913043,1.15
21712,/images/81af1442-d835-46bf-b80b-a898dba3da1b.png,179,573,293,705,114,132,red blood cell,15048,1.1578947368421053,0.8636363636363636
79116,/images/1c90231b-2830-42d9-884e-7301edb16933.png,248,1080,343,1175,95,95,red blood cell,9025,1.0,1.0
25606,/images/770b8ca4-8377-479b-9ad5-5455ec3b44f8.png,998,1369,1115,1483,117,114,red blood cell,13338,0.9743589743589743,1.0263157894736843
9049,/images/ef815e3a-02a6-4cf8-9262-45bc74c50b00.png,892,999,1003,1100,111,101,red blood cell,11211,0.9099099099099099,1.099009900990099
75840,/images/c4c7ed75-dbdf-4bb6-b6ba-718903cf7264.png,479,126,594,237,115,111,red blood cell,12765,0.9652173913043478,1.0360360360360361
67697,/images/2b128a1a-95ed-408b-b9f8-8795cc814d80.png,298,1162,399,1262,101,100,red blood cell,10100,0.9900990099009901,1.01
69413,/images/fde0fd54-49cc-42e1-90c6-6b612cd062d8.png,652,72,760,192,108,120,red blood cell,12960,1.1111111111111112,0.9
65751,/images/daea4860-a296-4f6d-acef-996ab0882676.png,64,1324,171,1440,107,116,red blood cell,12412,1.0841121495327102,0.9224137931034483
34351,/images/1a48cbc1-5423-47e5-8ca5-2ab4f83a05a5.png,243,1072,364,1179,121,107,red blood cell,12947,0.8842975206611571,1.1308411214953271
75363,/images/468c261d-f5d8-423f-883e-48af2bbbc5d1.png,562,397,672,503,110,106,red blood cell,11660,0.9636363636363636,1.0377358490566038
37057,/images/b2e34f5f-904e-4473-9dc7-c6bc1ce12640.png,615,1141,713,1223,98,82,red blood cell,8036,0.8367346938775511,1.1951219512195121
27950,/images/46f5bd4f-8bea-48d1-a1da-4dea28e3b814.png,36,1236,146,1343,110,107,red blood cell,11770,0.9727272727272728,1.02803738317757
1908,/images/02ea7aa8-c142-4a3d-939f-e77689741341.png,822,1438,948,1574,126,136,red blood cell,17136,1.0793650793650793,0.9264705882352942
1350,/images/6d91d1f0-636b-4f5a-a526-7c17fc857190.png,1,687,94,773,93,86,red blood cell,7998,0.9247311827956989,1.0813953488372092
3202,/images/c3215597-a032-46be-9058-d6de1e5191d7.png,1071,1258,1191,1381,120,123,red blood cell,14760,1.025,0.975609756097561
9630,/images/d997337e-e4a8-4ef0-b8ba-975e6c43b62c.png,94,134,201,248,107,114,red blood cell,12198,1.0654205607476634,0.9385964912280702
63588,/images/de0321fa-6f7d-4dd1-b96b-186701c3b1d9.png,495,589,596,698,101,109,red blood cell,11009,1.0792079207920793,0.926605504587156
47877,/images/ab27173b-6e30-4957-bd68-29194328fd39.png,437,1303,554,1400,117,97,red blood cell,11349,0.8290598290598291,1.2061855670103092
9116,/images/d3ed519e-2152-4e30-838d-a3ea23be512f.png,296,78,400,180,104,102,red blood cell,10608,0.9807692307692307,1.0196078431372548
69934,/images/9edba799-e169-46cd-b100-c9f8fc7a8c7d.png,348,1022,446,1124,98,102,red blood cell,9996,1.0408163265306123,0.9607843137254902
3456,/images/ad36bd67-594b-4f63-93e3-886af0bc618e.png,1015,101,1123,228,108,127,red blood cell,13716,1.1759259259259258,0.8503937007874016
76546,/images/38c69905-8a4f-451a-8d0a-b855dc88dd16.png,368,1283,471,1381,103,98,red blood cell,10094,0.9514563106796117,1.0510204081632653
6017,/images/72732579-a812-4496-b2dd-ea1556924337.png,331,1122,433,1230,102,108,red blood cell,11016,1.0588235294117647,0.9444444444444444
67966,/images/bcaefb02-682a-41b9-acc7-e6cc010f5b30.png,471,357,571,441,100,84,red blood cell,8400,0.84,1.1904761904761905
6747,/images/672e4ecf-a56b-462e-b83b-76f4efaa6634.png,569,26,680,143,111,117,red blood cell,12987,1.054054054054054,0.9487179487179487
3015,/images/5a386082-397f-4524-a6f9-c2b8efe5014d.png,798,390,923,507,125,117,red blood cell,14625,0.936,1.0683760683760684
28148,/images/cd2774a0-dab2-4d68-aae9-7568b9f3d2a6.png,536,466,632,577,96,111,red blood cell,10656,1.15625,0.8648648648648649
27044,/images/ec301f62-1302-4407-96f9-fcfe45c150ae.png,498,11,611,120,113,109,red blood cell,12317,0.9646017699115044,1.036697247706422
21140,/images/fb05b297-180a-4171-b633-09d5616d7534.png,710,1303,824,1428,114,125,red blood cell,14250,1.0964912280701755,0.912
72069,/images/64b0e49a-0e48-447d-8872-c1dd255e7a21.png,324,674,442,797,118,123,red blood cell,14514,1.0423728813559323,0.959349593495935
47064,/images/997eabd9-55bf-4683-83c4-4cee4673a4ef.png,175,1474,265,1581,90,107,red blood cell,9630,1.1888888888888889,0.8411214953271028
41876,/images/783ae4ad-6a35-4b3c-b19f-754974b67b2d.png,500,1256,614,1381,114,125,red blood cell,14250,1.0964912280701755,0.912
27076,/images/ec301f62-1302-4407-96f9-fcfe45c150ae.png,800,603,893,711,93,108,red blood cell,10044,1.1612903225806452,0.8611111111111112
61377,/images/e16c0dab-780d-4035-872e-1bb91e49f9d2.png,160,1139,257,1239,97,100,red blood cell,9700,1.0309278350515463,0.97
40755,/images/252071ac-e9f2-41d2-abbb-87ef01b8a997.png,446,1495,556,1596,110,101,red blood cell,11110,0.9181818181818182,1.0891089108910892
27111,/images/f232eec3-02c0-43f9-bf32-3e60245397e2.png,667,423,779,529,112,106,red blood cell,11872,0.9464285714285714,1.0566037735849056
21534,/images/7625dfc4-858a-4c8e-907c-8943d665e9a7.png,1084,98,1185,223,101,125,red blood cell,12625,1.2376237623762376,0.808
73389,/images/c890ee00-daa5-4b20-9cd5-930748ecc4e0.png,202,174,299,277,97,103,red blood cell,9991,1.0618556701030928,0.941747572815534
8755,/images/29dc8176-dfe1-40e0-8247-2dc3c530057e.png,682,237,810,346,128,109,red blood cell,13952,0.8515625,1.1743119266055047
31770,/images/ab59c9e4-3e50-48b9-874d-060d317410cc.png,1088,465,1198,602,110,137,red blood cell,15070,1.2454545454545454,0.8029197080291971
49369,/images/28c96a4a-4549-4761-99e4-ace4ea7e7ac9.png,558,1035,690,1153,132,118,red blood cell,15576,0.8939393939393939,1.11864406779661
7405,/images/76dbce7f-dc3e-4a29-b1fe-ab9dce583080.png,849,941,968,1056,119,115,red blood cell,13685,0.9663865546218487,1.0347826086956522
46753,/images/da111ca5-520f-4ea8-97ad-ae5fce58ee91.png,880,304,962,388,82,84,red blood cell,6888,1.024390243902439,0.9761904761904762
19094,/images/6e39fb0a-aa41-4b16-b783-7589e97bf289.png,329,1343,457,1480,128,137,red blood cell,17536,1.0703125,0.9343065693430657
5678,/images/d3dcdf92-9328-4796-adf4-918646877ba1.png,947,1155,1053,1258,106,103,red blood cell,10918,0.9716981132075472,1.029126213592233
59266,/images/03c8da48-04b9-4520-b674-44a0ecd35688.png,743,338,843,437,100,99,red blood cell,9900,0.99,1.0101010101010102
9304,/images/261562a8-ffd8-4e0e-919b-22e267000b74.png,240,640,352,730,112,90,red blood cell,10080,0.8035714285714286,1.2444444444444445
69636,/images/4a49841f-216c-4815-8140-b8762c4f6603.png,41,1124,122,1219,81,95,red blood cell,7695,1.1728395061728396,0.8526315789473684
50751,/images/db0a1123-0b35-48d7-8337-3b1ebd6af0cc.png,90,1088,197,1192,107,104,red blood cell,11128,0.9719626168224299,1.0288461538461537
68608,/images/31653d0f-c4e6-4e12-8005-518c2de34687.png,739,227,830,331,91,104,red blood cell,9464,1.1428571428571428,0.875
31206,/images/1976cd04-d24f-457c-b423-7e4cdb05de9e.png,443,652,555,747,112,95,red blood cell,10640,0.8482142857142857,1.1789473684210525
12990,/images/b10ea12f-cd36-4f2c-994a-67d1665269ab.png,1010,640,1108,747,98,107,red blood cell,10486,1.0918367346938775,0.9158878504672897
15488,/images/79f63258-24ce-4e69-a5cb-8529635a89a9.png,547,737,654,827,107,90,red blood cell,9630,0.8411214953271028,1.1888888888888889
16157,/images/1e978dfa-d339-4025-809d-09cee76728ed.png,913,1022,1016,1135,103,113,red blood cell,11639,1.0970873786407767,0.911504424778761
53270,/images/d8f7e159-b7e3-49e4-86e8-aed8c5fbcd97.png,947,272,1057,382,110,110,red blood cell,12100,1.0,1.0
68961,/images/bbaa004f-05dc-4cb8-8768-e148085bb0f9.png,534,674,624,772,90,98,red blood cell,8820,1.0888888888888888,0.9183673469387755
29041,/images/4c13e22e-dfd1-4fa1-b373-be9d0c272c0f.png,43,1335,142,1438,99,103,red blood cell,10197,1.0404040404040404,0.9611650485436893
42735,/images/b8dd6125-5027-47e2-a283-14e199274c80.png,929,23,1031,144,102,121,red blood cell,12342,1.1862745098039216,0.8429752066115702
29551,/images/8cc6fe77-5f2f-4670-b4ac-1b49550241a8.png,1095,1203,1197,1296,102,93,red blood cell,9486,0.9117647058823529,1.096774193548387
75865,/images/3006096f-ceeb-42be-b69e-785179d7438b.png,592,475,701,581,109,106,red blood cell,11554,0.9724770642201835,1.028301886792453
21455,/images/b701b5c5-b922-4315-b12a-aac4ec65ee8b.png,406,996,503,1093,97,97,red blood cell,9409,1.0,1.0
11023,/images/c442e2d6-aaf9-417a-9905-4737a1115f33.png,707,430,823,546,116,116,red blood cell,13456,1.0,1.0
40851,/images/bf20d04d-ff8a-4910-91d7-94054c267d1b.png,127,480,246,593,119,113,red blood cell,13447,0.9495798319327731,1.0530973451327434
75736,/images/d12c5f45-6b20-46d6-a66f-c5a4683c25b3.png,459,1381,559,1483,100,102,red blood cell,10200,1.02,0.9803921568627451
52849,/images/58f7e1da-3478-48f4-958c-e9b1cb8696aa.png,396,865,510,982,114,117,red blood cell,13338,1.0263157894736843,0.9743589743589743
45400,/images/e4eea7ea-8989-46a9-9c98-25a178146b28.png,56,178,165,288,109,110,red blood cell,11990,1.0091743119266054,0.990909090909091
7739,/images/187f92b2-71ed-484a-9bd3-599ca0d2636f.png,811,1292,908,1404,97,112,red blood cell,10864,1.1546391752577319,0.8660714285714286
40142,/images/b34e65f6-c32e-42f1-a437-4a037c75a231.png,215,693,320,796,105,103,red blood cell,10815,0.9809523809523809,1.0194174757281553
16991,/images/8eeb378e-90f0-47ea-ac1c-2a201eb8d090.png,508,1092,598,1185,90,93,red blood cell,8370,1.0333333333333334,0.967741935483871
1315,/images/6d91d1f0-636b-4f5a-a526-7c17fc857190.png,707,835,798,930,91,95,red blood cell,8645,1.043956043956044,0.9578947368421052
66175,/images/14005767-9296-4b48-8a9d-bbe9b2040005.png,588,1202,696,1296,108,94,red blood cell,10152,0.8703703703703703,1.148936170212766
16880,/images/4823c1fe-a7f9-4b92-959f-0d9be09cd14b.png,841,20,946,110,105,90,red blood cell,9450,0.8571428571428571,1.1666666666666667
51371,/images/b4f3b2a4-f4b9-48de-ac5d-0e681b77be27.png,386,431,493,548,107,117,red blood cell,12519,1.0934579439252337,0.9145299145299145
71644,/images/5c99cd97-39f6-4809-9528-9d380cc16b16.png,396,270,509,389,113,119,red blood cell,13447,1.0530973451327434,0.9495798319327731
59482,/images/a7c3c52f-3b40-4c92-a212-df9462cf25d8.png,12,1061,135,1169,123,108,red blood cell,13284,0.8780487804878049,1.1388888888888888
376,/images/7c66d2fd-68ee-4628-b860-9d7ad25b2a80.png,595,1048,704,1160,109,112,red blood cell,12208,1.0275229357798166,0.9732142857142857
61659,/images/a3c0a876-be12-4ede-8aed-18b32a64401b.png,177,1039,297,1175,120,136,red blood cell,16320,1.1333333333333333,0.8823529411764706
59288,/images/03c8da48-04b9-4520-b674-44a0ecd35688.png,27,1007,111,1089,84,82,red blood cell,6888,0.9761904761904762,1.024390243902439
20555,/images/cbde7f7e-2458-4dda-9db2-3d5ccf950ced.png,973,8,1102,114,129,106,red blood cell,13674,0.8217054263565892,1.2169811320754718
8059,/images/694222bb-cddf-469a-9526-f873c6fba58e.png,656,1333,742,1410,86,77,red blood cell,6622,0.8953488372093024,1.1168831168831168
48710,/images/bc832bde-d3ea-4a8e-be90-7a3329dcc314.png,1076,1035,1197,1160,121,125,red blood cell,15125,1.0330578512396693,0.968
10162,/images/09ecf7be-28e2-4531-b9e2-07e01c44097d.png,472,1192,576,1304,104,112,red blood cell,11648,1.0769230769230769,0.9285714285714286
64565,/images/6ba5d0b8-cdc7-4266-9d78-db76faa312e9.png,0,206,102,306,102,100,red blood cell,10200,0.9803921568627451,1.02
52884,/images/abb2f9d6-26fa-4328-983c-959ef6717c05.png,882,1287,997,1404,115,117,red blood cell,13455,1.017391304347826,0.9829059829059829
24051,/images/5107dcb7-164f-4e10-bbff-822b39b76efc.png,308,681,429,795,121,114,red blood cell,13794,0.9421487603305785,1.0614035087719298
30977,/images/b59dc3a0-3d54-4e3b-a485-33b3e43966de.png,7,1389,133,1506,126,117,red blood cell,14742,0.9285714285714286,1.0769230769230769
8461,/images/e234ce8b-4ec4-4d93-9068-d7854d77ddf4.png,497,1293,619,1423,122,130,red blood cell,15860,1.0655737704918034,0.9384615384615385
62771,/images/631340cc-cedf-4bca-a3d8-a0731a5482b4.png,283,1468,386,1566,103,98,red blood cell,10094,0.9514563106796117,1.0510204081632653
65966,/images/25c6cfb1-01d0-4864-87f9-02b7593683c7.png,955,560,1041,660,86,100,red blood cell,8600,1.1627906976744187,0.86
71169,/images/4fac16e1-8e62-499b-a66b-c4c890372914.png,477,1028,595,1148,118,120,red blood cell,14160,1.0169491525423728,0.9833333333333333
57726,/images/5c037ffc-f515-48b3-b231-c110fbd2b8ca.png,929,436,1026,523,97,87,red blood cell,8439,0.8969072164948454,1.1149425287356323
11584,/images/b4dc3088-3fe2-4688-be24-70664a64e022.png,994,1153,1114,1263,120,110,red blood cell,13200,0.9166666666666666,1.0909090909090908
47289,/images/1dd3e6dd-343f-4cc9-b0ed-e4d27fb36f0a.png,623,975,742,1106,119,131,red blood cell,15589,1.1008403361344539,0.9083969465648855
12563,/images/8e4bdd0d-1c72-4836-ae3e-05e2e50e4983.png,583,396,693,496,110,100,red blood cell,11000,0.9090909090909091,1.1
30719,/images/8e0dfc1f-e3eb-4a3f-a1c4-249bdfbfaa27.png,579,481,698,600,119,119,red blood cell,14161,1.0,1.0
76664,/images/3317d733-ec0d-45e6-b631-40457392f343.png,648,1110,746,1219,98,109,red blood cell,10682,1.1122448979591837,0.8990825688073395
41373,/images/a065c50b-341d-4803-b4b0-0fe8f04fdbb5.png,1056,496,1176,605,120,109,red blood cell,13080,0.9083333333333333,1.1009174311926606
73294,/images/67a4fb91-6f38-4ca2-8f20-6b2f5f1b29a7.png,848,9,940,102,92,93,red blood cell,8556,1.0108695652173914,0.989247311827957
29696,/images/f25a2ac8-cb6e-4e05-a0cd-cc00ac47718a.png,637,1202,750,1336,113,134,red blood cell,15142,1.1858407079646018,0.8432835820895522
69556,/images/4a49841f-216c-4815-8140-b8762c4f6603.png,813,1121,929,1237,116,116,red blood cell,13456,1.0,1.0
61109,/images/80da32ce-8c22-470e-9f35-558c5f7a5df9.png,41,650,135,757,94,107,red blood cell,10058,1.1382978723404256,0.8785046728971962
34057,/images/1012abf2-cb05-4337-86c5-513ec4ca904d.png,921,1210,1026,1318,105,108,red blood cell,11340,1.0285714285714285,0.9722222222222222
6841,/images/e36cb882-c6d0-4467-812e-d18c169a9a47.png,791,1279,892,1388,101,109,red blood cell,11009,1.0792079207920793,0.926605504587156
1121,/images/edcb4d77-a4d3-465d-9b59-eb3087766b1c.png,655,15,761,116,106,101,red blood cell,10706,0.9528301886792453,1.0495049504950495
38526,/images/c3ae7090-fc68-41b4-85a1-8d9bce9825a7.png,384,533,506,659,122,126,red blood cell,15372,1.0327868852459017,0.9682539682539683
74981,/images/b4c52960-bbee-439e-83dc-f89ddaade71b.png,1017,1017,1126,1138,109,121,red blood cell,13189,1.110091743119266,0.9008264462809917
1479,/images/0ac747cd-ff32-49bf-bc1a-3e9b7702ce9c.png,176,286,273,387,97,101,red blood cell,9797,1.041237113402062,0.9603960396039604
73920,/images/2ae3e6e6-7482-4ab8-ad73-b530b5c2ee3b.png,985,1190,1079,1299,94,109,red blood cell,10246,1.1595744680851063,0.8623853211009175
24196,/images/194aec70-41a5-4ac3-b22f-0b6eda91f730.png,1036,330,1161,441,125,111,red blood cell,13875,0.888,1.1261261261261262
5578,/images/75c243e2-610d-4d5a-bc5a-4c53d99d9ae9.png,288,897,417,1022,129,125,red blood cell,16125,0.9689922480620154,1.032
67689,/images/2b128a1a-95ed-408b-b9f8-8795cc814d80.png,1041,545,1146,643,105,98,red blood cell,10290,0.9333333333333333,1.0714285714285714
55752,/images/68f34a9c-f73d-4238-8f55-4b05a8a2154c.png,194,1055,304,1166,110,111,red blood cell,12210,1.009090909090909,0.990990990990991
19115,/images/2196389c-45ec-46b5-bc6c-1f4a33df7f7c.png,801,503,932,626,131,123,red blood cell,16113,0.9389312977099237,1.065040650406504
4154,/images/ac3358f1-ef9a-4ccc-b66c-da5e47e352e0.png,481,1158,585,1262,104,104,red blood cell,10816,1.0,1.0
17593,/images/e80bad38-66d0-473e-85dd-92142dba37e6.png,249,889,375,994,126,105,red blood cell,13230,0.8333333333333334,1.2
1946,/images/b95ceeeb-8870-4492-9037-2091ff268c5a.png,388,1383,510,1495,122,112,red blood cell,13664,0.9180327868852459,1.0892857142857142
52186,/images/f4c00b8c-d675-4255-8277-ca65bd757f51.png,845,279,950,391,105,112,red blood cell,11760,1.0666666666666667,0.9375
57676,/images/5c037ffc-f515-48b3-b231-c110fbd2b8ca.png,606,663,705,759,99,96,red blood cell,9504,0.9696969696969697,1.03125
25726,/images/412c9fa5-fcf4-402b-b1e4-3271f775058e.png,325,1334,441,1468,116,134,red blood cell,15544,1.1551724137931034,0.8656716417910447
54590,/images/59dc7da9-35d1-421e-a61b-1e9637bfbfa1.png,324,52,424,153,100,101,red blood cell,10100,1.01,0.9900990099009901
69143,/images/de2b8835-552c-4f01-98b7-67bc4910062e.png,569,72,659,162,90,90,red blood cell,8100,1.0,1.0
20470,/images/b809b407-7b69-4334-873d-d6c49135f04a.png,393,1121,504,1250,111,129,red blood cell,14319,1.162162162162162,0.8604651162790697
71853,/images/093a831a-bf71-4333-bc06-942ae70cb164.png,373,987,473,1100,100,113,red blood cell,11300,1.13,0.8849557522123894
55921,/images/afd39466-aafa-4d81-9520-483727418723.png,612,535,732,641,120,106,red blood cell,12720,0.8833333333333333,1.1320754716981132
46091,/images/72088c26-d2dd-4906-b791-b8947fc7fbe4.png,524,1207,613,1307,89,100,red blood cell,8900,1.1235955056179776,0.89
67611,/images/59542a24-b409-4c95-8608-d9691a741526.png,455,419,543,507,88,88,red blood cell,7744,1.0,1.0
40188,/images/ef1a9020-5e45-450d-a237-165114308592.png,736,862,853,984,117,122,red blood cell,14274,1.0427350427350428,0.9590163934426229
28272,/images/036404d1-b9fc-497b-bbe1-f4d9c5ac3ce0.png,744,1002,838,1086,94,84,red blood cell,7896,0.8936170212765957,1.119047619047619
78235,/images/adff6e1d-ba9d-4c7b-a8fe-1ec458eaeeb8.png,501,1196,613,1302,112,106,red blood cell,11872,0.9464285714285714,1.0566037735849056
36292,/images/81fed4a1-9d48-4938-90c9-c8bf3f5e6b1f.png,630,1124,736,1252,106,128,red blood cell,13568,1.2075471698113207,0.828125
7479,/images/37a94c0f-e5d4-46fc-b4f8-994d477995fd.png,436,140,564,260,128,120,red blood cell,15360,0.9375,1.0666666666666667
50633,/images/c956e531-6805-4fe1-b61c-8b96a9815a77.png,369,761,479,873,110,112,red blood cell,12320,1.018181818181818,0.9821428571428571
69620,/images/4a49841f-216c-4815-8140-b8762c4f6603.png,1033,1405,1130,1525,97,120,red blood cell,11640,1.2371134020618557,0.8083333333333333
4917,/images/755e5bf8-e8e1-492b-a32f-f7d87cccaa40.png,316,1392,439,1510,123,118,red blood cell,14514,0.959349593495935,1.0423728813559323
79635,/images/a4409217-be11-4478-90a5-b406057d154d.png,67,852,169,961,102,109,red blood cell,11118,1.0686274509803921,0.9357798165137615
78053,/images/105af41b-13cc-4ad1-8a1f-8bc4d47cdd94.png,831,405,927,504,96,99,red blood cell,9504,1.03125,0.9696969696969697
22976,/images/b687c30d-cf15-445c-b3f6-5aca86584708.png,287,767,401,883,114,116,red blood cell,13224,1.0175438596491229,0.9827586206896551
23578,/images/79d7a014-21ff-40f1-9ac4-a69839390654.png,447,1004,548,1120,101,116,red blood cell,11716,1.1485148514851484,0.8706896551724138
9054,/images/ef815e3a-02a6-4cf8-9262-45bc74c50b00.png,948,284,1031,377,83,93,red blood cell,7719,1.1204819277108433,0.8924731182795699
66396,/images/e5fd5949-4cd0-4cb6-837a-02c26a5eb87a.png,886,422,1007,552,121,130,red blood cell,15730,1.0743801652892562,0.9307692307692308
31338,/images/31c749e8-18d1-4105-b7e6-8319cceddae0.png,116,1262,231,1362,115,100,red blood cell,11500,0.8695652173913043,1.15
37058,/images/b2e34f5f-904e-4473-9dc7-c6bc1ce12640.png,444,1381,546,1483,102,102,red blood cell,10404,1.0,1.0
75415,/images/468c261d-f5d8-423f-883e-48af2bbbc5d1.png,606,1243,687,1330,81,87,red blood cell,7047,1.0740740740740742,0.9310344827586207
76585,/images/4184a235-d209-4151-86e9-6c77e7938dab.png,782,307,884,414,102,107,red blood cell,10914,1.0490196078431373,0.9532710280373832
74965,/images/b4c52960-bbee-439e-83dc-f89ddaade71b.png,430,1014,532,1121,102,107,red blood cell,10914,1.0490196078431373,0.9532710280373832
32143,/images/25cfca07-2101-484f-b312-a927395f2651.png,554,1479,680,1599,126,120,red blood cell,15120,0.9523809523809523,1.05
37262,/images/2fdbd9bc-bbaf-44c2-b40c-d193709639fa.png,779,813,895,931,116,118,red blood cell,13688,1.0172413793103448,0.9830508474576272
13417,/images/370277f8-436b-4103-8210-b4feb5ab95ea.png,807,1272,923,1370,116,98,red blood cell,11368,0.8448275862068966,1.183673469387755
42148,/images/c63f190a-e860-44fc-a2db-7980e1c80519.png,360,75,468,177,108,102,red blood cell,11016,0.9444444444444444,1.0588235294117647
52154,/images/94d9fa50-d3e4-4eaf-acfc-92e7f2ed9ea5.png,183,1310,286,1401,103,91,red blood cell,9373,0.883495145631068,1.1318681318681318
22836,/images/72105bb0-8e39-48be-b7f7-5b32f047b99e.png,203,679,320,802,117,123,red blood cell,14391,1.0512820512820513,0.9512195121951219
40431,/images/db249e5a-4142-432c-8288-bacd10d7273d.png,146,1222,243,1338,97,116,red blood cell,11252,1.1958762886597938,0.8362068965517241
73371,/images/c890ee00-daa5-4b20-9cd5-930748ecc4e0.png,201,101,309,192,108,91,red blood cell,9828,0.8425925925925926,1.1868131868131868
47557,/images/adff132d-3af0-4cef-942c-58fc09729bee.png,81,1073,183,1180,102,107,red blood cell,10914,1.0490196078431373,0.9532710280373832
58730,/images/e4827c85-311a-4df1-89c2-99dad0c3558c.png,392,695,499,808,107,113,red blood cell,12091,1.0560747663551402,0.9469026548672567
543,/images/67acd5bc-4658-4c6e-a9b9-cd8ea3a03418.png,626,1147,759,1261,133,114,red blood cell,15162,0.8571428571428571,1.1666666666666667
57223,/images/ca5e6a15-ba65-48ea-8913-2d986e71bf3a.png,570,1343,687,1459,117,116,red blood cell,13572,0.9914529914529915,1.0086206896551724
78100,/images/105af41b-13cc-4ad1-8a1f-8bc4d47cdd94.png,465,291,585,416,120,125,red blood cell,15000,1.0416666666666667,0.96
38299,/images/674b0fd3-f247-4b7f-97f7-3e6c57c9ba9e.png,235,290,342,377,107,87,red blood cell,9309,0.8130841121495327,1.2298850574712643
59990,/images/49288109-80e9-4ec8-96d1-26a0166b8883.png,455,720,545,819,90,99,red blood cell,8910,1.1,0.9090909090909091
8179,/images/694222bb-cddf-469a-9526-f873c6fba58e.png,864,203,962,284,98,81,red blood cell,7938,0.826530612244898,1.2098765432098766
36366,/images/4a0a05e1-11ad-4bfc-bfa3-adf3b9bd0b56.png,353,535,463,656,110,121,red blood cell,13310,1.1,0.9090909090909091
9868,/images/3859deaf-6ae1-49a3-9051-898d0f0d7de6.png,960,686,1061,780,101,94,red blood cell,9494,0.9306930693069307,1.074468085106383
4404,/images/84041bf9-dace-4066-9fe0-52170d08f826.png,501,1333,605,1450,104,117,red blood cell,12168,1.125,0.8888888888888888
20071,/images/ebfd9f67-138e-49f0-9cef-a0352069eedb.png,674,1368,794,1493,120,125,red blood cell,15000,1.0416666666666667,0.96
27438,/images/50d52637-f5e0-4d0d-aaee-4a29f044cf74.png,946,640,1082,749,136,109,red blood cell,14824,0.8014705882352942,1.2477064220183487
21124,/images/fb05b297-180a-4171-b633-09d5616d7534.png,345,764,456,868,111,104,red blood cell,11544,0.9369369369369369,1.0673076923076923
62540,/images/9ecf2006-8d49-4ae8-a14b-ed8b3b14ee7c.png,84,702,197,818,113,116,red blood cell,13108,1.0265486725663717,0.9741379310344828
50345,/images/3d32a988-449d-4d58-b71f-abbfdc3f2fbc.png,416,151,517,258,101,107,red blood cell,10807,1.0594059405940595,0.9439252336448598
62713,/images/9e1b0217-0926-4fd1-bb9e-a815c05deb59.png,1080,1104,1186,1217,106,113,red blood cell,11978,1.0660377358490567,0.9380530973451328
5448,/images/3f106606-9a21-40d5-b849-273866fe0f49.png,536,1159,656,1256,120,97,red blood cell,11640,0.8083333333333333,1.2371134020618557
71689,/images/5c99cd97-39f6-4809-9528-9d380cc16b16.png,958,1268,1064,1380,106,112,red blood cell,11872,1.0566037735849056,0.9464285714285714
18251,/images/947348fe-4c70-468e-8009-3c14daeca69b.png,594,1209,697,1321,103,112,red blood cell,11536,1.087378640776699,0.9196428571428571
9532,/images/a18f122f-3a3e-4478-8ac4-91b83e050e65.png,148,664,274,792,126,128,red blood cell,16128,1.0158730158730158,0.984375
64589,/images/6dfafdf1-f588-4e80-8cf8-0126e1bf7af9.png,455,175,557,285,102,110,red blood cell,11220,1.0784313725490196,0.9272727272727272
78901,/images/4d0a1598-e4dd-45c4-8a90-dd7c780fe1da.png,113,269,230,374,117,105,red blood cell,12285,0.8974358974358975,1.1142857142857143
65320,/images/24418314-f7a4-49fc-a03e-ec597ca6796e.png,954,806,1045,912,91,106,red blood cell,9646,1.164835164835165,0.8584905660377359
9758,/images/3859deaf-6ae1-49a3-9051-898d0f0d7de6.png,645,1042,750,1143,105,101,red blood cell,10605,0.9619047619047619,1.0396039603960396
39096,/images/7bde7de1-889b-4218-b0e1-e2c04f6a7986.png,304,1409,400,1528,96,119,red blood cell,11424,1.2395833333333333,0.8067226890756303
49985,/images/05804cf0-f854-4099-97c2-df287f7c8a8c.png,91,1368,212,1488,121,120,red blood cell,14520,0.9917355371900827,1.0083333333333333
624,/images/e61e6af2-7f8b-47b0-bbe7-acb2ed0299ab.png,299,561,405,662,106,101,red blood cell,10706,0.9528301886792453,1.0495049504950495
60812,/images/0ab56f9a-846d-49e2-a617-c6cc477fdfad.png,542,1288,642,1390,100,102,red blood cell,10200,1.02,0.9803921568627451
59284,/images/03c8da48-04b9-4520-b674-44a0ecd35688.png,31,659,130,761,99,102,red blood cell,10098,1.0303030303030303,0.9705882352941176
37126,/images/d6942996-5664-4370-ad87-2bdcbd49ac16.png,738,1112,857,1213,119,101,red blood cell,12019,0.8487394957983193,1.1782178217821782
12709,/images/68442532-9cd2-4b42-9d4f-ddf8c13bb38c.png,393,1424,493,1536,100,112,red blood cell,11200,1.12,0.8928571428571429
6075,/images/c147584d-4c61-412a-bdaf-b02b22c18708.png,491,840,616,971,125,131,red blood cell,16375,1.048,0.9541984732824428
10394,/images/46a2d369-4bea-4405-ac78-91bbe130b9a7.png,789,1481,900,1596,111,115,red blood cell,12765,1.0360360360360361,0.9652173913043478
9597,/images/239f17eb-a2e2-47e9-82e3-fa0d9a70fb9f.png,782,721,896,838,114,117,red blood cell,13338,1.0263157894736843,0.9743589743589743
19658,/images/a3ada657-de00-44db-b1e2-54ba17e39983.png,1034,315,1149,458,115,143,red blood cell,16445,1.2434782608695651,0.8041958041958042
1064,/images/edcb4d77-a4d3-465d-9b59-eb3087766b1c.png,555,574,674,689,119,115,red blood cell,13685,0.9663865546218487,1.0347826086956522
15882,/images/c7c1b873-0548-4a73-9618-f60912e164df.png,768,1088,871,1184,103,96,red blood cell,9888,0.9320388349514563,1.0729166666666667
70031,/images/3e36698f-8c09-4c8b-8948-737310bf97e5.png,586,1267,683,1372,97,105,red blood cell,10185,1.0824742268041236,0.9238095238095239
2997,/images/5a386082-397f-4524-a6f9-c2b8efe5014d.png,383,1064,506,1181,123,117,red blood cell,14391,0.9512195121951219,1.0512820512820513
15087,/images/3a8f468f-f9de-46a8-a7c8-f2be239fa207.png,73,477,171,567,98,90,red blood cell,8820,0.9183673469387755,1.0888888888888888
21445,/images/b701b5c5-b922-4315-b12a-aac4ec65ee8b.png,10,105,111,198,101,93,red blood cell,9393,0.9207920792079208,1.086021505376344
34657,/images/8d989997-038c-4924-b2d3-d02629a7cdf5.png,932,465,1044,598,112,133,red blood cell,14896,1.1875,0.8421052631578947
66955,/images/9acf303a-fcba-4e52-be3e-8d061aa5e72a.png,836,705,921,787,85,82,red blood cell,6970,0.9647058823529412,1.0365853658536586
28929,/images/b12ae3b1-613c-4c0e-9163-3c5cc314abf5.png,660,1394,774,1501,114,107,red blood cell,12198,0.9385964912280702,1.0654205607476634
61373,/images/e16c0dab-780d-4035-872e-1bb91e49f9d2.png,525,712,617,810,92,98,red blood cell,9016,1.065217391304348,0.9387755102040817
13653,/images/1e86933d-6a5a-4a3c-a0f2-ca22afd767b3.png,149,304,239,404,90,100,red blood cell,9000,1.1111111111111112,0.9
60568,/images/58065a0c-d4c5-40fd-bcdc-037f61788482.png,690,460,814,578,124,118,red blood cell,14632,0.9516129032258065,1.0508474576271187
76785,/images/2165fe38-b474-467d-be11-d1d728085efd.png,956,1409,1072,1513,116,104,red blood cell,12064,0.896551724137931,1.1153846153846154
44996,/images/13bab3c3-3f79-44d9-a287-0ae6d71eff31.png,546,525,655,641,109,116,red blood cell,12644,1.0642201834862386,0.9396551724137931
41996,/images/46a03374-64c7-49ac-81c9-c3d62542bbf3.png,405,1434,513,1551,108,117,red blood cell,12636,1.0833333333333333,0.9230769230769231
79118,/images/1c90231b-2830-42d9-884e-7301edb16933.png,636,1135,745,1246,109,111,red blood cell,12099,1.018348623853211,0.9819819819819819
8708,/images/92e4fd7b-79ef-49c2-a52b-9ef13dd720ef.png,526,1055,656,1184,130,129,red blood cell,16770,0.9923076923076923,1.0077519379844961
67288,/images/49c4dbd3-6269-4d4c-9648-a2146c57bab1.png,44,231,162,346,118,115,red blood cell,13570,0.9745762711864406,1.0260869565217392
53959,/images/540a5fee-175b-4b92-bf62-1ea9b59c86c6.png,772,1051,880,1162,108,111,red blood cell,11988,1.0277777777777777,0.972972972972973
28721,/images/151f3af5-5e6e-4bcd-9389-4974fc68813e.png,994,367,1101,454,107,87,red blood cell,9309,0.8130841121495327,1.2298850574712643
75636,/images/c35ee701-fde2-46b5-b178-1fe3f1ea7da2.png,139,1234,240,1330,101,96,red blood cell,9696,0.9504950495049505,1.0520833333333333
76842,/images/2165fe38-b474-467d-be11-d1d728085efd.png,130,729,242,845,112,116,red blood cell,12992,1.0357142857142858,0.9655172413793104
24823,/images/65054b19-5c6a-4870-99a9-eef994721d3a.png,788,881,923,1001,135,120,red blood cell,16200,0.8888888888888888,1.125
78971,/images/6144887d-a1c1-46db-91a1-f7ff5bf8c8a5.png,826,414,918,516,92,102,red blood cell,9384,1.108695652173913,0.9019607843137255
7350,/images/89f10192-d3dd-4996-a571-4c851dbdc983.png,558,1333,644,1436,86,103,red blood cell,8858,1.197674418604651,0.8349514563106796
3267,/images/b901c906-91be-48c4-88ec-2c527544a258.png,1023,1192,1158,1310,135,118,red blood cell,15930,0.8740740740740741,1.1440677966101696
74427,/images/06a3effb-996c-4767-afd2-6aa3b697cb4e.png,1001,853,1112,966,111,113,red blood cell,12543,1.018018018018018,0.9823008849557522
45830,/images/584d62ed-4329-45dd-94ce-e929d8b2bb74.png,23,661,112,757,89,96,red blood cell,8544,1.0786516853932584,0.9270833333333334
29825,/images/7ef90770-6aeb-45eb-9744-49c5247dde30.png,1089,47,1196,162,107,115,red blood cell,12305,1.074766355140187,0.9304347826086956
52305,/images/a86e0647-ae41-4b75-9d45-dd58f5ea65f5.png,108,329,221,459,113,130,red blood cell,14690,1.1504424778761062,0.8692307692307693
13718,/images/0b04ec46-5119-4cda-8c35-c4e5b6f0eed0.png,517,832,648,953,131,121,red blood cell,15851,0.9236641221374046,1.0826446280991735
73118,/images/f39e2289-fedd-4d12-9e64-ffdafb89247e.png,1029,1376,1122,1490,93,114,red blood cell,10602,1.2258064516129032,0.8157894736842105
3559,/images/25132962-ff5d-4737-995f-c54d8490539b.png,872,891,982,1000,110,109,red blood cell,11990,0.990909090909091,1.0091743119266054
21843,/images/9b3fd401-dab0-440f-8498-eb3cc9ffa970.png,1058,163,1176,280,118,117,red blood cell,13806,0.9915254237288136,1.0085470085470085
39853,/images/af2e63a3-9fde-46aa-a867-81c5c259d1dc.png,412,444,531,561,119,117,red blood cell,13923,0.9831932773109243,1.017094017094017
64203,/images/2a91387a-d30f-418d-ac3a-f7cfa6836261.png,989,225,1093,337,104,112,red blood cell,11648,1.0769230769230769,0.9285714285714286
58299,/images/319c9c52-f316-49f3-baad-4444ab19f85b.png,373,676,467,787,94,111,red blood cell,10434,1.1808510638297873,0.8468468468468469
43004,/images/6c7095cd-ab6b-4f53-bd94-905d0cc95840.png,1082,632,1180,743,98,111,red blood cell,10878,1.1326530612244898,0.8828828828828829
73657,/images/a51d6c18-f9e8-4714-9dbb-38e1577445f2.png,1105,148,1199,250,94,102,red blood cell,9588,1.0851063829787233,0.9215686274509803
61583,/images/4a717a39-80f8-4b75-a25e-c46d65d7dcd5.png,205,1237,295,1325,90,88,red blood cell,7920,0.9777777777777777,1.0227272727272727
26007,/images/612bdd3c-da43-4321-a76b-c73c614928d1.png,164,1005,287,1121,123,116,red blood cell,14268,0.943089430894309,1.0603448275862069
73085,/images/f39e2289-fedd-4d12-9e64-ffdafb89247e.png,980,286,1084,389,104,103,red blood cell,10712,0.9903846153846154,1.0097087378640777
58000,/images/7942691b-6376-4c75-ae8a-ddf65454dcb2.png,802,996,908,1117,106,121,red blood cell,12826,1.1415094339622642,0.8760330578512396
45322,/images/e4eea7ea-8989-46a9-9c98-25a178146b28.png,12,1184,116,1277,104,93,red blood cell,9672,0.8942307692307693,1.118279569892473
17244,/images/471f75c6-bd5d-4c20-bcc1-258e836f4d69.png,123,442,216,545,93,103,red blood cell,9579,1.10752688172043,0.9029126213592233
62693,/images/9e1b0217-0926-4fd1-bb9e-a815c05deb59.png,419,1267,517,1368,98,101,red blood cell,9898,1.030612244897959,0.9702970297029703
62543,/images/9ecf2006-8d49-4ae8-a14b-ed8b3b14ee7c.png,725,585,854,709,129,124,red blood cell,15996,0.9612403100775194,1.0403225806451613
35496,/images/3722d213-f2a9-46d5-aa76-9183b443e455.png,770,1179,914,1310,144,131,red blood cell,18864,0.9097222222222222,1.099236641221374
54773,/images/10891eed-b0f2-4dd0-90cb-da185f6761b2.png,762,392,865,505,103,113,red blood cell,11639,1.0970873786407767,0.911504424778761
43804,/images/c84edeb4-311c-4e82-88f9-ae0505b3ad13.png,362,312,451,395,89,83,red blood cell,7387,0.9325842696629213,1.072289156626506
36622,/images/21f001d6-f568-4ea4-82da-fab54c77c419.png,418,432,511,538,93,106,red blood cell,9858,1.1397849462365592,0.8773584905660378
8076,/images/694222bb-cddf-469a-9526-f873c6fba58e.png,278,347,372,438,94,91,red blood cell,8554,0.9680851063829787,1.032967032967033
31543,/images/3130f950-8345-4315-9711-92f7af3f5c14.png,994,386,1114,506,120,120,red blood cell,14400,1.0,1.0
56720,/images/b3606d0e-6fe5-478a-bb4b-64d7c4889d86.png,200,13,306,111,106,98,red blood cell,10388,0.9245283018867925,1.0816326530612246
58124,/images/e9916e11-9be6-4dec-9df6-2e7d1a8e1735.png,86,853,185,958,99,105,red blood cell,10395,1.0606060606060606,0.9428571428571428
33440,/images/244ac6fa-8a92-4214-9cf4-ae0811d9ec7e.png,186,1368,282,1467,96,99,red blood cell,9504,1.03125,0.9696969696969697
44224,/images/8b494b40-cab5-49d3-893d-c805000fbe88.png,953,1390,1040,1476,87,86,red blood cell,7482,0.9885057471264368,1.0116279069767442
67923,/images/41ebf9a1-24dc-454e-8bf8-508218f5ee57.png,548,1052,656,1146,108,94,red blood cell,10152,0.8703703703703703,1.148936170212766
61435,/images/7e837856-3519-4dc0-b357-4cdcfd30b4eb.png,436,283,542,389,106,106,red blood cell,11236,1.0,1.0
49505,/images/9f33e0ea-065b-4703-9df9-15829b891860.png,750,71,839,169,89,98,red blood cell,8722,1.101123595505618,0.9081632653061225
36990,/images/b2e34f5f-904e-4473-9dc7-c6bc1ce12640.png,270,1237,370,1324,100,87,red blood cell,8700,0.87,1.1494252873563218
40508,/images/e3ade58d-086c-47fa-9120-76beacb45395.png,789,974,905,1084,116,110,red blood cell,12760,0.9482758620689655,1.0545454545454545
52402,/images/a2a20600-f851-4db7-90f9-6f7be027c8b5.png,134,247,242,345,108,98,red blood cell,10584,0.9074074074074074,1.1020408163265305
78843,/images/19979a60-df80-4111-bf69-81a7e9c4dd0b.png,1040,71,1161,200,121,129,red blood cell,15609,1.0661157024793388,0.937984496124031
68210,/images/ff1b23d0-3cef-459b-b81f-39bfcdb6526f.png,487,669,610,771,123,102,red blood cell,12546,0.8292682926829268,1.2058823529411764
34179,/images/f1cda808-69a9-4d10-ba0a-6607c98e362d.png,956,1343,1082,1480,126,137,red blood cell,17262,1.0873015873015872,0.9197080291970803
56107,/images/50d9fc90-8642-4bb6-91a7-0069a7e37392.png,748,659,849,755,101,96,red blood cell,9696,0.9504950495049505,1.0520833333333333
6713,/images/672e4ecf-a56b-462e-b83b-76f4efaa6634.png,228,401,341,526,113,125,red blood cell,14125,1.1061946902654867,0.904
70446,/images/8cca114a-ed05-4b87-95b7-fae02487f08c.png,573,783,699,884,126,101,red blood cell,12726,0.8015873015873016,1.2475247524752475
38314,/images/674b0fd3-f247-4b7f-97f7-3e6c57c9ba9e.png,679,9,775,111,96,102,red blood cell,9792,1.0625,0.9411764705882353
74713,/images/5ccca8ee-abea-458a-a891-bedd31c3ddc3.png,308,476,411,571,103,95,red blood cell,9785,0.9223300970873787,1.0842105263157895
49671,/images/9842445c-5899-4189-9f2e-3a3a179fdad3.png,504,127,623,238,119,111,red blood cell,13209,0.9327731092436975,1.072072072072072
1902,/images/02ea7aa8-c142-4a3d-939f-e77689741341.png,141,367,249,475,108,108,red blood cell,11664,1.0,1.0
41361,/images/a065c50b-341d-4803-b4b0-0fe8f04fdbb5.png,281,1038,378,1133,97,95,red blood cell,9215,0.979381443298969,1.0210526315789474
68194,/images/ff1b23d0-3cef-459b-b81f-39bfcdb6526f.png,838,870,931,960,93,90,red blood cell,8370,0.967741935483871,1.0333333333333334
22278,/images/787abd97-dd37-4212-8b43-61696eb3abc0.png,939,197,1049,305,110,108,red blood cell,11880,0.9818181818181818,1.0185185185185186
44566,/images/419309ef-da3f-4424-93cf-01ff4c52b017.png,629,1086,722,1202,93,116,red blood cell,10788,1.2473118279569892,0.8017241379310345
35217,/images/a9159b11-ba49-4885-902e-00c8d5095b98.png,999,838,1110,948,111,110,red blood cell,12210,0.990990990990991,1.009090909090909
70451,/images/8cca114a-ed05-4b87-95b7-fae02487f08c.png,542,1289,633,1387,91,98,red blood cell,8918,1.0769230769230769,0.9285714285714286
38342,/images/674b0fd3-f247-4b7f-97f7-3e6c57c9ba9e.png,674,130,760,229,86,99,red blood cell,8514,1.1511627906976745,0.8686868686868687
31691,/images/bd432159-5956-457c-bdeb-1b5e702ba513.png,384,10,486,134,102,124,red blood cell,12648,1.2156862745098038,0.8225806451612904
43870,/images/679ae89f-4a02-4301-862e-1d844cc66cbf.png,403,258,525,378,122,120,red blood cell,14640,0.9836065573770492,1.0166666666666666
20541,/images/cbde7f7e-2458-4dda-9db2-3d5ccf950ced.png,288,778,402,904,114,126,red blood cell,14364,1.105263157894737,0.9047619047619048
67161,/images/be6fe358-dee1-4dcf-9b0d-5d8612aba577.png,272,119,376,228,104,109,red blood cell,11336,1.0480769230769231,0.9541284403669725
23623,/images/79d7a014-21ff-40f1-9ac4-a69839390654.png,103,474,213,586,110,112,red blood cell,12320,1.018181818181818,0.9821428571428571
53013,/images/42e87148-a015-4148-923a-fb83016f64e7.png,94,59,220,166,126,107,red blood cell,13482,0.8492063492063492,1.1775700934579438
26718,/images/2518f6e4-29cc-4ae4-a914-b215a4c56099.png,911,89,1020,188,109,99,red blood cell,10791,0.908256880733945,1.101010101010101
35698,/images/4063945d-03fc-4ce3-a04c-17435dce8f91.png,762,148,882,261,120,113,red blood cell,13560,0.9416666666666667,1.0619469026548674
26251,/images/52767904-4cdc-4821-ba68-8cd0c28f9023.png,1053,575,1174,704,121,129,red blood cell,15609,1.0661157024793388,0.937984496124031
14331,/images/f5eb7c5e-bd77-4638-ba9f-58d42f87476b.png,236,81,348,191,112,110,red blood cell,12320,0.9821428571428571,1.018181818181818
74023,/images/fe436c09-b680-4f4c-8faf-aa10a55a335b.png,536,289,630,391,94,102,red blood cell,9588,1.0851063829787233,0.9215686274509803
756,/images/dcc1a193-7b74-44f8-ad8d-813751d8fa6b.png,835,1073,949,1203,114,130,red blood cell,14820,1.1403508771929824,0.8769230769230769
34071,/images/de5d19b7-e670-4ac7-843b-7ce7bcebdf45.png,317,341,424,445,107,104,red blood cell,11128,0.9719626168224299,1.0288461538461537
25047,/images/ed0bee2f-05e0-4392-8357-19750cec577c.png,1068,1342,1154,1429,86,87,red blood cell,7482,1.0116279069767442,0.9885057471264368
78582,/images/c5084fb8-2b62-464c-8a77-1a07ea653266.png,737,1488,848,1597,111,109,red blood cell,12099,0.9819819819819819,1.018348623853211
25951,/images/e683144c-0465-43a2-86b1-3cf52599d5e0.png,55,205,156,299,101,94,red blood cell,9494,0.9306930693069307,1.074468085106383
67920,/images/41ebf9a1-24dc-454e-8bf8-508218f5ee57.png,697,1484,770,1563,73,79,red blood cell,5767,1.082191780821918,0.9240506329113924
42716,/images/b8dd6125-5027-47e2-a283-14e199274c80.png,396,742,516,865,120,123,red blood cell,14760,1.025,0.975609756097561
2883,/images/a1c140f9-75d7-42a3-b767-4c01a118892b.png,645,174,746,291,101,117,red blood cell,11817,1.1584158415841583,0.8632478632478633
77135,/images/dd6f047e-af73-43df-9c46-354534fc20e0.png,352,980,465,1103,113,123,red blood cell,13899,1.0884955752212389,0.9186991869918699
61015,/images/3d1429ed-4619-41f7-8ff3-d698ad28034c.png,784,1482,888,1585,104,103,red blood cell,10712,0.9903846153846154,1.0097087378640777
46439,/images/bbecf1a8-a728-4c83-87f8-4dfbac0a1e03.png,312,1114,419,1232,107,118,red blood cell,12626,1.102803738317757,0.9067796610169492
78471,/images/72029aca-f0bc-477f-b790-f345f86228ce.png,347,676,473,808,126,132,red blood cell,16632,1.0476190476190477,0.9545454545454546
25423,/images/5f742392-278d-461c-a848-08def2c28878.png,498,1004,628,1127,130,123,red blood cell,15990,0.9461538461538461,1.056910569105691
52115,/images/de6d3020-9347-473b-9146-8909627790f6.png,1105,1460,1195,1563,90,103,red blood cell,9270,1.1444444444444444,0.8737864077669902
10980,/images/c442e2d6-aaf9-417a-9905-4737a1115f33.png,147,350,270,478,123,128,red blood cell,15744,1.0406504065040652,0.9609375
13350,/images/a7f1bbb1-6058-4642-bd66-cfb90dce762e.png,916,352,1022,484,106,132,red blood cell,13992,1.2452830188679245,0.803030303030303
20511,/images/cbde7f7e-2458-4dda-9db2-3d5ccf950ced.png,824,771,961,889,137,118,red blood cell,16166,0.8613138686131386,1.1610169491525424
29355,/images/3850f2a5-ab62-49d3-8135-68d60baa676b.png,100,456,221,579,121,123,red blood cell,14883,1.0165289256198347,0.983739837398374
56050,/images/177a3141-fa93-426a-9b52-7da71547ce44.png,300,424,394,517,94,93,red blood cell,8742,0.9893617021276596,1.010752688172043
23021,/images/0d095f3a-9243-472b-90b4-0ce8309e778c.png,345,1312,456,1440,111,128,red blood cell,14208,1.1531531531531531,0.8671875
11677,/images/0ed416f9-7c20-4829-9016-559e4009568e.png,696,1017,821,1122,125,105,red blood cell,13125,0.84,1.1904761904761905
48220,/images/71204a6d-814e-44b6-9cee-7b979f478021.png,364,1023,460,1121,96,98,red blood cell,9408,1.0208333333333333,0.9795918367346939
48463,/images/e13f2327-fbf4-4d84-a8c1-09cb1e449c8c.png,895,163,1025,290,130,127,red blood cell,16510,0.9769230769230769,1.0236220472440944
33607,/images/00c8364b-8c85-4502-bcfe-64736fe76815.png,205,285,310,401,105,116,red blood cell,12180,1.1047619047619048,0.9051724137931034
40256,/images/f05ffdca-dc3a-47bd-a231-2a0d9bd1d50e.png,25,1077,148,1212,123,135,red blood cell,16605,1.0975609756097562,0.9111111111111111
40105,/images/6fd30823-3b77-40c9-ba5d-e1eda9660674.png,504,1387,617,1492,113,105,red blood cell,11865,0.9292035398230089,1.0761904761904761
52145,/images/94d9fa50-d3e4-4eaf-acfc-92e7f2ed9ea5.png,935,609,1029,713,94,104,red blood cell,9776,1.1063829787234043,0.9038461538461539
39559,/images/5a631871-2fc7-4a68-9c39-f3b9a0bf4a04.png,669,1009,761,1106,92,97,red blood cell,8924,1.0543478260869565,0.9484536082474226
48256,/images/71204a6d-814e-44b6-9cee-7b979f478021.png,907,1273,1017,1383,110,110,red blood cell,12100,1.0,1.0
72743,/images/caeb2d62-1166-43f0-8eac-5b8fc48f02eb.png,298,397,401,504,103,107,red blood cell,11021,1.0388349514563107,0.9626168224299065
6725,/images/672e4ecf-a56b-462e-b83b-76f4efaa6634.png,523,1336,641,1457,118,121,red blood cell,14278,1.0254237288135593,0.9752066115702479
38077,/images/e3e9c2de-0a24-4c7e-8a69-3d3093d5bdab.png,814,820,887,910,73,90,red blood cell,6570,1.2328767123287672,0.8111111111111111
13008,/images/b10ea12f-cd36-4f2c-994a-67d1665269ab.png,272,1308,359,1404,87,96,red blood cell,8352,1.103448275862069,0.90625
35004,/images/2b369d75-9c55-43e0-b352-d981aea544e3.png,230,416,338,520,108,104,red blood cell,11232,0.9629629629629629,1.0384615384615385
78156,/images/bb137718-20ba-457d-8ffe-4f9420ecaab6.png,707,0,811,100,104,100,red blood cell,10400,0.9615384615384616,1.04
27564,/images/715761a2-745e-4743-9849-956a034ad3c4.png,14,765,131,869,117,104,red blood cell,12168,0.8888888888888888,1.125
42554,/images/9a25f103-1683-47d1-8b07-ac20fe0b3ee9.png,576,1130,708,1246,132,116,red blood cell,15312,0.8787878787878788,1.1379310344827587
46358,/images/fcc2b245-f47f-447f-8527-275b0005677c.png,428,1078,539,1193,111,115,red blood cell,12765,1.0360360360360361,0.9652173913043478
4212,/images/ac3358f1-ef9a-4ccc-b66c-da5e47e352e0.png,736,180,849,302,113,122,red blood cell,13786,1.079646017699115,0.9262295081967213
21611,/images/66183740-e1e5-43c9-8539-a87028bb3621.png,1037,440,1139,549,102,109,red blood cell,11118,1.0686274509803921,0.9357798165137615
44174,/images/8b494b40-cab5-49d3-893d-c805000fbe88.png,409,940,516,1026,107,86,red blood cell,9202,0.8037383177570093,1.244186046511628
66905,/images/9acf303a-fcba-4e52-be3e-8d061aa5e72a.png,1013,839,1106,935,93,96,red blood cell,8928,1.032258064516129,0.96875
34436,/images/b4bde4e8-f48b-4ae2-be01-86d8c91d0af9.png,205,627,317,736,112,109,red blood cell,12208,0.9732142857142857,1.0275229357798166
66894,/images/9acf303a-fcba-4e52-be3e-8d061aa5e72a.png,123,1154,232,1260,109,106,red blood cell,11554,0.9724770642201835,1.028301886792453
14648,/images/9d155086-acf5-4c86-a9e1-94b587c46e87.png,989,847,1098,968,109,121,red blood cell,13189,1.110091743119266,0.9008264462809917
19502,/images/a85cd1ae-0c94-4387-8305-84ab8d96d137.png,697,1405,817,1530,120,125,red blood cell,15000,1.0416666666666667,0.96
46874,/images/63055d1b-5221-4c80-8b39-37ac069a1b5c.png,985,631,1104,729,119,98,red blood cell,11662,0.8235294117647058,1.2142857142857142
340,/images/7c66d2fd-68ee-4628-b860-9d7ad25b2a80.png,1006,931,1112,1042,106,111,red blood cell,11766,1.0471698113207548,0.954954954954955
75438,/images/468c261d-f5d8-423f-883e-48af2bbbc5d1.png,273,71,377,171,104,100,red blood cell,10400,0.9615384615384616,1.04
57782,/images/5c037ffc-f515-48b3-b231-c110fbd2b8ca.png,219,213,297,306,78,93,red blood cell,7254,1.1923076923076923,0.8387096774193549
32358,/images/a6526894-e290-482d-ac43-f1df34864817.png,668,74,781,198,113,124,red blood cell,14012,1.0973451327433628,0.9112903225806451
41047,/images/e871f52c-77a6-4813-80d4-95bd97985f1a.png,414,512,523,630,109,118,red blood cell,12862,1.0825688073394495,0.923728813559322
35280,/images/516bf1d5-5d00-4985-926c-3993e9bc3ff5.png,196,1388,322,1524,126,136,red blood cell,17136,1.0793650793650793,0.9264705882352942
79287,/images/05ac7b2a-6a77-4464-926b-8570f7c01693.png,523,419,615,524,92,105,red blood cell,9660,1.141304347826087,0.8761904761904762
78473,/images/72029aca-f0bc-477f-b790-f345f86228ce.png,472,69,586,184,114,115,red blood cell,13110,1.0087719298245614,0.991304347826087
47965,/images/eba73bff-fbe1-436d-9a5f-0a61331a0ea2.png,970,1185,1068,1295,98,110,red blood cell,10780,1.1224489795918366,0.8909090909090909
35042,/images/67582df6-bf13-4c83-a531-1214692b70de.png,539,141,649,269,110,128,red blood cell,14080,1.1636363636363636,0.859375
8192,/images/6bb4892c-27a9-4642-aba1-4b73f38f757c.png,562,441,664,542,102,101,red blood cell,10302,0.9901960784313726,1.00990099009901
61000,/images/3d1429ed-4619-41f7-8ff3-d698ad28034c.png,1012,363,1122,477,110,114,red blood cell,12540,1.0363636363636364,0.9649122807017544
1657,/images/5f783f43-0090-4f8a-bd75-9562f4aa2dd5.png,642,48,737,152,95,104,red blood cell,9880,1.0947368421052632,0.9134615384615384
33752,/images/441d7843-b20b-4c10-84e3-e6d32621e880.png,899,1119,1001,1218,102,99,red blood cell,10098,0.9705882352941176,1.0303030303030303
71289,/images/445d0db9-e830-4ceb-a845-b23d819e6097.png,428,666,520,765,92,99,red blood cell,9108,1.076086956521739,0.9292929292929293
15361,/images/035f6c4b-0897-46ab-9c3b-5f3b0feff043.png,568,272,671,383,103,111,red blood cell,11433,1.0776699029126213,0.9279279279279279
73109,/images/f39e2289-fedd-4d12-9e64-ffdafb89247e.png,289,370,408,479,119,109,red blood cell,12971,0.9159663865546218,1.091743119266055
39959,/images/8271d0d8-9985-43eb-94b3-c702adca139f.png,799,1270,920,1385,121,115,red blood cell,13915,0.9504132231404959,1.0521739130434782
77399,/images/c7ec51d5-9f45-4209-8357-39e9a984a733.png,917,318,1007,410,90,92,red blood cell,8280,1.0222222222222221,0.9782608695652174
11463,/images/2f9f400d-2d67-4118-aaa1-9094bc4b0e47.png,660,322,788,449,128,127,red blood cell,16256,0.9921875,1.0078740157480315
57831,/images/c9ad92d4-b408-4506-916e-def47b2e6ed0.png,964,56,1073,180,109,124,red blood cell,13516,1.1376146788990826,0.8790322580645161
49738,/images/5e17f8e6-fd8d-426c-b444-1515d14f04b7.png,594,1270,710,1382,116,112,red blood cell,12992,0.9655172413793104,1.0357142857142858
71695,/images/5c99cd97-39f6-4809-9528-9d380cc16b16.png,712,872,805,970,93,98,red blood cell,9114,1.053763440860215,0.9489795918367347
79702,/images/03b9d6ad-39ca-4097-a98b-77f02b3c00a7.png,779,644,887,760,108,116,red blood cell,12528,1.0740740740740742,0.9310344827586207
54534,/images/db871d17-28fd-4ceb-b421-e4e4afa0a7a0.png,118,760,237,884,119,124,red blood cell,14756,1.0420168067226891,0.9596774193548387
8072,/images/694222bb-cddf-469a-9526-f873c6fba58e.png,423,1355,539,1449,116,94,red blood cell,10904,0.8103448275862069,1.2340425531914894
18795,/images/cc882eae-a341-4783-bd19-8bdedf798538.png,752,912,853,1004,101,92,red blood cell,9292,0.9108910891089109,1.0978260869565217
18779,/images/cc882eae-a341-4783-bd19-8bdedf798538.png,207,780,318,879,111,99,red blood cell,10989,0.8918918918918919,1.121212121212121
48259,/images/71204a6d-814e-44b6-9cee-7b979f478021.png,988,77,1091,171,103,94,red blood cell,9682,0.912621359223301,1.0957446808510638
77189,/images/fe691faa-3bc7-475e-b558-aa8fe7b795bc.png,907,83,1012,193,105,110,red blood cell,11550,1.0476190476190477,0.9545454545454546
75362,/images/468c261d-f5d8-423f-883e-48af2bbbc5d1.png,1021,902,1115,992,94,90,red blood cell,8460,0.9574468085106383,1.0444444444444445
36786,/images/aa2dfa24-2dc3-4279-a232-f84780ace190.png,845,1414,956,1551,111,137,red blood cell,15207,1.2342342342342343,0.8102189781021898
27221,/images/9f38055f-4fe6-47fd-a6dd-c0743db4eccf.png,198,1247,322,1365,124,118,red blood cell,14632,0.9516129032258065,1.0508474576271187
56746,/images/b3606d0e-6fe5-478a-bb4b-64d7c4889d86.png,684,685,791,791,107,106,red blood cell,11342,0.9906542056074766,1.009433962264151
38566,/images/c3ae7090-fc68-41b4-85a1-8d9bce9825a7.png,122,1329,241,1445,119,116,red blood cell,13804,0.9747899159663865,1.0258620689655173
47589,/images/06cd484f-e864-4fee-8819-688b45eed98e.png,803,1415,919,1550,116,135,red blood cell,15660,1.1637931034482758,0.8592592592592593
27865,/images/948c94ad-395c-41f4-9a68-8a1dcb76888c.png,276,1338,362,1431,86,93,red blood cell,7998,1.0813953488372092,0.9247311827956989
16889,/images/4823c1fe-a7f9-4b92-959f-0d9be09cd14b.png,862,1280,953,1365,91,85,red blood cell,7735,0.9340659340659341,1.0705882352941176
39534,/images/5a631871-2fc7-4a68-9c39-f3b9a0bf4a04.png,241,1355,343,1457,102,102,red blood cell,10404,1.0,1.0
66811,/images/9106a6bb-1352-411f-ac26-0d6fe48c16a8.png,961,1249,1060,1348,99,99,red blood cell,9801,1.0,1.0
43215,/images/fe1ee954-ba71-47b3-954a-d20ab940cd7b.png,655,278,776,396,121,118,red blood cell,14278,0.9752066115702479,1.0254237288135593
57450,/images/00d04a90-80e5-4bce-9511-1b64eabb7a47.png,363,422,456,526,93,104,red blood cell,9672,1.118279569892473,0.8942307692307693
66386,/images/e5fd5949-4cd0-4cb6-837a-02c26a5eb87a.png,886,67,1005,192,119,125,red blood cell,14875,1.050420168067227,0.952
16255,/images/acdc6e12-73d9-44ba-be8c-2a56aaffef4f.png,519,834,636,960,117,126,red blood cell,14742,1.0769230769230769,0.9285714285714286
28021,/images/c4d34e35-4db2-41de-ba77-1a94aa9ef788.png,957,857,1078,955,121,98,red blood cell,11858,0.8099173553719008,1.2346938775510203
42015,/images/46a03374-64c7-49ac-81c9-c3d62542bbf3.png,289,1404,380,1508,91,104,red blood cell,9464,1.1428571428571428,0.875
1267,/images/6d91d1f0-636b-4f5a-a526-7c17fc857190.png,698,640,812,742,114,102,red blood cell,11628,0.8947368421052632,1.1176470588235294
3158,/images/729a38d6-66db-48e5-a00d-7d90d224290f.png,417,1137,536,1279,119,142,red blood cell,16898,1.1932773109243697,0.8380281690140845
62858,/images/4b346035-b8c0-46ca-8fdb-a01b1421ee4a.png,486,76,597,184,111,108,red blood cell,11988,0.972972972972973,1.0277777777777777
30112,/images/81c3c8f0-d5a9-4dda-afd5-e86f6afd9424.png,528,295,624,389,96,94,red blood cell,9024,0.9791666666666666,1.0212765957446808
79949,/images/e640ae51-cbf1-4a84-b7cf-d38b17f59c2f.png,964,1419,1059,1517,95,98,red blood cell,9310,1.0315789473684212,0.9693877551020408
16654,/images/bc377041-e098-45c4-9651-2b1ea90d1d7e.png,406,343,548,470,142,127,red blood cell,18034,0.8943661971830986,1.1181102362204725
22949,/images/ecd68ba2-48af-4866-826a-7cd1c147c055.png,439,16,555,124,116,108,red blood cell,12528,0.9310344827586207,1.0740740740740742
68799,/images/aa3ad405-828e-4986-8251-20fd981f34d3.png,888,1143,1013,1262,125,119,red blood cell,14875,0.952,1.050420168067227
59165,/images/4736f545-1f1f-4d77-9241-d69cbf4dae35.png,708,780,803,882,95,102,red blood cell,9690,1.0736842105263158,0.9313725490196079
26135,/images/27388ff2-4000-4c9a-a2e3-addc448a5f92.png,719,175,858,299,139,124,red blood cell,17236,0.8920863309352518,1.1209677419354838
15805,/images/64113b22-03b1-4ab8-89ab-b2f32154fbbd.png,152,730,247,836,95,106,red blood cell,10070,1.1157894736842104,0.8962264150943396
67917,/images/41ebf9a1-24dc-454e-8bf8-508218f5ee57.png,819,351,901,434,82,83,red blood cell,6806,1.0121951219512195,0.9879518072289156
14726,/images/1fdf99d1-a494-4174-bcd7-efbe457ab899.png,219,1209,317,1300,98,91,red blood cell,8918,0.9285714285714286,1.0769230769230769
59490,/images/a7c3c52f-3b40-4c92-a212-df9462cf25d8.png,482,1285,576,1397,94,112,red blood cell,10528,1.1914893617021276,0.8392857142857143
24323,/images/4d8a4ce8-0f9c-4f21-8844-4cf0e5514bbf.png,7,79,118,181,111,102,red blood cell,11322,0.918918918918919,1.088235294117647
64425,/images/34a70114-d3e3-4351-b8db-f6caab17e743.png,831,1155,930,1264,99,109,red blood cell,10791,1.101010101010101,0.908256880733945
41395,/images/65e8b0cd-05d1-4c8d-8efd-24bf71df3167.png,499,266,633,383,134,117,red blood cell,15678,0.8731343283582089,1.1452991452991452
64701,/images/76021d69-8919-4688-95ef-7418eff620cc.png,754,528,859,644,105,116,red blood cell,12180,1.1047619047619048,0.9051724137931034
77038,/images/637957ef-df75-4a7b-86d5-9f6e9c042ca2.png,162,933,257,1028,95,95,red blood cell,9025,1.0,1.0
10160,/images/09ecf7be-28e2-4531-b9e2-07e01c44097d.png,152,571,238,662,86,91,red blood cell,7826,1.058139534883721,0.945054945054945
55443,/images/d67655e6-0a80-4a86-b552-1f5e85788377.png,74,1512,163,1594,89,82,red blood cell,7298,0.9213483146067416,1.0853658536585367
78265,/images/adff6e1d-ba9d-4c7b-a8fe-1ec458eaeeb8.png,680,862,790,974,110,112,red blood cell,12320,1.018181818181818,0.9821428571428571
30054,/images/81c3c8f0-d5a9-4dda-afd5-e86f6afd9424.png,1023,64,1119,167,96,103,red blood cell,9888,1.0729166666666667,0.9320388349514563
19756,/images/68e69cfb-1a07-48d2-8abe-46b46fe264ed.png,891,87,986,191,95,104,red blood cell,9880,1.0947368421052632,0.9134615384615384
55146,/images/29d4b75f-d400-4702-a9ac-e5a4ed1a1db1.png,431,617,534,726,103,109,red blood cell,11227,1.058252427184466,0.944954128440367
47653,/images/4b3a49bc-8536-4760-9553-440a6f64db37.png,479,290,584,403,105,113,red blood cell,11865,1.0761904761904761,0.9292035398230089
76538,/images/38c69905-8a4f-451a-8d0a-b855dc88dd16.png,568,157,669,253,101,96,red blood cell,9696,0.9504950495049505,1.0520833333333333
53045,/images/69b5b3de-ec64-4e5d-bcc2-44f495e06e76.png,146,1412,247,1510,101,98,red blood cell,9898,0.9702970297029703,1.030612244897959
21304,/images/8dace03a-10c4-4d59-bcd9-a2c314c5df33.png,460,790,579,899,119,109,red blood cell,12971,0.9159663865546218,1.091743119266055
15167,/images/3a8f468f-f9de-46a8-a7c8-f2be239fa207.png,442,876,532,976,90,100,red blood cell,9000,1.1111111111111112,0.9
28682,/images/151f3af5-5e6e-4bcd-9389-4974fc68813e.png,548,75,661,188,113,113,red blood cell,12769,1.0,1.0
50014,/images/b1145408-feae-4637-b4cf-3e70b99cc62d.png,688,327,790,452,102,125,red blood cell,12750,1.2254901960784315,0.816
33910,/images/1a332b2c-9d49-4ff2-810c-5633d2314527.png,951,53,1073,185,122,132,red blood cell,16104,1.0819672131147542,0.9242424242424242
32466,/images/3911fcd2-4e26-4ad9-aaf0-d1c5bf41defc.png,917,818,1033,937,116,119,red blood cell,13804,1.0258620689655173,0.9747899159663865
17912,/images/eb77e4a9-acb0-4d83-8055-2c5fcaa54b45.png,173,672,260,764,87,92,red blood cell,8004,1.0574712643678161,0.9456521739130435
53562,/images/7c1cd7c7-7452-4428-a98e-dd7675c8ddea.png,839,832,948,945,109,113,red blood cell,12317,1.036697247706422,0.9646017699115044
57311,/images/aaade430-4c49-4038-97b7-f8cdd937db57.png,598,722,709,837,111,115,red blood cell,12765,1.0360360360360361,0.9652173913043478
64328,/images/0a7bfa8a-ee52-4f7a-b9c5-2919ecfa93ef.png,13,491,119,607,106,116,red blood cell,12296,1.0943396226415094,0.9137931034482759
38730,/images/b426ef1d-4a59-4f90-b593-50226af60a60.png,451,354,564,479,113,125,red blood cell,14125,1.1061946902654867,0.904
927,/images/a8cb75ba-3f2f-40d8-8bc7-c79ebd1b9603.png,171,1303,264,1396,93,93,red blood cell,8649,1.0,1.0
29138,/images/4c13e22e-dfd1-4fa1-b373-be9d0c272c0f.png,487,452,564,542,77,90,red blood cell,6930,1.1688311688311688,0.8555555555555555
52207,/images/f4c00b8c-d675-4255-8277-ca65bd757f51.png,1051,159,1135,250,84,91,red blood cell,7644,1.0833333333333333,0.9230769230769231
29282,/images/6274fe0d-0d71-40be-b61b-f0bd5b5df1e2.png,1108,745,1195,825,87,80,red blood cell,6960,0.9195402298850575,1.0875
37736,/images/fe0c5e48-f65e-488c-9c3c-1ea7c7835c0c.png,853,1064,961,1152,108,88,red blood cell,9504,0.8148148148148148,1.2272727272727273
47778,/images/5a105b89-c592-4d78-b208-7db6c6572752.png,303,89,410,204,107,115,red blood cell,12305,1.074766355140187,0.9304347826086956
66672,/images/b88fe674-fb9a-41d4-b100-cb1c86440d44.png,969,450,1064,543,95,93,red blood cell,8835,0.9789473684210527,1.021505376344086
19832,/images/b318889c-3c60-477c-b8f6-d18cb01a59df.png,981,471,1097,602,116,131,red blood cell,15196,1.1293103448275863,0.8854961832061069
9256,/images/261562a8-ffd8-4e0e-919b-22e267000b74.png,750,1053,842,1161,92,108,red blood cell,9936,1.173913043478261,0.8518518518518519
12150,/images/87d6343b-70dd-4cdd-939f-d3ac0ca2e700.png,398,144,504,260,106,116,red blood cell,12296,1.0943396226415094,0.9137931034482759
73487,/images/5f2b32bd-fdca-4d6f-b13a-ee9f83626c8d.png,1077,1325,1183,1434,106,109,red blood cell,11554,1.028301886792453,0.9724770642201835
52241,/images/4903d9c7-de88-426a-b42d-a7e797e5ebcd.png,739,262,831,361,92,99,red blood cell,9108,1.076086956521739,0.9292929292929293
74356,/images/06a3effb-996c-4767-afd2-6aa3b697cb4e.png,508,1068,623,1193,115,125,red blood cell,14375,1.0869565217391304,0.92
49310,/images/99b13257-b9d9-422f-8262-802da0bdc510.png,149,706,292,826,143,120,red blood cell,17160,0.8391608391608392,1.1916666666666667
5632,/images/afa470d9-c74c-41cd-b4dc-7bf93fde8263.png,21,716,132,829,111,113,red blood cell,12543,1.018018018018018,0.9823008849557522
63297,/images/43bc935a-f655-45e1-a64d-fcb8b78267a6.png,978,871,1093,987,115,116,red blood cell,13340,1.008695652173913,0.9913793103448276
79041,/images/6144887d-a1c1-46db-91a1-f7ff5bf8c8a5.png,338,1327,439,1426,101,99,red blood cell,9999,0.9801980198019802,1.02020202020202
71270,/images/445d0db9-e830-4ceb-a845-b23d819e6097.png,159,1277,265,1384,106,107,red blood cell,11342,1.009433962264151,0.9906542056074766
30697,/images/8e0dfc1f-e3eb-4a3f-a1c4-249bdfbfaa27.png,577,1411,707,1536,130,125,red blood cell,16250,0.9615384615384616,1.04
1468,/images/0ac747cd-ff32-49bf-bc1a-3e9b7702ce9c.png,45,1234,149,1349,104,115,red blood cell,11960,1.1057692307692308,0.9043478260869565
43633,/images/a4851ed0-1499-4eae-9157-dcd34773254f.png,923,540,1019,658,96,118,red blood cell,11328,1.2291666666666667,0.8135593220338984
14899,/images/3090a362-1f3d-49e9-a76e-ce76ff9c2276.png,244,195,351,306,107,111,red blood cell,11877,1.0373831775700935,0.963963963963964
11749,/images/082e1f81-4f49-44ad-b5bb-9dfc155b2ed8.png,802,1478,894,1583,92,105,red blood cell,9660,1.141304347826087,0.8761904761904762
26018,/images/612bdd3c-da43-4321-a76b-c73c614928d1.png,1029,1292,1129,1376,100,84,red blood cell,8400,0.84,1.1904761904761905
28239,/images/036404d1-b9fc-497b-bbe1-f4d9c5ac3ce0.png,291,218,411,342,120,124,red blood cell,14880,1.0333333333333334,0.967741935483871
1716,/images/5f783f43-0090-4f8a-bd75-9562f4aa2dd5.png,317,763,430,877,113,114,red blood cell,12882,1.008849557522124,0.9912280701754386
33737,/images/441d7843-b20b-4c10-84e3-e6d32621e880.png,119,97,205,196,86,99,red blood cell,8514,1.1511627906976745,0.8686868686868687
32330,/images/1c406ce1-023b-47fc-a2cd-5ea2e255de65.png,15,1285,114,1386,99,101,red blood cell,9999,1.02020202020202,0.9801980198019802
53315,/images/d8f7e159-b7e3-49e4-86e8-aed8c5fbcd97.png,519,658,620,773,101,115,red blood cell,11615,1.1386138613861385,0.8782608695652174
20758,/images/eeac81a5-9202-4965-b7de-35b12910cdf6.png,594,835,713,977,119,142,red blood cell,16898,1.1932773109243697,0.8380281690140845
66336,/images/fcdf6632-c03f-49a8-9fb3-42e87c99b9d0.png,666,450,778,556,112,106,red blood cell,11872,0.9464285714285714,1.0566037735849056
66656,/images/b88fe674-fb9a-41d4-b100-cb1c86440d44.png,148,428,241,511,93,83,red blood cell,7719,0.8924731182795699,1.1204819277108433
73094,/images/f39e2289-fedd-4d12-9e64-ffdafb89247e.png,220,1445,318,1544,98,99,red blood cell,9702,1.010204081632653,0.98989898989899
28380,/images/34e024a5-5698-42d4-972f-fee234b4bd64.png,397,213,485,308,88,95,red blood cell,8360,1.0795454545454546,0.9263157894736842
39905,/images/71cf2467-77d3-4fac-ac6e-1d8767717c34.png,1075,85,1199,207,124,122,red blood cell,15128,0.9838709677419355,1.0163934426229508
35865,/images/2102e5d1-8bec-4ab6-ab35-2705485da1f8.png,339,649,469,773,130,124,red blood cell,16120,0.9538461538461539,1.0483870967741935
61043,/images/6e86206f-dafe-4c28-bacc-7b83b2d40f0c.png,92,44,215,157,123,113,red blood cell,13899,0.9186991869918699,1.0884955752212389
68262,/images/a6391703-0820-4913-a7cd-e843ff0d84ba.png,790,625,895,723,105,98,red blood cell,10290,0.9333333333333333,1.0714285714285714
18312,/images/9ca20b10-e2fd-4bd2-93ef-78298f763ed5.png,1004,583,1088,688,84,105,red blood cell,8820,1.25,0.8
45500,/images/e4eea7ea-8989-46a9-9c98-25a178146b28.png,716,766,805,862,89,96,red blood cell,8544,1.0786516853932584,0.9270833333333334
66285,/images/e8058bed-c362-4e1c-85dc-62f80f32938f.png,3,517,112,616,109,99,red blood cell,10791,0.908256880733945,1.101010101010101
15293,/images/2d0f600d-f94e-4907-b712-52fb37d9ed52.png,915,994,1021,1095,106,101,red blood cell,10706,0.9528301886792453,1.0495049504950495
15731,/images/3892b776-f49a-4368-b0fa-7e855e76ccec.png,222,1183,340,1283,118,100,red blood cell,11800,0.847457627118644,1.18
57215,/images/ca5e6a15-ba65-48ea-8913-2d986e71bf3a.png,685,1296,796,1407,111,111,red blood cell,12321,1.0,1.0
6318,/images/c6575e75-c8ce-4766-841f-1137b9e0956c.png,670,17,780,118,110,101,red blood cell,11110,0.9181818181818182,1.0891089108910892
2371,/images/fe851c88-692d-4199-87e0-d19d9c4eb591.png,684,971,795,1061,111,90,red blood cell,9990,0.8108108108108109,1.2333333333333334
52380,/images/a2a20600-f851-4db7-90f9-6f7be027c8b5.png,19,546,111,647,92,101,red blood cell,9292,1.0978260869565217,0.9108910891089109
67416,/images/266180ed-77a3-4284-8292-50a49fc47fce.png,548,1191,643,1280,95,89,red blood cell,8455,0.9368421052631579,1.0674157303370786
47763,/images/6b5ed184-cb15-4d54-93bb-9a3ca00184a1.png,176,765,297,892,121,127,red blood cell,15367,1.0495867768595042,0.952755905511811
76803,/images/2165fe38-b474-467d-be11-d1d728085efd.png,805,658,924,760,119,102,red blood cell,12138,0.8571428571428571,1.1666666666666667
61983,/images/bdb5d571-27bc-4a42-ae45-aa5a9af40a81.png,1046,1436,1161,1555,115,119,red blood cell,13685,1.0347826086956522,0.9663865546218487
33045,/images/6231d81d-9e84-4a5a-8cb8-47c6a37a0176.png,418,65,535,173,117,108,red blood cell,12636,0.9230769230769231,1.0833333333333333
24084,/images/505355c9-23bf-4f90-8ebc-6a7ef50964d0.png,754,1109,847,1202,93,93,red blood cell,8649,1.0,1.0
53240,/images/d8f7e159-b7e3-49e4-86e8-aed8c5fbcd97.png,672,956,761,1067,89,111,red blood cell,9879,1.247191011235955,0.8018018018018018
61296,/images/b3058064-d817-47dd-a8c4-cdb1f62374f8.png,6,96,99,200,93,104,red blood cell,9672,1.118279569892473,0.8942307692307693
69023,/images/b5246b58-6f40-4c9e-8024-f49b0ed6bdbd.png,743,1088,856,1187,113,99,red blood cell,11187,0.8761061946902655,1.1414141414141414
38189,/images/452ab003-ced5-40cb-82d1-5495d9e068b1.png,380,992,476,1110,96,118,red blood cell,11328,1.2291666666666667,0.8135593220338984
6981,/images/c776eb78-3323-4571-b39f-7ffc73ae63ce.png,870,124,992,247,122,123,red blood cell,15006,1.0081967213114753,0.991869918699187
43628,/images/a4851ed0-1499-4eae-9157-dcd34773254f.png,820,789,921,890,101,101,red blood cell,10201,1.0,1.0
53153,/images/801296d9-3403-426f-859e-5c532858e025.png,794,750,896,862,102,112,red blood cell,11424,1.0980392156862746,0.9107142857142857
45231,/images/b7a0d235-2217-43b4-aeff-cde4ccaf6789.png,138,666,287,793,149,127,red blood cell,18923,0.8523489932885906,1.1732283464566928
59770,/images/f77d7469-d083-4c2d-a4ea-5a9ff162e3e2.png,713,1022,800,1103,87,81,red blood cell,7047,0.9310344827586207,1.0740740740740742
62612,/images/f7a4334a-4332-4de8-b39b-22da907976f2.png,987,1410,1075,1509,88,99,red blood cell,8712,1.125,0.8888888888888888
17483,/images/56077789-8580-41b4-89d6-deea227e5c60.png,333,1345,434,1465,101,120,red blood cell,12120,1.188118811881188,0.8416666666666667
58552,/images/7fd2d254-b062-4f3d-8970-687e73c5a00a.png,834,509,939,611,105,102,red blood cell,10710,0.9714285714285714,1.0294117647058822
44825,/images/83ec8923-6232-40d7-ba1f-a1b8bf7cb66c.png,378,428,497,543,119,115,red blood cell,13685,0.9663865546218487,1.0347826086956522
34500,/images/fa1f9f89-cecb-4972-842c-d14c632f89a9.png,657,1455,763,1570,106,115,red blood cell,12190,1.0849056603773586,0.9217391304347826
78406,/images/fe00fa09-d3c8-485b-9d0f-3cce556c9edd.png,232,931,332,1027,100,96,red blood cell,9600,0.96,1.0416666666666667
8157,/images/694222bb-cddf-469a-9526-f873c6fba58e.png,661,276,763,366,102,90,red blood cell,9180,0.8823529411764706,1.1333333333333333
47042,/images/997eabd9-55bf-4683-83c4-4cee4673a4ef.png,262,1144,388,1263,126,119,red blood cell,14994,0.9444444444444444,1.0588235294117647
34091,/images/de5d19b7-e670-4ac7-843b-7ce7bcebdf45.png,1052,92,1168,205,116,113,red blood cell,13108,0.9741379310344828,1.0265486725663717
66646,/images/b88fe674-fb9a-41d4-b100-cb1c86440d44.png,964,527,1070,636,106,109,red blood cell,11554,1.028301886792453,0.9724770642201835
50657,/images/c956e531-6805-4fe1-b61c-8b96a9815a77.png,953,1385,1053,1484,100,99,red blood cell,9900,0.99,1.0101010101010102
6192,/images/27cdd837-e40f-491e-8adb-61e493189832.png,941,100,1064,231,123,131,red blood cell,16113,1.065040650406504,0.9389312977099237
76174,/images/16244280-6c74-47d3-b544-9fd6831a6bf9.png,202,1414,293,1517,91,103,red blood cell,9373,1.1318681318681318,0.883495145631068
25931,/images/e683144c-0465-43a2-86b1-3cf52599d5e0.png,287,426,402,528,115,102,red blood cell,11730,0.8869565217391304,1.1274509803921569
26909,/images/71bbdc58-11af-41f2-9a93-3fe9257c5cf3.png,423,1065,525,1168,102,103,red blood cell,10506,1.0098039215686274,0.9902912621359223
40908,/images/550cf4ce-b641-44a3-8487-3e16d4049187.png,865,671,990,796,125,125,red blood cell,15625,1.0,1.0
76825,/images/2165fe38-b474-467d-be11-d1d728085efd.png,795,459,908,566,113,107,red blood cell,12091,0.9469026548672567,1.0560747663551402
9090,/images/21c2a8aa-407c-4569-8212-96fcafa84138.png,211,82,330,194,119,112,red blood cell,13328,0.9411764705882353,1.0625
18227,/images/947348fe-4c70-468e-8009-3c14daeca69b.png,32,395,142,507,110,112,red blood cell,12320,1.018181818181818,0.9821428571428571
20695,/images/e6d7c5e1-43fc-4712-86d5-aa70252b978f.png,961,180,1088,294,127,114,red blood cell,14478,0.8976377952755905,1.1140350877192982
68275,/images/a6391703-0820-4913-a7cd-e843ff0d84ba.png,161,283,262,391,101,108,red blood cell,10908,1.0693069306930694,0.9351851851851852
21664,/images/66183740-e1e5-43c9-8539-a87028bb3621.png,483,1416,603,1545,120,129,red blood cell,15480,1.075,0.9302325581395349
19203,/images/064b84fe-bd21-4c27-b682-0a832272eac4.png,1005,1319,1114,1448,109,129,red blood cell,14061,1.18348623853211,0.8449612403100775
57255,/images/6d05ed67-43e2-43af-9d57-70c7a6eeef5e.png,806,1078,919,1209,113,131,red blood cell,14803,1.1592920353982301,0.8625954198473282
70505,/images/8cca114a-ed05-4b87-95b7-fae02487f08c.png,866,423,963,526,97,103,red blood cell,9991,1.0618556701030928,0.941747572815534
60002,/images/49288109-80e9-4ec8-96d1-26a0166b8883.png,793,596,893,696,100,100,red blood cell,10000,1.0,1.0
52858,/images/58f7e1da-3478-48f4-958c-e9b1cb8696aa.png,412,1139,535,1239,123,100,red blood cell,12300,0.8130081300813008,1.23
46474,/images/21417261-475a-456f-b03f-57ac85a6e106.png,882,1301,993,1412,111,111,red blood cell,12321,1.0,1.0
14467,/images/3b13e20f-ec0d-44ec-b2f4-eaebfa09150e.png,671,1426,799,1542,128,116,red blood cell,14848,0.90625,1.103448275862069
15080,/images/3a8f468f-f9de-46a8-a7c8-f2be239fa207.png,658,833,777,945,119,112,red blood cell,13328,0.9411764705882353,1.0625
24154,/images/1d4cdf2e-79a0-41e9-aabe-e437a190dfc4.png,773,159,885,280,112,121,red blood cell,13552,1.0803571428571428,0.9256198347107438
73911,/images/2ae3e6e6-7482-4ab8-ad73-b530b5c2ee3b.png,716,1011,821,1115,105,104,red blood cell,10920,0.9904761904761905,1.0096153846153846
75490,/images/6c20abb2-c4bb-4de0-8774-03f4d30ce93d.png,672,1276,796,1417,124,141,red blood cell,17484,1.1370967741935485,0.8794326241134752
28220,/images/036404d1-b9fc-497b-bbe1-f4d9c5ac3ce0.png,756,801,848,897,92,96,red blood cell,8832,1.0434782608695652,0.9583333333333334
28519,/images/dbdfad64-110c-421f-a1c7-f68fd9e82d67.png,623,907,722,1001,99,94,red blood cell,9306,0.9494949494949495,1.053191489361702
52473,/images/a2a20600-f851-4db7-90f9-6f7be027c8b5.png,592,415,664,485,72,70,red blood cell,5040,0.9722222222222222,1.0285714285714285
58953,/images/a0eeeb10-d0cb-48d9-8c22-2c3a3c908d00.png,919,14,1032,126,113,112,red blood cell,12656,0.9911504424778761,1.0089285714285714
13465,/images/370277f8-436b-4103-8210-b4feb5ab95ea.png,641,1435,740,1546,99,111,red blood cell,10989,1.121212121212121,0.8918918918918919
40878,/images/550cf4ce-b641-44a3-8487-3e16d4049187.png,886,414,1013,531,127,117,red blood cell,14859,0.9212598425196851,1.0854700854700854
66843,/images/9106a6bb-1352-411f-ac26-0d6fe48c16a8.png,424,701,534,796,110,95,red blood cell,10450,0.8636363636363636,1.1578947368421053
33245,/images/877d5e7f-19b6-40e7-81bd-c92f25e72503.png,496,1434,607,1551,111,117,red blood cell,12987,1.054054054054054,0.9487179487179487
10794,/images/2a02cec2-a09b-483a-ad38-14359a763fa4.png,247,1044,363,1163,116,119,red blood cell,13804,1.0258620689655173,0.9747899159663865
35298,/images/516bf1d5-5d00-4985-926c-3993e9bc3ff5.png,560,1283,691,1401,131,118,red blood cell,15458,0.9007633587786259,1.1101694915254237
41124,/images/2240b991-48f6-4c59-9b62-5a8b5e541fae.png,995,86,1093,184,98,98,red blood cell,9604,1.0,1.0
17197,/images/471f75c6-bd5d-4c20-bcc1-258e836f4d69.png,171,176,281,285,110,109,red blood cell,11990,0.990909090909091,1.0091743119266054
13846,/images/345cb914-7583-49df-96e3-3cf19c2ba8f1.png,267,796,393,910,126,114,red blood cell,14364,0.9047619047619048,1.105263157894737
21054,/images/c680004e-6ee2-43d7-877c-edc9b5ebeecc.png,827,1421,931,1528,104,107,red blood cell,11128,1.0288461538461537,0.9719626168224299
11521,/images/834a30bb-26bf-4e60-9ea1-3250b926892e.png,348,154,479,290,131,136,red blood cell,17816,1.0381679389312977,0.9632352941176471
57733,/images/5c037ffc-f515-48b3-b231-c110fbd2b8ca.png,21,299,119,417,98,118,red blood cell,11564,1.2040816326530612,0.8305084745762712
36252,/images/b2103776-9b32-4160-b4f0-0692deda19dc.png,9,148,110,263,101,115,red blood cell,11615,1.1386138613861385,0.8782608695652174
30257,/images/cecbf663-0751-4e7f-b298-770c88afc2c1.png,134,258,250,374,116,116,red blood cell,13456,1.0,1.0
55623,/images/c32b8bb8-c89d-4ae9-9c77-5b9356ca35a1.png,310,400,429,509,119,109,red blood cell,12971,0.9159663865546218,1.091743119266055
17781,/images/1863da5f-c595-4541-a8f4-21fe78678168.png,296,230,388,326,92,96,red blood cell,8832,1.0434782608695652,0.9583333333333334
56309,/images/6b473806-e936-4b19-98cf-a2b94cac35ff.png,118,1447,206,1556,88,109,red blood cell,9592,1.2386363636363635,0.8073394495412844
50579,/images/e98ea067-82b5-4a0d-87bf-b4bbdc10ddab.png,264,601,360,693,96,92,red blood cell,8832,0.9583333333333334,1.0434782608695652
27830,/images/db3f4098-02e4-45a3-a7af-5dda37ac1526.png,717,1239,830,1356,113,117,red blood cell,13221,1.0353982300884956,0.9658119658119658
26376,/images/ef1419e0-3a3a-458a-b3b2-7efddac50404.png,442,1075,549,1198,107,123,red blood cell,13161,1.1495327102803738,0.8699186991869918
77649,/images/07d15855-eb9b-46a9-b894-7cfe4d097826.png,723,580,827,687,104,107,red blood cell,11128,1.0288461538461537,0.9719626168224299
55153,/images/29d4b75f-d400-4702-a9ac-e5a4ed1a1db1.png,148,1006,254,1110,106,104,red blood cell,11024,0.9811320754716981,1.0192307692307692
63458,/images/b9d65ef3-1adc-4479-abee-2e422f5a613a.png,532,366,620,459,88,93,red blood cell,8184,1.0568181818181819,0.946236559139785
34897,/images/a4fbb9f2-9b75-4fdc-877d-2feaafac25b3.png,134,574,224,669,90,95,red blood cell,8550,1.0555555555555556,0.9473684210526315
21613,/images/66183740-e1e5-43c9-8539-a87028bb3621.png,12,288,134,423,122,135,red blood cell,16470,1.1065573770491803,0.9037037037037037
53401,/images/766d5547-8dd2-4c8d-b78e-3007f83932e8.png,1047,426,1156,544,109,118,red blood cell,12862,1.0825688073394495,0.923728813559322
69662,/images/f0713bee-2a71-4ced-b953-4041ea99496a.png,463,1414,557,1511,94,97,red blood cell,9118,1.0319148936170213,0.9690721649484536
65218,/images/50715879-2300-4dba-8f4a-3314ff8cfcce.png,646,1222,761,1336,115,114,red blood cell,13110,0.991304347826087,1.0087719298245614
15697,/images/3892b776-f49a-4368-b0fa-7e855e76ccec.png,611,247,711,352,100,105,red blood cell,10500,1.05,0.9523809523809523
63161,/images/f0804a5e-e7f5-4cf2-a5df-b65e66502bf1.png,881,841,986,953,105,112,red blood cell,11760,1.0666666666666667,0.9375
68804,/images/aa3ad405-828e-4986-8251-20fd981f34d3.png,23,723,115,820,92,97,red blood cell,8924,1.0543478260869565,0.9484536082474226
24202,/images/194aec70-41a5-4ac3-b22f-0b6eda91f730.png,431,119,553,238,122,119,red blood cell,14518,0.9754098360655737,1.0252100840336134
79536,/images/161978c3-3a05-47a5-9fee-be7d25693eae.png,880,1017,979,1112,99,95,red blood cell,9405,0.9595959595959596,1.0421052631578946
27684,/images/18dbe7c4-89d2-42a6-a969-1e951ab313b1.png,398,156,506,276,108,120,red blood cell,12960,1.1111111111111112,0.9
36031,/images/ca9626bc-21a4-46f4-ba94-e7ee7a4cf735.png,446,1015,561,1116,115,101,red blood cell,11615,0.8782608695652174,1.1386138613861385
16098,/images/66557580-fd38-4d4b-80d8-88611ecc78c6.png,80,338,200,453,120,115,red blood cell,13800,0.9583333333333334,1.0434782608695652
51501,/images/baa87bf8-786c-444c-81e8-9fa0a41d8149.png,711,1089,830,1187,119,98,red blood cell,11662,0.8235294117647058,1.2142857142857142
69317,/images/3f8c5ae1-b9fd-464b-8e91-98143ddd8d29.png,362,80,464,187,102,107,red blood cell,10914,1.0490196078431373,0.9532710280373832
71550,/images/b9c6db13-ca3a-4937-8ecf-e537047ed858.png,956,760,1077,872,121,112,red blood cell,13552,0.9256198347107438,1.0803571428571428
39465,/images/5a631871-2fc7-4a68-9c39-f3b9a0bf4a04.png,851,212,958,327,107,115,red blood cell,12305,1.074766355140187,0.9304347826086956
55667,/images/c32b8bb8-c89d-4ae9-9c77-5b9356ca35a1.png,299,853,402,939,103,86,red blood cell,8858,0.8349514563106796,1.197674418604651
7702,/images/9f959520-e15e-45c2-bc29-ef3c19154d1c.png,379,232,481,341,102,109,red blood cell,11118,1.0686274509803921,0.9357798165137615
21450,/images/b701b5c5-b922-4315-b12a-aac4ec65ee8b.png,1072,652,1170,754,98,102,red blood cell,9996,1.0408163265306123,0.9607843137254902
57107,/images/7d041c38-11f2-4186-8a24-29d7d0f5c3cf.png,334,705,426,811,92,106,red blood cell,9752,1.1521739130434783,0.8679245283018868
6058,/images/72732579-a812-4496-b2dd-ea1556924337.png,331,580,431,689,100,109,red blood cell,10900,1.09,0.9174311926605505
50818,/images/db0a1123-0b35-48d7-8337-3b1ebd6af0cc.png,1082,1282,1199,1411,117,129,red blood cell,15093,1.1025641025641026,0.9069767441860465
78964,/images/6144887d-a1c1-46db-91a1-f7ff5bf8c8a5.png,751,608,860,721,109,113,red blood cell,12317,1.036697247706422,0.9646017699115044
14349,/images/f5eb7c5e-bd77-4638-ba9f-58d42f87476b.png,327,1402,448,1503,121,101,red blood cell,12221,0.8347107438016529,1.198019801980198
21495,/images/7625dfc4-858a-4c8e-907c-8943d665e9a7.png,351,710,447,824,96,114,red blood cell,10944,1.1875,0.8421052631578947
51459,/images/baa87bf8-786c-444c-81e8-9fa0a41d8149.png,889,104,989,199,100,95,red blood cell,9500,0.95,1.0526315789473684
64068,/images/03cbfcf2-8da6-462c-b30d-16d63357371f.png,49,888,168,996,119,108,red blood cell,12852,0.907563025210084,1.1018518518518519
47790,/images/5a105b89-c592-4d78-b208-7db6c6572752.png,1069,1341,1178,1449,109,108,red blood cell,11772,0.9908256880733946,1.0092592592592593
61424,/images/e16c0dab-780d-4035-872e-1bb91e49f9d2.png,604,871,697,965,93,94,red blood cell,8742,1.010752688172043,0.9893617021276596
64734,/images/76021d69-8919-4688-95ef-7418eff620cc.png,998,1495,1094,1588,96,93,red blood cell,8928,0.96875,1.032258064516129
19352,/images/a302a6fa-f635-4ade-b72b-b6f3c2a34ec9.png,841,294,971,412,130,118,red blood cell,15340,0.9076923076923077,1.1016949152542372
16366,/images/69569ecf-cfa1-4ddd-9342-b22c23387fdb.png,19,624,134,731,115,107,red blood cell,12305,0.9304347826086956,1.074766355140187
41454,/images/c4494d4f-732f-431a-8a9d-62403f0b74fe.png,103,951,202,1049,99,98,red blood cell,9702,0.98989898989899,1.010204081632653
60767,/images/645cd195-af50-409f-8da9-6e7c7f18ea09.png,587,366,678,466,91,100,red blood cell,9100,1.098901098901099,0.91
64653,/images/6dfafdf1-f588-4e80-8cf8-0126e1bf7af9.png,729,1062,838,1171,109,109,red blood cell,11881,1.0,1.0
34178,/images/f1cda808-69a9-4d10-ba0a-6607c98e362d.png,584,1110,689,1211,105,101,red blood cell,10605,0.9619047619047619,1.0396039603960396
52673,/images/3f390b82-8859-4c27-bbfe-d1b242477f63.png,933,1333,1036,1423,103,90,red blood cell,9270,0.8737864077669902,1.1444444444444444
48336,/images/6fa2b30f-9b89-46ac-9b79-c0bc105d4271.png,173,125,282,251,109,126,red blood cell,13734,1.1559633027522935,0.8650793650793651
59636,/images/a2754679-68b0-40f4-be01-bafad5ac1261.png,868,122,977,253,109,131,red blood cell,14279,1.201834862385321,0.8320610687022901
75644,/images/50d7c6c9-3230-48fe-947c-7dcfd0aad710.png,232,563,331,685,99,122,red blood cell,12078,1.2323232323232323,0.8114754098360656
5750,/images/21a50e4c-b750-46b5-801f-5429ede7dea9.png,861,1098,985,1231,124,133,red blood cell,16492,1.0725806451612903,0.9323308270676691
17294,/images/3d302619-473d-4c5b-af43-8833ff94233f.png,704,302,796,392,92,90,red blood cell,8280,0.9782608695652174,1.0222222222222221
2963,/images/00a02700-2ea2-4590-9e15-ffc9160fd3de.png,296,453,406,561,110,108,red blood cell,11880,0.9818181818181818,1.0185185185185186
37050,/images/b2e34f5f-904e-4473-9dc7-c6bc1ce12640.png,942,807,1047,907,105,100,red blood cell,10500,0.9523809523809523,1.05
71558,/images/b9c6db13-ca3a-4937-8ecf-e537047ed858.png,695,875,800,977,105,102,red blood cell,10710,0.9714285714285714,1.0294117647058822
17504,/images/56077789-8580-41b4-89d6-deea227e5c60.png,170,183,292,307,122,124,red blood cell,15128,1.0163934426229508,0.9838709677419355
58771,/images/e4827c85-311a-4df1-89c2-99dad0c3558c.png,1100,1381,1186,1474,86,93,red blood cell,7998,1.0813953488372092,0.9247311827956989
3490,/images/ad36bd67-594b-4f63-93e3-886af0bc618e.png,848,1444,948,1552,100,108,red blood cell,10800,1.08,0.9259259259259259
53450,/images/766d5547-8dd2-4c8d-b78e-3007f83932e8.png,1070,1031,1186,1140,116,109,red blood cell,12644,0.9396551724137931,1.0642201834862386
44745,/images/ccb4b13d-ab20-4222-892f-5adf70249aaa.png,823,1274,935,1407,112,133,red blood cell,14896,1.1875,0.8421052631578947
35179,/images/bfc61c48-685d-470b-86b1-e4c7eb85c4fd.png,649,13,763,140,114,127,red blood cell,14478,1.1140350877192982,0.8976377952755905
10993,/images/c442e2d6-aaf9-417a-9905-4737a1115f33.png,463,1269,581,1378,118,109,red blood cell,12862,0.923728813559322,1.0825688073394495
60225,/images/214f1d15-a081-476e-992d-6c3a77f03d59.png,864,11,966,103,102,92,red blood cell,9384,0.9019607843137255,1.108695652173913
64832,/images/a74b6d6a-7e04-40ac-9292-d62f13f7ded3.png,1070,594,1172,695,102,101,red blood cell,10302,0.9901960784313726,1.00990099009901
72890,/images/31435107-c77d-42f8-a619-75cba6a5161b.png,301,886,374,964,73,78,red blood cell,5694,1.0684931506849316,0.9358974358974359
75058,/images/073c10c9-5749-44b5-b08b-1be556a960f0.png,975,680,1094,792,119,112,red blood cell,13328,0.9411764705882353,1.0625
73056,/images/2bd26501-2fbc-4c1a-bef0-4ad57e02b4d0.png,533,1394,611,1474,78,80,red blood cell,6240,1.0256410256410255,0.975
28403,/images/a6d85204-24b8-4b23-a8b1-c3e8b93f9f22.png,34,938,150,1051,116,113,red blood cell,13108,0.9741379310344828,1.0265486725663717
78600,/images/c5084fb8-2b62-464c-8a77-1a07ea653266.png,855,0,973,121,118,121,red blood cell,14278,1.0254237288135593,0.9752066115702479
71538,/images/191071ab-6515-428c-9f05-8e4309542b75.png,967,1103,1061,1185,94,82,red blood cell,7708,0.8723404255319149,1.146341463414634
35853,/images/027ab174-e47a-44f8-b85b-372449eeb7d8.png,1013,1476,1122,1596,109,120,red blood cell,13080,1.1009174311926606,0.9083333333333333
3492,/images/ad36bd67-594b-4f63-93e3-886af0bc618e.png,546,1273,644,1370,98,97,red blood cell,9506,0.9897959183673469,1.0103092783505154
21308,/images/8dace03a-10c4-4d59-bcd9-a2c314c5df33.png,481,1226,596,1324,115,98,red blood cell,11270,0.8521739130434782,1.1734693877551021
223,/images/2559636b-f01a-4414-93da-210c3b12d153.png,26,502,137,622,111,120,red blood cell,13320,1.0810810810810811,0.925
4081,/images/e02edd82-c424-4dee-98a7-575640655d9b.png,57,163,173,276,116,113,red blood cell,13108,0.9741379310344828,1.0265486725663717
937,/images/a8cb75ba-3f2f-40d8-8bc7-c79ebd1b9603.png,1083,880,1190,996,107,116,red blood cell,12412,1.0841121495327102,0.9224137931034483
2902,/images/a1c140f9-75d7-42a3-b767-4c01a118892b.png,697,71,810,182,113,111,red blood cell,12543,0.9823008849557522,1.018018018018018
3114,/images/14efbfc8-39f6-4599-9994-a8cc95605b9c.png,323,256,457,378,134,122,red blood cell,16348,0.9104477611940298,1.098360655737705
25005,/images/ed0bee2f-05e0-4392-8357-19750cec577c.png,638,496,747,601,109,105,red blood cell,11445,0.963302752293578,1.0380952380952382
55894,/images/afd39466-aafa-4d81-9520-483727418723.png,438,1460,527,1559,89,99,red blood cell,8811,1.1123595505617978,0.898989898989899
52353,/images/a2a20600-f851-4db7-90f9-6f7be027c8b5.png,595,1137,692,1252,97,115,red blood cell,11155,1.1855670103092784,0.8434782608695652
40107,/images/6fd30823-3b77-40c9-ba5d-e1eda9660674.png,821,1381,937,1490,116,109,red blood cell,12644,0.9396551724137931,1.0642201834862386
67729,/images/48e2f0bd-2164-40c3-af43-1f2708359978.png,265,1073,391,1186,126,113,red blood cell,14238,0.8968253968253969,1.1150442477876106
43976,/images/d7c7eb2c-2acd-4f86-8a5a-09ab3dd02d16.png,1121,1373,1200,1461,79,88,red blood cell,6952,1.1139240506329113,0.8977272727272727
49164,/images/df3d98b9-3dd7-4107-8d4a-ae1b7f247793.png,827,935,907,1028,80,93,red blood cell,7440,1.1625,0.8602150537634409
43302,/images/36569710-a574-40be-ad42-897a6e74a128.png,419,791,525,907,106,116,red blood cell,12296,1.0943396226415094,0.9137931034482759
2164,/images/e94a811d-3145-4313-ba42-2d5ed283179f.png,246,416,351,512,105,96,red blood cell,10080,0.9142857142857143,1.09375
75758,/images/f48bf825-13c4-42fc-8dd8-10cc4ae6b202.png,878,1024,997,1142,119,118,red blood cell,14042,0.9915966386554622,1.0084745762711864
32133,/images/25cfca07-2101-484f-b312-a927395f2651.png,569,669,669,787,100,118,red blood cell,11800,1.18,0.847457627118644
72839,/images/31435107-c77d-42f8-a619-75cba6a5161b.png,710,22,806,125,96,103,red blood cell,9888,1.0729166666666667,0.9320388349514563
71570,/images/b9c6db13-ca3a-4937-8ecf-e537047ed858.png,556,973,688,1132,132,159,red blood cell,20988,1.2045454545454546,0.8301886792452831
20548,/images/cbde7f7e-2458-4dda-9db2-3d5ccf950ced.png,323,407,436,533,113,126,red blood cell,14238,1.1150442477876106,0.8968253968253969
62899,/images/4b346035-b8c0-46ca-8fdb-a01b1421ee4a.png,547,996,652,1104,105,108,red blood cell,11340,1.0285714285714285,0.9722222222222222
28061,/images/f1f9df6d-c4cb-4b42-9ca2-8fb47b1b0e91.png,462,1382,598,1502,136,120,red blood cell,16320,0.8823529411764706,1.1333333333333333
5313,/images/06df7bbe-60d4-4f7c-ba4a-5a42ac4be91b.png,746,926,871,1072,125,146,red blood cell,18250,1.168,0.8561643835616438
67166,/images/be6fe358-dee1-4dcf-9b0d-5d8612aba577.png,742,391,847,483,105,92,red blood cell,9660,0.8761904761904762,1.141304347826087
34206,/images/f1cda808-69a9-4d10-ba0a-6607c98e362d.png,659,545,774,650,115,105,red blood cell,12075,0.9130434782608695,1.0952380952380953
11556,/images/834a30bb-26bf-4e60-9ea1-3250b926892e.png,1088,1058,1188,1158,100,100,red blood cell,10000,1.0,1.0
15295,/images/2d0f600d-f94e-4907-b712-52fb37d9ed52.png,235,1199,341,1316,106,117,red blood cell,12402,1.1037735849056605,0.905982905982906
54938,/images/f1872d08-f8a6-4b21-aa29-f56bbf607883.png,686,310,784,391,98,81,red blood cell,7938,0.826530612244898,1.2098765432098766
42502,/images/29648565-fe28-4517-ba72-68df0c82c9c5.png,430,635,537,731,107,96,red blood cell,10272,0.897196261682243,1.1145833333333333
14578,/images/b8410821-a42b-47d0-8bcf-c2fc82e4e2d5.png,82,1293,197,1408,115,115,red blood cell,13225,1.0,1.0
52112,/images/de6d3020-9347-473b-9146-8909627790f6.png,725,513,822,611,97,98,red blood cell,9506,1.0103092783505154,0.9897959183673469
26834,/images/2518f6e4-29cc-4ae4-a914-b215a4c56099.png,91,1259,206,1362,115,103,red blood cell,11845,0.8956521739130435,1.116504854368932
63861,/images/5e974892-0ebe-4037-8427-ea8616d6d3b8.png,193,635,299,739,106,104,red blood cell,11024,0.9811320754716981,1.0192307692307692
30283,/images/cecbf663-0751-4e7f-b298-770c88afc2c1.png,343,1434,442,1552,99,118,red blood cell,11682,1.1919191919191918,0.8389830508474576
18519,/images/c22f7031-9cf8-48ce-b03b-1b12d0db4951.png,333,640,434,741,101,101,red blood cell,10201,1.0,1.0
25871,/images/461a3ed6-039f-4a70-97cf-c474ecf51ccd.png,186,1154,312,1262,126,108,red blood cell,13608,0.8571428571428571,1.1666666666666667
32672,/images/0154dd8e-72f8-4d78-a4dd-93e139577bd1.png,784,1158,897,1270,113,112,red blood cell,12656,0.9911504424778761,1.0089285714285714
48438,/images/0fa5b35d-6c44-4207-b6f8-d5b355086b5f.png,1049,1340,1162,1453,113,113,red blood cell,12769,1.0,1.0
49812,/images/5e17f8e6-fd8d-426c-b444-1515d14f04b7.png,738,593,830,699,92,106,red blood cell,9752,1.1521739130434783,0.8679245283018868
64461,/images/34a70114-d3e3-4351-b8db-f6caab17e743.png,274,1397,389,1507,115,110,red blood cell,12650,0.9565217391304348,1.0454545454545454
42124,/images/c63f190a-e860-44fc-a2db-7980e1c80519.png,22,926,127,1035,105,109,red blood cell,11445,1.0380952380952382,0.963302752293578
55427,/images/d67655e6-0a80-4a86-b552-1f5e85788377.png,66,1148,160,1248,94,100,red blood cell,9400,1.0638297872340425,0.94
30765,/images/8e0dfc1f-e3eb-4a3f-a1c4-249bdfbfaa27.png,438,1320,566,1448,128,128,red blood cell,16384,1.0,1.0
41086,/images/e871f52c-77a6-4813-80d4-95bd97985f1a.png,855,435,976,565,121,130,red blood cell,15730,1.0743801652892562,0.9307692307692308
59500,/images/6bfe6a90-8a69-4171-8e7f-42dc9417c6d9.png,895,1103,1003,1216,108,113,red blood cell,12204,1.0462962962962963,0.9557522123893806
45413,/images/e4eea7ea-8989-46a9-9c98-25a178146b28.png,490,1293,580,1388,90,95,red blood cell,8550,1.0555555555555556,0.9473684210526315
27948,/images/46f5bd4f-8bea-48d1-a1da-4dea28e3b814.png,1034,903,1148,996,114,93,red blood cell,10602,0.8157894736842105,1.2258064516129032
65652,/images/397f37bc-a3a4-4257-9430-c8fc5716f8b1.png,216,599,332,712,116,113,red blood cell,13108,0.9741379310344828,1.0265486725663717
63578,/images/de0321fa-6f7d-4dd1-b96b-186701c3b1d9.png,261,902,367,1001,106,99,red blood cell,10494,0.9339622641509434,1.0707070707070707
61849,/images/5f300fd1-7eec-41ac-bbd1-0f4a943c757c.png,359,229,470,359,111,130,red blood cell,14430,1.1711711711711712,0.8538461538461538
13546,/images/370277f8-436b-4103-8210-b4feb5ab95ea.png,354,1284,428,1371,74,87,red blood cell,6438,1.1756756756756757,0.8505747126436781
5751,/images/21a50e4c-b750-46b5-801f-5429ede7dea9.png,699,1420,824,1557,125,137,red blood cell,17125,1.096,0.9124087591240876
18436,/images/39cc33be-d752-40fe-b7a8-2e69a3517205.png,859,1427,978,1556,119,129,red blood cell,15351,1.084033613445378,0.9224806201550387
39134,/images/7bde7de1-889b-4218-b0e1-e2c04f6a7986.png,0,547,114,654,114,107,red blood cell,12198,0.9385964912280702,1.0654205607476634
6459,/images/640c4a52-3742-4f57-aee3-9e3dc0887622.png,165,730,268,835,103,105,red blood cell,10815,1.0194174757281553,0.9809523809523809
22626,/images/406e05f0-4444-414c-bb40-f4cb08e75ac9.png,336,1171,437,1286,101,115,red blood cell,11615,1.1386138613861385,0.8782608695652174
26489,/images/cdb086a8-2bf8-4436-b1ef-96cdd801f247.png,494,1104,582,1191,88,87,red blood cell,7656,0.9886363636363636,1.0114942528735633
44272,/images/4257342d-6d77-4671-a84b-1f0c36ccb367.png,485,679,581,784,96,105,red blood cell,10080,1.09375,0.9142857142857143
15911,/images/c7c1b873-0548-4a73-9618-f60912e164df.png,528,1227,617,1319,89,92,red blood cell,8188,1.0337078651685394,0.967391304347826
47922,/images/ab27173b-6e30-4957-bd68-29194328fd39.png,428,1091,521,1190,93,99,red blood cell,9207,1.064516129032258,0.9393939393939394
36364,/images/4a0a05e1-11ad-4bfc-bfa3-adf3b9bd0b56.png,373,1347,489,1471,116,124,red blood cell,14384,1.0689655172413792,0.9354838709677419
29369,/images/30167dc1-f739-4036-b5c4-5fad435c2c67.png,454,909,575,1017,121,108,red blood cell,13068,0.8925619834710744,1.1203703703703705
73675,/images/a51d6c18-f9e8-4714-9dbb-38e1577445f2.png,1112,1503,1200,1595,88,92,red blood cell,8096,1.0454545454545454,0.9565217391304348
69222,/images/f274b784-b995-4a7e-a2c2-6cc31c24c4b4.png,539,719,627,801,88,82,red blood cell,7216,0.9318181818181818,1.0731707317073171
64835,/images/a74b6d6a-7e04-40ac-9292-d62f13f7ded3.png,748,492,836,594,88,102,red blood cell,8976,1.1590909090909092,0.8627450980392157
41902,/images/783ae4ad-6a35-4b3c-b19f-754974b67b2d.png,226,766,342,911,116,145,red blood cell,16820,1.25,0.8
32796,/images/67f5ca94-d84e-490e-bf0d-4ffba7bdbe30.png,1079,912,1188,1007,109,95,red blood cell,10355,0.8715596330275229,1.1473684210526316
12654,/images/0901f9d1-be4f-4c19-8e83-dd724dded9f5.png,915,784,1028,892,113,108,red blood cell,12204,0.9557522123893806,1.0462962962962963
24780,/images/530761d4-1931-44cd-b220-d60db0e228f9.png,618,513,755,629,137,116,red blood cell,15892,0.8467153284671532,1.1810344827586208
7453,/images/37a94c0f-e5d4-46fc-b4f8-994d477995fd.png,928,135,1042,228,114,93,red blood cell,10602,0.8157894736842105,1.2258064516129032
69750,/images/2bd15b6e-fe2d-49f3-b394-940d024d1f91.png,809,654,902,747,93,93,red blood cell,8649,1.0,1.0
5521,/images/eb6e8684-b84e-483d-b835-f59286d2516b.png,188,572,286,686,98,114,red blood cell,11172,1.163265306122449,0.8596491228070176
66630,/images/b88fe674-fb9a-41d4-b100-cb1c86440d44.png,222,1165,332,1272,110,107,red blood cell,11770,0.9727272727272728,1.02803738317757
14130,/images/eaf4b781-b3aa-41ce-8c5e-287979b4e15a.png,348,1442,444,1534,96,92,red blood cell,8832,0.9583333333333334,1.0434782608695652
50331,/images/3d32a988-449d-4d58-b71f-abbfdc3f2fbc.png,0,310,104,420,104,110,red blood cell,11440,1.0576923076923077,0.9454545454545454
37916,/images/56a57a8d-c9b9-432a-a3b0-32a09355806c.png,987,743,1088,849,101,106,red blood cell,10706,1.0495049504950495,0.9528301886792453
2367,/images/fe851c88-692d-4199-87e0-d19d9c4eb591.png,1052,347,1156,437,104,90,red blood cell,9360,0.8653846153846154,1.1555555555555554
30079,/images/81c3c8f0-d5a9-4dda-afd5-e86f6afd9424.png,710,103,809,207,99,104,red blood cell,10296,1.0505050505050506,0.9519230769230769
67027,/images/1fe1e118-adb8-4b10-a41e-1e5814e8f067.png,156,577,280,696,124,119,red blood cell,14756,0.9596774193548387,1.0420168067226891
45964,/images/72088c26-d2dd-4906-b791-b8947fc7fbe4.png,398,1155,499,1255,101,100,red blood cell,10100,0.9900990099009901,1.01
54348,/images/19370afd-f897-47d8-bfae-c0d257bbf795.png,755,122,862,230,107,108,red blood cell,11556,1.0093457943925233,0.9907407407407407
7485,/images/37a94c0f-e5d4-46fc-b4f8-994d477995fd.png,887,208,1005,316,118,108,red blood cell,12744,0.9152542372881356,1.0925925925925926
78695,/images/76a8a5f5-1328-4539-a131-baf877f40cf3.png,575,751,673,853,98,102,red blood cell,9996,1.0408163265306123,0.9607843137254902
33529,/images/795d0331-da56-4d45-a58a-54803408ffd9.png,742,448,871,581,129,133,red blood cell,17157,1.0310077519379846,0.9699248120300752
2131,/images/e94a811d-3145-4313-ba42-2d5ed283179f.png,389,534,482,648,93,114,red blood cell,10602,1.2258064516129032,0.8157894736842105
32524,/images/d31dd2c0-ae8e-4499-86bb-7cabb6e438b9.png,816,1038,944,1158,128,120,red blood cell,15360,0.9375,1.0666666666666667
24469,/images/b78ba2c8-ecb3-45b2-9cda-2c8088fa95d1.png,200,542,307,643,107,101,red blood cell,10807,0.9439252336448598,1.0594059405940595
37232,/images/71881a39-a30c-40c7-8c4a-9f64c93e79d9.png,291,868,402,998,111,130,red blood cell,14430,1.1711711711711712,0.8538461538461538
71759,/images/093a831a-bf71-4333-bc06-942ae70cb164.png,658,1079,755,1183,97,104,red blood cell,10088,1.0721649484536082,0.9326923076923077
11701,/images/0ed416f9-7c20-4829-9016-559e4009568e.png,213,1020,330,1140,117,120,red blood cell,14040,1.0256410256410255,0.975
72952,/images/a20d0b4b-6e2e-4507-bc22-f321dedc4ed9.png,811,1406,913,1502,102,96,red blood cell,9792,0.9411764705882353,1.0625
55472,/images/d67655e6-0a80-4a86-b552-1f5e85788377.png,820,1405,901,1478,81,73,red blood cell,5913,0.9012345679012346,1.1095890410958904
7827,/images/e726dac6-f962-449c-acff-4dd56847b685.png,937,1243,1037,1360,100,117,red blood cell,11700,1.17,0.8547008547008547
23083,/images/be5bb7d0-7c3f-4bb9-8bb4-f8bc8d875943.png,919,1203,1040,1321,121,118,red blood cell,14278,0.9752066115702479,1.0254237288135593
35672,/images/4063945d-03fc-4ce3-a04c-17435dce8f91.png,1023,1367,1126,1492,103,125,red blood cell,12875,1.2135922330097086,0.824
13862,/images/7d65d296-0f7b-41cc-9073-a547e24326c8.png,692,1293,809,1427,117,134,red blood cell,15678,1.1452991452991452,0.8731343283582089
20015,/images/ebfd9f67-138e-49f0-9cef-a0352069eedb.png,804,335,902,451,98,116,red blood cell,11368,1.183673469387755,0.8448275862068966
10498,/images/46a2d369-4bea-4405-ac78-91bbe130b9a7.png,9,1275,98,1364,89,89,red blood cell,7921,1.0,1.0
53317,/images/d8f7e159-b7e3-49e4-86e8-aed8c5fbcd97.png,492,18,574,108,82,90,red blood cell,7380,1.0975609756097562,0.9111111111111111
79995,/images/e640ae51-cbf1-4a84-b7cf-d38b17f59c2f.png,933,987,1037,1075,104,88,red blood cell,9152,0.8461538461538461,1.1818181818181819
75154,/images/7fdc8be8-7579-4a5c-b369-8a07ee0a8b7d.png,47,637,131,720,84,83,red blood cell,6972,0.9880952380952381,1.0120481927710843
37847,/images/56a57a8d-c9b9-432a-a3b0-32a09355806c.png,1055,1428,1165,1535,110,107,red blood cell,11770,0.9727272727272728,1.02803738317757
14808,/images/f8b6a868-60e9-4569-ae69-638a0c39834d.png,45,318,170,447,125,129,red blood cell,16125,1.032,0.9689922480620154
30512,/images/5955289d-19e5-45ef-a012-c8ea08ef45e2.png,532,680,644,791,112,111,red blood cell,12432,0.9910714285714286,1.009009009009009
8159,/images/694222bb-cddf-469a-9526-f873c6fba58e.png,558,457,647,551,89,94,red blood cell,8366,1.0561797752808988,0.9468085106382979
2074,/images/f3bd0fcc-647d-4ca0-8c43-a16bd6ea3878.png,11,6,121,117,110,111,red blood cell,12210,1.009090909090909,0.990990990990991
67529,/images/45902b63-be9a-49ae-9ede-3a8015671bc4.png,972,1015,1083,1121,111,106,red blood cell,11766,0.954954954954955,1.0471698113207548
44424,/images/edd3862f-04e1-49cf-97dd-ca566d17e71a.png,341,453,467,574,126,121,red blood cell,15246,0.9603174603174603,1.0413223140495869
35770,/images/bb2042c5-35e1-43cc-8171-7de81b764361.png,1064,1167,1171,1267,107,100,red blood cell,10700,0.9345794392523364,1.07
79297,/images/05ac7b2a-6a77-4464-926b-8570f7c01693.png,254,267,342,359,88,92,red blood cell,8096,1.0454545454545454,0.9565217391304348
10959,/images/c442e2d6-aaf9-417a-9905-4737a1115f33.png,362,1104,500,1240,138,136,red blood cell,18768,0.9855072463768116,1.0147058823529411
48494,/images/9c4cb048-d64a-4b7f-84ff-ca28a8084fc7.png,140,698,266,808,126,110,red blood cell,13860,0.873015873015873,1.1454545454545455
36933,/images/b2e34f5f-904e-4473-9dc7-c6bc1ce12640.png,84,341,178,436,94,95,red blood cell,8930,1.0106382978723405,0.9894736842105263
9672,/images/53afd70c-08a7-4b9a-b137-7003b2ecbeab.png,445,228,577,358,132,130,red blood cell,17160,0.9848484848484849,1.0153846153846153
65607,/images/01b38a56-13eb-447b-89ee-fc21cb40dcc1.png,1070,499,1153,583,83,84,red blood cell,6972,1.0120481927710843,0.9880952380952381
52205,/images/f4c00b8c-d675-4255-8277-ca65bd757f51.png,537,44,622,133,85,89,red blood cell,7565,1.0470588235294118,0.9550561797752809
32967,/images/d1924af6-7512-4ccc-9c6b-adbbaa8db41f.png,376,211,488,326,112,115,red blood cell,12880,1.0267857142857142,0.9739130434782609
74545,/images/bbedfcbe-9528-4ba9-9d86-4ebba7589ac5.png,155,1123,258,1219,103,96,red blood cell,9888,0.9320388349514563,1.0729166666666667
73557,/images/7624ac36-1cf9-42fb-844d-376078309553.png,890,1244,1020,1358,130,114,red blood cell,14820,0.8769230769230769,1.1403508771929824
18925,/images/e9e78ff8-831b-46e9-9785-3eee9acbfcd8.png,639,163,753,280,114,117,red blood cell,13338,1.0263157894736843,0.9743589743589743
47651,/images/4b3a49bc-8536-4760-9553-440a6f64db37.png,158,103,277,230,119,127,red blood cell,15113,1.0672268907563025,0.937007874015748
27670,/images/18dbe7c4-89d2-42a6-a969-1e951ab313b1.png,247,617,349,711,102,94,red blood cell,9588,0.9215686274509803,1.0851063829787233
33165,/images/6231d81d-9e84-4a5a-8cb8-47c6a37a0176.png,1097,1340,1193,1420,96,80,red blood cell,7680,0.8333333333333334,1.2
64509,/images/6ba5d0b8-cdc7-4266-9d78-db76faa312e9.png,565,428,648,526,83,98,red blood cell,8134,1.180722891566265,0.8469387755102041
18145,/images/947348fe-4c70-468e-8009-3c14daeca69b.png,644,740,737,841,93,101,red blood cell,9393,1.086021505376344,0.9207920792079208
78054,/images/105af41b-13cc-4ad1-8a1f-8bc4d47cdd94.png,894,1225,1022,1339,128,114,red blood cell,14592,0.890625,1.1228070175438596
62865,/images/4b346035-b8c0-46ca-8fdb-a01b1421ee4a.png,1060,1368,1175,1492,115,124,red blood cell,14260,1.0782608695652174,0.9274193548387096
6524,/images/640c4a52-3742-4f57-aee3-9e3dc0887622.png,9,460,115,564,106,104,red blood cell,11024,0.9811320754716981,1.0192307692307692
57912,/images/09bcedaa-e007-4692-a13f-ab02c3f872c4.png,494,241,601,353,107,112,red blood cell,11984,1.0467289719626167,0.9553571428571429
38048,/images/e3e9c2de-0a24-4c7e-8a69-3d3093d5bdab.png,35,277,132,376,97,99,red blood cell,9603,1.0206185567010309,0.9797979797979798
18445,/images/39cc33be-d752-40fe-b7a8-2e69a3517205.png,955,798,1084,912,129,114,red blood cell,14706,0.8837209302325582,1.131578947368421
59245,/images/03c8da48-04b9-4520-b674-44a0ecd35688.png,93,1179,195,1287,102,108,red blood cell,11016,1.0588235294117647,0.9444444444444444
19893,/images/b318889c-3c60-477c-b8f6-d18cb01a59df.png,981,1355,1072,1457,91,102,red blood cell,9282,1.120879120879121,0.8921568627450981
2795,/images/e79bd81b-f878-4bee-9be2-d91a722c031e.png,1028,84,1118,167,90,83,red blood cell,7470,0.9222222222222223,1.0843373493975903
21772,/images/f68ae8e9-e760-4106-88e0-4bdef2785f06.png,414,1421,533,1537,119,116,red blood cell,13804,0.9747899159663865,1.0258620689655173
51992,/images/4f62b14e-c6f4-4155-8f50-881558f83fae.png,479,890,568,983,89,93,red blood cell,8277,1.0449438202247192,0.956989247311828
30432,/images/dedbb10c-43f1-45fb-bb40-3ce2fb874015.png,449,1378,564,1488,115,110,red blood cell,12650,0.9565217391304348,1.0454545454545454
72555,/images/01b99da8-b66b-464b-a7ee-1cadab8db18b.png,962,1181,1068,1284,106,103,red blood cell,10918,0.9716981132075472,1.029126213592233
50487,/images/833b1d3e-d389-4d0f-8638-6aca5b89f917.png,790,148,898,277,108,129,red blood cell,13932,1.1944444444444444,0.8372093023255814
59406,/images/a7c3c52f-3b40-4c92-a212-df9462cf25d8.png,1069,1012,1169,1106,100,94,red blood cell,9400,0.94,1.0638297872340425
6809,/images/e36cb882-c6d0-4467-812e-d18c169a9a47.png,82,700,202,818,120,118,red blood cell,14160,0.9833333333333333,1.0169491525423728
79973,/images/e640ae51-cbf1-4a84-b7cf-d38b17f59c2f.png,67,1012,165,1105,98,93,red blood cell,9114,0.9489795918367347,1.053763440860215
33761,/images/441d7843-b20b-4c10-84e3-e6d32621e880.png,544,1151,649,1250,105,99,red blood cell,10395,0.9428571428571428,1.0606060606060606
27593,/images/715761a2-745e-4743-9849-956a034ad3c4.png,207,19,296,126,89,107,red blood cell,9523,1.202247191011236,0.8317757009345794
16758,/images/4823c1fe-a7f9-4b92-959f-0d9be09cd14b.png,620,974,729,1069,109,95,red blood cell,10355,0.8715596330275229,1.1473684210526316
8977,/images/ef815e3a-02a6-4cf8-9262-45bc74c50b00.png,858,864,959,969,101,105,red blood cell,10605,1.0396039603960396,0.9619047619047619
59688,/images/a2754679-68b0-40f4-be01-bafad5ac1261.png,6,10,95,102,89,92,red blood cell,8188,1.0337078651685394,0.967391304347826
50472,/images/833b1d3e-d389-4d0f-8638-6aca5b89f917.png,486,103,586,215,100,112,red blood cell,11200,1.12,0.8928571428571429
12692,/images/5a043d69-f435-46d4-8691-395c1602a76a.png,657,24,781,170,124,146,red blood cell,18104,1.1774193548387097,0.8493150684931506
25587,/images/f6ab936d-924b-4038-aa47-71b07c26b4e2.png,132,596,238,709,106,113,red blood cell,11978,1.0660377358490567,0.9380530973451328
64735,/images/76021d69-8919-4688-95ef-7418eff620cc.png,641,936,729,1024,88,88,red blood cell,7744,1.0,1.0
39782,/images/5c68070c-3391-4db6-8c01-94175105dbea.png,307,230,405,332,98,102,red blood cell,9996,1.0408163265306123,0.9607843137254902
32677,/images/0154dd8e-72f8-4d78-a4dd-93e139577bd1.png,501,840,620,937,119,97,red blood cell,11543,0.8151260504201681,1.2268041237113403
21710,/images/81af1442-d835-46bf-b80b-a898dba3da1b.png,666,147,780,269,114,122,red blood cell,13908,1.0701754385964912,0.9344262295081968
33808,/images/cb08956d-dd6a-4e13-817b-40a0a93068f1.png,622,83,740,193,118,110,red blood cell,12980,0.9322033898305084,1.0727272727272728
48752,/images/fed6ba05-36a5-45dc-a4e1-9baa7de2c622.png,132,1450,257,1559,125,109,red blood cell,13625,0.872,1.146788990825688
48374,/images/6fa2b30f-9b89-46ac-9b79-c0bc105d4271.png,398,873,488,965,90,92,red blood cell,8280,1.0222222222222221,0.9782608695652174
13484,/images/370277f8-436b-4103-8210-b4feb5ab95ea.png,191,895,277,996,86,101,red blood cell,8686,1.1744186046511629,0.8514851485148515
33059,/images/6231d81d-9e84-4a5a-8cb8-47c6a37a0176.png,494,1344,611,1464,117,120,red blood cell,14040,1.0256410256410255,0.975
9650,/images/d997337e-e4a8-4ef0-b8ba-975e6c43b62c.png,526,24,646,149,120,125,red blood cell,15000,1.0416666666666667,0.96
44723,/images/ccb4b13d-ab20-4222-892f-5adf70249aaa.png,467,677,583,788,116,111,red blood cell,12876,0.9568965517241379,1.045045045045045
27927,/images/46f5bd4f-8bea-48d1-a1da-4dea28e3b814.png,706,158,833,282,127,124,red blood cell,15748,0.9763779527559056,1.0241935483870968
53261,/images/d8f7e159-b7e3-49e4-86e8-aed8c5fbcd97.png,1080,1108,1177,1204,97,96,red blood cell,9312,0.9896907216494846,1.0104166666666667
49109,/images/df3d98b9-3dd7-4107-8d4a-ae1b7f247793.png,34,905,139,1015,105,110,red blood cell,11550,1.0476190476190477,0.9545454545454546
22428,/images/f97c7c87-5e27-45ea-9f93-3285d74091de.png,709,960,826,1066,117,106,red blood cell,12402,0.905982905982906,1.1037735849056605
53342,/images/d8f7e159-b7e3-49e4-86e8-aed8c5fbcd97.png,66,811,153,912,87,101,red blood cell,8787,1.160919540229885,0.8613861386138614
72812,/images/31435107-c77d-42f8-a619-75cba6a5161b.png,397,838,502,924,105,86,red blood cell,9030,0.819047619047619,1.2209302325581395
66255,/images/e8058bed-c362-4e1c-85dc-62f80f32938f.png,360,1274,460,1376,100,102,red blood cell,10200,1.02,0.9803921568627451
13877,/images/7d65d296-0f7b-41cc-9073-a547e24326c8.png,171,74,299,207,128,133,red blood cell,17024,1.0390625,0.9624060150375939
47516,/images/adff132d-3af0-4cef-942c-58fc09729bee.png,153,1413,281,1530,128,117,red blood cell,14976,0.9140625,1.0940170940170941
71210,/images/86495bbf-687b-429c-b9d3-6c2681ade7e2.png,942,1355,1044,1461,102,106,red blood cell,10812,1.0392156862745099,0.9622641509433962
68826,/images/aa3ad405-828e-4986-8251-20fd981f34d3.png,923,1269,1027,1386,104,117,red blood cell,12168,1.125,0.8888888888888888
47709,/images/afbb264e-ff60-443a-83f5-49d09be1b835.png,1048,886,1163,1009,115,123,red blood cell,14145,1.0695652173913044,0.9349593495934959
49108,/images/df3d98b9-3dd7-4107-8d4a-ae1b7f247793.png,316,962,411,1038,95,76,red blood cell,7220,0.8,1.25
67803,/images/48e2f0bd-2164-40c3-af43-1f2708359978.png,635,107,714,188,79,81,red blood cell,6399,1.0253164556962024,0.9753086419753086
69157,/images/de2b8835-552c-4f01-98b7-67bc4910062e.png,581,632,664,707,83,75,red blood cell,6225,0.9036144578313253,1.1066666666666667
62503,/images/7dfbfeaf-e3b1-4159-8dcd-d7f731280ac8.png,328,200,424,290,96,90,red blood cell,8640,0.9375,1.0666666666666667
79622,/images/a4409217-be11-4478-90a5-b406057d154d.png,214,1053,316,1158,102,105,red blood cell,10710,1.0294117647058822,0.9714285714285714
71453,/images/bcb447c9-5d37-414f-a513-d7076b04a532.png,569,220,663,325,94,105,red blood cell,9870,1.1170212765957446,0.8952380952380953
20615,/images/0f2a6cda-afec-437b-8803-8d3176b072c1.png,777,301,894,410,117,109,red blood cell,12753,0.9316239316239316,1.073394495412844
1200,/images/5ff7c0c8-d208-4e7d-958d-ca3c2260ff39.png,984,881,1115,1003,131,122,red blood cell,15982,0.9312977099236641,1.0737704918032787
4024,/images/a5e05ba8-0c19-41e3-92d5-10e42a03b85e.png,1004,414,1118,523,114,109,red blood cell,12426,0.956140350877193,1.0458715596330275
7354,/images/89f10192-d3dd-4996-a571-4c851dbdc983.png,156,864,251,946,95,82,red blood cell,7790,0.8631578947368421,1.1585365853658536
75945,/images/034c8d57-04d5-4786-93a4-6ae8fde2c258.png,720,99,832,202,112,103,red blood cell,11536,0.9196428571428571,1.087378640776699
4613,/images/9615ff33-b3fc-4d1e-9c05-0b8e3ef936df.png,927,63,1057,181,130,118,red blood cell,15340,0.9076923076923077,1.1016949152542372
25494,/images/f6ab936d-924b-4038-aa47-71b07c26b4e2.png,994,1076,1120,1190,126,114,red blood cell,14364,0.9047619047619048,1.105263157894737
64998,/images/ff3b9d4d-373c-48ef-a75a-d23e2c2ade87.png,276,1148,387,1245,111,97,red blood cell,10767,0.8738738738738738,1.1443298969072164
55691,/images/c32b8bb8-c89d-4ae9-9c77-5b9356ca35a1.png,248,1097,349,1191,101,94,red blood cell,9494,0.9306930693069307,1.074468085106383
75454,/images/468c261d-f5d8-423f-883e-48af2bbbc5d1.png,1021,1482,1097,1561,76,79,red blood cell,6004,1.0394736842105263,0.9620253164556962
75398,/images/468c261d-f5d8-423f-883e-48af2bbbc5d1.png,439,860,546,961,107,101,red blood cell,10807,0.9439252336448598,1.0594059405940595
21184,/images/fb05b297-180a-4171-b633-09d5616d7534.png,105,809,207,909,102,100,red blood cell,10200,0.9803921568627451,1.02
31055,/images/9c48fdf4-621d-4f40-bcd7-6a28cd530de7.png,200,1260,312,1387,112,127,red blood cell,14224,1.1339285714285714,0.8818897637795275
10301,/images/f91670db-be74-474c-bd72-68120aed4756.png,66,1461,187,1591,121,130,red blood cell,15730,1.0743801652892562,0.9307692307692308
41987,/images/46a03374-64c7-49ac-81c9-c3d62542bbf3.png,891,969,982,1049,91,80,red blood cell,7280,0.8791208791208791,1.1375
34499,/images/fa1f9f89-cecb-4972-842c-d14c632f89a9.png,321,879,443,1008,122,129,red blood cell,15738,1.0573770491803278,0.9457364341085271
9914,/images/b4261fa5-876d-48ea-b6da-ec7ca5b48fe2.png,1094,1023,1199,1131,105,108,red blood cell,11340,1.0285714285714285,0.9722222222222222
67257,/images/5f491efd-a21c-4a80-aaba-70b8876238ac.png,305,540,409,636,104,96,red blood cell,9984,0.9230769230769231,1.0833333333333333
56191,/images/137d540f-d71e-47e8-bd9b-6cd0a6433c33.png,155,1288,242,1366,87,78,red blood cell,6786,0.896551724137931,1.1153846153846154
78638,/images/3612aa3b-2906-44a6-9c80-6144511a35ce.png,26,799,138,910,112,111,red blood cell,12432,0.9910714285714286,1.009009009009009
76924,/images/25ddc1ca-d368-4fff-b1ad-1dbf1e7c97aa.png,932,119,1048,226,116,107,red blood cell,12412,0.9224137931034483,1.0841121495327102
49034,/images/df3d98b9-3dd7-4107-8d4a-ae1b7f247793.png,719,312,837,422,118,110,red blood cell,12980,0.9322033898305084,1.0727272727272728
12515,/images/8e4bdd0d-1c72-4836-ae3e-05e2e50e4983.png,476,755,583,862,107,107,red blood cell,11449,1.0,1.0
64332,/images/0a7bfa8a-ee52-4f7a-b9c5-2919ecfa93ef.png,417,573,521,681,104,108,red blood cell,11232,1.0384615384615385,0.9629629629629629
57090,/images/7d041c38-11f2-4186-8a24-29d7d0f5c3cf.png,66,1076,186,1197,120,121,red blood cell,14520,1.0083333333333333,0.9917355371900827
16827,/images/4823c1fe-a7f9-4b92-959f-0d9be09cd14b.png,349,1471,439,1577,90,106,red blood cell,9540,1.1777777777777778,0.8490566037735849
53850,/images/f24c8fe0-a534-44cf-9995-b2b314d945ba.png,921,1453,1031,1575,110,122,red blood cell,13420,1.1090909090909091,0.9016393442622951
15608,/images/169d541c-daed-468e-8b41-0f1abccdf319.png,805,1468,917,1598,112,130,red blood cell,14560,1.1607142857142858,0.8615384615384616
62597,/images/f7a4334a-4332-4de8-b39b-22da907976f2.png,685,1278,782,1390,97,112,red blood cell,10864,1.1546391752577319,0.8660714285714286
77416,/images/c7ec51d5-9f45-4209-8357-39e9a984a733.png,69,955,180,1070,111,115,red blood cell,12765,1.0360360360360361,0.9652173913043478
40679,/images/252071ac-e9f2-41d2-abbb-87ef01b8a997.png,962,1283,1064,1394,102,111,red blood cell,11322,1.088235294117647,0.918918918918919
6721,/images/672e4ecf-a56b-462e-b83b-76f4efaa6634.png,712,1124,823,1229,111,105,red blood cell,11655,0.9459459459459459,1.0571428571428572
48092,/images/05717db9-f1ef-4101-a9f7-7a007e83b1c9.png,992,301,1104,410,112,109,red blood cell,12208,0.9732142857142857,1.0275229357798166
41964,/images/46a03374-64c7-49ac-81c9-c3d62542bbf3.png,27,1264,132,1378,105,114,red blood cell,11970,1.0857142857142856,0.9210526315789473
55730,/images/c32b8bb8-c89d-4ae9-9c77-5b9356ca35a1.png,1035,1006,1131,1100,96,94,red blood cell,9024,0.9791666666666666,1.0212765957446808
58934,/images/7aae78ce-ac97-478d-983c-c0ec290171df.png,43,888,168,993,125,105,red blood cell,13125,0.84,1.1904761904761905
51499,/images/baa87bf8-786c-444c-81e8-9fa0a41d8149.png,342,1021,438,1122,96,101,red blood cell,9696,1.0520833333333333,0.9504950495049505
24120,/images/505355c9-23bf-4f90-8ebc-6a7ef50964d0.png,436,248,551,366,115,118,red blood cell,13570,1.0260869565217392,0.9745762711864406
58369,/images/50f2f514-6c8e-4c79-b3b3-0be56dd0b78b.png,895,1102,1007,1221,112,119,red blood cell,13328,1.0625,0.9411764705882353
28160,/images/cd2774a0-dab2-4d68-aae9-7568b9f3d2a6.png,70,1245,183,1347,113,102,red blood cell,11526,0.9026548672566371,1.107843137254902
71261,/images/445d0db9-e830-4ceb-a845-b23d819e6097.png,378,301,484,406,106,105,red blood cell,11130,0.9905660377358491,1.0095238095238095
20211,/images/c66cb6b2-1480-446a-a9d2-b8032a3de0d7.png,558,801,678,923,120,122,red blood cell,14640,1.0166666666666666,0.9836065573770492
5361,/images/716273ea-19c4-49af-8604-df587b295eca.png,369,882,482,996,113,114,red blood cell,12882,1.008849557522124,0.9912280701754386
35864,/images/2102e5d1-8bec-4ab6-ab35-2705485da1f8.png,236,1031,359,1153,123,122,red blood cell,15006,0.991869918699187,1.0081967213114753
57351,/images/a88a48b6-f85c-45c1-b42f-79716c8463f1.png,49,1165,170,1287,121,122,red blood cell,14762,1.0082644628099173,0.9918032786885246
59878,/images/1519257c-e3e5-4474-908f-8665b3cf1258.png,555,1332,665,1449,110,117,red blood cell,12870,1.0636363636363637,0.9401709401709402
27641,/images/a0785022-e82b-4878-b9d4-19cb7b75213f.png,148,1305,284,1440,136,135,red blood cell,18360,0.9926470588235294,1.0074074074074073
52367,/images/a2a20600-f851-4db7-90f9-6f7be027c8b5.png,658,76,761,174,103,98,red blood cell,10094,0.9514563106796117,1.0510204081632653
37947,/images/56a57a8d-c9b9-432a-a3b0-32a09355806c.png,592,1257,686,1349,94,92,red blood cell,8648,0.9787234042553191,1.0217391304347827
20050,/images/ebfd9f67-138e-49f0-9cef-a0352069eedb.png,559,1364,667,1476,108,112,red blood cell,12096,1.037037037037037,0.9642857142857143
5409,/images/75579b27-8191-4044-859b-268be969c42b.png,21,1469,148,1577,127,108,red blood cell,13716,0.8503937007874016,1.1759259259259258
4943,/images/755e5bf8-e8e1-492b-a32f-f7d87cccaa40.png,1052,985,1162,1098,110,113,red blood cell,12430,1.0272727272727273,0.9734513274336283
69701,/images/f0713bee-2a71-4ced-b953-4041ea99496a.png,260,776,357,875,97,99,red blood cell,9603,1.0206185567010309,0.9797979797979798
27224,/images/9f38055f-4fe6-47fd-a6dd-c0743db4eccf.png,181,839,281,945,100,106,red blood cell,10600,1.06,0.9433962264150944
79322,/images/05ac7b2a-6a77-4464-926b-8570f7c01693.png,1034,622,1118,710,84,88,red blood cell,7392,1.0476190476190477,0.9545454545454546
57401,/images/a88a48b6-f85c-45c1-b42f-79716c8463f1.png,249,264,329,361,80,97,red blood cell,7760,1.2125,0.8247422680412371
70256,/images/a5c3b3f8-7ceb-4573-a400-a76b9479af46.png,243,282,342,393,99,111,red blood cell,10989,1.121212121212121,0.8918918918918919
60982,/images/5397d8e2-bb09-42e7-9861-65ffad0fe94e.png,979,1342,1086,1467,107,125,red blood cell,13375,1.1682242990654206,0.856
24590,/images/c03d9b87-e19b-402b-ad86-b30d6e8aeb59.png,201,453,293,531,92,78,red blood cell,7176,0.8478260869565217,1.1794871794871795
12848,/images/b10ea12f-cd36-4f2c-994a-67d1665269ab.png,538,1361,643,1457,105,96,red blood cell,10080,0.9142857142857143,1.09375
16214,/images/acdc6e12-73d9-44ba-be8c-2a56aaffef4f.png,71,70,177,186,106,116,red blood cell,12296,1.0943396226415094,0.9137931034482759
53698,/images/6f67a66b-56ec-4c36-ae7c-f250d3b86a23.png,870,1107,977,1195,107,88,red blood cell,9416,0.822429906542056,1.2159090909090908
33090,/images/6231d81d-9e84-4a5a-8cb8-47c6a37a0176.png,343,1493,436,1589,93,96,red blood cell,8928,1.032258064516129,0.96875
32344,/images/a6526894-e290-482d-ac43-f1df34864817.png,34,1272,163,1377,129,105,red blood cell,13545,0.813953488372093,1.2285714285714286
52940,/images/e81bf478-27ff-458c-ac30-9e1f8480bc5c.png,62,1269,170,1383,108,114,red blood cell,12312,1.0555555555555556,0.9473684210526315
15705,/images/3892b776-f49a-4368-b0fa-7e855e76ccec.png,90,9,204,118,114,109,red blood cell,12426,0.956140350877193,1.0458715596330275
51442,/images/b4f3b2a4-f4b9-48de-ac5d-0e681b77be27.png,686,478,788,590,102,112,red blood cell,11424,1.0980392156862746,0.9107142857142857
14243,/images/6382976c-ee87-4916-b798-4ef1373b2df0.png,279,1020,385,1129,106,109,red blood cell,11554,1.028301886792453,0.9724770642201835
11763,/images/082e1f81-4f49-44ad-b5bb-9dfc155b2ed8.png,145,956,241,1059,96,103,red blood cell,9888,1.0729166666666667,0.9320388349514563
54413,/images/22a464ef-c3da-4d56-b37e-e22e95d945e7.png,707,201,801,289,94,88,red blood cell,8272,0.9361702127659575,1.0681818181818181
43865,/images/679ae89f-4a02-4301-862e-1d844cc66cbf.png,648,383,783,509,135,126,red blood cell,17010,0.9333333333333333,1.0714285714285714
74502,/images/cbb58718-6319-48db-b84b-78ac9b12ff89.png,480,824,589,922,109,98,red blood cell,10682,0.8990825688073395,1.1122448979591837
10143,/images/09ecf7be-28e2-4531-b9e2-07e01c44097d.png,185,951,302,1051,117,100,red blood cell,11700,0.8547008547008547,1.17
20275,/images/c66cb6b2-1480-446a-a9d2-b8032a3de0d7.png,503,368,610,487,107,119,red blood cell,12733,1.1121495327102804,0.8991596638655462
19706,/images/627d6331-7bb9-4d1a-b20d-e6541af4d0f9.png,617,139,725,244,108,105,red blood cell,11340,0.9722222222222222,1.0285714285714285
63552,/images/44b4a765-104e-4182-8871-e933c83c91ef.png,853,456,944,553,91,97,red blood cell,8827,1.065934065934066,0.9381443298969072
63345,/images/9f4bc3b4-abb0-4bcb-baa8-ec9f25e2b9c6.png,628,853,726,959,98,106,red blood cell,10388,1.0816326530612246,0.9245283018867925
39676,/images/04d21589-b777-43c2-86b5-038cbf8c3a4e.png,199,353,310,451,111,98,red blood cell,10878,0.8828828828828829,1.1326530612244898
30984,/images/b59dc3a0-3d54-4e3b-a485-33b3e43966de.png,697,263,821,375,124,112,red blood cell,13888,0.9032258064516129,1.1071428571428572
626,/images/e61e6af2-7f8b-47b0-bbe7-acb2ed0299ab.png,299,554,387,650,88,96,red blood cell,8448,1.0909090909090908,0.9166666666666666
48105,/images/05717db9-f1ef-4101-a9f7-7a007e83b1c9.png,17,1158,128,1260,111,102,red blood cell,11322,0.918918918918919,1.088235294117647
63414,/images/289ef1b7-02d5-42e9-a401-687688181306.png,934,557,1034,671,100,114,red blood cell,11400,1.14,0.8771929824561403
6350,/images/c6575e75-c8ce-4766-841f-1137b9e0956c.png,63,1491,182,1592,119,101,red blood cell,12019,0.8487394957983193,1.1782178217821782
22906,/images/be779f52-0bfa-4c01-a16f-b7f0bc92ed7c.png,295,1136,415,1244,120,108,red blood cell,12960,0.9,1.1111111111111112
75527,/images/fa4f8d1a-cb3a-4722-a566-6c7072f30606.png,813,985,927,1080,114,95,red blood cell,10830,0.8333333333333334,1.2
67146,/images/be6fe358-dee1-4dcf-9b0d-5d8612aba577.png,281,348,387,455,106,107,red blood cell,11342,1.009433962264151,0.9906542056074766
27784,/images/e3c1442a-717f-41dd-bf97-81e1233ac9fa.png,672,1510,764,1594,92,84,red blood cell,7728,0.9130434782608695,1.0952380952380953
61077,/images/6e86206f-dafe-4c28-bacc-7b83b2d40f0c.png,7,279,118,389,111,110,red blood cell,12210,0.990990990990991,1.009090909090909
79424,/images/dcb21739-3c36-459d-b3cc-1be5871d6fe7.png,546,1133,628,1217,82,84,red blood cell,6888,1.024390243902439,0.9761904761904762
78190,/images/2bed2796-75a9-4d93-bb2d-e3ccbe1a5cbe.png,24,1136,134,1238,110,102,red blood cell,11220,0.9272727272727272,1.0784313725490196
46657,/images/da111ca5-520f-4ea8-97ad-ae5fce58ee91.png,576,142,680,245,104,103,red blood cell,10712,0.9903846153846154,1.0097087378640777
78494,/images/c94827ce-d619-4705-a68a-df63a2c95ffa.png,399,195,502,292,103,97,red blood cell,9991,0.941747572815534,1.0618556701030928
30285,/images/cecbf663-0751-4e7f-b298-770c88afc2c1.png,686,1249,802,1369,116,120,red blood cell,13920,1.0344827586206897,0.9666666666666667
41774,/images/32a1ea24-b6b7-4253-ad3e-bdf99c2c9b9d.png,857,1199,973,1308,116,109,red blood cell,12644,0.9396551724137931,1.0642201834862386
28765,/images/686ed568-d5f8-475e-81ad-edab9dd473a0.png,547,1104,675,1211,128,107,red blood cell,13696,0.8359375,1.1962616822429906
66575,/images/087f2c9c-188d-43cc-a94c-0eb8f10ac092.png,243,1074,340,1173,97,99,red blood cell,9603,1.0206185567010309,0.9797979797979798
42968,/images/ff37dd9b-2e3c-444d-9d29-6db186cfa2fb.png,977,1246,1096,1374,119,128,red blood cell,15232,1.0756302521008403,0.9296875
7513,/images/071901eb-4c3f-404b-a747-3d0b9d0a5158.png,334,914,453,1036,119,122,red blood cell,14518,1.0252100840336134,0.9754098360655737
27233,/images/9f38055f-4fe6-47fd-a6dd-c0743db4eccf.png,1066,316,1173,407,107,91,red blood cell,9737,0.8504672897196262,1.1758241758241759
11838,/images/3cdcb09b-6a8c-43ca-b1d0-c1a289202f65.png,823,1151,930,1253,107,102,red blood cell,10914,0.9532710280373832,1.0490196078431373
28059,/images/f1f9df6d-c4cb-4b42-9ca2-8fb47b1b0e91.png,824,980,939,1101,115,121,red blood cell,13915,1.0521739130434782,0.9504132231404959
54599,/images/59dc7da9-35d1-421e-a61b-1e9637bfbfa1.png,610,1086,693,1185,83,99,red blood cell,8217,1.1927710843373494,0.8383838383838383
3898,/images/65e865f3-acfb-4d01-a75f-ff5a535ffa6a.png,254,1485,374,1600,120,115,red blood cell,13800,0.9583333333333334,1.0434782608695652
7774,/images/e726dac6-f962-449c-acff-4dd56847b685.png,666,972,761,1070,95,98,red blood cell,9310,1.0315789473684212,0.9693877551020408
64810,/images/a74b6d6a-7e04-40ac-9292-d62f13f7ded3.png,921,375,1013,466,92,91,red blood cell,8372,0.9891304347826086,1.010989010989011
14175,/images/c8fd1336-dd0a-4f97-abbf-be2c18b91e02.png,660,479,792,612,132,133,red blood cell,17556,1.0075757575757576,0.9924812030075187
47915,/images/ab27173b-6e30-4957-bd68-29194328fd39.png,305,417,415,549,110,132,red blood cell,14520,1.2,0.8333333333333334
48787,/images/fed6ba05-36a5-45dc-a4e1-9baa7de2c622.png,93,18,183,127,90,109,red blood cell,9810,1.211111111111111,0.8256880733944955
47856,/images/ab27173b-6e30-4957-bd68-29194328fd39.png,283,1362,379,1453,96,91,red blood cell,8736,0.9479166666666666,1.054945054945055
30882,/images/fbc1f360-4382-48bb-a32e-3f5f2f9dbe57.png,583,721,698,836,115,115,red blood cell,13225,1.0,1.0
65448,/images/b523daee-317b-461d-bdc1-07b4add4d488.png,616,509,743,629,127,120,red blood cell,15240,0.9448818897637795,1.0583333333333333
21023,/images/666601e7-608d-4d19-999f-8fc6ab373a55.png,927,1018,1036,1120,109,102,red blood cell,11118,0.9357798165137615,1.0686274509803921
47694,/images/4b3a49bc-8536-4760-9553-440a6f64db37.png,748,439,871,562,123,123,red blood cell,15129,1.0,1.0
24126,/images/505355c9-23bf-4f90-8ebc-6a7ef50964d0.png,795,1213,901,1317,106,104,red blood cell,11024,0.9811320754716981,1.0192307692307692
66761,/images/334bf865-e3fb-4200-bd53-d9ff5808ed9f.png,423,1122,514,1223,91,101,red blood cell,9191,1.10989010989011,0.900990099009901
48607,/images/55836297-fc8e-4e00-9767-0d12b86e4604.png,80,88,176,193,96,105,red blood cell,10080,1.09375,0.9142857142857143
27474,/images/f5869ba8-6253-426b-93f3-82af59a86144.png,380,313,487,434,107,121,red blood cell,12947,1.1308411214953271,0.8842975206611571
21780,/images/f68ae8e9-e760-4106-88e0-4bdef2785f06.png,354,921,478,1052,124,131,red blood cell,16244,1.0564516129032258,0.9465648854961832
12018,/images/ca16a5ad-b106-4e84-8a43-178710e854ba.png,980,1038,1091,1128,111,90,red blood cell,9990,0.8108108108108109,1.2333333333333334
30553,/images/7d9c1422-6332-44e9-b134-3ac94f07b0f0.png,872,283,969,391,97,108,red blood cell,10476,1.1134020618556701,0.8981481481481481
67508,/images/75660b56-51c2-45a9-9c15-e18d12a3af8c.png,418,401,527,518,109,117,red blood cell,12753,1.073394495412844,0.9316239316239316
12551,/images/8e4bdd0d-1c72-4836-ae3e-05e2e50e4983.png,1034,1410,1140,1514,106,104,red blood cell,11024,0.9811320754716981,1.0192307692307692
44020,/images/de81bf7a-7a56-437f-a068-4d9c3e01134c.png,975,448,1070,553,95,105,red blood cell,9975,1.105263157894737,0.9047619047619048
30185,/images/a1669b59-fe09-4fe6-ba9f-06bec6725502.png,100,964,215,1075,115,111,red blood cell,12765,0.9652173913043478,1.0360360360360361
18425,/images/39cc33be-d752-40fe-b7a8-2e69a3517205.png,471,1114,592,1246,121,132,red blood cell,15972,1.0909090909090908,0.9166666666666666
22600,/images/406e05f0-4444-414c-bb40-f4cb08e75ac9.png,334,504,452,605,118,101,red blood cell,11918,0.8559322033898306,1.1683168316831682
46045,/images/72088c26-d2dd-4906-b791-b8947fc7fbe4.png,957,266,1056,377,99,111,red blood cell,10989,1.121212121212121,0.8918918918918919
10673,/images/20d4f65e-6c63-433a-935c-d568d577967b.png,619,1458,724,1579,105,121,red blood cell,12705,1.1523809523809523,0.8677685950413223
54788,/images/b6364a57-72a9-43f3-8d02-9f53a992dc95.png,498,528,592,626,94,98,red blood cell,9212,1.0425531914893618,0.9591836734693877
59091,/images/5e2cea49-0823-49d1-83cf-8fd1559cdd93.png,743,542,834,636,91,94,red blood cell,8554,1.032967032967033,0.9680851063829787
61073,/images/6e86206f-dafe-4c28-bacc-7b83b2d40f0c.png,474,204,573,304,99,100,red blood cell,9900,1.0101010101010102,0.99
15058,/images/3003252a-2d2e-4687-ad30-9c38d68f1394.png,683,1198,797,1314,114,116,red blood cell,13224,1.0175438596491229,0.9827586206896551
43739,/images/ef83ed4c-2724-4d5f-8abe-1a18d25cea35.png,160,643,272,773,112,130,red blood cell,14560,1.1607142857142858,0.8615384615384616
70392,/images/4876c9d0-b386-48fb-84e8-91bf87529161.png,289,37,396,139,107,102,red blood cell,10914,0.9532710280373832,1.0490196078431373
1476,/images/0ac747cd-ff32-49bf-bc1a-3e9b7702ce9c.png,289,384,384,483,95,99,red blood cell,9405,1.0421052631578946,0.9595959595959596
70490,/images/8cca114a-ed05-4b87-95b7-fae02487f08c.png,1007,243,1115,362,108,119,red blood cell,12852,1.1018518518518519,0.907563025210084
14035,/images/eaf4b781-b3aa-41ce-8c5e-287979b4e15a.png,811,1409,903,1522,92,113,red blood cell,10396,1.2282608695652173,0.8141592920353983
36311,/images/81fed4a1-9d48-4938-90c9-c8bf3f5e6b1f.png,473,1450,589,1583,116,133,red blood cell,15428,1.146551724137931,0.8721804511278195
43016,/images/6c7095cd-ab6b-4f53-bd94-905d0cc95840.png,591,416,718,526,127,110,red blood cell,13970,0.8661417322834646,1.1545454545454545
78556,/images/c5084fb8-2b62-464c-8a77-1a07ea653266.png,360,1005,461,1104,101,99,red blood cell,9999,0.9801980198019802,1.02020202020202
16268,/images/d5009906-bce1-4353-90b4-f4c79362f4cf.png,296,484,412,614,116,130,red blood cell,15080,1.1206896551724137,0.8923076923076924
27185,/images/f232eec3-02c0-43f9-bf32-3e60245397e2.png,617,1156,738,1271,121,115,red blood cell,13915,0.9504132231404959,1.0521739130434782
46564,/images/edd09b2e-2673-4405-8ac0-e476e003e96a.png,881,136,1001,272,120,136,red blood cell,16320,1.1333333333333333,0.8823529411764706
48124,/images/05717db9-f1ef-4101-a9f7-7a007e83b1c9.png,333,388,445,489,112,101,red blood cell,11312,0.9017857142857143,1.108910891089109
46484,/images/21417261-475a-456f-b03f-57ac85a6e106.png,535,283,660,391,125,108,red blood cell,13500,0.864,1.1574074074074074
74668,/images/5ccca8ee-abea-458a-a891-bedd31c3ddc3.png,1073,463,1192,571,119,108,red blood cell,12852,0.907563025210084,1.1018518518518519
26101,/images/71925778-a26e-483e-a07c-f3aaf740122a.png,789,1296,904,1401,115,105,red blood cell,12075,0.9130434782608695,1.0952380952380953
12170,/images/87d6343b-70dd-4cdd-939f-d3ac0ca2e700.png,725,1307,826,1421,101,114,red blood cell,11514,1.1287128712871286,0.8859649122807017
55424,/images/d67655e6-0a80-4a86-b552-1f5e85788377.png,139,322,238,434,99,112,red blood cell,11088,1.1313131313131313,0.8839285714285714
52099,/images/de6d3020-9347-473b-9146-8909627790f6.png,14,1394,95,1474,81,80,red blood cell,6480,0.9876543209876543,1.0125
40262,/images/f05ffdca-dc3a-47bd-a231-2a0d9bd1d50e.png,1012,942,1124,1056,112,114,red blood cell,12768,1.0178571428571428,0.9824561403508771
64723,/images/76021d69-8919-4688-95ef-7418eff620cc.png,867,1007,974,1102,107,95,red blood cell,10165,0.8878504672897196,1.1263157894736842
12164,/images/87d6343b-70dd-4cdd-939f-d3ac0ca2e700.png,19,1303,141,1424,122,121,red blood cell,14762,0.9918032786885246,1.0082644628099173
74931,/images/dd090806-e4ac-4a78-b2ee-55a30626369c.png,992,842,1105,939,113,97,red blood cell,10961,0.8584070796460177,1.1649484536082475
24678,/images/78a5d1c3-44dd-44bc-ad5b-5e25bdcc4fae.png,858,385,962,486,104,101,red blood cell,10504,0.9711538461538461,1.0297029702970297
18415,/images/39cc33be-d752-40fe-b7a8-2e69a3517205.png,421,814,536,943,115,129,red blood cell,14835,1.1217391304347826,0.8914728682170543
51027,/images/cc275c45-7511-4070-84af-10b8ffebda53.png,542,639,651,750,109,111,red blood cell,12099,1.018348623853211,0.9819819819819819
27676,/images/18dbe7c4-89d2-42a6-a969-1e951ab313b1.png,639,829,736,938,97,109,red blood cell,10573,1.1237113402061856,0.8899082568807339
72601,/images/a63ce82f-f3d1-4818-9035-d3d230e5f686.png,916,417,1030,518,114,101,red blood cell,11514,0.8859649122807017,1.1287128712871286
59893,/images/1519257c-e3e5-4474-908f-8665b3cf1258.png,24,295,110,393,86,98,red blood cell,8428,1.1395348837209303,0.8775510204081632
71378,/images/bcb447c9-5d37-414f-a513-d7076b04a532.png,384,1308,489,1403,105,95,red blood cell,9975,0.9047619047619048,1.105263157894737
28550,/images/dbdfad64-110c-421f-a1c7-f68fd9e82d67.png,716,52,828,155,112,103,red blood cell,11536,0.9196428571428571,1.087378640776699
57674,/images/5c037ffc-f515-48b3-b231-c110fbd2b8ca.png,7,1300,113,1404,106,104,red blood cell,11024,0.9811320754716981,1.0192307692307692
66908,/images/9acf303a-fcba-4e52-be3e-8d061aa5e72a.png,168,1103,271,1213,103,110,red blood cell,11330,1.0679611650485437,0.9363636363636364
61054,/images/6e86206f-dafe-4c28-bacc-7b83b2d40f0c.png,849,279,956,385,107,106,red blood cell,11342,0.9906542056074766,1.009433962264151
6288,/images/f4a27dfd-4c52-459f-96b5-ee6b452a3395.png,207,751,330,863,123,112,red blood cell,13776,0.9105691056910569,1.0982142857142858
70733,/images/8ab5c462-045e-4b59-b53a-9b2bc3ed2487.png,630,287,732,394,102,107,red blood cell,10914,1.0490196078431373,0.9532710280373832
26287,/images/52767904-4cdc-4821-ba68-8cd0c28f9023.png,837,1483,959,1596,122,113,red blood cell,13786,0.9262295081967213,1.079646017699115
21694,/images/81af1442-d835-46bf-b80b-a898dba3da1b.png,865,1273,979,1403,114,130,red blood cell,14820,1.1403508771929824,0.8769230769230769
2707,/images/a89cace5-c818-4f23-a432-052b3433b81e.png,947,871,1049,994,102,123,red blood cell,12546,1.2058823529411764,0.8292682926829268
18573,/images/c22f7031-9cf8-48ce-b03b-1b12d0db4951.png,237,602,328,710,91,108,red blood cell,9828,1.1868131868131868,0.8425925925925926
40971,/images/bbe65c18-8a56-4dfe-875c-94e124a84125.png,149,546,263,680,114,134,red blood cell,15276,1.1754385964912282,0.8507462686567164
36374,/images/4a0a05e1-11ad-4bfc-bfa3-adf3b9bd0b56.png,956,1249,1064,1365,108,116,red blood cell,12528,1.0740740740740742,0.9310344827586207
3882,/images/73dd09d3-2bff-4b5e-b996-9da0b8b54a8f.png,177,873,331,1006,154,133,red blood cell,20482,0.8636363636363636,1.1578947368421053
31067,/images/9c48fdf4-621d-4f40-bcd7-6a28cd530de7.png,308,1038,431,1144,123,106,red blood cell,13038,0.8617886178861789,1.1603773584905661
35648,/images/45f18ac0-f097-4b20-a99d-8837cf488822.png,904,1088,1022,1206,118,118,red blood cell,13924,1.0,1.0
66123,/images/191f87a4-6f2d-49e7-bba0-08e3aa78ddaf.png,464,843,538,924,74,81,red blood cell,5994,1.0945945945945945,0.9135802469135802
36128,/images/cb2fac19-90b0-48b4-bdc5-7dbbd58756d1.png,1,1430,105,1540,104,110,red blood cell,11440,1.0576923076923077,0.9454545454545454
55258,/images/8ad7ba46-5db8-4ba9-b3e0-3cac52f7efc3.png,245,677,348,788,103,111,red blood cell,11433,1.0776699029126213,0.9279279279279279
57410,/images/00d04a90-80e5-4bce-9511-1b64eabb7a47.png,785,1219,875,1317,90,98,red blood cell,8820,1.0888888888888888,0.9183673469387755
37824,/images/8d56197c-21d7-4cb6-92df-80637efd129b.png,496,1408,604,1527,108,119,red blood cell,12852,1.1018518518518519,0.907563025210084
39432,/images/55f8c052-8e49-4423-a4c4-365fc6afb6e1.png,958,346,1099,477,141,131,red blood cell,18471,0.9290780141843972,1.0763358778625953
15674,/images/3892b776-f49a-4368-b0fa-7e855e76ccec.png,853,465,968,571,115,106,red blood cell,12190,0.9217391304347826,1.0849056603773586
41,/images/8d02117d-6c71-4e47-b50a-6cc8d5eb1d55.png,240,515,315,592,75,77,red blood cell,5775,1.0266666666666666,0.974025974025974
18633,/images/c22f7031-9cf8-48ce-b03b-1b12d0db4951.png,729,1399,828,1502,99,103,red blood cell,10197,1.0404040404040404,0.9611650485436893
35914,/images/33068c1a-48f7-470b-8e49-e2f0888042e9.png,4,347,135,472,131,125,red blood cell,16375,0.9541984732824428,1.048
63003,/images/f234a2de-f3c8-4521-a306-8cfdf52dd597.png,589,129,671,206,82,77,red blood cell,6314,0.9390243902439024,1.0649350649350648
77471,/images/a11ed7d0-12f6-468f-abad-5cba7d968123.png,591,391,715,507,124,116,red blood cell,14384,0.9354838709677419,1.0689655172413792
57697,/images/5c037ffc-f515-48b3-b231-c110fbd2b8ca.png,895,115,1019,221,124,106,red blood cell,13144,0.8548387096774194,1.169811320754717
58083,/images/a7c91b63-b97c-4f4b-8d34-7ad2b08d7a17.png,892,70,995,171,103,101,red blood cell,10403,0.9805825242718447,1.0198019801980198
55328,/images/4fb83278-adc5-4424-9f45-b6d0db2955b6.png,470,846,568,948,98,102,red blood cell,9996,1.0408163265306123,0.9607843137254902
72315,/images/ee57e743-a876-4f69-9fe5-bf5d01b44689.png,642,158,731,246,89,88,red blood cell,7832,0.9887640449438202,1.0113636363636365
2698,/images/a89cace5-c818-4f23-a432-052b3433b81e.png,751,254,863,369,112,115,red blood cell,12880,1.0267857142857142,0.9739130434782609
37247,/images/2fdbd9bc-bbaf-44c2-b40c-d193709639fa.png,170,204,260,307,90,103,red blood cell,9270,1.1444444444444444,0.8737864077669902
15918,/images/c7c1b873-0548-4a73-9618-f60912e164df.png,148,324,249,415,101,91,red blood cell,9191,0.900990099009901,1.10989010989011
69793,/images/2bd15b6e-fe2d-49f3-b394-940d024d1f91.png,188,655,269,740,81,85,red blood cell,6885,1.0493827160493827,0.9529411764705882
65296,/images/24418314-f7a4-49fc-a03e-ec597ca6796e.png,635,843,733,958,98,115,red blood cell,11270,1.1734693877551021,0.8521739130434782
51535,/images/6afb3717-f197-4668-929a-4fab389ae6e8.png,1066,921,1174,1045,108,124,red blood cell,13392,1.1481481481481481,0.8709677419354839
39355,/images/17ef5841-bd19-4610-ba47-7d321231847b.png,407,1356,508,1477,101,121,red blood cell,12221,1.198019801980198,0.8347107438016529
18365,/images/39cc33be-d752-40fe-b7a8-2e69a3517205.png,522,324,621,445,99,121,red blood cell,11979,1.2222222222222223,0.8181818181818182
44480,/images/b6573be3-9e04-49c3-9f48-6a145d065363.png,839,315,955,432,116,117,red blood cell,13572,1.0086206896551724,0.9914529914529915
50702,/images/6b4c79f5-b194-4586-be9f-e339c5af4188.png,985,527,1117,642,132,115,red blood cell,15180,0.8712121212121212,1.1478260869565218
29668,/images/b85fc640-de49-4f7e-afc0-978ff020f2e2.png,942,1223,1069,1337,127,114,red blood cell,14478,0.8976377952755905,1.1140350877192982
34150,/images/f1cda808-69a9-4d10-ba0a-6607c98e362d.png,285,332,417,460,132,128,red blood cell,16896,0.9696969696969697,1.03125
18802,/images/cc882eae-a341-4783-bd19-8bdedf798538.png,1093,357,1189,464,96,107,red blood cell,10272,1.1145833333333333,0.897196261682243
35566,/images/a1ff36df-71df-4e6e-a65f-ced9a2b381c3.png,247,833,363,944,116,111,red blood cell,12876,0.9568965517241379,1.045045045045045
51347,/images/b4f3b2a4-f4b9-48de-ac5d-0e681b77be27.png,713,1400,821,1508,108,108,red blood cell,11664,1.0,1.0
4473,/images/cf90d82f-2814-4fb7-a3ff-a86b7c5efca7.png,355,1304,463,1411,108,107,red blood cell,11556,0.9907407407407407,1.0093457943925233
64784,/images/a74b6d6a-7e04-40ac-9292-d62f13f7ded3.png,655,1185,749,1271,94,86,red blood cell,8084,0.9148936170212766,1.0930232558139534
39906,/images/71cf2467-77d3-4fac-ac6e-1d8767717c34.png,357,333,485,457,128,124,red blood cell,15872,0.96875,1.032258064516129
28051,/images/c4d34e35-4db2-41de-ba77-1a94aa9ef788.png,721,1078,829,1169,108,91,red blood cell,9828,0.8425925925925926,1.1868131868131868
6953,/images/a9feccda-18f2-405e-9aa1-409fa1f49fe4.png,194,517,312,634,118,117,red blood cell,13806,0.9915254237288136,1.0085470085470085
18797,/images/cc882eae-a341-4783-bd19-8bdedf798538.png,434,902,539,1002,105,100,red blood cell,10500,0.9523809523809523,1.05
13108,/images/711f6b3f-cd63-46d1-834a-bc8e9aa9b43e.png,301,1418,405,1527,104,109,red blood cell,11336,1.0480769230769231,0.9541284403669725
78951,/images/6144887d-a1c1-46db-91a1-f7ff5bf8c8a5.png,780,1105,879,1216,99,111,red blood cell,10989,1.121212121212121,0.8918918918918919
50147,/images/4cccfcf0-cac9-46f0-870c-0eabfdc781ba.png,804,954,913,1069,109,115,red blood cell,12535,1.055045871559633,0.9478260869565217
42175,/images/04c07425-57c7-415c-a0bc-36857bbd4049.png,1050,1358,1178,1497,128,139,red blood cell,17792,1.0859375,0.920863309352518
21551,/images/49efc89d-9cba-44f7-8257-7f911b73f68a.png,140,958,251,1063,111,105,red blood cell,11655,0.9459459459459459,1.0571428571428572
65410,/images/b523daee-317b-461d-bdc1-07b4add4d488.png,61,885,162,975,101,90,red blood cell,9090,0.8910891089108911,1.1222222222222222
2852,/images/521a26aa-0a31-4c07-b4d0-fac08eb08344.png,76,677,192,773,116,96,red blood cell,11136,0.8275862068965517,1.2083333333333333
31417,/images/6695a204-e39c-4418-b904-3f080fdbe7e8.png,216,284,316,389,100,105,red blood cell,10500,1.05,0.9523809523809523
21573,/images/49efc89d-9cba-44f7-8257-7f911b73f68a.png,466,484,558,577,92,93,red blood cell,8556,1.0108695652173914,0.989247311827957
22573,/images/bfe65b11-8aff-46aa-908b-1e989d25fdc4.png,56,1201,188,1314,132,113,red blood cell,14916,0.8560606060606061,1.168141592920354
74484,/images/cbb58718-6319-48db-b84b-78ac9b12ff89.png,287,886,385,972,98,86,red blood cell,8428,0.8775510204081632,1.1395348837209303
72891,/images/31435107-c77d-42f8-a619-75cba6a5161b.png,0,1065,86,1153,86,88,red blood cell,7568,1.0232558139534884,0.9772727272727273
70973,/images/deaa1931-5f97-45bf-8c00-be6ddeb37b9a.png,647,530,759,647,112,117,red blood cell,13104,1.0446428571428572,0.9572649572649573
60339,/images/1c87b997-a8e6-48ca-bf40-19b9a7fd6a96.png,259,1105,387,1228,128,123,red blood cell,15744,0.9609375,1.0406504065040652
29009,/images/4c13e22e-dfd1-4fa1-b373-be9d0c272c0f.png,615,1152,706,1254,91,102,red blood cell,9282,1.120879120879121,0.8921568627450981
4979,/images/2cc3c4ad-670f-41b6-8910-0704cbc192ef.png,248,547,339,643,91,96,red blood cell,8736,1.054945054945055,0.9479166666666666
8752,/images/29dc8176-dfe1-40e0-8247-2dc3c530057e.png,245,652,368,778,123,126,red blood cell,15498,1.024390243902439,0.9761904761904762
1528,/images/0ac747cd-ff32-49bf-bc1a-3e9b7702ce9c.png,670,673,782,781,112,108,red blood cell,12096,0.9642857142857143,1.037037037037037
40023,/images/8a4aadac-cf5c-4a79-b875-271b3fbfd230.png,814,925,931,1035,117,110,red blood cell,12870,0.9401709401709402,1.0636363636363637
39245,/images/2aeb7b85-7df9-4a63-8d37-2eecaaa190e7.png,823,885,926,982,103,97,red blood cell,9991,0.941747572815534,1.0618556701030928
31561,/images/a0b277cb-20bc-4921-a6bd-5ccd5b91d14f.png,57,521,195,649,138,128,red blood cell,17664,0.927536231884058,1.078125
44987,/images/13bab3c3-3f79-44d9-a287-0ae6d71eff31.png,198,957,321,1085,123,128,red blood cell,15744,1.0406504065040652,0.9609375
65566,/images/01b38a56-13eb-447b-89ee-fc21cb40dcc1.png,482,540,580,643,98,103,red blood cell,10094,1.0510204081632653,0.9514563106796117
73052,/images/2bd26501-2fbc-4c1a-bef0-4ad57e02b4d0.png,1097,1078,1192,1190,95,112,red blood cell,10640,1.1789473684210525,0.8482142857142857
1501,/images/0ac747cd-ff32-49bf-bc1a-3e9b7702ce9c.png,89,174,206,273,117,99,red blood cell,11583,0.8461538461538461,1.1818181818181819
54158,/images/c415532c-4cce-4580-9fcd-623c172a1abd.png,3,7,121,122,118,115,red blood cell,13570,0.9745762711864406,1.0260869565217392
14942,/images/5d1418d3-1559-4725-ad4a-9afb6eaecdfd.png,144,493,242,591,98,98,red blood cell,9604,1.0,1.0
18215,/images/947348fe-4c70-468e-8009-3c14daeca69b.png,171,427,276,528,105,101,red blood cell,10605,0.9619047619047619,1.0396039603960396
50353,/images/3d32a988-449d-4d58-b71f-abbfdc3f2fbc.png,1090,274,1189,375,99,101,red blood cell,9999,1.02020202020202,0.9801980198019802
76464,/images/34df8890-272d-423a-ae78-ff8d068d3306.png,152,511,247,607,95,96,red blood cell,9120,1.0105263157894737,0.9895833333333334
67945,/images/bcaefb02-682a-41b9-acc7-e6cc010f5b30.png,696,303,787,397,91,94,red blood cell,8554,1.032967032967033,0.9680851063829787
63273,/images/d3283f5b-3b3a-40ea-800b-79960ca851cb.png,825,1019,948,1131,123,112,red blood cell,13776,0.9105691056910569,1.0982142857142858
8376,/images/9a1cd456-310c-47b6-a1f8-0fbd8e33d1fd.png,738,319,855,428,117,109,red blood cell,12753,0.9316239316239316,1.073394495412844
18283,/images/947348fe-4c70-468e-8009-3c14daeca69b.png,912,1392,1006,1481,94,89,red blood cell,8366,0.9468085106382979,1.0561797752808988
77542,/images/2d2e81f3-e329-4765-9ba1-2c95f12dc9f3.png,439,1087,549,1205,110,118,red blood cell,12980,1.0727272727272728,0.9322033898305084
27849,/images/948c94ad-395c-41f4-9a68-8a1dcb76888c.png,412,374,533,489,121,115,red blood cell,13915,0.9504132231404959,1.0521739130434782
64498,/images/6ba5d0b8-cdc7-4266-9d78-db76faa312e9.png,806,829,921,942,115,113,red blood cell,12995,0.9826086956521739,1.0176991150442478
4475,/images/cf90d82f-2814-4fb7-a3ff-a86b7c5efca7.png,775,250,898,376,123,126,red blood cell,15498,1.024390243902439,0.9761904761904762
50250,/images/3d32a988-449d-4d58-b71f-abbfdc3f2fbc.png,247,1069,351,1175,104,106,red blood cell,11024,1.0192307692307692,0.9811320754716981
54568,/images/59dc7da9-35d1-421e-a61b-1e9637bfbfa1.png,624,681,759,808,135,127,red blood cell,17145,0.9407407407407408,1.062992125984252
71216,/images/86495bbf-687b-429c-b9d3-6c2681ade7e2.png,827,1014,929,1123,102,109,red blood cell,11118,1.0686274509803921,0.9357798165137615
69273,/images/f274b784-b995-4a7e-a2c2-6cc31c24c4b4.png,562,399,648,485,86,86,red blood cell,7396,1.0,1.0
78824,/images/19979a60-df80-4111-bf69-81a7e9c4dd0b.png,626,776,759,905,133,129,red blood cell,17157,0.9699248120300752,1.0310077519379846
164,/images/13099edb-35d9-438f-b093-2cf2ebf9d255.png,716,796,840,922,124,126,red blood cell,15624,1.0161290322580645,0.9841269841269841
56236,/images/b600b38d-225b-46a5-b6f8-b607430f6a10.png,521,650,627,754,106,104,red blood cell,11024,0.9811320754716981,1.0192307692307692
18029,/images/0f0c949e-018a-4f3f-ab02-3704f49c7754.png,1059,1090,1178,1217,119,127,red blood cell,15113,1.0672268907563025,0.937007874015748
68919,/images/bbaa004f-05dc-4cb8-8768-e148085bb0f9.png,1055,674,1146,780,91,106,red blood cell,9646,1.164835164835165,0.8584905660377359
78791,/images/9174f910-3859-4839-8e30-2c3b25269322.png,105,1287,230,1388,125,101,red blood cell,12625,0.808,1.2376237623762376
36653,/images/21f001d6-f568-4ea4-82da-fab54c77c419.png,25,265,112,359,87,94,red blood cell,8178,1.0804597701149425,0.925531914893617
28420,/images/a6d85204-24b8-4b23-a8b1-c3e8b93f9f22.png,596,959,713,1077,117,118,red blood cell,13806,1.0085470085470085,0.9915254237288136
41137,/images/2240b991-48f6-4c59-9b62-5a8b5e541fae.png,1022,1140,1138,1255,116,115,red blood cell,13340,0.9913793103448276,1.008695652173913
18382,/images/39cc33be-d752-40fe-b7a8-2e69a3517205.png,377,650,494,747,117,97,red blood cell,11349,0.8290598290598291,1.2061855670103092
69904,/images/9edba799-e169-46cd-b100-c9f8fc7a8c7d.png,981,699,1090,816,109,117,red blood cell,12753,1.073394495412844,0.9316239316239316
24728,/images/78a5d1c3-44dd-44bc-ad5b-5e25bdcc4fae.png,167,282,274,400,107,118,red blood cell,12626,1.102803738317757,0.9067796610169492
43124,/images/c5db0fc0-b96c-496e-90b4-f9fb1b85b28e.png,860,457,973,582,113,125,red blood cell,14125,1.1061946902654867,0.904
38808,/images/d0d3ae45-b434-4869-a518-427320ebe62d.png,9,164,137,285,128,121,red blood cell,15488,0.9453125,1.0578512396694215
17103,/images/dc3bdfe9-1565-4cda-9c4e-0979846dab60.png,562,192,661,290,99,98,red blood cell,9702,0.98989898989899,1.010204081632653
51284,/images/216f9d43-6869-4ba1-9106-4f5ea6aac223.png,406,1459,500,1569,94,110,red blood cell,10340,1.1702127659574468,0.8545454545454545
62676,/images/f7a4334a-4332-4de8-b39b-22da907976f2.png,1106,7,1178,93,72,86,red blood cell,6192,1.1944444444444444,0.8372093023255814
75208,/images/61dfc937-a428-44b4-94fb-d682bdb8dff0.png,79,650,195,757,116,107,red blood cell,12412,0.9224137931034483,1.0841121495327102
14128,/images/eaf4b781-b3aa-41ce-8c5e-287979b4e15a.png,308,1298,395,1392,87,94,red blood cell,8178,1.0804597701149425,0.925531914893617
53944,/images/540a5fee-175b-4b92-bf62-1ea9b59c86c6.png,403,1,523,121,120,120,red blood cell,14400,1.0,1.0
22624,/images/406e05f0-4444-414c-bb40-f4cb08e75ac9.png,314,1294,424,1410,110,116,red blood cell,12760,1.0545454545454545,0.9482758620689655
24788,/images/530761d4-1931-44cd-b220-d60db0e228f9.png,156,598,285,706,129,108,red blood cell,13932,0.8372093023255814,1.1944444444444444
41824,/images/c3b07675-9d02-477c-91fe-f0737867049b.png,831,158,953,291,122,133,red blood cell,16226,1.0901639344262295,0.9172932330827067
67531,/images/45902b63-be9a-49ae-9ede-3a8015671bc4.png,396,984,509,1105,113,121,red blood cell,13673,1.0707964601769913,0.9338842975206612
8292,/images/65e3d6a6-012c-4b40-9a42-83078eb85e31.png,1075,580,1164,670,89,90,red blood cell,8010,1.0112359550561798,0.9888888888888889
48819,/images/fed6ba05-36a5-45dc-a4e1-9baa7de2c622.png,796,972,890,1067,94,95,red blood cell,8930,1.0106382978723405,0.9894736842105263
78506,/images/c94827ce-d619-4705-a68a-df63a2c95ffa.png,609,406,729,510,120,104,red blood cell,12480,0.8666666666666667,1.1538461538461537
68785,/images/aa3ad405-828e-4986-8251-20fd981f34d3.png,402,625,500,718,98,93,red blood cell,9114,0.9489795918367347,1.053763440860215
40385,/images/db249e5a-4142-432c-8288-bacd10d7273d.png,513,1244,630,1365,117,121,red blood cell,14157,1.0341880341880343,0.9669421487603306
28806,/images/686ed568-d5f8-475e-81ad-edab9dd473a0.png,25,1117,126,1220,101,103,red blood cell,10403,1.0198019801980198,0.9805825242718447
3573,/images/25132962-ff5d-4737-995f-c54d8490539b.png,681,276,791,396,110,120,red blood cell,13200,1.0909090909090908,0.9166666666666666
80071,/images/99e979d4-ee97-4d7f-9da6-00bead40db4d.png,29,1141,125,1243,96,102,red blood cell,9792,1.0625,0.9411764705882353
47420,/images/3e753a44-3264-438c-8389-a7822e4a84cc.png,205,290,338,398,133,108,red blood cell,14364,0.8120300751879699,1.2314814814814814
38798,/images/b426ef1d-4a59-4f90-b593-50226af60a60.png,619,41,727,147,108,106,red blood cell,11448,0.9814814814814815,1.0188679245283019
76971,/images/51e86aa9-caa0-4297-94e8-34a57d7f7e36.png,355,1500,452,1592,97,92,red blood cell,8924,0.9484536082474226,1.0543478260869565
59435,/images/a7c3c52f-3b40-4c92-a212-df9462cf25d8.png,189,198,298,293,109,95,red blood cell,10355,0.8715596330275229,1.1473684210526316
47777,/images/5a105b89-c592-4d78-b208-7db6c6572752.png,988,530,1089,642,101,112,red blood cell,11312,1.108910891089109,0.9017857142857143
17675,/images/b5143aae-6e98-4dc6-b546-980cb472de67.png,289,499,407,613,118,114,red blood cell,13452,0.9661016949152542,1.0350877192982457
35943,/images/5836500a-221e-40ca-a8be-caaa37f7d300.png,388,1379,487,1482,99,103,red blood cell,10197,1.0404040404040404,0.9611650485436893
30170,/images/a1669b59-fe09-4fe6-ba9f-06bec6725502.png,477,206,586,331,109,125,red blood cell,13625,1.146788990825688,0.872
19048,/images/6e39fb0a-aa41-4b16-b783-7589e97bf289.png,645,573,771,698,126,125,red blood cell,15750,0.9920634920634921,1.008
43456,/images/5a539312-6cfa-43e6-8d5d-db883f343ad9.png,118,292,230,423,112,131,red blood cell,14672,1.1696428571428572,0.8549618320610687
73015,/images/2bd26501-2fbc-4c1a-bef0-4ad57e02b4d0.png,173,997,267,1082,94,85,red blood cell,7990,0.9042553191489362,1.1058823529411765
10947,/images/c442e2d6-aaf9-417a-9905-4737a1115f33.png,927,808,1047,929,120,121,red blood cell,14520,1.0083333333333333,0.9917355371900827
62574,/images/9ecf2006-8d49-4ae8-a14b-ed8b3b14ee7c.png,467,690,604,820,137,130,red blood cell,17810,0.948905109489051,1.0538461538461539
46802,/images/63055d1b-5221-4c80-8b39-37ac069a1b5c.png,950,984,1075,1093,125,109,red blood cell,13625,0.872,1.146788990825688
51300,/images/216f9d43-6869-4ba1-9106-4f5ea6aac223.png,277,486,370,577,93,91,red blood cell,8463,0.978494623655914,1.021978021978022
74774,/images/c53fd511-31bd-4901-baac-3b44891f6744.png,2,697,101,798,99,101,red blood cell,9999,1.02020202020202,0.9801980198019802
59477,/images/a7c3c52f-3b40-4c92-a212-df9462cf25d8.png,91,833,193,937,102,104,red blood cell,10608,1.0196078431372548,0.9807692307692307
30390,/images/58d75854-be99-484e-89f0-4ab208fe07e0.png,434,841,541,952,107,111,red blood cell,11877,1.0373831775700935,0.963963963963964
13300,/images/030f3421-ed3f-4bf1-8f27-4d02590bffbc.png,993,582,1091,662,98,80,red blood cell,7840,0.8163265306122449,1.225
30121,/images/81c3c8f0-d5a9-4dda-afd5-e86f6afd9424.png,686,532,797,636,111,104,red blood cell,11544,0.9369369369369369,1.0673076923076923
41570,/images/0fcd1ebe-ee4a-40a0-b787-29cee18bfa1b.png,820,467,931,567,111,100,red blood cell,11100,0.9009009009009009,1.11
19642,/images/a3ada657-de00-44db-b1e2-54ba17e39983.png,704,1338,823,1454,119,116,red blood cell,13804,0.9747899159663865,1.0258620689655173
53352,/images/f23ae29e-1bda-4784-b10c-d736757d39b8.png,155,682,270,784,115,102,red blood cell,11730,0.8869565217391304,1.1274509803921569
72101,/images/64b0e49a-0e48-447d-8872-c1dd255e7a21.png,957,1025,1035,1105,78,80,red blood cell,6240,1.0256410256410255,0.975
7082,/images/8be185e7-2a1a-441c-a5c7-b50a9eb926cb.png,403,1398,520,1514,117,116,red blood cell,13572,0.9914529914529915,1.0086206896551724
11014,/images/c442e2d6-aaf9-417a-9905-4737a1115f33.png,39,824,162,928,123,104,red blood cell,12792,0.8455284552845529,1.1826923076923077
32413,/images/3911fcd2-4e26-4ad9-aaf0-d1c5bf41defc.png,276,1074,376,1198,100,124,red blood cell,12400,1.24,0.8064516129032258
58337,/images/50f2f514-6c8e-4c79-b3b3-0be56dd0b78b.png,202,305,324,427,122,122,red blood cell,14884,1.0,1.0
70268,/images/a5c3b3f8-7ceb-4573-a400-a76b9479af46.png,612,1497,708,1600,96,103,red blood cell,9888,1.0729166666666667,0.9320388349514563
63776,/images/06401963-8b02-46c5-ab2a-3d70bd01623f.png,204,829,292,907,88,78,red blood cell,6864,0.8863636363636364,1.1282051282051282
59798,/images/f77d7469-d083-4c2d-a4ea-5a9ff162e3e2.png,1120,1326,1197,1401,77,75,red blood cell,5775,0.974025974025974,1.0266666666666666
33622,/images/00c8364b-8c85-4502-bcfe-64736fe76815.png,593,338,702,428,109,90,red blood cell,9810,0.8256880733944955,1.211111111111111
61236,/images/b3058064-d817-47dd-a8c4-cdb1f62374f8.png,306,609,412,708,106,99,red blood cell,10494,0.9339622641509434,1.0707070707070707
37318,/images/4d88e2d2-5aad-410c-9bbc-702ee9496995.png,329,894,455,1014,126,120,red blood cell,15120,0.9523809523809523,1.05
23385,/images/a7688988-2bcc-4458-83d3-5e482da5f87b.png,268,272,384,373,116,101,red blood cell,11716,0.8706896551724138,1.1485148514851484
72308,/images/ee57e743-a876-4f69-9fe5-bf5d01b44689.png,347,481,456,574,109,93,red blood cell,10137,0.8532110091743119,1.1720430107526882
21915,/images/d57b3894-c912-47e8-b00a-e1a2a7aba644.png,178,1215,295,1328,117,113,red blood cell,13221,0.9658119658119658,1.0353982300884956
59135,/images/4736f545-1f1f-4d77-9241-d69cbf4dae35.png,82,1143,196,1256,114,113,red blood cell,12882,0.9912280701754386,1.008849557522124
42478,/images/29648565-fe28-4517-ba72-68df0c82c9c5.png,172,1156,292,1275,120,119,red blood cell,14280,0.9916666666666667,1.0084033613445378
13655,/images/1e86933d-6a5a-4a3c-a0f2-ca22afd767b3.png,10,657,141,788,131,131,red blood cell,17161,1.0,1.0
18705,/images/f6f8a69a-3fd2-4684-ac77-3e83ea0fb36d.png,312,309,435,433,123,124,red blood cell,15252,1.008130081300813,0.9919354838709677
18897,/images/e9e78ff8-831b-46e9-9785-3eee9acbfcd8.png,122,701,226,798,104,97,red blood cell,10088,0.9326923076923077,1.0721649484536082
60582,/images/58065a0c-d4c5-40fd-bcdc-037f61788482.png,0,1407,132,1532,132,125,red blood cell,16500,0.946969696969697,1.056
47883,/images/ab27173b-6e30-4957-bd68-29194328fd39.png,258,829,358,931,100,102,red blood cell,10200,1.02,0.9803921568627451
23671,/images/79d7a014-21ff-40f1-9ac4-a69839390654.png,863,241,947,335,84,94,red blood cell,7896,1.119047619047619,0.8936170212765957
43766,/images/ef83ed4c-2724-4d5f-8abe-1a18d25cea35.png,711,90,811,197,100,107,red blood cell,10700,1.07,0.9345794392523364
71449,/images/bcb447c9-5d37-414f-a513-d7076b04a532.png,603,658,706,754,103,96,red blood cell,9888,0.9320388349514563,1.0729166666666667
33121,/images/6231d81d-9e84-4a5a-8cb8-47c6a37a0176.png,139,711,226,802,87,91,red blood cell,7917,1.0459770114942528,0.9560439560439561
61378,/images/e16c0dab-780d-4035-872e-1bb91e49f9d2.png,894,585,987,700,93,115,red blood cell,10695,1.2365591397849462,0.808695652173913
70770,/images/b62d47f9-2ff5-4902-abdc-b3610acfc7ba.png,965,586,1059,682,94,96,red blood cell,9024,1.0212765957446808,0.9791666666666666
37308,/images/4d88e2d2-5aad-410c-9bbc-702ee9496995.png,591,41,720,183,129,142,red blood cell,18318,1.1007751937984496,0.9084507042253521
46757,/images/da111ca5-520f-4ea8-97ad-ae5fce58ee91.png,514,64,592,159,78,95,red blood cell,7410,1.2179487179487178,0.8210526315789474
13604,/images/d47cd049-d78b-4ba3-a7d4-399be4dd1dde.png,403,294,517,414,114,120,red blood cell,13680,1.0526315789473684,0.95
32863,/images/2a6370b0-08f1-4c11-a639-265d4419c9a3.png,135,1205,256,1324,121,119,red blood cell,14399,0.9834710743801653,1.0168067226890756
76824,/images/2165fe38-b474-467d-be11-d1d728085efd.png,931,753,1043,870,112,117,red blood cell,13104,1.0446428571428572,0.9572649572649573
42256,/images/ca734448-0d52-42fa-b41c-17b2939e58ae.png,612,75,728,204,116,129,red blood cell,14964,1.1120689655172413,0.8992248062015504
36470,/images/cfe6086f-eb0b-4cb0-a430-8cd7de6556e2.png,227,1314,322,1419,95,105,red blood cell,9975,1.105263157894737,0.9047619047619048
16959,/images/8eeb378e-90f0-47ea-ac1c-2a201eb8d090.png,931,1293,1051,1409,120,116,red blood cell,13920,0.9666666666666667,1.0344827586206897
28488,/images/dc4270fb-e5c2-414f-96e9-6769ba1d77e4.png,674,139,771,236,97,97,red blood cell,9409,1.0,1.0
9071,/images/21c2a8aa-407c-4569-8212-96fcafa84138.png,1075,321,1179,444,104,123,red blood cell,12792,1.1826923076923077,0.8455284552845529
66608,/images/087f2c9c-188d-43cc-a94c-0eb8f10ac092.png,346,322,427,417,81,95,red blood cell,7695,1.1728395061728396,0.8526315789473684
6085,/images/c147584d-4c61-412a-bdaf-b02b22c18708.png,1,1111,108,1217,107,106,red blood cell,11342,0.9906542056074766,1.009433962264151
7401,/images/76dbce7f-dc3e-4a29-b1fe-ab9dce583080.png,337,957,458,1074,121,117,red blood cell,14157,0.9669421487603306,1.0341880341880343
6293,/images/f4a27dfd-4c52-459f-96b5-ee6b452a3395.png,211,1127,338,1240,127,113,red blood cell,14351,0.889763779527559,1.1238938053097345
9874,/images/3859deaf-6ae1-49a3-9051-898d0f0d7de6.png,1116,844,1198,933,82,89,red blood cell,7298,1.0853658536585367,0.9213483146067416
25471,/images/5f742392-278d-461c-a848-08def2c28878.png,286,861,388,959,102,98,red blood cell,9996,0.9607843137254902,1.0408163265306123
16501,/images/1315c2a4-0794-4dfa-a709-e2451723d2b6.png,338,1433,470,1572,132,139,red blood cell,18348,1.053030303030303,0.9496402877697842
71273,/images/445d0db9-e830-4ceb-a845-b23d819e6097.png,669,520,781,626,112,106,red blood cell,11872,0.9464285714285714,1.0566037735849056
36950,/images/b2e34f5f-904e-4473-9dc7-c6bc1ce12640.png,5,555,104,656,99,101,red blood cell,9999,1.02020202020202,0.9801980198019802
56317,/images/4372709c-f356-4906-be17-415384d916e8.png,205,995,321,1112,116,117,red blood cell,13572,1.0086206896551724,0.9914529914529915
14624,/images/c649e1cb-4029-4433-b231-d67d68f7391a.png,153,776,254,889,101,113,red blood cell,11413,1.118811881188119,0.8938053097345132
57521,/images/00d04a90-80e5-4bce-9511-1b64eabb7a47.png,828,581,901,671,73,90,red blood cell,6570,1.2328767123287672,0.8111111111111111
59064,/images/5e2cea49-0823-49d1-83cf-8fd1559cdd93.png,121,123,217,223,96,100,red blood cell,9600,1.0416666666666667,0.96
39512,/images/5a631871-2fc7-4a68-9c39-f3b9a0bf4a04.png,259,1069,377,1194,118,125,red blood cell,14750,1.0593220338983051,0.944
36323,/images/81fed4a1-9d48-4938-90c9-c8bf3f5e6b1f.png,359,707,503,863,144,156,red blood cell,22464,1.0833333333333333,0.9230769230769231
4942,/images/755e5bf8-e8e1-492b-a32f-f7d87cccaa40.png,12,1194,136,1313,124,119,red blood cell,14756,0.9596774193548387,1.0420168067226891
54284,/images/3b5a8060-dec6-4a83-b7f2-b604e4e69dfc.png,608,1431,699,1538,91,107,red blood cell,9737,1.1758241758241759,0.8504672897196262
731,/images/dcc1a193-7b74-44f8-ad8d-813751d8fa6b.png,283,1115,399,1228,116,113,red blood cell,13108,0.9741379310344828,1.0265486725663717
50928,/images/ef8fcfa4-8466-4186-8c69-f5f4904eb489.png,817,260,921,364,104,104,red blood cell,10816,1.0,1.0
37047,/images/b2e34f5f-904e-4473-9dc7-c6bc1ce12640.png,1095,1047,1193,1150,98,103,red blood cell,10094,1.0510204081632653,0.9514563106796117
63031,/images/f234a2de-f3c8-4521-a306-8cfdf52dd597.png,161,895,240,961,79,66,red blood cell,5214,0.8354430379746836,1.196969696969697
49441,/images/f2574be3-81c6-4fc3-8a40-0230d1264f52.png,47,1054,141,1144,94,90,red blood cell,8460,0.9574468085106383,1.0444444444444445
9844,/images/3859deaf-6ae1-49a3-9051-898d0f0d7de6.png,295,725,386,823,91,98,red blood cell,8918,1.0769230769230769,0.9285714285714286
10365,/images/46a2d369-4bea-4405-ac78-91bbe130b9a7.png,185,719,302,828,117,109,red blood cell,12753,0.9316239316239316,1.073394495412844
38742,/images/b426ef1d-4a59-4f90-b593-50226af60a60.png,913,907,1011,1015,98,108,red blood cell,10584,1.1020408163265305,0.9074074074074074
4063,/images/e02edd82-c424-4dee-98a7-575640655d9b.png,104,37,219,138,115,101,red blood cell,11615,0.8782608695652174,1.1386138613861385
8788,/images/ae17a099-18b5-4a42-a901-850ea056423e.png,465,625,569,731,104,106,red blood cell,11024,1.0192307692307692,0.9811320754716981
34915,/images/a4fbb9f2-9b75-4fdc-877d-2feaafac25b3.png,357,174,457,271,100,97,red blood cell,9700,0.97,1.0309278350515463
32775,/images/eef2ac0b-42de-4bc3-a3c3-d5fcd597fbe4.png,538,517,636,617,98,100,red blood cell,9800,1.0204081632653061,0.98
38241,/images/b834cbf7-ff97-49d9-9561-566c9343735c.png,839,448,966,578,127,130,red blood cell,16510,1.0236220472440944,0.9769230769230769
20657,/images/d09eed76-e09b-4d90-b8f0-5a801beae41c.png,867,471,995,596,128,125,red blood cell,16000,0.9765625,1.024
65036,/images/ff3b9d4d-373c-48ef-a75a-d23e2c2ade87.png,457,1018,557,1119,100,101,red blood cell,10100,1.01,0.9900990099009901
79003,/images/6144887d-a1c1-46db-91a1-f7ff5bf8c8a5.png,902,164,994,256,92,92,red blood cell,8464,1.0,1.0
25672,/images/c118ff18-f9f2-4617-bddb-dc4091fb8f5f.png,1056,64,1172,171,116,107,red blood cell,12412,0.9224137931034483,1.0841121495327102
65046,/images/ff3b9d4d-373c-48ef-a75a-d23e2c2ade87.png,140,120,230,215,90,95,red blood cell,8550,1.0555555555555556,0.9473684210526315
48134,/images/913099c5-8085-4908-bf4b-1f098bbfcf66.png,30,507,134,620,104,113,red blood cell,11752,1.0865384615384615,0.9203539823008849
72087,/images/64b0e49a-0e48-447d-8872-c1dd255e7a21.png,1077,1467,1172,1557,95,90,red blood cell,8550,0.9473684210526315,1.0555555555555556
40445,/images/db249e5a-4142-432c-8288-bacd10d7273d.png,45,1368,134,1474,89,106,red blood cell,9434,1.1910112359550562,0.839622641509434
37202,/images/befe6182-266b-4f8a-ac82-3a4154f05f60.png,714,615,840,741,126,126,red blood cell,15876,1.0,1.0
2397,/images/fe851c88-692d-4199-87e0-d19d9c4eb591.png,553,1470,658,1563,105,93,red blood cell,9765,0.8857142857142857,1.1290322580645162
62382,/images/9af1ee02-87fd-42bc-963e-fa9ac3eb45bb.png,363,1136,456,1232,93,96,red blood cell,8928,1.032258064516129,0.96875
67482,/images/8e72e20e-e714-4db6-a1da-c05a409257d4.png,607,62,697,159,90,97,red blood cell,8730,1.0777777777777777,0.9278350515463918
30142,/images/a1669b59-fe09-4fe6-ba9f-06bec6725502.png,1067,611,1178,727,111,116,red blood cell,12876,1.045045045045045,0.9568965517241379
39804,/images/5c68070c-3391-4db6-8c01-94175105dbea.png,268,1355,357,1439,89,84,red blood cell,7476,0.9438202247191011,1.0595238095238095
80076,/images/99e979d4-ee97-4d7f-9da6-00bead40db4d.png,849,835,942,936,93,101,red blood cell,9393,1.086021505376344,0.9207920792079208
6,/images/8d02117d-6c71-4e47-b50a-6cc8d5eb1d55.png,257,1384,364,1502,107,118,red blood cell,12626,1.102803738317757,0.9067796610169492
57547,/images/8190ec37-9a5e-419f-89ed-fbfb079370db.png,851,787,944,887,93,100,red blood cell,9300,1.075268817204301,0.93
68321,/images/0f735cca-051c-4048-a1fa-cb36f389e12f.png,522,272,647,393,125,121,red blood cell,15125,0.968,1.0330578512396693
46999,/images/9ebd623d-5534-4dd9-bff8-cdedf322db35.png,949,1292,1046,1385,97,93,red blood cell,9021,0.9587628865979382,1.043010752688172
24211,/images/194aec70-41a5-4ac3-b22f-0b6eda91f730.png,391,1261,501,1368,110,107,red blood cell,11770,0.9727272727272728,1.02803738317757
73498,/images/5f2b32bd-fdca-4d6f-b13a-ee9f83626c8d.png,914,655,1002,744,88,89,red blood cell,7832,1.0113636363636365,0.9887640449438202
53914,/images/540a5fee-175b-4b92-bf62-1ea9b59c86c6.png,821,567,932,673,111,106,red blood cell,11766,0.954954954954955,1.0471698113207548
2469,/images/fe851c88-692d-4199-87e0-d19d9c4eb591.png,491,805,594,912,103,107,red blood cell,11021,1.0388349514563107,0.9626168224299065
5939,/images/e0e6b676-c39c-4542-8adf-de257a8e92e2.png,925,967,1052,1082,127,115,red blood cell,14605,0.905511811023622,1.1043478260869566
54136,/images/c415532c-4cce-4580-9fcd-623c172a1abd.png,927,269,1041,391,114,122,red blood cell,13908,1.0701754385964912,0.9344262295081968
62098,/images/f5c51193-8a27-4ef3-83ad-771395d63caf.png,576,1219,696,1318,120,99,red blood cell,11880,0.825,1.2121212121212122
48350,/images/6fa2b30f-9b89-46ac-9b79-c0bc105d4271.png,4,1358,107,1476,103,118,red blood cell,12154,1.145631067961165,0.8728813559322034
61080,/images/6e86206f-dafe-4c28-bacc-7b83b2d40f0c.png,437,892,537,1000,100,108,red blood cell,10800,1.08,0.9259259259259259
55644,/images/c32b8bb8-c89d-4ae9-9c77-5b9356ca35a1.png,66,1220,174,1317,108,97,red blood cell,10476,0.8981481481481481,1.1134020618556701
31950,/images/9eb66577-7857-43dc-a879-8f2c9d7f780f.png,945,556,1050,665,105,109,red blood cell,11445,1.0380952380952382,0.963302752293578
54277,/images/3b5a8060-dec6-4a83-b7f2-b604e4e69dfc.png,884,1006,985,1106,101,100,red blood cell,10100,0.9900990099009901,1.01
65891,/images/d7581cb0-7a12-471d-a3d8-68dcea362213.png,869,150,962,250,93,100,red blood cell,9300,1.075268817204301,0.93
56135,/images/50d9fc90-8642-4bb6-91a7-0069a7e37392.png,825,287,926,377,101,90,red blood cell,9090,0.8910891089108911,1.1222222222222222
60903,/images/11b72c7b-5c52-44b7-adb7-21eacc25e441.png,105,1377,196,1466,91,89,red blood cell,8099,0.978021978021978,1.0224719101123596
46578,/images/edd09b2e-2673-4405-8ac0-e476e003e96a.png,359,734,462,839,103,105,red blood cell,10815,1.0194174757281553,0.9809523809523809
60356,/images/1c87b997-a8e6-48ca-bf40-19b9a7fd6a96.png,132,1342,263,1458,131,116,red blood cell,15196,0.8854961832061069,1.1293103448275863
25409,/images/5f742392-278d-461c-a848-08def2c28878.png,8,687,122,812,114,125,red blood cell,14250,1.0964912280701755,0.912
12620,/images/0901f9d1-be4f-4c19-8e83-dd724dded9f5.png,1004,714,1127,843,123,129,red blood cell,15867,1.048780487804878,0.9534883720930233
7653,/images/21cc498b-8cb2-42ed-8f80-bfa27b86ef11.png,19,723,131,832,112,109,red blood cell,12208,0.9732142857142857,1.0275229357798166
31745,/images/bd432159-5956-457c-bdeb-1b5e702ba513.png,2,873,117,980,115,107,red blood cell,12305,0.9304347826086956,1.074766355140187
72099,/images/64b0e49a-0e48-447d-8872-c1dd255e7a21.png,935,56,1028,136,93,80,red blood cell,7440,0.8602150537634409,1.1625
61758,/images/985627c9-7b85-40de-a106-eb9cc47b47cb.png,270,866,363,960,93,94,red blood cell,8742,1.010752688172043,0.9893617021276596
60071,/images/e63e1607-f344-43d6-a0d8-e10cf2e5054a.png,968,1419,1088,1531,120,112,red blood cell,13440,0.9333333333333333,1.0714285714285714
35796,/images/bb2042c5-35e1-43cc-8171-7de81b764361.png,197,462,290,565,93,103,red blood cell,9579,1.10752688172043,0.9029126213592233
43154,/images/c5db0fc0-b96c-496e-90b4-f9fb1b85b28e.png,389,1088,491,1194,102,106,red blood cell,10812,1.0392156862745099,0.9622641509433962
63619,/images/d9c9479e-f1ea-4d6e-861f-843ff9a90d19.png,287,466,409,587,122,121,red blood cell,14762,0.9918032786885246,1.0082644628099173
66422,/images/5f66d20c-fbfe-44ec-a01b-8a09da24807e.png,720,398,836,529,116,131,red blood cell,15196,1.1293103448275863,0.8854961832061069
77294,/images/07a80340-f65e-4f58-9317-94bb6ebd5a28.png,567,501,657,585,90,84,red blood cell,7560,0.9333333333333333,1.0714285714285714
10890,/images/b78b88f0-154a-4b54-8aaf-85d37a42a0f9.png,640,918,788,1042,148,124,red blood cell,18352,0.8378378378378378,1.1935483870967742
77827,/images/6bc7b53c-5a98-48ef-a9de-59a476707ea4.png,921,727,1031,842,110,115,red blood cell,12650,1.0454545454545454,0.9565217391304348
26310,/images/d33bc9fc-3444-4f26-8082-307f9fccc52b.png,812,182,940,322,128,140,red blood cell,17920,1.09375,0.9142857142857143
64781,/images/a74b6d6a-7e04-40ac-9292-d62f13f7ded3.png,308,688,413,784,105,96,red blood cell,10080,0.9142857142857143,1.09375
31003,/images/b59dc3a0-3d54-4e3b-a485-33b3e43966de.png,682,389,810,500,128,111,red blood cell,14208,0.8671875,1.1531531531531531
3129,/images/14efbfc8-39f6-4599-9994-a8cc95605b9c.png,880,362,991,473,111,111,red blood cell,12321,1.0,1.0
4352,/images/84041bf9-dace-4066-9fe0-52170d08f826.png,276,1380,368,1482,92,102,red blood cell,9384,1.108695652173913,0.9019607843137255
7258,/images/89f10192-d3dd-4996-a571-4c851dbdc983.png,971,1440,1076,1567,105,127,red blood cell,13335,1.2095238095238094,0.8267716535433071
22307,/images/49b03a6e-6b26-4a96-a061-e05647a02138.png,14,1057,129,1176,115,119,red blood cell,13685,1.0347826086956522,0.9663865546218487
46461,/images/bbecf1a8-a728-4c83-87f8-4dfbac0a1e03.png,532,65,649,179,117,114,red blood cell,13338,0.9743589743589743,1.0263157894736843
44278,/images/4257342d-6d77-4671-a84b-1f0c36ccb367.png,30,832,144,928,114,96,red blood cell,10944,0.8421052631578947,1.1875
15405,/images/1b7f47fc-26cd-4273-b848-88a7cbfd9f85.png,419,1035,530,1140,111,105,red blood cell,11655,0.9459459459459459,1.0571428571428572
56646,/images/4adcaa26-aa1f-47b5-bdf0-18c9f814f576.png,271,309,386,434,115,125,red blood cell,14375,1.0869565217391304,0.92
16437,/images/e474a20b-2769-48f1-a520-4f6ef5a0dbf5.png,917,490,999,588,82,98,red blood cell,8036,1.1951219512195121,0.8367346938775511
70351,/images/90246988-0d6d-4bf8-8a76-94107de4121e.png,570,593,654,673,84,80,red blood cell,6720,0.9523809523809523,1.05
39575,/images/5a631871-2fc7-4a68-9c39-f3b9a0bf4a04.png,740,171,853,274,113,103,red blood cell,11639,0.911504424778761,1.0970873786407767
692,/images/e61e6af2-7f8b-47b0-bbe7-acb2ed0299ab.png,60,13,167,122,107,109,red blood cell,11663,1.0186915887850467,0.981651376146789
65571,/images/01b38a56-13eb-447b-89ee-fc21cb40dcc1.png,433,1493,528,1575,95,82,red blood cell,7790,0.8631578947368421,1.1585365853658536
36410,/images/4a0a05e1-11ad-4bfc-bfa3-adf3b9bd0b56.png,456,451,578,571,122,120,red blood cell,14640,0.9836065573770492,1.0166666666666666
1366,/images/6d91d1f0-636b-4f5a-a526-7c17fc857190.png,791,244,884,331,93,87,red blood cell,8091,0.9354838709677419,1.0689655172413792
15666,/images/3892b776-f49a-4368-b0fa-7e855e76ccec.png,505,557,641,683,136,126,red blood cell,17136,0.9264705882352942,1.0793650793650793
50709,/images/6b4c79f5-b194-4586-be9f-e339c5af4188.png,586,253,710,376,124,123,red blood cell,15252,0.9919354838709677,1.008130081300813
41816,/images/c3b07675-9d02-477c-91fe-f0737867049b.png,206,1353,332,1471,126,118,red blood cell,14868,0.9365079365079365,1.0677966101694916
44112,/images/8b494b40-cab5-49d3-893d-c805000fbe88.png,768,173,886,270,118,97,red blood cell,11446,0.8220338983050848,1.2164948453608246
40571,/images/29861cf9-9a1e-4733-8309-4bd10706b4a3.png,780,1161,917,1282,137,121,red blood cell,16577,0.8832116788321168,1.1322314049586777
30948,/images/533c47c9-02a6-419b-961b-81797f022f6c.png,1049,365,1156,460,107,95,red blood cell,10165,0.8878504672897196,1.1263157894736842
58792,/images/e4827c85-311a-4df1-89c2-99dad0c3558c.png,984,748,1070,832,86,84,red blood cell,7224,0.9767441860465116,1.0238095238095237
34637,/images/a0eedcb9-b85c-4612-b945-7e8227f53c35.png,711,726,810,816,99,90,red blood cell,8910,0.9090909090909091,1.1
5569,/images/eb6e8684-b84e-483d-b835-f59286d2516b.png,467,638,580,759,113,121,red blood cell,13673,1.0707964601769913,0.9338842975206612
14712,/images/1fdf99d1-a494-4174-bcd7-efbe457ab899.png,298,1357,400,1461,102,104,red blood cell,10608,1.0196078431372548,0.9807692307692307
33071,/images/6231d81d-9e84-4a5a-8cb8-47c6a37a0176.png,135,756,228,852,93,96,red blood cell,8928,1.032258064516129,0.96875
60835,/images/0ab56f9a-846d-49e2-a617-c6cc477fdfad.png,163,94,275,211,112,117,red blood cell,13104,1.0446428571428572,0.9572649572649573
26526,/images/b2f05937-b965-4c4b-b86e-f50e95d9d691.png,966,1181,1096,1298,130,117,red blood cell,15210,0.9,1.1111111111111112
49354,/images/28c96a4a-4549-4761-99e4-ace4ea7e7ac9.png,1089,1403,1200,1525,111,122,red blood cell,13542,1.0990990990990992,0.9098360655737705
61938,/images/c66a3e52-0f3f-4c81-bab9-0303499549f7.png,631,349,759,478,128,129,red blood cell,16512,1.0078125,0.9922480620155039
14746,/images/1fdf99d1-a494-4174-bcd7-efbe457ab899.png,238,561,363,694,125,133,red blood cell,16625,1.064,0.9398496240601504
46865,/images/63055d1b-5221-4c80-8b39-37ac069a1b5c.png,627,457,722,554,95,97,red blood cell,9215,1.0210526315789474,0.979381443298969
42399,/images/1a27ebe9-93a1-4898-af69-f276057d4012.png,263,567,372,683,109,116,red blood cell,12644,1.0642201834862386,0.9396551724137931
60176,/images/214f1d15-a081-476e-992d-6c3a77f03d59.png,849,1250,946,1361,97,111,red blood cell,10767,1.1443298969072164,0.8738738738738738
19405,/images/5487faad-24a7-46b6-92d8-479d3a8d229f.png,452,1023,551,1111,99,88,red blood cell,8712,0.8888888888888888,1.125
10210,/images/e3ea07d7-884a-412e-874a-40fd6b856736.png,711,1194,827,1304,116,110,red blood cell,12760,0.9482758620689655,1.0545454545454545
19985,/images/8e69098c-fae0-47a3-8833-c2bfdfb1a416.png,176,375,291,486,115,111,red blood cell,12765,0.9652173913043478,1.0360360360360361
59290,/images/03c8da48-04b9-4520-b674-44a0ecd35688.png,429,1139,510,1215,81,76,red blood cell,6156,0.9382716049382716,1.0657894736842106
16014,/images/7e25ced3-5caf-47f8-ad0c-42946bd4468b.png,309,1314,430,1416,121,102,red blood cell,12342,0.8429752066115702,1.1862745098039216
63546,/images/44b4a765-104e-4182-8871-e933c83c91ef.png,558,1138,658,1244,100,106,red blood cell,10600,1.06,0.9433962264150944
73987,/images/99a21c5c-f5a7-4c07-9cb6-5dda2d388f48.png,855,116,950,226,95,110,red blood cell,10450,1.1578947368421053,0.8636363636363636
16280,/images/d5009906-bce1-4353-90b4-f4c79362f4cf.png,1052,604,1172,728,120,124,red blood cell,14880,1.0333333333333334,0.967741935483871
16450,/images/e474a20b-2769-48f1-a520-4f6ef5a0dbf5.png,854,590,950,671,96,81,red blood cell,7776,0.84375,1.1851851851851851
58988,/images/a0eeeb10-d0cb-48d9-8c22-2c3a3c908d00.png,832,1274,970,1386,138,112,red blood cell,15456,0.8115942028985508,1.2321428571428572
54286,/images/3b5a8060-dec6-4a83-b7f2-b604e4e69dfc.png,757,1397,860,1515,103,118,red blood cell,12154,1.145631067961165,0.8728813559322034
58919,/images/8a7deb24-d2b4-4acf-86c4-3aadd39157fa.png,634,1026,760,1152,126,126,red blood cell,15876,1.0,1.0
32789,/images/eef2ac0b-42de-4bc3-a3c3-d5fcd597fbe4.png,687,181,768,276,81,95,red blood cell,7695,1.1728395061728396,0.8526315789473684
31052,/images/9c48fdf4-621d-4f40-bcd7-6a28cd530de7.png,510,332,627,445,117,113,red blood cell,13221,0.9658119658119658,1.0353982300884956
30402,/images/58d75854-be99-484e-89f0-4ab208fe07e0.png,809,799,918,904,109,105,red blood cell,11445,0.963302752293578,1.0380952380952382
7266,/images/89f10192-d3dd-4996-a571-4c851dbdc983.png,165,254,267,359,102,105,red blood cell,10710,1.0294117647058822,0.9714285714285714
48507,/images/f3d84be2-8af0-4d62-9f72-23d3dc08cbbe.png,289,986,406,1108,117,122,red blood cell,14274,1.0427350427350428,0.9590163934426229
71133,/images/b666fcc2-d0b2-441e-bc5a-c660345eeb5d.png,128,1094,250,1217,122,123,red blood cell,15006,1.0081967213114753,0.991869918699187
31426,/images/6695a204-e39c-4418-b904-3f080fdbe7e8.png,490,468,603,578,113,110,red blood cell,12430,0.9734513274336283,1.0272727272727273
36145,/images/749df49e-5212-49ea-9e88-7d66f258f1df.png,417,249,519,364,102,115,red blood cell,11730,1.1274509803921569,0.8869565217391304
170,/images/13099edb-35d9-438f-b093-2cf2ebf9d255.png,81,1099,200,1223,119,124,red blood cell,14756,1.0420168067226891,0.9596774193548387
52091,/images/de6d3020-9347-473b-9146-8909627790f6.png,55,1299,168,1405,113,106,red blood cell,11978,0.9380530973451328,1.0660377358490567
53357,/images/f23ae29e-1bda-4784-b10c-d736757d39b8.png,232,281,326,383,94,102,red blood cell,9588,1.0851063829787233,0.9215686274509803
66462,/images/5f66d20c-fbfe-44ec-a01b-8a09da24807e.png,3,810,115,912,112,102,red blood cell,11424,0.9107142857142857,1.0980392156862746
12318,/images/3b55c42f-ad59-422f-ba99-4f4f4ca9cb2e.png,1082,67,1178,157,96,90,red blood cell,8640,0.9375,1.0666666666666667
24581,/images/c03d9b87-e19b-402b-ad86-b30d6e8aeb59.png,364,650,457,734,93,84,red blood cell,7812,0.9032258064516129,1.1071428571428572
11997,/images/ca16a5ad-b106-4e84-8a43-178710e854ba.png,104,1322,223,1431,119,109,red blood cell,12971,0.9159663865546218,1.091743119266055
71610,/images/390ad256-e1ed-476a-9f14-2dc34e0da632.png,719,150,830,266,111,116,red blood cell,12876,1.045045045045045,0.9568965517241379
69018,/images/b5246b58-6f40-4c9e-8024-f49b0ed6bdbd.png,361,1065,475,1161,114,96,red blood cell,10944,0.8421052631578947,1.1875
77626,/images/07d15855-eb9b-46a9-b894-7cfe4d097826.png,367,448,472,549,105,101,red blood cell,10605,0.9619047619047619,1.0396039603960396
63786,/images/6013bff0-dc4b-4bde-9409-0f6139c3495c.png,560,591,667,701,107,110,red blood cell,11770,1.02803738317757,0.9727272727272728
3507,/images/ad36bd67-594b-4f63-93e3-886af0bc618e.png,857,183,991,307,134,124,red blood cell,16616,0.9253731343283582,1.0806451612903225
14993,/images/5d1418d3-1559-4725-ad4a-9afb6eaecdfd.png,19,1471,131,1579,112,108,red blood cell,12096,0.9642857142857143,1.037037037037037
30604,/images/f939782b-f5a2-40a3-9c22-6c6d7e18edc3.png,240,158,344,272,104,114,red blood cell,11856,1.0961538461538463,0.9122807017543859
1451,/images/5f17d2fb-22fa-4aa6-9dad-6a1d50c03815.png,129,1359,248,1476,119,117,red blood cell,13923,0.9831932773109243,1.017094017094017
43158,/images/c5db0fc0-b96c-496e-90b4-f9fb1b85b28e.png,82,1190,191,1290,109,100,red blood cell,10900,0.9174311926605505,1.09
51936,/images/4f62b14e-c6f4-4155-8f50-881558f83fae.png,704,749,806,858,102,109,red blood cell,11118,1.0686274509803921,0.9357798165137615
55296,/images/4fb83278-adc5-4424-9f45-b6d0db2955b6.png,821,1175,919,1284,98,109,red blood cell,10682,1.1122448979591837,0.8990825688073395
16100,/images/66557580-fd38-4d4b-80d8-88611ecc78c6.png,65,201,187,335,122,134,red blood cell,16348,1.098360655737705,0.9104477611940298
20735,/images/79b3a64f-2fb9-46e0-85d4-2bdd59c2075e.png,342,671,462,777,120,106,red blood cell,12720,0.8833333333333333,1.1320754716981132
49333,/images/28c96a4a-4549-4761-99e4-ace4ea7e7ac9.png,413,819,524,932,111,113,red blood cell,12543,1.018018018018018,0.9823008849557522
54783,/images/b6364a57-72a9-43f3-8d02-9f53a992dc95.png,496,321,601,421,105,100,red blood cell,10500,0.9523809523809523,1.05
25245,/images/90171428-f208-428a-b40e-f57ee3bea457.png,736,133,823,238,87,105,red blood cell,9135,1.206896551724138,0.8285714285714286
52680,/images/3f390b82-8859-4c27-bbfe-d1b242477f63.png,698,1060,831,1184,133,124,red blood cell,16492,0.9323308270676691,1.0725806451612903
16215,/images/acdc6e12-73d9-44ba-be8c-2a56aaffef4f.png,964,455,1080,565,116,110,red blood cell,12760,0.9482758620689655,1.0545454545454545
72984,/images/2bd26501-2fbc-4c1a-bef0-4ad57e02b4d0.png,955,690,1047,785,92,95,red blood cell,8740,1.0326086956521738,0.968421052631579
64454,/images/34a70114-d3e3-4351-b8db-f6caab17e743.png,570,478,670,570,100,92,red blood cell,9200,0.92,1.0869565217391304
67743,/images/48e2f0bd-2164-40c3-af43-1f2708359978.png,667,216,788,335,121,119,red blood cell,14399,0.9834710743801653,1.0168067226890756
31126,/images/1976cd04-d24f-457c-b423-7e4cdb05de9e.png,954,1226,1076,1349,122,123,red blood cell,15006,1.0081967213114753,0.991869918699187
75693,/images/50d7c6c9-3230-48fe-947c-7dcfd0aad710.png,386,665,473,761,87,96,red blood cell,8352,1.103448275862069,0.90625
18350,/images/9ca20b10-e2fd-4bd2-93ef-78298f763ed5.png,836,745,969,884,133,139,red blood cell,18487,1.0451127819548873,0.9568345323741008
46425,/images/bbecf1a8-a728-4c83-87f8-4dfbac0a1e03.png,980,588,1090,696,110,108,red blood cell,11880,0.9818181818181818,1.0185185185185186
21441,/images/b701b5c5-b922-4315-b12a-aac4ec65ee8b.png,341,1,438,96,97,95,red blood cell,9215,0.979381443298969,1.0210526315789474
31226,/images/1976cd04-d24f-457c-b423-7e4cdb05de9e.png,846,852,951,972,105,120,red blood cell,12600,1.1428571428571428,0.875
27202,/images/bca27923-b270-45df-a0bf-3e1a7d135b2c.png,245,1424,347,1528,102,104,red blood cell,10608,1.0196078431372548,0.9807692307692307
69910,/images/9edba799-e169-46cd-b100-c9f8fc7a8c7d.png,605,156,733,274,128,118,red blood cell,15104,0.921875,1.0847457627118644
38424,/images/674b0fd3-f247-4b7f-97f7-3e6c57c9ba9e.png,880,891,969,972,89,81,red blood cell,7209,0.9101123595505618,1.0987654320987654
26321,/images/580210c2-a8ed-4720-b71c-a77945968abc.png,509,1487,624,1580,115,93,red blood cell,10695,0.808695652173913,1.2365591397849462
38439,/images/674b0fd3-f247-4b7f-97f7-3e6c57c9ba9e.png,5,1083,87,1182,82,99,red blood cell,8118,1.2073170731707317,0.8282828282828283
5383,/images/716273ea-19c4-49af-8604-df587b295eca.png,163,200,273,306,110,106,red blood cell,11660,0.9636363636363636,1.0377358490566038
38829,/images/d0d3ae45-b434-4869-a518-427320ebe62d.png,203,378,302,486,99,108,red blood cell,10692,1.0909090909090908,0.9166666666666666
9596,/images/239f17eb-a2e2-47e9-82e3-fa0d9a70fb9f.png,919,592,1040,721,121,129,red blood cell,15609,1.0661157024793388,0.937984496124031
63646,/images/d9c9479e-f1ea-4d6e-861f-843ff9a90d19.png,284,118,378,222,94,104,red blood cell,9776,1.1063829787234043,0.9038461538461539
43768,/images/ef83ed4c-2724-4d5f-8abe-1a18d25cea35.png,1075,1257,1176,1378,101,121,red blood cell,12221,1.198019801980198,0.8347107438016529
37296,/images/2fdbd9bc-bbaf-44c2-b40c-d193709639fa.png,1000,624,1112,740,112,116,red blood cell,12992,1.0357142857142858,0.9655172413793104
18753,/images/f6f8a69a-3fd2-4684-ac77-3e83ea0fb36d.png,150,132,266,244,116,112,red blood cell,12992,0.9655172413793104,1.0357142857142858
57910,/images/09bcedaa-e007-4692-a13f-ab02c3f872c4.png,343,202,449,307,106,105,red blood cell,11130,0.9905660377358491,1.0095238095238095
9235,/images/261562a8-ffd8-4e0e-919b-22e267000b74.png,959,565,1065,676,106,111,red blood cell,11766,1.0471698113207548,0.954954954954955
52446,/images/a2a20600-f851-4db7-90f9-6f7be027c8b5.png,122,988,208,1065,86,77,red blood cell,6622,0.8953488372093024,1.1168831168831168
66796,/images/334bf865-e3fb-4200-bd53-d9ff5808ed9f.png,245,335,350,422,105,87,red blood cell,9135,0.8285714285714286,1.206896551724138
78219,/images/2bed2796-75a9-4d93-bb2d-e3ccbe1a5cbe.png,69,190,165,272,96,82,red blood cell,7872,0.8541666666666666,1.170731707317073
13016,/images/b10ea12f-cd36-4f2c-994a-67d1665269ab.png,1099,956,1195,1060,96,104,red blood cell,9984,1.0833333333333333,0.9230769230769231
43702,/images/ef83ed4c-2724-4d5f-8abe-1a18d25cea35.png,639,251,756,379,117,128,red blood cell,14976,1.0940170940170941,0.9140625
15907,/images/c7c1b873-0548-4a73-9618-f60912e164df.png,402,683,517,777,115,94,red blood cell,10810,0.8173913043478261,1.2234042553191489
34355,/images/1a48cbc1-5423-47e5-8ca5-2ab4f83a05a5.png,742,101,848,211,106,110,red blood cell,11660,1.0377358490566038,0.9636363636363636
34084,/images/de5d19b7-e670-4ac7-843b-7ce7bcebdf45.png,572,732,676,846,104,114,red blood cell,11856,1.0961538461538463,0.9122807017543859
16999,/images/57e1879e-4294-45e7-9c1b-627e8cca0271.png,1055,699,1172,822,117,123,red blood cell,14391,1.0512820512820513,0.9512195121951219
60106,/images/ec60ab26-3343-4c5f-9667-cdae999c7d86.png,751,363,865,471,114,108,red blood cell,12312,0.9473684210526315,1.0555555555555556
15448,/images/1b7f47fc-26cd-4273-b848-88a7cbfd9f85.png,756,785,859,888,103,103,red blood cell,10609,1.0,1.0
31952,/images/9eb66577-7857-43dc-a879-8f2c9d7f780f.png,670,359,776,471,106,112,red blood cell,11872,1.0566037735849056,0.9464285714285714
63181,/images/f0804a5e-e7f5-4cf2-a5df-b65e66502bf1.png,986,628,1098,724,112,96,red blood cell,10752,0.8571428571428571,1.1666666666666667
34,/images/8d02117d-6c71-4e47-b50a-6cc8d5eb1d55.png,706,532,823,649,117,117,red blood cell,13689,1.0,1.0
29098,/images/4c13e22e-dfd1-4fa1-b373-be9d0c272c0f.png,432,128,521,204,89,76,red blood cell,6764,0.8539325842696629,1.1710526315789473
79728,/images/03b9d6ad-39ca-4097-a98b-77f02b3c00a7.png,656,9,756,102,100,93,red blood cell,9300,0.93,1.075268817204301
23989,/images/3d8fb5bf-3315-48fb-8ab1-802eafd550bc.png,501,907,619,1012,118,105,red blood cell,12390,0.8898305084745762,1.1238095238095238
33677,/images/84ee2ea3-9edd-4672-a1b3-f09c607d833a.png,63,1151,164,1255,101,104,red blood cell,10504,1.0297029702970297,0.9711538461538461
64895,/images/dec61ae1-5037-4c3a-8952-15371becca7d.png,511,486,622,604,111,118,red blood cell,13098,1.063063063063063,0.940677966101695
67234,/images/5f491efd-a21c-4a80-aaba-70b8876238ac.png,665,667,769,756,104,89,red blood cell,9256,0.8557692307692307,1.1685393258426966
25743,/images/1f8edb2a-40bc-4beb-aa6b-884d2473df0f.png,82,634,202,745,120,111,red blood cell,13320,0.925,1.0810810810810811
31266,/images/db7c5ec1-fefe-4e9d-83c1-da8fb982f1e2.png,797,1263,899,1357,102,94,red blood cell,9588,0.9215686274509803,1.0851063829787233
861,/images/c7a2d648-47cb-4b39-afa4-1b7fcfe51934.png,62,1195,204,1320,142,125,red blood cell,17750,0.8802816901408451,1.136
35237,/images/a9159b11-ba49-4885-902e-00c8d5095b98.png,69,998,157,1088,88,90,red blood cell,7920,1.0227272727272727,0.9777777777777777
78664,/images/fd1c4c7a-24bc-43f2-b84f-fee182207aee.png,339,109,441,209,102,100,red blood cell,10200,0.9803921568627451,1.02
10697,/images/20d4f65e-6c63-433a-935c-d568d577967b.png,512,1369,599,1461,87,92,red blood cell,8004,1.0574712643678161,0.9456521739130435
40402,/images/db249e5a-4142-432c-8288-bacd10d7273d.png,826,1420,938,1539,112,119,red blood cell,13328,1.0625,0.9411764705882353
42806,/images/7029feb3-9ffe-46e4-9883-6a9df84f7b62.png,128,236,228,345,100,109,red blood cell,10900,1.09,0.9174311926605505
79115,/images/1c90231b-2830-42d9-884e-7301edb16933.png,791,651,901,770,110,119,red blood cell,13090,1.0818181818181818,0.9243697478991597
27953,/images/46f5bd4f-8bea-48d1-a1da-4dea28e3b814.png,847,592,973,707,126,115,red blood cell,14490,0.9126984126984127,1.0956521739130434
19169,/images/bb795ddf-ce72-42d5-9006-124db4d5cf1c.png,444,380,551,492,107,112,red blood cell,11984,1.0467289719626167,0.9553571428571429
30073,/images/81c3c8f0-d5a9-4dda-afd5-e86f6afd9424.png,817,460,931,562,114,102,red blood cell,11628,0.8947368421052632,1.1176470588235294
73867,/images/3eba916c-998b-40a7-993c-7ed916c2a04c.png,233,711,325,816,92,105,red blood cell,9660,1.141304347826087,0.8761904761904762
79539,/images/161978c3-3a05-47a5-9fee-be7d25693eae.png,513,107,608,206,95,99,red blood cell,9405,1.0421052631578946,0.9595959595959596
14486,/images/3b13e20f-ec0d-44ec-b2f4-eaebfa09150e.png,86,308,184,401,98,93,red blood cell,9114,0.9489795918367347,1.053763440860215
51115,/images/4748ba2b-6771-41d9-93a5-af9ccd559261.png,841,1238,962,1340,121,102,red blood cell,12342,0.8429752066115702,1.1862745098039216
48519,/images/f3d84be2-8af0-4d62-9f72-23d3dc08cbbe.png,260,1067,369,1185,109,118,red blood cell,12862,1.0825688073394495,0.923728813559322
37610,/images/205306da-0ed8-475a-ace6-f2f81d4be88a.png,151,734,245,820,94,86,red blood cell,8084,0.9148936170212766,1.0930232558139534
11363,/images/2f6224be-50d0-4e85-94ef-88315df561b6.png,34,1215,136,1338,102,123,red blood cell,12546,1.2058823529411764,0.8292682926829268
50425,/images/a2de1248-7bc0-44dc-b508-70a357eedd68.png,256,982,374,1094,118,112,red blood cell,13216,0.9491525423728814,1.0535714285714286
72260,/images/ee57e743-a876-4f69-9fe5-bf5d01b44689.png,207,1458,318,1565,111,107,red blood cell,11877,0.963963963963964,1.0373831775700935
5506,/images/eb6e8684-b84e-483d-b835-f59286d2516b.png,454,478,573,589,119,111,red blood cell,13209,0.9327731092436975,1.072072072072072
34911,/images/a4fbb9f2-9b75-4fdc-877d-2feaafac25b3.png,1026,378,1138,485,112,107,red blood cell,11984,0.9553571428571429,1.0467289719626167
37911,/images/56a57a8d-c9b9-432a-a3b0-32a09355806c.png,1040,364,1140,480,100,116,red blood cell,11600,1.16,0.8620689655172413
12373,/images/3b55c42f-ad59-422f-ba99-4f4f4ca9cb2e.png,254,1291,356,1399,102,108,red blood cell,11016,1.0588235294117647,0.9444444444444444
51666,/images/592c941a-aa54-4971-b499-dc47356f80a3.png,610,695,705,790,95,95,red blood cell,9025,1.0,1.0
23774,/images/6b2ff7ca-c5b3-415c-9481-7b14efc6d7ef.png,1027,530,1146,659,119,129,red blood cell,15351,1.084033613445378,0.9224806201550387
14527,/images/458cb2e9-5a7f-437c-ac5d-a56f98a3efdf.png,224,80,325,169,101,89,red blood cell,8989,0.8811881188118812,1.1348314606741574
56313,/images/6b473806-e936-4b19-98cf-a2b94cac35ff.png,908,1504,1020,1598,112,94,red blood cell,10528,0.8392857142857143,1.1914893617021276
15441,/images/1b7f47fc-26cd-4273-b848-88a7cbfd9f85.png,51,1022,173,1131,122,109,red blood cell,13298,0.8934426229508197,1.1192660550458715
29215,/images/6274fe0d-0d71-40be-b61b-f0bd5b5df1e2.png,382,1308,471,1381,89,73,red blood cell,6497,0.8202247191011236,1.2191780821917808
38469,/images/674b0fd3-f247-4b7f-97f7-3e6c57c9ba9e.png,992,976,1076,1072,84,96,red blood cell,8064,1.1428571428571428,0.875
10833,/images/2a02cec2-a09b-483a-ad38-14359a763fa4.png,362,1290,466,1414,104,124,red blood cell,12896,1.1923076923076923,0.8387096774193549
28164,/images/cd2774a0-dab2-4d68-aae9-7568b9f3d2a6.png,637,48,742,154,105,106,red blood cell,11130,1.0095238095238095,0.9905660377358491
53459,/images/766d5547-8dd2-4c8d-b78e-3007f83932e8.png,650,1002,739,1101,89,99,red blood cell,8811,1.1123595505617978,0.898989898989899
8081,/images/694222bb-cddf-469a-9526-f873c6fba58e.png,997,585,1093,687,96,102,red blood cell,9792,1.0625,0.9411764705882353
157,/images/13099edb-35d9-438f-b093-2cf2ebf9d255.png,642,927,768,1053,126,126,red blood cell,15876,1.0,1.0
19273,/images/b4d22412-a495-43a9-bec0-73a2322f8dad.png,945,1063,1048,1166,103,103,red blood cell,10609,1.0,1.0
19839,/images/b318889c-3c60-477c-b8f6-d18cb01a59df.png,573,693,698,827,125,134,red blood cell,16750,1.072,0.9328358208955224
38569,/images/c3ae7090-fc68-41b4-85a1-8d9bce9825a7.png,343,1402,429,1500,86,98,red blood cell,8428,1.1395348837209303,0.8775510204081632
2653,/images/a2ccbf70-e444-49a9-8b7e-9797a05220d8.png,1029,856,1131,981,102,125,red blood cell,12750,1.2254901960784315,0.816
9935,/images/b4261fa5-876d-48ea-b6da-ec7ca5b48fe2.png,139,1097,235,1200,96,103,red blood cell,9888,1.0729166666666667,0.9320388349514563
60836,/images/0ab56f9a-846d-49e2-a617-c6cc477fdfad.png,939,686,1051,811,112,125,red blood cell,14000,1.1160714285714286,0.896
24694,/images/78a5d1c3-44dd-44bc-ad5b-5e25bdcc4fae.png,872,1174,978,1282,106,108,red blood cell,11448,1.0188679245283019,0.9814814814814815
5216,/images/729733ff-a349-4a96-b636-ccabe7d7e167.png,183,83,311,199,128,116,red blood cell,14848,0.90625,1.103448275862069
67298,/images/49c4dbd3-6269-4d4c-9648-a2146c57bab1.png,126,405,240,516,114,111,red blood cell,12654,0.9736842105263158,1.027027027027027
2843,/images/e79bd81b-f878-4bee-9be2-d91a722c031e.png,712,1303,825,1414,113,111,red blood cell,12543,0.9823008849557522,1.018018018018018
41670,/images/0fcd1ebe-ee4a-40a0-b787-29cee18bfa1b.png,583,896,658,980,75,84,red blood cell,6300,1.12,0.8928571428571429
67054,/images/1fe1e118-adb8-4b10-a41e-1e5814e8f067.png,327,0,438,96,111,96,red blood cell,10656,0.8648648648648649,1.15625
40059,/images/6fd30823-3b77-40c9-ba5d-e1eda9660674.png,369,413,479,527,110,114,red blood cell,12540,1.0363636363636364,0.9649122807017544
26476,/images/cdb086a8-2bf8-4436-b1ef-96cdd801f247.png,791,258,889,354,98,96,red blood cell,9408,0.9795918367346939,1.0208333333333333
14685,/images/4e2873dd-651e-4ecc-ac70-7335cf21a469.png,456,796,580,920,124,124,red blood cell,15376,1.0,1.0
60952,/images/5397d8e2-bb09-42e7-9861-65ffad0fe94e.png,391,582,495,708,104,126,red blood cell,13104,1.2115384615384615,0.8253968253968254
42405,/images/1a27ebe9-93a1-4898-af69-f276057d4012.png,914,1112,1019,1235,105,123,red blood cell,12915,1.1714285714285715,0.8536585365853658
18685,/images/c22f7031-9cf8-48ce-b03b-1b12d0db4951.png,334,190,411,277,77,87,red blood cell,6699,1.12987012987013,0.8850574712643678
50325,/images/3d32a988-449d-4d58-b71f-abbfdc3f2fbc.png,69,657,184,765,115,108,red blood cell,12420,0.9391304347826087,1.0648148148148149
13938,/images/3061aac0-cda3-47d1-8c48-6293e9ffdf36.png,45,468,156,584,111,116,red blood cell,12876,1.045045045045045,0.9568965517241379
70919,/images/bf002a25-6535-4621-be19-56d468be5413.png,1013,7,1097,88,84,81,red blood cell,6804,0.9642857142857143,1.037037037037037
34043,/images/1012abf2-cb05-4337-86c5-513ec4ca904d.png,485,292,584,393,99,101,red blood cell,9999,1.02020202020202,0.9801980198019802
26749,/images/2518f6e4-29cc-4ae4-a914-b215a4c56099.png,962,336,1055,434,93,98,red blood cell,9114,1.053763440860215,0.9489795918367347
75174,/images/7fdc8be8-7579-4a5c-b369-8a07ee0a8b7d.png,111,10,219,127,108,117,red blood cell,12636,1.0833333333333333,0.9230769230769231
21226,/images/0ceb4539-5c4c-487d-9826-452a88b5d537.png,795,276,895,396,100,120,red blood cell,12000,1.2,0.8333333333333334
65941,/images/25c6cfb1-01d0-4864-87f9-02b7593683c7.png,534,1419,648,1532,114,113,red blood cell,12882,0.9912280701754386,1.008849557522124
25492,/images/f6ab936d-924b-4038-aa47-71b07c26b4e2.png,1083,1251,1199,1369,116,118,red blood cell,13688,1.0172413793103448,0.9830508474576272
25550,/images/f6ab936d-924b-4038-aa47-71b07c26b4e2.png,616,494,741,606,125,112,red blood cell,14000,0.896,1.1160714285714286
7069,/images/8be185e7-2a1a-441c-a5c7-b50a9eb926cb.png,70,822,176,941,106,119,red blood cell,12614,1.1226415094339623,0.8907563025210085
39836,/images/af2e63a3-9fde-46aa-a867-81c5c259d1dc.png,385,341,486,456,101,115,red blood cell,11615,1.1386138613861385,0.8782608695652174
67799,/images/48e2f0bd-2164-40c3-af43-1f2708359978.png,11,829,100,902,89,73,red blood cell,6497,0.8202247191011236,1.2191780821917808
56074,/images/ffb7be9a-65df-4f0b-99ae-cfd34e81cd34.png,914,661,1017,761,103,100,red blood cell,10300,0.970873786407767,1.03
35543,/images/3e33ee12-ef02-4287-8318-7ad3b284a617.png,812,1029,932,1143,120,114,red blood cell,13680,0.95,1.0526315789473684
75374,/images/468c261d-f5d8-423f-883e-48af2bbbc5d1.png,380,233,470,331,90,98,red blood cell,8820,1.0888888888888888,0.9183673469387755
13789,/images/1b369bcf-ced4-4ae2-9196-2664bd2b1738.png,632,485,744,605,112,120,red blood cell,13440,1.0714285714285714,0.9333333333333333
34952,/images/a4fbb9f2-9b75-4fdc-877d-2feaafac25b3.png,740,885,839,974,99,89,red blood cell,8811,0.898989898989899,1.1123595505617978
70930,/images/bf002a25-6535-4621-be19-56d468be5413.png,603,91,680,186,77,95,red blood cell,7315,1.2337662337662338,0.8105263157894737
74544,/images/bbedfcbe-9528-4ba9-9d86-4ebba7589ac5.png,374,241,485,357,111,116,red blood cell,12876,1.045045045045045,0.9568965517241379
62083,/images/7f528918-27d4-421f-ab57-0cf9c693e697.png,613,1108,735,1241,122,133,red blood cell,16226,1.0901639344262295,0.9172932330827067
63109,/images/d82c657e-5678-41da-9a6e-3ad29430b759.png,619,517,716,604,97,87,red blood cell,8439,0.8969072164948454,1.1149425287356323
60785,/images/645cd195-af50-409f-8da9-6e7c7f18ea09.png,303,49,393,151,90,102,red blood cell,9180,1.1333333333333333,0.8823529411764706
52566,/images/0546d843-d778-4aca-b8b5-bfe23d7c87da.png,366,1283,481,1392,115,109,red blood cell,12535,0.9478260869565217,1.055045871559633
75483,/images/6c20abb2-c4bb-4de0-8774-03f4d30ce93d.png,403,1143,544,1270,141,127,red blood cell,17907,0.900709219858156,1.110236220472441
47526,/images/adff132d-3af0-4cef-942c-58fc09729bee.png,27,885,143,1020,116,135,red blood cell,15660,1.1637931034482758,0.8592592592592593
16247,/images/acdc6e12-73d9-44ba-be8c-2a56aaffef4f.png,1001,920,1111,1033,110,113,red blood cell,12430,1.0272727272727273,0.9734513274336283
33542,/images/255d5f0c-87fc-4337-bb51-07c440df4f1b.png,400,861,508,983,108,122,red blood cell,13176,1.1296296296296295,0.8852459016393442
42657,/images/3abbc4d3-1d7e-40c9-9963-33732da7cc50.png,657,474,768,582,111,108,red blood cell,11988,0.972972972972973,1.0277777777777777
60666,/images/45651e76-4bd0-45e5-895b-edec65f51987.png,239,227,352,333,113,106,red blood cell,11978,0.9380530973451328,1.0660377358490567
28233,/images/036404d1-b9fc-497b-bbe1-f4d9c5ac3ce0.png,429,299,534,405,105,106,red blood cell,11130,1.0095238095238095,0.9905660377358491
6986,/images/c776eb78-3323-4571-b39f-7ffc73ae63ce.png,632,1070,751,1181,119,111,red blood cell,13209,0.9327731092436975,1.072072072072072
9020,/images/ef815e3a-02a6-4cf8-9262-45bc74c50b00.png,749,1397,878,1526,129,129,red blood cell,16641,1.0,1.0
56692,/images/89b3d781-2f81-4d23-bed4-84da064df7f3.png,876,1235,984,1364,108,129,red blood cell,13932,1.1944444444444444,0.8372093023255814
21029,/images/666601e7-608d-4d19-999f-8fc6ab373a55.png,302,846,412,960,110,114,red blood cell,12540,1.0363636363636364,0.9649122807017544
28545,/images/dbdfad64-110c-421f-a1c7-f68fd9e82d67.png,312,546,412,668,100,122,red blood cell,12200,1.22,0.819672131147541
49102,/images/df3d98b9-3dd7-4107-8d4a-ae1b7f247793.png,576,702,658,804,82,102,red blood cell,8364,1.2439024390243902,0.803921568627451
61274,/images/b3058064-d817-47dd-a8c4-cdb1f62374f8.png,244,1447,339,1546,95,99,red blood cell,9405,1.0421052631578946,0.9595959595959596
44289,/images/4257342d-6d77-4671-a84b-1f0c36ccb367.png,313,519,427,620,114,101,red blood cell,11514,0.8859649122807017,1.1287128712871286
23251,/images/3dcd4f1b-ce43-4a34-b1ed-076bb42963b1.png,385,291,473,394,88,103,red blood cell,9064,1.1704545454545454,0.8543689320388349
60018,/images/49288109-80e9-4ec8-96d1-26a0166b8883.png,536,741,645,849,109,108,red blood cell,11772,0.9908256880733946,1.0092592592592593
52573,/images/0546d843-d778-4aca-b8b5-bfe23d7c87da.png,439,54,539,158,100,104,red blood cell,10400,1.04,0.9615384615384616
41046,/images/e871f52c-77a6-4813-80d4-95bd97985f1a.png,536,665,655,784,119,119,red blood cell,14161,1.0,1.0
59138,/images/4736f545-1f1f-4d77-9241-d69cbf4dae35.png,557,278,649,384,92,106,red blood cell,9752,1.1521739130434783,0.8679245283018868
76914,/images/25ddc1ca-d368-4fff-b1ad-1dbf1e7c97aa.png,362,1035,481,1141,119,106,red blood cell,12614,0.8907563025210085,1.1226415094339623
79282,/images/05ac7b2a-6a77-4464-926b-8570f7c01693.png,752,1336,838,1439,86,103,red blood cell,8858,1.197674418604651,0.8349514563106796
33552,/images/255d5f0c-87fc-4337-bb51-07c440df4f1b.png,320,1035,439,1169,119,134,red blood cell,15946,1.1260504201680672,0.8880597014925373
71281,/images/445d0db9-e830-4ceb-a845-b23d819e6097.png,867,984,969,1109,102,125,red blood cell,12750,1.2254901960784315,0.816
58912,/images/8a7deb24-d2b4-4acf-86c4-3aadd39157fa.png,388,1116,485,1205,97,89,red blood cell,8633,0.9175257731958762,1.0898876404494382
4296,/images/882b91b7-5906-4091-bad4-688d4375eeb5.png,573,907,695,1010,122,103,red blood cell,12566,0.8442622950819673,1.1844660194174756
5143,/images/a777e78c-ad1f-4380-9ab2-b4f9f32b2d78.png,1057,1284,1180,1399,123,115,red blood cell,14145,0.9349593495934959,1.0695652173913044
38212,/images/1d9d4dac-66f9-4c87-b714-d723d5b15fa9.png,652,190,780,313,128,123,red blood cell,15744,0.9609375,1.0406504065040652
61016,/images/3d1429ed-4619-41f7-8ff3-d698ad28034c.png,1068,1373,1185,1495,117,122,red blood cell,14274,1.0427350427350428,0.9590163934426229
15242,/images/dd7142e4-2d86-4170-a41f-e825743e8907.png,991,1358,1119,1483,128,125,red blood cell,16000,0.9765625,1.024
41313,/images/2374ae5b-c2df-4db5-afea-c54180aa22e3.png,968,1455,1058,1559,90,104,red blood cell,9360,1.1555555555555554,0.8653846153846154
44470,/images/b6573be3-9e04-49c3-9f48-6a145d065363.png,468,1104,570,1205,102,101,red blood cell,10302,0.9901960784313726,1.00990099009901
25147,/images/9e74feb8-017d-4d53-8896-9ebda4327dd1.png,1009,468,1115,555,106,87,red blood cell,9222,0.8207547169811321,1.2183908045977012
10133,/images/09ecf7be-28e2-4531-b9e2-07e01c44097d.png,60,1261,168,1380,108,119,red blood cell,12852,1.1018518518518519,0.907563025210084
25760,/images/1f8edb2a-40bc-4beb-aa6b-884d2473df0f.png,582,297,723,416,141,119,red blood cell,16779,0.8439716312056738,1.184873949579832
12710,/images/68442532-9cd2-4b42-9d4f-ddf8c13bb38c.png,1040,1427,1151,1527,111,100,red blood cell,11100,0.9009009009009009,1.11
44601,/images/6388e241-09a2-4fbe-a712-07d8fe714c51.png,661,719,777,826,116,107,red blood cell,12412,0.9224137931034483,1.0841121495327102
17301,/images/3d302619-473d-4c5b-af43-8833ff94233f.png,819,1155,920,1258,101,103,red blood cell,10403,1.0198019801980198,0.9805825242718447
3256,/images/b901c906-91be-48c4-88ec-2c527544a258.png,397,1463,516,1592,119,129,red blood cell,15351,1.084033613445378,0.9224806201550387
69776,/images/2bd15b6e-fe2d-49f3-b394-940d024d1f91.png,89,1488,198,1599,109,111,red blood cell,12099,1.018348623853211,0.9819819819819819
72695,/images/6ab870ba-b24b-49a9-9570-8eafe63aa74e.png,1095,818,1182,906,87,88,red blood cell,7656,1.0114942528735633,0.9886363636363636
33201,/images/877d5e7f-19b6-40e7-81bd-c92f25e72503.png,775,1190,914,1304,139,114,red blood cell,15846,0.8201438848920863,1.219298245614035
66231,/images/e8058bed-c362-4e1c-85dc-62f80f32938f.png,907,1188,1027,1298,120,110,red blood cell,13200,0.9166666666666666,1.0909090909090908
19284,/images/b4d22412-a495-43a9-bec0-73a2322f8dad.png,137,398,240,500,103,102,red blood cell,10506,0.9902912621359223,1.0098039215686274
69838,/images/9edba799-e169-46cd-b100-c9f8fc7a8c7d.png,535,460,651,574,116,114,red blood cell,13224,0.9827586206896551,1.0175438596491229
36819,/images/dfac6c92-8f0f-429a-8caf-9b7732bf78da.png,431,1351,534,1455,103,104,red blood cell,10712,1.0097087378640777,0.9903846153846154
63674,/images/d9c9479e-f1ea-4d6e-861f-843ff9a90d19.png,378,1428,462,1512,84,84,red blood cell,7056,1.0,1.0
17222,/images/471f75c6-bd5d-4c20-bcc1-258e836f4d69.png,534,760,635,857,101,97,red blood cell,9797,0.9603960396039604,1.041237113402062
43723,/images/ef83ed4c-2724-4d5f-8abe-1a18d25cea35.png,787,452,904,565,117,113,red blood cell,13221,0.9658119658119658,1.0353982300884956
72108,/images/64b0e49a-0e48-447d-8872-c1dd255e7a21.png,221,17,304,96,83,79,red blood cell,6557,0.9518072289156626,1.0506329113924051
16877,/images/4823c1fe-a7f9-4b92-959f-0d9be09cd14b.png,428,188,526,270,98,82,red blood cell,8036,0.8367346938775511,1.1951219512195121
47249,/images/58ced55c-bf0d-4204-b6b2-4f8992d92779.png,938,1290,1063,1417,125,127,red blood cell,15875,1.016,0.984251968503937
29690,/images/b85fc640-de49-4f7e-afc0-978ff020f2e2.png,582,1281,695,1400,113,119,red blood cell,13447,1.0530973451327434,0.9495798319327731
63993,/images/5e974892-0ebe-4037-8427-ea8616d6d3b8.png,832,1264,928,1365,96,101,red blood cell,9696,1.0520833333333333,0.9504950495049505
48311,/images/6fa2b30f-9b89-46ac-9b79-c0bc105d4271.png,824,1339,946,1453,122,114,red blood cell,13908,0.9344262295081968,1.0701754385964912
11793,/images/082e1f81-4f49-44ad-b5bb-9dfc155b2ed8.png,644,524,742,633,98,109,red blood cell,10682,1.1122448979591837,0.8990825688073395
13383,/images/a7f1bbb1-6058-4642-bd66-cfb90dce762e.png,73,220,161,307,88,87,red blood cell,7656,0.9886363636363636,1.0114942528735633
73775,/images/22cbf509-c9bf-46ec-bfce-f079c6b76c8c.png,10,480,132,592,122,112,red blood cell,13664,0.9180327868852459,1.0892857142857142
53419,/images/766d5547-8dd2-4c8d-b78e-3007f83932e8.png,34,984,142,1092,108,108,red blood cell,11664,1.0,1.0
43524,/images/2d857091-efcd-41c0-ba3f-226de90445c4.png,526,1328,637,1447,111,119,red blood cell,13209,1.072072072072072,0.9327731092436975
66140,/images/191f87a4-6f2d-49e7-bba0-08e3aa78ddaf.png,717,462,807,555,90,93,red blood cell,8370,1.0333333333333334,0.967741935483871
32926,/images/e40000b4-1b26-42ce-909d-4715e04f0a6e.png,1002,1190,1130,1310,128,120,red blood cell,15360,0.9375,1.0666666666666667
15181,/images/3a8f468f-f9de-46a8-a7c8-f2be239fa207.png,1022,1220,1104,1310,82,90,red blood cell,7380,1.0975609756097562,0.9111111111111111
26042,/images/612bdd3c-da43-4321-a76b-c73c614928d1.png,289,604,417,735,128,131,red blood cell,16768,1.0234375,0.9770992366412213
27590,/images/715761a2-745e-4743-9849-956a034ad3c4.png,807,984,912,1088,105,104,red blood cell,10920,0.9904761904761905,1.0096153846153846
39326,/images/17ef5841-bd19-4610-ba47-7d321231847b.png,927,579,1046,711,119,132,red blood cell,15708,1.1092436974789917,0.9015151515151515
33654,/images/84ee2ea3-9edd-4672-a1b3-f09c607d833a.png,115,946,229,1058,114,112,red blood cell,12768,0.9824561403508771,1.0178571428571428
15689,/images/3892b776-f49a-4368-b0fa-7e855e76ccec.png,531,171,648,301,117,130,red blood cell,15210,1.1111111111111112,0.9
65752,/images/daea4860-a296-4f6d-acef-996ab0882676.png,823,152,924,273,101,121,red blood cell,12221,1.198019801980198,0.8347107438016529
53488,/images/43158031-a335-4533-9c20-48bebba90123.png,1034,914,1135,1011,101,97,red blood cell,9797,0.9603960396039604,1.041237113402062
4085,/images/d3b79739-aea2-4804-8c7a-183b7ed07de3.png,793,1327,898,1434,105,107,red blood cell,11235,1.019047619047619,0.9813084112149533
41405,/images/65e8b0cd-05d1-4c8d-8efd-24bf71df3167.png,986,162,1108,271,122,109,red blood cell,13298,0.8934426229508197,1.1192660550458715
14940,/images/5d1418d3-1559-4725-ad4a-9afb6eaecdfd.png,570,1238,667,1341,97,103,red blood cell,9991,1.0618556701030928,0.941747572815534
6911,/images/b21f6c6e-4b45-407a-b4c7-034a115f3ee4.png,1095,1386,1191,1506,96,120,red blood cell,11520,1.25,0.8
39094,/images/7bde7de1-889b-4218-b0e1-e2c04f6a7986.png,265,299,372,419,107,120,red blood cell,12840,1.1214953271028036,0.8916666666666667
46260,/images/815bf40c-371a-4d34-aa41-c549c8221881.png,326,652,428,773,102,121,red blood cell,12342,1.1862745098039216,0.8429752066115702
21319,/images/8dace03a-10c4-4d59-bcd9-a2c314c5df33.png,129,1175,230,1292,101,117,red blood cell,11817,1.1584158415841583,0.8632478632478633
58887,/images/8a7deb24-d2b4-4acf-86c4-3aadd39157fa.png,558,1217,663,1333,105,116,red blood cell,12180,1.1047619047619048,0.9051724137931034
78960,/images/6144887d-a1c1-46db-91a1-f7ff5bf8c8a5.png,757,736,848,845,91,109,red blood cell,9919,1.1978021978021978,0.8348623853211009
77146,/images/dd6f047e-af73-43df-9c46-354534fc20e0.png,616,733,713,842,97,109,red blood cell,10573,1.1237113402061856,0.8899082568807339
25573,/images/f6ab936d-924b-4038-aa47-71b07c26b4e2.png,220,606,322,724,102,118,red blood cell,12036,1.1568627450980393,0.864406779661017
54960,/images/f1872d08-f8a6-4b21-aa29-f56bbf607883.png,878,165,984,293,106,128,red blood cell,13568,1.2075471698113207,0.828125
23613,/images/79d7a014-21ff-40f1-9ac4-a69839390654.png,879,1441,985,1546,106,105,red blood cell,11130,0.9905660377358491,1.0095238095238095
25427,/images/5f742392-278d-461c-a848-08def2c28878.png,184,453,290,555,106,102,red blood cell,10812,0.9622641509433962,1.0392156862745099
57507,/images/00d04a90-80e5-4bce-9511-1b64eabb7a47.png,877,1196,951,1275,74,79,red blood cell,5846,1.0675675675675675,0.9367088607594937
20235,/images/c66cb6b2-1480-446a-a9d2-b8032a3de0d7.png,199,1090,304,1191,105,101,red blood cell,10605,0.9619047619047619,1.0396039603960396
6814,/images/e36cb882-c6d0-4467-812e-d18c169a9a47.png,135,1231,258,1353,123,122,red blood cell,15006,0.991869918699187,1.0081967213114753
21391,/images/b701b5c5-b922-4315-b12a-aac4ec65ee8b.png,698,612,799,707,101,95,red blood cell,9595,0.9405940594059405,1.063157894736842
76872,/images/2165fe38-b474-467d-be11-d1d728085efd.png,489,1497,576,1586,87,89,red blood cell,7743,1.0229885057471264,0.9775280898876404
24843,/images/93f7e207-0d8e-47f8-8258-09a0e03dbdd6.png,1067,612,1199,733,132,121,red blood cell,15972,0.9166666666666666,1.0909090909090908
69457,/images/664c570b-4822-413c-9724-11b1d91fac44.png,626,580,729,687,103,107,red blood cell,11021,1.0388349514563107,0.9626168224299065
27189,/images/f232eec3-02c0-43f9-bf32-3e60245397e2.png,565,1050,688,1160,123,110,red blood cell,13530,0.8943089430894309,1.1181818181818182
56146,/images/50d9fc90-8642-4bb6-91a7-0069a7e37392.png,109,164,219,281,110,117,red blood cell,12870,1.0636363636363637,0.9401709401709402
2876,/images/521a26aa-0a31-4c07-b4d0-fac08eb08344.png,362,612,470,729,108,117,red blood cell,12636,1.0833333333333333,0.9230769230769231
63537,/images/44b4a765-104e-4182-8871-e933c83c91ef.png,430,268,542,385,112,117,red blood cell,13104,1.0446428571428572,0.9572649572649573
11041,/images/85a4d82e-cfb7-4983-b272-626c9e8c7583.png,238,79,361,206,123,127,red blood cell,15621,1.032520325203252,0.968503937007874
16890,/images/4823c1fe-a7f9-4b92-959f-0d9be09cd14b.png,900,853,990,939,90,86,red blood cell,7740,0.9555555555555556,1.0465116279069768
40786,/images/252071ac-e9f2-41d2-abbb-87ef01b8a997.png,523,1404,635,1522,112,118,red blood cell,13216,1.0535714285714286,0.9491525423728814
93,/images/10be6380-cbbb-4886-8b9e-ff56b1710576.png,124,154,230,266,106,112,red blood cell,11872,1.0566037735849056,0.9464285714285714
31904,/images/f62d4fb6-df7c-446c-94a8-d5aede0b1e0c.png,153,277,264,394,111,117,red blood cell,12987,1.054054054054054,0.9487179487179487
60447,/images/93b47b14-7f78-4b31-8897-d63a81fdab01.png,1021,673,1136,794,115,121,red blood cell,13915,1.0521739130434782,0.9504132231404959
40581,/images/29861cf9-9a1e-4733-8309-4bd10706b4a3.png,428,943,568,1073,140,130,red blood cell,18200,0.9285714285714286,1.0769230769230769
34253,/images/259da25f-40f3-4d37-bca9-a9c807af1547.png,766,162,889,284,123,122,red blood cell,15006,0.991869918699187,1.0081967213114753
16560,/images/69565501-6e77-4f40-bd80-caa3dda34d8b.png,846,1293,962,1419,116,126,red blood cell,14616,1.0862068965517242,0.9206349206349206
35949,/images/5836500a-221e-40ca-a8be-caaa37f7d300.png,118,897,225,996,107,99,red blood cell,10593,0.9252336448598131,1.0808080808080809
41726,/images/32a1ea24-b6b7-4253-ad3e-bdf99c2c9b9d.png,1009,337,1134,456,125,119,red blood cell,14875,0.952,1.050420168067227
29770,/images/7ef90770-6aeb-45eb-9744-49c5247dde30.png,1032,280,1149,395,117,115,red blood cell,13455,0.9829059829059829,1.017391304347826
54939,/images/f1872d08-f8a6-4b21-aa29-f56bbf607883.png,706,193,797,303,91,110,red blood cell,10010,1.2087912087912087,0.8272727272727273
75467,/images/6c20abb2-c4bb-4de0-8774-03f4d30ce93d.png,828,1340,945,1453,117,113,red blood cell,13221,0.9658119658119658,1.0353982300884956
6311,/images/c6575e75-c8ce-4766-841f-1137b9e0956c.png,267,166,364,265,97,99,red blood cell,9603,1.0206185567010309,0.9797979797979798
33388,/images/f632981c-1330-4078-8a12-691beb2dab02.png,1006,1423,1106,1519,100,96,red blood cell,9600,0.96,1.0416666666666667
77800,/images/4849866a-73a2-4fcf-a407-2d0a25a09a89.png,811,561,907,662,96,101,red blood cell,9696,1.0520833333333333,0.9504950495049505
2408,/images/fe851c88-692d-4199-87e0-d19d9c4eb591.png,114,660,229,763,115,103,red blood cell,11845,0.8956521739130435,1.116504854368932
74606,/images/bbedfcbe-9528-4ba9-9d86-4ebba7589ac5.png,815,1406,900,1488,85,82,red blood cell,6970,0.9647058823529412,1.0365853658536586
69771,/images/2bd15b6e-fe2d-49f3-b394-940d024d1f91.png,403,193,495,287,92,94,red blood cell,8648,1.0217391304347827,0.9787234042553191
18126,/images/947348fe-4c70-468e-8009-3c14daeca69b.png,334,368,432,488,98,120,red blood cell,11760,1.2244897959183674,0.8166666666666667
19055,/images/6e39fb0a-aa41-4b16-b783-7589e97bf289.png,94,454,213,582,119,128,red blood cell,15232,1.0756302521008403,0.9296875
51618,/images/d0347b49-8f98-4632-a384-1a4f57ac6374.png,778,1079,874,1179,96,100,red blood cell,9600,1.0416666666666667,0.96
74463,/images/cbb58718-6319-48db-b84b-78ac9b12ff89.png,727,1104,830,1222,103,118,red blood cell,12154,1.145631067961165,0.8728813559322034
25716,/images/412c9fa5-fcf4-402b-b1e4-3271f775058e.png,410,970,543,1097,133,127,red blood cell,16891,0.9548872180451128,1.047244094488189
78181,/images/2bed2796-75a9-4d93-bb2d-e3ccbe1a5cbe.png,266,1418,375,1526,109,108,red blood cell,11772,0.9908256880733946,1.0092592592592593
13038,/images/555c6ea2-c76c-4e71-af57-855d940c2b37.png,161,1185,277,1300,116,115,red blood cell,13340,0.9913793103448276,1.008695652173913
12237,/images/5a0628af-4c0a-4ba6-a935-4ec94c9c700e.png,886,1031,1021,1140,135,109,red blood cell,14715,0.8074074074074075,1.238532110091743
32193,/images/07346d2e-a6e6-4dc0-95f1-9f7d8d7e3f66.png,41,37,154,150,113,113,red blood cell,12769,1.0,1.0
56444,/images/d75933ed-d26e-4d1f-bda3-96bc0d77fb36.png,659,1111,764,1203,105,92,red blood cell,9660,0.8761904761904762,1.141304347826087
75457,/images/468c261d-f5d8-423f-883e-48af2bbbc5d1.png,103,49,204,133,101,84,red blood cell,8484,0.8316831683168316,1.2023809523809523
36636,/images/21f001d6-f568-4ea4-82da-fab54c77c419.png,866,500,958,604,92,104,red blood cell,9568,1.1304347826086956,0.8846153846153846
35558,/images/3e33ee12-ef02-4287-8318-7ad3b284a617.png,735,1198,839,1320,104,122,red blood cell,12688,1.1730769230769231,0.8524590163934426
78417,/images/fe00fa09-d3c8-485b-9d0f-3cce556c9edd.png,599,487,721,609,122,122,red blood cell,14884,1.0,1.0
2003,/images/bfefa21c-11e1-4dab-ac5d-8ff6f046d65f.png,118,223,237,343,119,120,red blood cell,14280,1.0084033613445378,0.9916666666666667
16401,/images/e474a20b-2769-48f1-a520-4f6ef5a0dbf5.png,981,299,1088,396,107,97,red blood cell,10379,0.9065420560747663,1.1030927835051547
10727,/images/20d4f65e-6c63-433a-935c-d568d577967b.png,555,389,642,482,87,93,red blood cell,8091,1.0689655172413792,0.9354838709677419
75677,/images/50d7c6c9-3230-48fe-947c-7dcfd0aad710.png,882,537,988,653,106,116,red blood cell,12296,1.0943396226415094,0.9137931034482759
8215,/images/65e3d6a6-012c-4b40-9a42-83078eb85e31.png,897,54,995,155,98,101,red blood cell,9898,1.030612244897959,0.9702970297029703
8971,/images/ef815e3a-02a6-4cf8-9262-45bc74c50b00.png,879,1439,981,1554,102,115,red blood cell,11730,1.1274509803921569,0.8869565217391304
30575,/images/7d9c1422-6332-44e9-b134-3ac94f07b0f0.png,653,242,759,354,106,112,red blood cell,11872,1.0566037735849056,0.9464285714285714
59494,/images/6bfe6a90-8a69-4171-8e7f-42dc9417c6d9.png,503,951,599,1054,96,103,red blood cell,9888,1.0729166666666667,0.9320388349514563
60410,/images/8d5d5c22-2f75-4fe1-9ea3-03a3c7b92ea9.png,807,475,910,583,103,108,red blood cell,11124,1.0485436893203883,0.9537037037037037
33207,/images/877d5e7f-19b6-40e7-81bd-c92f25e72503.png,438,1041,551,1156,113,115,red blood cell,12995,1.0176991150442478,0.9826086956521739
19984,/images/8e69098c-fae0-47a3-8833-c2bfdfb1a416.png,179,44,305,162,126,118,red blood cell,14868,0.9365079365079365,1.0677966101694916
49639,/images/bd7937db-fca2-44d0-8538-460110210927.png,606,392,712,519,106,127,red blood cell,13462,1.1981132075471699,0.8346456692913385
77067,/images/637957ef-df75-4a7b-86d5-9f6e9c042ca2.png,942,678,1042,790,100,112,red blood cell,11200,1.12,0.8928571428571429
56145,/images/50d9fc90-8642-4bb6-91a7-0069a7e37392.png,34,92,139,198,105,106,red blood cell,11130,1.0095238095238095,0.9905660377358491
2125,/images/e94a811d-3145-4313-ba42-2d5ed283179f.png,785,97,903,200,118,103,red blood cell,12154,0.8728813559322034,1.145631067961165
28567,/images/dbdfad64-110c-421f-a1c7-f68fd9e82d67.png,574,1179,696,1325,122,146,red blood cell,17812,1.1967213114754098,0.8356164383561644
33400,/images/f632981c-1330-4078-8a12-691beb2dab02.png,806,1151,907,1260,101,109,red blood cell,11009,1.0792079207920793,0.926605504587156
10873,/images/b78b88f0-154a-4b54-8aaf-85d37a42a0f9.png,412,1140,536,1254,124,114,red blood cell,14136,0.9193548387096774,1.087719298245614
36902,/images/b2e34f5f-904e-4473-9dc7-c6bc1ce12640.png,713,60,816,167,103,107,red blood cell,11021,1.0388349514563107,0.9626168224299065
55099,/images/3768c577-4e5e-4d70-8c4d-93d8aacd5baa.png,136,632,247,752,111,120,red blood cell,13320,1.0810810810810811,0.925
75654,/images/50d7c6c9-3230-48fe-947c-7dcfd0aad710.png,212,1382,308,1475,96,93,red blood cell,8928,0.96875,1.032258064516129
12348,/images/3b55c42f-ad59-422f-ba99-4f4f4ca9cb2e.png,903,64,993,166,90,102,red blood cell,9180,1.1333333333333333,0.8823529411764706
12836,/images/b10ea12f-cd36-4f2c-994a-67d1665269ab.png,573,568,661,661,88,93,red blood cell,8184,1.0568181818181819,0.946236559139785
59542,/images/6bfe6a90-8a69-4171-8e7f-42dc9417c6d9.png,584,363,668,447,84,84,red blood cell,7056,1.0,1.0
70677,/images/7521ec48-57b5-48a8-a5d6-8280ad5da19c.png,782,1282,867,1385,85,103,red blood cell,8755,1.2117647058823529,0.8252427184466019
1038,/images/63d36d2c-43a9-49ac-9504-028b4968c860.png,468,794,573,880,105,86,red blood cell,9030,0.819047619047619,1.2209302325581395
24504,/images/109fbb82-bc3c-41ac-984d-e2da86202873.png,918,562,1045,693,127,131,red blood cell,16637,1.031496062992126,0.9694656488549618
27483,/images/f5869ba8-6253-426b-93f3-82af59a86144.png,238,260,351,370,113,110,red blood cell,12430,0.9734513274336283,1.0272727272727273
27577,/images/715761a2-745e-4743-9849-956a034ad3c4.png,695,939,796,1049,101,110,red blood cell,11110,1.0891089108910892,0.9181818181818182
31400,/images/04fb49a2-07b8-4cdf-b6f7-df5c3688e5f8.png,0,1478,99,1583,99,105,red blood cell,10395,1.0606060606060606,0.9428571428571428
32685,/images/0154dd8e-72f8-4d78-a4dd-93e139577bd1.png,1077,1318,1174,1436,97,118,red blood cell,11446,1.2164948453608246,0.8220338983050848
47263,/images/58ced55c-bf0d-4204-b6b2-4f8992d92779.png,521,433,630,533,109,100,red blood cell,10900,0.9174311926605505,1.09
19970,/images/8e69098c-fae0-47a3-8833-c2bfdfb1a416.png,490,1205,608,1323,118,118,red blood cell,13924,1.0,1.0
69086,/images/de2b8835-552c-4f01-98b7-67bc4910062e.png,153,1025,249,1131,96,106,red blood cell,10176,1.1041666666666667,0.9056603773584906
42238,/images/ca734448-0d52-42fa-b41c-17b2939e58ae.png,598,873,699,992,101,119,red blood cell,12019,1.1782178217821782,0.8487394957983193
54499,/images/db871d17-28fd-4ceb-b421-e4e4afa0a7a0.png,1023,770,1136,886,113,116,red blood cell,13108,1.0265486725663717,0.9741379310344828
33061,/images/6231d81d-9e84-4a5a-8cb8-47c6a37a0176.png,889,1358,1003,1460,114,102,red blood cell,11628,0.8947368421052632,1.1176470588235294
80020,/images/38d1b930-dd97-4248-9160-e9389a1a8dd7.png,1071,309,1183,424,112,115,red blood cell,12880,1.0267857142857142,0.9739130434782609
6183,/images/27cdd837-e40f-491e-8adb-61e493189832.png,293,566,389,664,96,98,red blood cell,9408,1.0208333333333333,0.9795918367346939
20237,/images/c66cb6b2-1480-446a-a9d2-b8032a3de0d7.png,578,68,688,178,110,110,red blood cell,12100,1.0,1.0
31242,/images/1976cd04-d24f-457c-b423-7e4cdb05de9e.png,304,78,421,212,117,134,red blood cell,15678,1.1452991452991452,0.8731343283582089
51112,/images/4748ba2b-6771-41d9-93a5-af9ccd559261.png,473,562,615,701,142,139,red blood cell,19738,0.9788732394366197,1.0215827338129497
49428,/images/f2574be3-81c6-4fc3-8a40-0230d1264f52.png,36,1236,146,1346,110,110,red blood cell,12100,1.0,1.0
38153,/images/33bdb7b5-ad5b-4a73-bbc2-3350f8c2ac0c.png,188,754,307,878,119,124,red blood cell,14756,1.0420168067226891,0.9596774193548387
7866,/images/1493d140-c9d5-4c3a-9caf-3eafb290a49b.png,443,789,571,912,128,123,red blood cell,15744,0.9609375,1.0406504065040652
22000,/images/393df10a-5d64-476b-88f5-14ac56d6ed60.png,522,1266,643,1398,121,132,red blood cell,15972,1.0909090909090908,0.9166666666666666
9840,/images/3859deaf-6ae1-49a3-9051-898d0f0d7de6.png,68,208,158,302,90,94,red blood cell,8460,1.0444444444444445,0.9574468085106383
22183,/images/ca677c3c-083f-4d54-9dec-39f79f6a17d8.png,916,237,1014,344,98,107,red blood cell,10486,1.0918367346938775,0.9158878504672897
10420,/images/46a2d369-4bea-4405-ac78-91bbe130b9a7.png,135,1393,239,1488,104,95,red blood cell,9880,0.9134615384615384,1.0947368421052632
66537,/images/b87fb62d-2c36-4f68-aba9-37fcd7d46eef.png,910,1405,998,1484,88,79,red blood cell,6952,0.8977272727272727,1.1139240506329113
75107,/images/073c10c9-5749-44b5-b08b-1be556a960f0.png,843,964,953,1060,110,96,red blood cell,10560,0.8727272727272727,1.1458333333333333
30632,/images/f939782b-f5a2-40a3-9c22-6c6d7e18edc3.png,877,1201,984,1299,107,98,red blood cell,10486,0.9158878504672897,1.0918367346938775
32817,/images/67f5ca94-d84e-490e-bf0d-4ffba7bdbe30.png,34,826,149,944,115,118,red blood cell,13570,1.0260869565217392,0.9745762711864406
75088,/images/073c10c9-5749-44b5-b08b-1be556a960f0.png,981,857,1084,958,103,101,red blood cell,10403,0.9805825242718447,1.0198019801980198
37786,/images/fe0c5e48-f65e-488c-9c3c-1ea7c7835c0c.png,302,1176,411,1284,109,108,red blood cell,11772,0.9908256880733946,1.0092592592592593
14011,/images/eaf4b781-b3aa-41ce-8c5e-287979b4e15a.png,400,1270,494,1376,94,106,red blood cell,9964,1.127659574468085,0.8867924528301887
33891,/images/1a332b2c-9d49-4ff2-810c-5633d2314527.png,237,667,368,780,131,113,red blood cell,14803,0.8625954198473282,1.1592920353982301
20819,/images/c2ec116f-f091-422c-926c-70b548a8f6ef.png,450,1219,555,1330,105,111,red blood cell,11655,1.0571428571428572,0.9459459459459459
61055,/images/6e86206f-dafe-4c28-bacc-7b83b2d40f0c.png,48,798,152,921,104,123,red blood cell,12792,1.1826923076923077,0.8455284552845529
11265,/images/6303f964-98ef-47c6-bb2d-283aa393f918.png,263,332,356,420,93,88,red blood cell,8184,0.946236559139785,1.0568181818181819
41077,/images/e871f52c-77a6-4813-80d4-95bd97985f1a.png,760,1464,877,1580,117,116,red blood cell,13572,0.9914529914529915,1.0086206896551724
56809,/images/0dcbf2c9-f959-4703-a72b-f6a81e66c2ea.png,776,150,871,245,95,95,red blood cell,9025,1.0,1.0
38752,/images/b426ef1d-4a59-4f90-b593-50226af60a60.png,128,1057,249,1188,121,131,red blood cell,15851,1.0826446280991735,0.9236641221374046
5663,/images/d3dcdf92-9328-4796-adf4-918646877ba1.png,536,1224,661,1349,125,125,red blood cell,15625,1.0,1.0
78734,/images/dc6ac71b-2616-431e-bfd5-4c38139e4ddd.png,804,1278,912,1372,108,94,red blood cell,10152,0.8703703703703703,1.148936170212766
21690,/images/81af1442-d835-46bf-b80b-a898dba3da1b.png,63,957,181,1096,118,139,red blood cell,16402,1.1779661016949152,0.8489208633093526
31141,/images/1976cd04-d24f-457c-b423-7e4cdb05de9e.png,127,321,238,442,111,121,red blood cell,13431,1.09009009009009,0.9173553719008265
70465,/images/8cca114a-ed05-4b87-95b7-fae02487f08c.png,1058,823,1162,935,104,112,red blood cell,11648,1.0769230769230769,0.9285714285714286
52543,/images/d1144956-5a0c-4bd2-b67d-8498c82d6a12.png,746,19,841,120,95,101,red blood cell,9595,1.063157894736842,0.9405940594059405
44966,/images/83ec8923-6232-40d7-ba1f-a1b8bf7cb66c.png,345,948,446,1052,101,104,red blood cell,10504,1.0297029702970297,0.9711538461538461
26715,/images/2518f6e4-29cc-4ae4-a914-b215a4c56099.png,714,1226,839,1337,125,111,red blood cell,13875,0.888,1.1261261261261262
75400,/images/468c261d-f5d8-423f-883e-48af2bbbc5d1.png,29,445,119,534,90,89,red blood cell,8010,0.9888888888888889,1.0112359550561798
69579,/images/4a49841f-216c-4815-8140-b8762c4f6603.png,168,1045,249,1138,81,93,red blood cell,7533,1.1481481481481481,0.8709677419354839
22423,/images/f97c7c87-5e27-45ea-9f93-3285d74091de.png,262,1283,358,1386,96,103,red blood cell,9888,1.0729166666666667,0.9320388349514563
31651,/images/0d7bf56f-3b5a-40bd-971c-2ca33dd89b2c.png,868,610,975,710,107,100,red blood cell,10700,0.9345794392523364,1.07
12184,/images/87d6343b-70dd-4cdd-939f-d3ac0ca2e700.png,400,1372,517,1489,117,117,red blood cell,13689,1.0,1.0
4704,/images/b91b1641-ee06-44d8-94cc-24cdb583cc37.png,323,727,456,848,133,121,red blood cell,16093,0.9097744360902256,1.0991735537190082
28210,/images/c244166d-12ca-445f-9ed9-a13d9caa412f.png,712,638,847,758,135,120,red blood cell,16200,0.8888888888888888,1.125
44116,/images/8b494b40-cab5-49d3-893d-c805000fbe88.png,842,1353,945,1474,103,121,red blood cell,12463,1.174757281553398,0.8512396694214877
25676,/images/c118ff18-f9f2-4617-bddb-dc4091fb8f5f.png,23,49,143,167,120,118,red blood cell,14160,0.9833333333333333,1.0169491525423728
6184,/images/27cdd837-e40f-491e-8adb-61e493189832.png,119,678,245,814,126,136,red blood cell,17136,1.0793650793650793,0.9264705882352942
32459,/images/3911fcd2-4e26-4ad9-aaf0-d1c5bf41defc.png,679,1348,779,1470,100,122,red blood cell,12200,1.22,0.819672131147541
3783,/images/c9499a06-fb31-4552-a9e2-fb4ebb440859.png,675,927,791,1039,116,112,red blood cell,12992,0.9655172413793104,1.0357142857142858
227,/images/2559636b-f01a-4414-93da-210c3b12d153.png,852,729,976,842,124,113,red blood cell,14012,0.9112903225806451,1.0973451327433628
43826,/images/c84edeb4-311c-4e82-88f9-ae0505b3ad13.png,559,1275,663,1380,104,105,red blood cell,10920,1.0096153846153846,0.9904761904761905
57860,/images/f4c2b43f-a2e7-4746-8034-0b34aebba8ee.png,666,182,784,296,118,114,red blood cell,13452,0.9661016949152542,1.0350877192982457
2720,/images/a89cace5-c818-4f23-a432-052b3433b81e.png,124,418,237,533,113,115,red blood cell,12995,1.0176991150442478,0.9826086956521739
34428,/images/b4bde4e8-f48b-4ae2-be01-86d8c91d0af9.png,935,1172,1038,1270,103,98,red blood cell,10094,0.9514563106796117,1.0510204081632653
78700,/images/76a8a5f5-1328-4539-a131-baf877f40cf3.png,637,540,747,649,110,109,red blood cell,11990,0.990909090909091,1.0091743119266054
73203,/images/85546330-4efd-43e2-87aa-d53a30220bfc.png,785,127,880,216,95,89,red blood cell,8455,0.9368421052631579,1.0674157303370786
69743,/images/2bd15b6e-fe2d-49f3-b394-940d024d1f91.png,933,1099,1036,1201,103,102,red blood cell,10506,0.9902912621359223,1.0098039215686274
8515,/images/dfc026a9-079f-4f45-8666-e0ccba5bb437.png,417,139,521,248,104,109,red blood cell,11336,1.0480769230769231,0.9541284403669725
59720,/images/f77d7469-d083-4c2d-a4ea-5a9ff162e3e2.png,66,446,168,547,102,101,red blood cell,10302,0.9901960784313726,1.00990099009901
59122,/images/4736f545-1f1f-4d77-9241-d69cbf4dae35.png,525,566,644,682,119,116,red blood cell,13804,0.9747899159663865,1.0258620689655173
33646,/images/84ee2ea3-9edd-4672-a1b3-f09c607d833a.png,73,1279,171,1384,98,105,red blood cell,10290,1.0714285714285714,0.9333333333333333
78942,/images/4d0a1598-e4dd-45c4-8a90-dd7c780fe1da.png,62,929,135,1007,73,78,red blood cell,5694,1.0684931506849316,0.9358974358974359
74731,/images/c53fd511-31bd-4901-baac-3b44891f6744.png,868,857,966,951,98,94,red blood cell,9212,0.9591836734693877,1.0425531914893618
5472,/images/3f106606-9a21-40d5-b849-273866fe0f49.png,410,720,539,825,129,105,red blood cell,13545,0.813953488372093,1.2285714285714286
77330,/images/3ff98212-7c2a-46cd-afb7-34a2479bed07.png,294,317,398,431,104,114,red blood cell,11856,1.0961538461538463,0.9122807017543859
14619,/images/c649e1cb-4029-4433-b231-d67d68f7391a.png,806,475,930,594,124,119,red blood cell,14756,0.9596774193548387,1.0420168067226891
75727,/images/d12c5f45-6b20-46d6-a66f-c5a4683c25b3.png,228,276,329,379,101,103,red blood cell,10403,1.0198019801980198,0.9805825242718447
69778,/images/2bd15b6e-fe2d-49f3-b394-940d024d1f91.png,1100,976,1192,1080,92,104,red blood cell,9568,1.1304347826086956,0.8846153846153846
23463,/images/8757be1e-b832-407a-8e95-62abae485b24.png,909,1441,1011,1534,102,93,red blood cell,9486,0.9117647058823529,1.096774193548387
19069,/images/6e39fb0a-aa41-4b16-b783-7589e97bf289.png,367,62,499,190,132,128,red blood cell,16896,0.9696969696969697,1.03125
2560,/images/a23f5539-bfe6-4885-9a0e-dba972475ea9.png,417,93,497,188,80,95,red blood cell,7600,1.1875,0.8421052631578947
71016,/images/deaa1931-5f97-45bf-8c00-be6ddeb37b9a.png,957,996,1034,1086,77,90,red blood cell,6930,1.1688311688311688,0.8555555555555555
61789,/images/985627c9-7b85-40de-a106-eb9cc47b47cb.png,1039,223,1120,308,81,85,red blood cell,6885,1.0493827160493827,0.9529411764705882
42976,/images/ff37dd9b-2e3c-444d-9d29-6db186cfa2fb.png,1070,1466,1178,1600,108,134,red blood cell,14472,1.2407407407407407,0.8059701492537313
44543,/images/419309ef-da3f-4424-93cf-01ff4c52b017.png,452,1481,564,1593,112,112,red blood cell,12544,1.0,1.0
39902,/images/71cf2467-77d3-4fac-ac6e-1d8767717c34.png,253,1140,385,1267,132,127,red blood cell,16764,0.9621212121212122,1.0393700787401574
70080,/images/b8339d7b-85ec-48d0-83e8-c8f831070459.png,948,466,1070,577,122,111,red blood cell,13542,0.9098360655737705,1.0990990990990992
18959,/images/e9e78ff8-831b-46e9-9785-3eee9acbfcd8.png,1063,527,1171,615,108,88,red blood cell,9504,0.8148148148148148,1.2272727272727273
29292,/images/6274fe0d-0d71-40be-b61b-f0bd5b5df1e2.png,816,674,907,763,91,89,red blood cell,8099,0.978021978021978,1.0224719101123596
78470,/images/72029aca-f0bc-477f-b790-f345f86228ce.png,810,1040,940,1160,130,120,red blood cell,15600,0.9230769230769231,1.0833333333333333
15909,/images/c7c1b873-0548-4a73-9618-f60912e164df.png,1049,784,1138,880,89,96,red blood cell,8544,1.0786516853932584,0.9270833333333334
31275,/images/db7c5ec1-fefe-4e9d-83c1-da8fb982f1e2.png,623,1251,733,1359,110,108,red blood cell,11880,0.9818181818181818,1.0185185185185186
5721,/images/d3dcdf92-9328-4796-adf4-918646877ba1.png,396,1195,545,1328,149,133,red blood cell,19817,0.8926174496644296,1.1203007518796992
60574,/images/58065a0c-d4c5-40fd-bcdc-037f61788482.png,113,1466,238,1598,125,132,red blood cell,16500,1.056,0.946969696969697
35418,/images/002f20ad-2ace-499c-9335-c9080bc3e6b5.png,205,771,323,887,118,116,red blood cell,13688,0.9830508474576272,1.0172413793103448
3242,/images/96596a68-8c95-43f3-b74e-e9506c235144.png,866,631,964,746,98,115,red blood cell,11270,1.1734693877551021,0.8521739130434782
36993,/images/b2e34f5f-904e-4473-9dc7-c6bc1ce12640.png,491,967,585,1061,94,94,red blood cell,8836,1.0,1.0
63688,/images/d9c9479e-f1ea-4d6e-861f-843ff9a90d19.png,499,1512,582,1595,83,83,red blood cell,6889,1.0,1.0
41925,/images/46a03374-64c7-49ac-81c9-c3d62542bbf3.png,1052,1389,1152,1492,100,103,red blood cell,10300,1.03,0.970873786407767
76588,/images/4184a235-d209-4151-86e9-6c77e7938dab.png,931,1162,1041,1272,110,110,red blood cell,12100,1.0,1.0
46056,/images/72088c26-d2dd-4906-b791-b8947fc7fbe4.png,165,66,267,153,102,87,red blood cell,8874,0.8529411764705882,1.1724137931034482
61353,/images/e16c0dab-780d-4035-872e-1bb91e49f9d2.png,208,1381,324,1493,116,112,red blood cell,12992,0.9655172413793104,1.0357142857142858
9871,/images/3859deaf-6ae1-49a3-9051-898d0f0d7de6.png,683,1300,788,1396,105,96,red blood cell,10080,0.9142857142857143,1.09375
77810,/images/6bc7b53c-5a98-48ef-a9de-59a476707ea4.png,736,542,843,640,107,98,red blood cell,10486,0.9158878504672897,1.0918367346938775
8248,/images/65e3d6a6-012c-4b40-9a42-83078eb85e31.png,858,766,970,864,112,98,red blood cell,10976,0.875,1.1428571428571428
62719,/images/9e1b0217-0926-4fd1-bb9e-a815c05deb59.png,1061,239,1172,348,111,109,red blood cell,12099,0.9819819819819819,1.018348623853211
56030,/images/177a3141-fa93-426a-9b52-7da71547ce44.png,107,693,216,801,109,108,red blood cell,11772,0.9908256880733946,1.0092592592592593
72537,/images/01b99da8-b66b-464b-a7ee-1cadab8db18b.png,10,1056,130,1184,120,128,red blood cell,15360,1.0666666666666667,0.9375
56184,/images/137d540f-d71e-47e8-bd9b-6cd0a6433c33.png,141,439,262,546,121,107,red blood cell,12947,0.8842975206611571,1.1308411214953271
26282,/images/52767904-4cdc-4821-ba68-8cd0c28f9023.png,418,184,518,291,100,107,red blood cell,10700,1.07,0.9345794392523364
8988,/images/ef815e3a-02a6-4cf8-9262-45bc74c50b00.png,715,226,807,336,92,110,red blood cell,10120,1.1956521739130435,0.8363636363636363
51538,/images/6afb3717-f197-4668-929a-4fab389ae6e8.png,660,87,778,204,118,117,red blood cell,13806,0.9915254237288136,1.0085470085470085
33143,/images/6231d81d-9e84-4a5a-8cb8-47c6a37a0176.png,684,869,772,953,88,84,red blood cell,7392,0.9545454545454546,1.0476190476190477
6914,/images/b21f6c6e-4b45-407a-b4c7-034a115f3ee4.png,131,479,231,588,100,109,red blood cell,10900,1.09,0.9174311926605505
54617,/images/59dc7da9-35d1-421e-a61b-1e9637bfbfa1.png,139,644,224,729,85,85,red blood cell,7225,1.0,1.0
6910,/images/b21f6c6e-4b45-407a-b4c7-034a115f3ee4.png,616,695,738,800,122,105,red blood cell,12810,0.860655737704918,1.161904761904762
38626,/images/3b601a1b-26d8-4873-afcf-fdd1b1e0010c.png,417,401,517,514,100,113,red blood cell,11300,1.13,0.8849557522123894
16741,/images/d6352a03-ef81-421d-915e-226499555d20.png,903,1236,1048,1355,145,119,red blood cell,17255,0.8206896551724138,1.218487394957983
58082,/images/a7c91b63-b97c-4f4b-8d34-7ad2b08d7a17.png,232,682,323,789,91,107,red blood cell,9737,1.1758241758241759,0.8504672897196262
42965,/images/ff37dd9b-2e3c-444d-9d29-6db186cfa2fb.png,927,1430,1047,1554,120,124,red blood cell,14880,1.0333333333333334,0.967741935483871
72838,/images/31435107-c77d-42f8-a619-75cba6a5161b.png,288,340,391,429,103,89,red blood cell,9167,0.8640776699029126,1.1573033707865168
30076,/images/81c3c8f0-d5a9-4dda-afd5-e86f6afd9424.png,657,1275,764,1378,107,103,red blood cell,11021,0.9626168224299065,1.0388349514563107
50950,/images/ef8fcfa4-8466-4186-8c69-f5f4904eb489.png,134,1199,246,1305,112,106,red blood cell,11872,0.9464285714285714,1.0566037735849056
21567,/images/49efc89d-9cba-44f7-8257-7f911b73f68a.png,710,1413,807,1519,97,106,red blood cell,10282,1.092783505154639,0.9150943396226415
11622,/images/37e072a6-000d-4773-8d9f-d66b60ace668.png,722,1379,825,1477,103,98,red blood cell,10094,0.9514563106796117,1.0510204081632653
77616,/images/f20a4fcf-ea8e-4c14-883d-d26a9e08ce25.png,67,1143,198,1249,131,106,red blood cell,13886,0.8091603053435115,1.2358490566037736
15006,/images/3003252a-2d2e-4687-ad30-9c38d68f1394.png,859,1088,991,1205,132,117,red blood cell,15444,0.8863636363636364,1.1282051282051282
49754,/images/5e17f8e6-fd8d-426c-b444-1515d14f04b7.png,1033,44,1119,130,86,86,red blood cell,7396,1.0,1.0
40298,/images/eb86033f-4f1c-4e8c-ae84-e8e4c7e08626.png,136,881,249,1003,113,122,red blood cell,13786,1.079646017699115,0.9262295081967213
16612,/images/a27858ef-6533-413e-bc75-cc54690261a2.png,138,1408,255,1523,117,115,red blood cell,13455,0.9829059829059829,1.017391304347826
59693,/images/a2754679-68b0-40f4-be01-bafad5ac1261.png,665,733,772,837,107,104,red blood cell,11128,0.9719626168224299,1.0288461538461537
59976,/images/f0fe292d-85ae-4c3a-a676-037dde2594e6.png,710,1088,844,1219,134,131,red blood cell,17554,0.9776119402985075,1.0229007633587786
29864,/images/9cdee92c-6267-4188-a41e-125bc0abb9ae.png,548,206,662,313,114,107,red blood cell,12198,0.9385964912280702,1.0654205607476634
68286,/images/a6391703-0820-4913-a7cd-e843ff0d84ba.png,528,1346,641,1471,113,125,red blood cell,14125,1.1061946902654867,0.904
13889,/images/7d65d296-0f7b-41cc-9073-a547e24326c8.png,133,1255,247,1364,114,109,red blood cell,12426,0.956140350877193,1.0458715596330275
61613,/images/a3c0a876-be12-4ede-8aed-18b32a64401b.png,467,579,557,680,90,101,red blood cell,9090,1.1222222222222222,0.8910891089108911
395,/images/84c88143-940d-4b62-bbd2-7acc4cadcb6b.png,62,616,168,735,106,119,red blood cell,12614,1.1226415094339623,0.8907563025210085
51035,/images/7eb95580-693f-41b6-9338-174be1430c23.png,645,1336,747,1435,102,99,red blood cell,10098,0.9705882352941176,1.0303030303030303
46650,/images/da111ca5-520f-4ea8-97ad-ae5fce58ee91.png,464,298,560,388,96,90,red blood cell,8640,0.9375,1.0666666666666667
6237,/images/effd6334-516f-4d48-9f3c-5272a99780fb.png,500,490,607,602,107,112,red blood cell,11984,1.0467289719626167,0.9553571428571429
33997,/images/701206c5-aaac-4b99-9cc0-4a6854359457.png,801,650,921,765,120,115,red blood cell,13800,0.9583333333333334,1.0434782608695652
25500,/images/f6ab936d-924b-4038-aa47-71b07c26b4e2.png,427,879,551,1004,124,125,red blood cell,15500,1.0080645161290323,0.992
64646,/images/6dfafdf1-f588-4e80-8cf8-0126e1bf7af9.png,720,620,819,704,99,84,red blood cell,8316,0.8484848484848485,1.1785714285714286
15659,/images/84d7545e-c3a8-4b1f-9a39-36aab78c8699.png,665,988,801,1132,136,144,red blood cell,19584,1.0588235294117647,0.9444444444444444
62509,/images/7dfbfeaf-e3b1-4159-8dcd-d7f731280ac8.png,331,449,436,549,105,100,red blood cell,10500,0.9523809523809523,1.05
54871,/images/8f84a2c9-ca38-4405-a488-12fcd101278b.png,64,252,180,368,116,116,red blood cell,13456,1.0,1.0
75696,/images/50d7c6c9-3230-48fe-947c-7dcfd0aad710.png,50,837,149,930,99,93,red blood cell,9207,0.9393939393939394,1.064516129032258
58209,/images/2f68686f-1fe8-46e7-ad92-a08e3523ea79.png,747,1304,848,1400,101,96,red blood cell,9696,0.9504950495049505,1.0520833333333333
2886,/images/a1c140f9-75d7-42a3-b767-4c01a118892b.png,215,1107,331,1231,116,124,red blood cell,14384,1.0689655172413792,0.9354838709677419
39729,/images/56adbb1e-96a8-40a5-a5a2-243c97ea889b.png,19,683,146,794,127,111,red blood cell,14097,0.8740157480314961,1.1441441441441442
30546,/images/7d9c1422-6332-44e9-b134-3ac94f07b0f0.png,877,82,986,199,109,117,red blood cell,12753,1.073394495412844,0.9316239316239316
18957,/images/e9e78ff8-831b-46e9-9785-3eee9acbfcd8.png,599,816,688,908,89,92,red blood cell,8188,1.0337078651685394,0.967391304347826
16903,/images/f5419bc0-4415-41b6-b832-5326cfcc534b.png,474,1356,605,1475,131,119,red blood cell,15589,0.9083969465648855,1.1008403361344539
2136,/images/e94a811d-3145-4313-ba42-2d5ed283179f.png,453,1173,563,1268,110,95,red blood cell,10450,0.8636363636363636,1.1578947368421053
27086,/images/ec301f62-1302-4407-96f9-fcfe45c150ae.png,129,723,248,823,119,100,red blood cell,11900,0.8403361344537815,1.19
20884,/images/c2ec116f-f091-422c-926c-70b548a8f6ef.png,558,455,661,556,103,101,red blood cell,10403,0.9805825242718447,1.0198019801980198
77411,/images/c7ec51d5-9f45-4209-8357-39e9a984a733.png,596,1236,711,1334,115,98,red blood cell,11270,0.8521739130434782,1.1734693877551021
65299,/images/24418314-f7a4-49fc-a03e-ec597ca6796e.png,281,220,370,320,89,100,red blood cell,8900,1.1235955056179776,0.89
8591,/images/a6aa3b72-2970-4c78-b655-ea8dfe6e018c.png,744,853,856,970,112,117,red blood cell,13104,1.0446428571428572,0.9572649572649573
12844,/images/b10ea12f-cd36-4f2c-994a-67d1665269ab.png,102,1013,205,1122,103,109,red blood cell,11227,1.058252427184466,0.944954128440367
31523,/images/3130f950-8345-4315-9711-92f7af3f5c14.png,891,281,1012,403,121,122,red blood cell,14762,1.0082644628099173,0.9918032786885246
60859,/images/11b72c7b-5c52-44b7-adb7-21eacc25e441.png,445,786,546,884,101,98,red blood cell,9898,0.9702970297029703,1.030612244897959
77760,/images/4849866a-73a2-4fcf-a407-2d0a25a09a89.png,874,1278,962,1363,88,85,red blood cell,7480,0.9659090909090909,1.035294117647059
26259,/images/52767904-4cdc-4821-ba68-8cd0c28f9023.png,751,357,868,485,117,128,red blood cell,14976,1.0940170940170941,0.9140625
18131,/images/947348fe-4c70-468e-8009-3c14daeca69b.png,716,254,827,353,111,99,red blood cell,10989,0.8918918918918919,1.121212121212121
66234,/images/e8058bed-c362-4e1c-85dc-62f80f32938f.png,806,81,909,192,103,111,red blood cell,11433,1.0776699029126213,0.9279279279279279
66073,/images/c8af0297-ce1f-40ea-bf44-9256dcdae4e9.png,471,1225,577,1347,106,122,red blood cell,12932,1.150943396226415,0.8688524590163934
26554,/images/4935818a-7e7a-4f44-a3b6-b361d1abfe16.png,422,701,527,814,105,113,red blood cell,11865,1.0761904761904761,0.9292035398230089
11050,/images/85a4d82e-cfb7-4983-b272-626c9e8c7583.png,131,298,254,435,123,137,red blood cell,16851,1.113821138211382,0.8978102189781022
20226,/images/c66cb6b2-1480-446a-a9d2-b8032a3de0d7.png,123,597,240,700,117,103,red blood cell,12051,0.8803418803418803,1.1359223300970873
22341,/images/78c35732-7e31-4153-842e-55ab1cd656f6.png,298,265,412,370,114,105,red blood cell,11970,0.9210526315789473,1.0857142857142856
69710,/images/f0713bee-2a71-4ced-b953-4041ea99496a.png,801,824,905,933,104,109,red blood cell,11336,1.0480769230769231,0.9541284403669725
75267,/images/2afe2750-c963-46f9-a1ad-9260e80679ca.png,887,1059,1012,1194,125,135,red blood cell,16875,1.08,0.9259259259259259
72870,/images/31435107-c77d-42f8-a619-75cba6a5161b.png,403,1410,497,1507,94,97,red blood cell,9118,1.0319148936170213,0.9690721649484536
62587,/images/f7a4334a-4332-4de8-b39b-22da907976f2.png,877,48,994,161,117,113,red blood cell,13221,0.9658119658119658,1.0353982300884956
16324,/images/d5009906-bce1-4353-90b4-f4c79362f4cf.png,641,857,734,950,93,93,red blood cell,8649,1.0,1.0
38046,/images/e3e9c2de-0a24-4c7e-8a69-3d3093d5bdab.png,912,195,1014,290,102,95,red blood cell,9690,0.9313725490196079,1.0736842105263158
58042,/images/a7c91b63-b97c-4f4b-8d34-7ad2b08d7a17.png,689,995,777,1086,88,91,red blood cell,8008,1.0340909090909092,0.967032967032967
48386,/images/0fa5b35d-6c44-4207-b6f8-d5b355086b5f.png,937,1198,1058,1322,121,124,red blood cell,15004,1.024793388429752,0.9758064516129032
73914,/images/2ae3e6e6-7482-4ab8-ad73-b530b5c2ee3b.png,638,1155,756,1257,118,102,red blood cell,12036,0.864406779661017,1.1568627450980393
41882,/images/783ae4ad-6a35-4b3c-b19f-754974b67b2d.png,504,664,607,757,103,93,red blood cell,9579,0.9029126213592233,1.10752688172043
13649,/images/1e86933d-6a5a-4a3c-a0f2-ca22afd767b3.png,880,282,988,396,108,114,red blood cell,12312,1.0555555555555556,0.9473684210526315
59355,/images/565513be-2c20-4ee3-94f3-093869515d3d.png,374,519,472,623,98,104,red blood cell,10192,1.0612244897959184,0.9423076923076923
49159,/images/df3d98b9-3dd7-4107-8d4a-ae1b7f247793.png,651,411,763,505,112,94,red blood cell,10528,0.8392857142857143,1.1914893617021276
68381,/images/040112be-3c8d-49aa-93f1-522f94a592ff.png,542,1367,646,1479,104,112,red blood cell,11648,1.0769230769230769,0.9285714285714286
66240,/images/e8058bed-c362-4e1c-85dc-62f80f32938f.png,586,406,691,503,105,97,red blood cell,10185,0.9238095238095239,1.0824742268041236
50951,/images/ef8fcfa4-8466-4186-8c69-f5f4904eb489.png,651,342,755,453,104,111,red blood cell,11544,1.0673076923076923,0.9369369369369369
52674,/images/3f390b82-8859-4c27-bbfe-d1b242477f63.png,62,1206,170,1327,108,121,red blood cell,13068,1.1203703703703705,0.8925619834710744
45834,/images/7db1373d-5bbf-47e6-ab40-30cba7678745.png,430,1319,538,1425,108,106,red blood cell,11448,0.9814814814814815,1.0188679245283019
75538,/images/c35ee701-fde2-46b5-b178-1fe3f1ea7da2.png,445,883,545,984,100,101,red blood cell,10100,1.01,0.9900990099009901
30525,/images/7d9c1422-6332-44e9-b134-3ac94f07b0f0.png,1033,1108,1138,1201,105,93,red blood cell,9765,0.8857142857142857,1.1290322580645162
41977,/images/46a03374-64c7-49ac-81c9-c3d62542bbf3.png,525,595,631,684,106,89,red blood cell,9434,0.839622641509434,1.1910112359550562
72008,/images/6ad3efc9-4392-4cee-98a5-186564a96373.png,389,875,506,984,117,109,red blood cell,12753,0.9316239316239316,1.073394495412844
73095,/images/f39e2289-fedd-4d12-9e64-ffdafb89247e.png,953,585,1059,690,106,105,red blood cell,11130,0.9905660377358491,1.0095238095238095
39742,/images/56adbb1e-96a8-40a5-a5a2-243c97ea889b.png,281,288,375,396,94,108,red blood cell,10152,1.148936170212766,0.8703703703703703
41709,/images/67abb826-9b70-4459-8764-da76ecf35bfe.png,1026,1074,1145,1212,119,138,red blood cell,16422,1.1596638655462186,0.8623188405797102
28401,/images/a6d85204-24b8-4b23-a8b1-c3e8b93f9f22.png,850,1030,961,1140,111,110,red blood cell,12210,0.990990990990991,1.009090909090909
59665,/images/a2754679-68b0-40f4-be01-bafad5ac1261.png,354,52,443,149,89,97,red blood cell,8633,1.0898876404494382,0.9175257731958762
30917,/images/533c47c9-02a6-419b-961b-81797f022f6c.png,884,1256,985,1368,101,112,red blood cell,11312,1.108910891089109,0.9017857142857143
44528,/images/419309ef-da3f-4424-93cf-01ff4c52b017.png,68,381,166,491,98,110,red blood cell,10780,1.1224489795918366,0.8909090909090909
76990,/images/51e86aa9-caa0-4297-94e8-34a57d7f7e36.png,536,469,629,576,93,107,red blood cell,9951,1.1505376344086022,0.8691588785046729
17800,/images/1863da5f-c595-4541-a8f4-21fe78678168.png,681,1414,764,1500,83,86,red blood cell,7138,1.036144578313253,0.9651162790697675
60309,/images/7abc0d26-dd66-4ef4-8c4e-4a661e589a7f.png,1092,957,1193,1046,101,89,red blood cell,8989,0.8811881188118812,1.1348314606741574
51584,/images/d0347b49-8f98-4632-a384-1a4f57ac6374.png,500,574,611,681,111,107,red blood cell,11877,0.963963963963964,1.0373831775700935
47067,/images/997eabd9-55bf-4683-83c4-4cee4673a4ef.png,8,1333,88,1427,80,94,red blood cell,7520,1.175,0.851063829787234
40053,/images/6fd30823-3b77-40c9-ba5d-e1eda9660674.png,260,356,369,487,109,131,red blood cell,14279,1.201834862385321,0.8320610687022901
17964,/images/eb77e4a9-acb0-4d83-8055-2c5fcaa54b45.png,489,1312,578,1385,89,73,red blood cell,6497,0.8202247191011236,1.2191780821917808
18236,/images/947348fe-4c70-468e-8009-3c14daeca69b.png,1086,852,1196,956,110,104,red blood cell,11440,0.9454545454545454,1.0576923076923077
63488,/images/b9d65ef3-1adc-4479-abee-2e422f5a613a.png,1085,1391,1194,1497,109,106,red blood cell,11554,0.9724770642201835,1.028301886792453
43210,/images/fe1ee954-ba71-47b3-954a-d20ab940cd7b.png,459,382,594,512,135,130,red blood cell,17550,0.9629629629629629,1.0384615384615385
24326,/images/4d8a4ce8-0f9c-4f21-8844-4cf0e5514bbf.png,655,0,761,119,106,119,red blood cell,12614,1.1226415094339623,0.8907563025210085
68911,/images/bbaa004f-05dc-4cb8-8768-e148085bb0f9.png,738,842,848,941,110,99,red blood cell,10890,0.9,1.1111111111111112
1261,/images/6d91d1f0-636b-4f5a-a526-7c17fc857190.png,158,47,259,154,101,107,red blood cell,10807,1.0594059405940595,0.9439252336448598
64491,/images/6ba5d0b8-cdc7-4266-9d78-db76faa312e9.png,577,1307,671,1412,94,105,red blood cell,9870,1.1170212765957446,0.8952380952380953
42247,/images/ca734448-0d52-42fa-b41c-17b2939e58ae.png,926,738,1013,824,87,86,red blood cell,7482,0.9885057471264368,1.0116279069767442
73734,/images/22cbf509-c9bf-46ec-bfce-f079c6b76c8c.png,267,1406,382,1526,115,120,red blood cell,13800,1.0434782608695652,0.9583333333333334
6273,/images/f4a27dfd-4c52-459f-96b5-ee6b452a3395.png,457,762,575,859,118,97,red blood cell,11446,0.8220338983050848,1.2164948453608246
9637,/images/d997337e-e4a8-4ef0-b8ba-975e6c43b62c.png,509,1455,641,1574,132,119,red blood cell,15708,0.9015151515151515,1.1092436974789917
36350,/images/4a0a05e1-11ad-4bfc-bfa3-adf3b9bd0b56.png,746,794,841,901,95,107,red blood cell,10165,1.1263157894736842,0.8878504672897196
53570,/images/7c1cd7c7-7452-4428-a98e-dd7675c8ddea.png,461,1380,570,1490,109,110,red blood cell,11990,1.0091743119266054,0.990909090909091
32450,/images/3911fcd2-4e26-4ad9-aaf0-d1c5bf41defc.png,174,1496,292,1599,118,103,red blood cell,12154,0.8728813559322034,1.145631067961165
29830,/images/9cdee92c-6267-4188-a41e-125bc0abb9ae.png,754,1281,851,1375,97,94,red blood cell,9118,0.9690721649484536,1.0319148936170213
4996,/images/2cc3c4ad-670f-41b6-8910-0704cbc192ef.png,119,1054,216,1172,97,118,red blood cell,11446,1.2164948453608246,0.8220338983050848
33262,/images/5721e41b-90ef-4851-8587-8dc71227ef90.png,633,679,747,788,114,109,red blood cell,12426,0.956140350877193,1.0458715596330275
74631,/images/5ccca8ee-abea-458a-a891-bedd31c3ddc3.png,625,1172,728,1279,103,107,red blood cell,11021,1.0388349514563107,0.9626168224299065
1710,/images/5f783f43-0090-4f8a-bd75-9562f4aa2dd5.png,818,933,922,1038,104,105,red blood cell,10920,1.0096153846153846,0.9904761904761905
28467,/images/c3042130-a6e2-458f-9fde-bb012f68f5f2.png,0,1353,127,1472,127,119,red blood cell,15113,0.937007874015748,1.0672268907563025
34492,/images/fa1f9f89-cecb-4972-842c-d14c632f89a9.png,430,961,537,1052,107,91,red blood cell,9737,0.8504672897196262,1.1758241758241759
47679,/images/4b3a49bc-8536-4760-9553-440a6f64db37.png,792,1236,906,1356,114,120,red blood cell,13680,1.0526315789473684,0.95
68966,/images/bbaa004f-05dc-4cb8-8768-e148085bb0f9.png,535,1102,626,1213,91,111,red blood cell,10101,1.2197802197802199,0.8198198198198198
72467,/images/a15e0fa8-2620-4f66-896e-175115c9dc3d.png,841,381,943,477,102,96,red blood cell,9792,0.9411764705882353,1.0625
22977,/images/b687c30d-cf15-445c-b3f6-5aca86584708.png,739,254,843,375,104,121,red blood cell,12584,1.1634615384615385,0.859504132231405
65826,/images/daea4860-a296-4f6d-acef-996ab0882676.png,4,431,102,538,98,107,red blood cell,10486,1.0918367346938775,0.9158878504672897
48135,/images/913099c5-8085-4908-bf4b-1f098bbfcf66.png,467,1085,563,1189,96,104,red blood cell,9984,1.0833333333333333,0.9230769230769231
17186,/images/471f75c6-bd5d-4c20-bcc1-258e836f4d69.png,540,1459,655,1569,115,110,red blood cell,12650,0.9565217391304348,1.0454545454545454
38821,/images/d0d3ae45-b434-4869-a518-427320ebe62d.png,477,648,588,784,111,136,red blood cell,15096,1.2252252252252251,0.8161764705882353
66324,/images/fcdf6632-c03f-49a8-9fb3-42e87c99b9d0.png,446,279,542,379,96,100,red blood cell,9600,1.0416666666666667,0.96
67952,/images/bcaefb02-682a-41b9-acc7-e6cc010f5b30.png,544,288,649,388,105,100,red blood cell,10500,0.9523809523809523,1.05
76139,/images/16244280-6c74-47d3-b544-9fd6831a6bf9.png,408,187,505,284,97,97,red blood cell,9409,1.0,1.0
15353,/images/035f6c4b-0897-46ab-9c3b-5f3b0feff043.png,284,1150,402,1261,118,111,red blood cell,13098,0.940677966101695,1.063063063063063
40868,/images/550cf4ce-b641-44a3-8487-3e16d4049187.png,131,303,249,428,118,125,red blood cell,14750,1.0593220338983051,0.944
9789,/images/3859deaf-6ae1-49a3-9051-898d0f0d7de6.png,520,255,619,347,99,92,red blood cell,9108,0.9292929292929293,1.076086956521739
19039,/images/e9e78ff8-831b-46e9-9785-3eee9acbfcd8.png,496,1468,594,1572,98,104,red blood cell,10192,1.0612244897959184,0.9423076923076923
11575,/images/b4dc3088-3fe2-4688-be24-70664a64e022.png,1016,1395,1136,1518,120,123,red blood cell,14760,1.025,0.975609756097561
8791,/images/ae17a099-18b5-4a42-a901-850ea056423e.png,960,578,1056,670,96,92,red blood cell,8832,0.9583333333333334,1.0434782608695652
76980,/images/51e86aa9-caa0-4297-94e8-34a57d7f7e36.png,722,820,820,919,98,99,red blood cell,9702,1.010204081632653,0.98989898989899
24023,/images/5107dcb7-164f-4e10-bbff-822b39b76efc.png,414,1296,525,1395,111,99,red blood cell,10989,0.8918918918918919,1.121212121212121
77756,/images/4849866a-73a2-4fcf-a407-2d0a25a09a89.png,73,1074,184,1180,111,106,red blood cell,11766,0.954954954954955,1.0471698113207548
52033,/images/6c3f81d7-5670-46bd-9eaa-9b426413abb7.png,362,73,495,199,133,126,red blood cell,16758,0.9473684210526315,1.0555555555555556
61625,/images/a3c0a876-be12-4ede-8aed-18b32a64401b.png,315,326,410,412,95,86,red blood cell,8170,0.9052631578947369,1.1046511627906976
26738,/images/2518f6e4-29cc-4ae4-a914-b215a4c56099.png,516,700,631,807,115,107,red blood cell,12305,0.9304347826086956,1.074766355140187
47566,/images/06cd484f-e864-4fee-8819-688b45eed98e.png,585,769,703,897,118,128,red blood cell,15104,1.0847457627118644,0.921875
16588,/images/c7045ab6-230e-4c1e-a8e0-f624d41a00d9.png,946,558,1040,667,94,109,red blood cell,10246,1.1595744680851063,0.8623853211009175
39935,/images/8271d0d8-9985-43eb-94b3-c702adca139f.png,973,1428,1072,1550,99,122,red blood cell,12078,1.2323232323232323,0.8114754098360656
5501,/images/eb6e8684-b84e-483d-b835-f59286d2516b.png,452,134,583,257,131,123,red blood cell,16113,0.9389312977099237,1.065040650406504
25855,/images/14b68d86-ac7f-419d-b4a5-6b0b1d9aaa18.png,409,1112,516,1215,107,103,red blood cell,11021,0.9626168224299065,1.0388349514563107
43734,/images/ef83ed4c-2724-4d5f-8abe-1a18d25cea35.png,43,1335,157,1446,114,111,red blood cell,12654,0.9736842105263158,1.027027027027027
73502,/images/5f2b32bd-fdca-4d6f-b13a-ee9f83626c8d.png,765,1375,848,1459,83,84,red blood cell,6972,1.0120481927710843,0.9880952380952381
53506,/images/43158031-a335-4533-9c20-48bebba90123.png,108,1468,220,1585,112,117,red blood cell,13104,1.0446428571428572,0.9572649572649573
56537,/images/ac8df764-c8d8-4312-916d-70bfb37574b4.png,286,559,393,662,107,103,red blood cell,11021,0.9626168224299065,1.0388349514563107
75858,/images/3006096f-ceeb-42be-b69e-785179d7438b.png,900,886,1008,997,108,111,red blood cell,11988,1.0277777777777777,0.972972972972973
44482,/images/b6573be3-9e04-49c3-9f48-6a145d065363.png,674,1393,786,1487,112,94,red blood cell,10528,0.8392857142857143,1.1914893617021276
12575,/images/8e4bdd0d-1c72-4836-ae3e-05e2e50e4983.png,595,290,692,399,97,109,red blood cell,10573,1.1237113402061856,0.8899082568807339
34363,/images/1a48cbc1-5423-47e5-8ca5-2ab4f83a05a5.png,646,1369,757,1490,111,121,red blood cell,13431,1.09009009009009,0.9173553719008265
38040,/images/e3e9c2de-0a24-4c7e-8a69-3d3093d5bdab.png,981,785,1082,898,101,113,red blood cell,11413,1.118811881188119,0.8938053097345132
48355,/images/6fa2b30f-9b89-46ac-9b79-c0bc105d4271.png,219,838,330,950,111,112,red blood cell,12432,1.009009009009009,0.9910714285714286
25812,/images/14b68d86-ac7f-419d-b4a5-6b0b1d9aaa18.png,481,637,597,738,116,101,red blood cell,11716,0.8706896551724138,1.1485148514851484
75162,/images/7fdc8be8-7579-4a5c-b369-8a07ee0a8b7d.png,287,180,387,279,100,99,red blood cell,9900,0.99,1.0101010101010102
51342,/images/b4f3b2a4-f4b9-48de-ac5d-0e681b77be27.png,574,999,685,1100,111,101,red blood cell,11211,0.9099099099099099,1.099009900990099
19033,/images/e9e78ff8-831b-46e9-9785-3eee9acbfcd8.png,896,1394,985,1483,89,89,red blood cell,7921,1.0,1.0
71525,/images/191071ab-6515-428c-9f05-8e4309542b75.png,589,545,693,639,104,94,red blood cell,9776,0.9038461538461539,1.1063829787234043
198,/images/2559636b-f01a-4414-93da-210c3b12d153.png,689,1035,819,1168,130,133,red blood cell,17290,1.023076923076923,0.9774436090225563
67465,/images/8e72e20e-e714-4db6-a1da-c05a409257d4.png,907,591,987,681,80,90,red blood cell,7200,1.125,0.8888888888888888
60304,/images/7abc0d26-dd66-4ef4-8c4e-4a661e589a7f.png,456,1162,557,1253,101,91,red blood cell,9191,0.900990099009901,1.10989010989011
65790,/images/daea4860-a296-4f6d-acef-996ab0882676.png,357,1444,462,1559,105,115,red blood cell,12075,1.0952380952380953,0.9130434782608695
65812,/images/daea4860-a296-4f6d-acef-996ab0882676.png,241,1404,344,1508,103,104,red blood cell,10712,1.0097087378640777,0.9903846153846154
42447,/images/29648565-fe28-4517-ba72-68df0c82c9c5.png,771,384,884,498,113,114,red blood cell,12882,1.008849557522124,0.9912280701754386
12138,/images/87d6343b-70dd-4cdd-939f-d3ac0ca2e700.png,466,53,571,177,105,124,red blood cell,13020,1.180952380952381,0.8467741935483871
50734,/images/6b4c79f5-b194-4586-be9f-e339c5af4188.png,696,1141,809,1266,113,125,red blood cell,14125,1.1061946902654867,0.904
59073,/images/5e2cea49-0823-49d1-83cf-8fd1559cdd93.png,578,694,673,812,95,118,red blood cell,11210,1.2421052631578948,0.8050847457627118
13468,/images/370277f8-436b-4103-8210-b4feb5ab95ea.png,174,212,262,306,88,94,red blood cell,8272,1.0681818181818181,0.9361702127659575
48897,/images/5dec0204-af81-44ef-a942-8a173669c123.png,590,1368,699,1481,109,113,red blood cell,12317,1.036697247706422,0.9646017699115044
47550,/images/adff132d-3af0-4cef-942c-58fc09729bee.png,72,1116,195,1242,123,126,red blood cell,15498,1.024390243902439,0.9761904761904762
41643,/images/0fcd1ebe-ee4a-40a0-b787-29cee18bfa1b.png,763,935,857,1044,94,109,red blood cell,10246,1.1595744680851063,0.8623853211009175
79721,/images/03b9d6ad-39ca-4097-a98b-77f02b3c00a7.png,201,668,304,771,103,103,red blood cell,10609,1.0,1.0
25253,/images/90171428-f208-428a-b40e-f57ee3bea457.png,869,638,963,736,94,98,red blood cell,9212,1.0425531914893618,0.9591836734693877
63572,/images/de0321fa-6f7d-4dd1-b96b-186701c3b1d9.png,327,975,438,1082,111,107,red blood cell,11877,0.963963963963964,1.0373831775700935
28251,/images/036404d1-b9fc-497b-bbe1-f4d9c5ac3ce0.png,665,1197,778,1296,113,99,red blood cell,11187,0.8761061946902655,1.1414141414141414
17583,/images/e80bad38-66d0-473e-85dd-92142dba37e6.png,564,16,695,136,131,120,red blood cell,15720,0.916030534351145,1.0916666666666666
3678,/images/8bd71314-e38a-4670-bb25-5cd6c9acb595.png,121,1155,247,1271,126,116,red blood cell,14616,0.9206349206349206,1.0862068965517242
70711,/images/8ab5c462-045e-4b59-b53a-9b2bc3ed2487.png,701,811,788,907,87,96,red blood cell,8352,1.103448275862069,0.90625
13835,/images/345cb914-7583-49df-96e3-3cf19c2ba8f1.png,348,853,475,968,127,115,red blood cell,14605,0.905511811023622,1.1043478260869566
25396,/images/fbb1b44c-d75a-4550-a6c0-0eb62b96bfce.png,85,303,188,407,103,104,red blood cell,10712,1.0097087378640777,0.9903846153846154
72924,/images/a20d0b4b-6e2e-4507-bc22-f321dedc4ed9.png,1018,589,1116,709,98,120,red blood cell,11760,1.2244897959183674,0.8166666666666667
55170,/images/29d4b75f-d400-4702-a9ac-e5a4ed1a1db1.png,1052,425,1139,505,87,80,red blood cell,6960,0.9195402298850575,1.0875
12550,/images/8e4bdd0d-1c72-4836-ae3e-05e2e50e4983.png,384,621,496,713,112,92,red blood cell,10304,0.8214285714285714,1.2173913043478262
60736,/images/45651e76-4bd0-45e5-895b-edec65f51987.png,1041,1,1159,111,118,110,red blood cell,12980,0.9322033898305084,1.0727272727272728
78849,/images/4d0a1598-e4dd-45c4-8a90-dd7c780fe1da.png,1015,132,1124,234,109,102,red blood cell,11118,0.9357798165137615,1.0686274509803921
22741,/images/8490c623-3d88-4532-baf5-0d266a45b16f.png,1038,512,1145,611,107,99,red blood cell,10593,0.9252336448598131,1.0808080808080809
53006,/images/42e87148-a015-4148-923a-fb83016f64e7.png,996,775,1097,874,101,99,red blood cell,9999,0.9801980198019802,1.02020202020202
31834,/images/f62d4fb6-df7c-446c-94a8-d5aede0b1e0c.png,582,61,714,177,132,116,red blood cell,15312,0.8787878787878788,1.1379310344827587
36028,/images/ca9626bc-21a4-46f4-ba94-e7ee7a4cf735.png,20,1107,138,1238,118,131,red blood cell,15458,1.1101694915254237,0.9007633587786259
8584,/images/a6aa3b72-2970-4c78-b655-ea8dfe6e018c.png,442,696,557,798,115,102,red blood cell,11730,0.8869565217391304,1.1274509803921569
71559,/images/b9c6db13-ca3a-4937-8ecf-e537047ed858.png,976,1149,1087,1248,111,99,red blood cell,10989,0.8918918918918919,1.121212121212121
65470,/images/da49db57-0c2f-4213-b322-c88c19fb9296.png,612,1412,713,1517,101,105,red blood cell,10605,1.0396039603960396,0.9619047619047619
28248,/images/036404d1-b9fc-497b-bbe1-f4d9c5ac3ce0.png,1076,1069,1183,1185,107,116,red blood cell,12412,1.0841121495327102,0.9224137931034483
63439,/images/b9d65ef3-1adc-4479-abee-2e422f5a613a.png,207,287,312,388,105,101,red blood cell,10605,0.9619047619047619,1.0396039603960396
28943,/images/b12ae3b1-613c-4c0e-9163-3c5cc314abf5.png,663,917,771,1024,108,107,red blood cell,11556,0.9907407407407407,1.0093457943925233
12078,/images/b234b6ea-b54d-470c-8461-ba7f4a024796.png,710,158,816,279,106,121,red blood cell,12826,1.1415094339622642,0.8760330578512396
12377,/images/3b55c42f-ad59-422f-ba99-4f4f4ca9cb2e.png,292,578,398,670,106,92,red blood cell,9752,0.8679245283018868,1.1521739130434783
15097,/images/3a8f468f-f9de-46a8-a7c8-f2be239fa207.png,270,1349,366,1445,96,96,red blood cell,9216,1.0,1.0
6287,/images/f4a27dfd-4c52-459f-96b5-ee6b452a3395.png,579,1170,711,1286,132,116,red blood cell,15312,0.8787878787878788,1.1379310344827587
8937,/images/04628a94-b674-469b-aff6-b476b70df87d.png,197,1303,317,1430,120,127,red blood cell,15240,1.0583333333333333,0.9448818897637795
9292,/images/261562a8-ffd8-4e0e-919b-22e267000b74.png,505,832,597,932,92,100,red blood cell,9200,1.0869565217391304,0.92
16761,/images/4823c1fe-a7f9-4b92-959f-0d9be09cd14b.png,169,1127,272,1229,103,102,red blood cell,10506,0.9902912621359223,1.0098039215686274
76718,/images/3317d733-ec0d-45e6-b631-40457392f343.png,683,266,786,375,103,109,red blood cell,11227,1.058252427184466,0.944954128440367
66356,/images/fcdf6632-c03f-49a8-9fb3-42e87c99b9d0.png,418,187,516,278,98,91,red blood cell,8918,0.9285714285714286,1.0769230769230769
29871,/images/9cdee92c-6267-4188-a41e-125bc0abb9ae.png,68,979,184,1091,116,112,red blood cell,12992,0.9655172413793104,1.0357142857142858
64228,/images/2a91387a-d30f-418d-ac3a-f7cfa6836261.png,288,1505,385,1596,97,91,red blood cell,8827,0.9381443298969072,1.065934065934066
74380,/images/06a3effb-996c-4767-afd2-6aa3b697cb4e.png,799,86,896,182,97,96,red blood cell,9312,0.9896907216494846,1.0104166666666667
33220,/images/877d5e7f-19b6-40e7-81bd-c92f25e72503.png,1042,495,1162,609,120,114,red blood cell,13680,0.95,1.0526315789473684
37694,/images/003a89b0-a095-417a-8dd6-f408339bbc68.png,137,915,244,1021,107,106,red blood cell,11342,0.9906542056074766,1.009433962264151
56326,/images/4372709c-f356-4906-be17-415384d916e8.png,940,1456,1051,1562,111,106,red blood cell,11766,0.954954954954955,1.0471698113207548
52850,/images/58f7e1da-3478-48f4-958c-e9b1cb8696aa.png,413,583,522,681,109,98,red blood cell,10682,0.8990825688073395,1.1122448979591837
775,/images/27fab82c-5bf0-426f-aeb9-47da829b6629.png,506,1196,625,1308,119,112,red blood cell,13328,0.9411764705882353,1.0625
10696,/images/20d4f65e-6c63-433a-935c-d568d577967b.png,482,1449,583,1559,101,110,red blood cell,11110,1.0891089108910892,0.9181818181818182
13368,/images/a7f1bbb1-6058-4642-bd66-cfb90dce762e.png,901,210,990,311,89,101,red blood cell,8989,1.1348314606741574,0.8811881188118812
43033,/images/1345dc89-a3d9-4b71-8a75-b3bff01ba518.png,43,139,155,249,112,110,red blood cell,12320,0.9821428571428571,1.018181818181818
24738,/images/78a5d1c3-44dd-44bc-ad5b-5e25bdcc4fae.png,1093,909,1192,1022,99,113,red blood cell,11187,1.1414141414141414,0.8761061946902655
73739,/images/22cbf509-c9bf-46ec-bfce-f079c6b76c8c.png,876,1040,1001,1162,125,122,red blood cell,15250,0.976,1.0245901639344261
30828,/images/93a306b8-594a-4c7f-8b4a-127fb6ad8f1a.png,976,544,1102,655,126,111,red blood cell,13986,0.8809523809523809,1.135135135135135
25820,/images/14b68d86-ac7f-419d-b4a5-6b0b1d9aaa18.png,975,697,1067,784,92,87,red blood cell,8004,0.9456521739130435,1.0574712643678161
17102,/images/883b726a-f61c-4382-9f1b-2fff302beba6.png,546,464,685,583,139,119,red blood cell,16541,0.8561151079136691,1.1680672268907564
68999,/images/b5246b58-6f40-4c9e-8024-f49b0ed6bdbd.png,621,151,723,241,102,90,red blood cell,9180,0.8823529411764706,1.1333333333333333
34586,/images/a0eedcb9-b85c-4612-b945-7e8227f53c35.png,1044,434,1164,559,120,125,red blood cell,15000,1.0416666666666667,0.96
78548,/images/c5084fb8-2b62-464c-8a77-1a07ea653266.png,442,1435,557,1549,115,114,red blood cell,13110,0.991304347826087,1.0087719298245614
32084,/images/b8a4d467-c40c-4ebf-91dd-1c19d0f2a7ae.png,854,834,950,930,96,96,red blood cell,9216,1.0,1.0
23137,/images/c94a5851-b846-4fde-8c89-05bec3a8ac53.png,951,1004,1056,1114,105,110,red blood cell,11550,1.0476190476190477,0.9545454545454546
49780,/images/5e17f8e6-fd8d-426c-b444-1515d14f04b7.png,409,700,502,803,93,103,red blood cell,9579,1.10752688172043,0.9029126213592233
29582,/images/42845335-4ab2-4963-806d-0985d1382a31.png,453,1166,566,1277,113,111,red blood cell,12543,0.9823008849557522,1.018018018018018
47936,/images/ab27173b-6e30-4957-bd68-29194328fd39.png,514,208,605,313,91,105,red blood cell,9555,1.1538461538461537,0.8666666666666667
39989,/images/8271d0d8-9985-43eb-94b3-c702adca139f.png,149,628,254,732,105,104,red blood cell,10920,0.9904761904761905,1.0096153846153846
42860,/images/a7b6894d-eeea-4ed5-bc0e-785d6c6da8df.png,938,149,1064,274,126,125,red blood cell,15750,0.9920634920634921,1.008
30425,/images/dedbb10c-43f1-45fb-bb40-3ce2fb874015.png,650,1288,767,1399,117,111,red blood cell,12987,0.9487179487179487,1.054054054054054
44332,/images/b197093e-2928-46a4-8e35-fa5ea7ea6dac.png,342,1412,478,1536,136,124,red blood cell,16864,0.9117647058823529,1.096774193548387
57705,/images/5c037ffc-f515-48b3-b231-c110fbd2b8ca.png,986,568,1112,685,126,117,red blood cell,14742,0.9285714285714286,1.0769230769230769
52426,/images/a2a20600-f851-4db7-90f9-6f7be027c8b5.png,775,673,868,782,93,109,red blood cell,10137,1.1720430107526882,0.8532110091743119
79105,/images/1c90231b-2830-42d9-884e-7301edb16933.png,760,34,854,130,94,96,red blood cell,9024,1.0212765957446808,0.9791666666666666
26609,/images/5893e081-04f2-4e33-9851-bed5f0e4d333.png,1063,299,1170,425,107,126,red blood cell,13482,1.1775700934579438,0.8492063492063492
52109,/images/de6d3020-9347-473b-9146-8909627790f6.png,491,191,574,280,83,89,red blood cell,7387,1.072289156626506,0.9325842696629213
67287,/images/49c4dbd3-6269-4d4c-9648-a2146c57bab1.png,945,1183,1050,1288,105,105,red blood cell,11025,1.0,1.0
40808,/images/252071ac-e9f2-41d2-abbb-87ef01b8a997.png,188,894,270,992,82,98,red blood cell,8036,1.1951219512195121,0.8367346938775511
54529,/images/db871d17-28fd-4ceb-b421-e4e4afa0a7a0.png,876,335,985,427,109,92,red blood cell,10028,0.8440366972477065,1.184782608695652
14255,/images/6382976c-ee87-4916-b798-4ef1373b2df0.png,1038,1379,1134,1487,96,108,red blood cell,10368,1.125,0.8888888888888888
50536,/images/e98ea067-82b5-4a0d-87bf-b4bbdc10ddab.png,413,1482,510,1597,97,115,red blood cell,11155,1.1855670103092784,0.8434782608695652
79583,/images/161978c3-3a05-47a5-9fee-be7d25693eae.png,4,1133,114,1237,110,104,red blood cell,11440,0.9454545454545454,1.0576923076923077
47138,/images/3d1b889e-bb4a-4ee6-b899-974ee7d956a7.png,762,489,875,589,113,100,red blood cell,11300,0.8849557522123894,1.13
25328,/images/587e5464-d70b-4279-8562-010279f6efbd.png,454,1334,579,1461,125,127,red blood cell,15875,1.016,0.984251968503937
22641,/images/4ab47131-c2ac-461f-b95c-ac19ce24edbd.png,492,1165,605,1294,113,129,red blood cell,14577,1.1415929203539823,0.875968992248062
12386,/images/3b55c42f-ad59-422f-ba99-4f4f4ca9cb2e.png,837,256,928,354,91,98,red blood cell,8918,1.0769230769230769,0.9285714285714286
33261,/images/5721e41b-90ef-4851-8587-8dc71227ef90.png,379,1397,486,1500,107,103,red blood cell,11021,0.9626168224299065,1.0388349514563107
31398,/images/04fb49a2-07b8-4cdf-b6f7-df5c3688e5f8.png,731,1,833,88,102,87,red blood cell,8874,0.8529411764705882,1.1724137931034482
29280,/images/6274fe0d-0d71-40be-b61b-f0bd5b5df1e2.png,670,1500,763,1598,93,98,red blood cell,9114,1.053763440860215,0.9489795918367347
32263,/images/f4722a74-35e7-42bd-8ef6-dfff04b9cd22.png,418,1027,521,1144,103,117,red blood cell,12051,1.1359223300970873,0.8803418803418803
63995,/images/5e974892-0ebe-4037-8427-ea8616d6d3b8.png,793,932,885,1013,92,81,red blood cell,7452,0.8804347826086957,1.1358024691358024
51694,/images/592c941a-aa54-4971-b499-dc47356f80a3.png,171,1383,267,1476,96,93,red blood cell,8928,0.96875,1.032258064516129
2926,/images/a1c140f9-75d7-42a3-b767-4c01a118892b.png,449,1289,549,1394,100,105,red blood cell,10500,1.05,0.9523809523809523
10729,/images/20d4f65e-6c63-433a-935c-d568d577967b.png,556,652,660,741,104,89,red blood cell,9256,0.8557692307692307,1.1685393258426966
45782,/images/584d62ed-4329-45dd-94ce-e929d8b2bb74.png,373,921,480,1049,107,128,red blood cell,13696,1.1962616822429906,0.8359375
72563,/images/01b99da8-b66b-464b-a7ee-1cadab8db18b.png,629,279,742,419,113,140,red blood cell,15820,1.238938053097345,0.8071428571428572
39760,/images/5c68070c-3391-4db6-8c01-94175105dbea.png,369,435,477,550,108,115,red blood cell,12420,1.0648148148148149,0.9391304347826087
38777,/images/b426ef1d-4a59-4f90-b593-50226af60a60.png,720,1429,824,1535,104,106,red blood cell,11024,1.0192307692307692,0.9811320754716981
4722,/images/3fa1a4e3-c80d-49da-8f7b-a1abb0424f48.png,536,927,657,1032,121,105,red blood cell,12705,0.8677685950413223,1.1523809523809523
53608,/images/7bcd3735-3134-46d1-8ca2-d4379f2d51c0.png,263,35,367,131,104,96,red blood cell,9984,0.9230769230769231,1.0833333333333333
35972,/images/5836500a-221e-40ca-a8be-caaa37f7d300.png,437,963,542,1072,105,109,red blood cell,11445,1.0380952380952382,0.963302752293578
74869,/images/81edcae1-65bf-4752-b0e4-494376b71e49.png,656,330,739,415,83,85,red blood cell,7055,1.0240963855421688,0.9764705882352941
62985,/images/f234a2de-f3c8-4521-a306-8cfdf52dd597.png,275,1461,367,1554,92,93,red blood cell,8556,1.0108695652173914,0.989247311827957
2422,/images/fe851c88-692d-4199-87e0-d19d9c4eb591.png,389,306,482,411,93,105,red blood cell,9765,1.1290322580645162,0.8857142857142857
742,/images/dcc1a193-7b74-44f8-ad8d-813751d8fa6b.png,395,414,501,537,106,123,red blood cell,13038,1.1603773584905661,0.8617886178861789
36497,/images/bd856928-96ee-4fc4-a377-f2fc4e84448b.png,60,284,176,394,116,110,red blood cell,12760,0.9482758620689655,1.0545454545454545
48616,/images/55836297-fc8e-4e00-9767-0d12b86e4604.png,95,512,194,622,99,110,red blood cell,10890,1.1111111111111112,0.9
70496,/images/8cca114a-ed05-4b87-95b7-fae02487f08c.png,346,1404,443,1503,97,99,red blood cell,9603,1.0206185567010309,0.9797979797979798
39523,/images/5a631871-2fc7-4a68-9c39-f3b9a0bf4a04.png,1081,34,1181,148,100,114,red blood cell,11400,1.14,0.8771929824561403
78342,/images/24115f58-a7d6-4022-a95a-86b515a78d3e.png,959,847,1074,947,115,100,red blood cell,11500,0.8695652173913043,1.15
11812,/images/3cdcb09b-6a8c-43ca-b1d0-c1a289202f65.png,253,573,358,688,105,115,red blood cell,12075,1.0952380952380953,0.9130434782608695
61538,/images/4a717a39-80f8-4b75-a25e-c46d65d7dcd5.png,705,387,815,496,110,109,red blood cell,11990,0.990909090909091,1.0091743119266054
19921,/images/0ca25c88-457f-4f03-bbc1-98fb6663f1d1.png,886,619,983,725,97,106,red blood cell,10282,1.092783505154639,0.9150943396226415
77279,/images/07a80340-f65e-4f58-9317-94bb6ebd5a28.png,159,1185,242,1270,83,85,red blood cell,7055,1.0240963855421688,0.9764705882352941
76362,/images/3dad6483-ac30-4d2b-b045-9f24fe6ff75e.png,446,1379,537,1467,91,88,red blood cell,8008,0.967032967032967,1.0340909090909092
56078,/images/ffb7be9a-65df-4f0b-99ae-cfd34e81cd34.png,694,777,803,888,109,111,red blood cell,12099,1.018348623853211,0.9819819819819819
73291,/images/67a4fb91-6f38-4ca2-8f20-6b2f5f1b29a7.png,808,1394,904,1499,96,105,red blood cell,10080,1.09375,0.9142857142857143
37073,/images/b2e34f5f-904e-4473-9dc7-c6bc1ce12640.png,121,583,219,693,98,110,red blood cell,10780,1.1224489795918366,0.8909090909090909
40706,/images/252071ac-e9f2-41d2-abbb-87ef01b8a997.png,197,257,309,360,112,103,red blood cell,11536,0.9196428571428571,1.087378640776699
53204,/images/d8f7e159-b7e3-49e4-86e8-aed8c5fbcd97.png,391,1448,476,1534,85,86,red blood cell,7310,1.011764705882353,0.9883720930232558
36480,/images/cfe6086f-eb0b-4cb0-a430-8cd7de6556e2.png,900,1484,995,1595,95,111,red blood cell,10545,1.168421052631579,0.8558558558558559
37634,/images/205306da-0ed8-475a-ace6-f2f81d4be88a.png,208,78,283,167,75,89,red blood cell,6675,1.1866666666666668,0.8426966292134831
39908,/images/71cf2467-77d3-4fac-ac6e-1d8767717c34.png,560,1,687,136,127,135,red blood cell,17145,1.062992125984252,0.9407407407407408
67133,/images/4272cbd7-5b0a-4bf7-b690-dee1c128f07b.png,635,1356,723,1443,88,87,red blood cell,7656,0.9886363636363636,1.0114942528735633
20955,/images/c2ec116f-f091-422c-926c-70b548a8f6ef.png,151,962,249,1051,98,89,red blood cell,8722,0.9081632653061225,1.101123595505618
20763,/images/eeac81a5-9202-4965-b7de-35b12910cdf6.png,321,584,440,715,119,131,red blood cell,15589,1.1008403361344539,0.9083969465648855
60312,/images/7abc0d26-dd66-4ef4-8c4e-4a661e589a7f.png,890,4,985,92,95,88,red blood cell,8360,0.9263157894736842,1.0795454545454546
7290,/images/89f10192-d3dd-4996-a571-4c851dbdc983.png,898,953,990,1050,92,97,red blood cell,8924,1.0543478260869565,0.9484536082474226
10198,/images/e3ea07d7-884a-412e-874a-40fd6b856736.png,1072,1450,1177,1568,105,118,red blood cell,12390,1.1238095238095238,0.8898305084745762
9411,/images/e3a4b3e7-9500-4b6c-a402-b6d3f45e714b.png,937,1248,1065,1365,128,117,red blood cell,14976,0.9140625,1.0940170940170941
57085,/images/7d041c38-11f2-4186-8a24-29d7d0f5c3cf.png,916,1216,1005,1302,89,86,red blood cell,7654,0.9662921348314607,1.0348837209302326
14966,/images/5d1418d3-1559-4725-ad4a-9afb6eaecdfd.png,659,1012,773,1132,114,120,red blood cell,13680,1.0526315789473684,0.95
49151,/images/df3d98b9-3dd7-4107-8d4a-ae1b7f247793.png,661,247,748,340,87,93,red blood cell,8091,1.0689655172413792,0.9354838709677419
60624,/images/724e0c34-32cd-41f1-ae37-586038bc67ab.png,605,1039,691,1122,86,83,red blood cell,7138,0.9651162790697675,1.036144578313253
46375,/images/fcc2b245-f47f-447f-8527-275b0005677c.png,682,864,810,980,128,116,red blood cell,14848,0.90625,1.103448275862069
18736,/images/f6f8a69a-3fd2-4684-ac77-3e83ea0fb36d.png,698,558,830,681,132,123,red blood cell,16236,0.9318181818181818,1.0731707317073171
36346,/images/4a0a05e1-11ad-4bfc-bfa3-adf3b9bd0b56.png,402,1259,504,1359,102,100,red blood cell,10200,0.9803921568627451,1.02
33215,/images/877d5e7f-19b6-40e7-81bd-c92f25e72503.png,835,1048,957,1159,122,111,red blood cell,13542,0.9098360655737705,1.0990990990990992
65106,/images/5e042380-6ef2-496f-8231-0ca550fbfa71.png,17,773,113,889,96,116,red blood cell,11136,1.2083333333333333,0.8275862068965517
75169,/images/7fdc8be8-7579-4a5c-b369-8a07ee0a8b7d.png,160,455,252,560,92,105,red blood cell,9660,1.141304347826087,0.8761904761904762
5598,/images/75c243e2-610d-4d5a-bc5a-4c53d99d9ae9.png,713,808,818,916,105,108,red blood cell,11340,1.0285714285714285,0.9722222222222222
45785,/images/584d62ed-4329-45dd-94ce-e929d8b2bb74.png,494,837,580,910,86,73,red blood cell,6278,0.8488372093023255,1.178082191780822
50769,/images/db0a1123-0b35-48d7-8337-3b1ebd6af0cc.png,270,1012,379,1127,109,115,red blood cell,12535,1.055045871559633,0.9478260869565217
19765,/images/68e69cfb-1a07-48d2-8abe-46b46fe264ed.png,94,937,210,1064,116,127,red blood cell,14732,1.0948275862068966,0.9133858267716536
38901,/images/d79b4e90-c45d-4f5d-a498-49c3e323c291.png,227,1267,325,1375,98,108,red blood cell,10584,1.1020408163265305,0.9074074074074074
14475,/images/3b13e20f-ec0d-44ec-b2f4-eaebfa09150e.png,646,807,739,913,93,106,red blood cell,9858,1.1397849462365592,0.8773584905660378
1912,/images/02ea7aa8-c142-4a3d-939f-e77689741341.png,915,565,1029,675,114,110,red blood cell,12540,0.9649122807017544,1.0363636363636364
54340,/images/19370afd-f897-47d8-bfae-c0d257bbf795.png,515,544,632,657,117,113,red blood cell,13221,0.9658119658119658,1.0353982300884956
25534,/images/f6ab936d-924b-4038-aa47-71b07c26b4e2.png,27,1026,136,1138,109,112,red blood cell,12208,1.0275229357798166,0.9732142857142857
34976,/images/2b369d75-9c55-43e0-b352-d981aea544e3.png,578,91,699,221,121,130,red blood cell,15730,1.0743801652892562,0.9307692307692308
19072,/images/6e39fb0a-aa41-4b16-b783-7589e97bf289.png,665,196,780,333,115,137,red blood cell,15755,1.191304347826087,0.8394160583941606
48760,/images/fed6ba05-36a5-45dc-a4e1-9baa7de2c622.png,811,290,927,391,116,101,red blood cell,11716,0.8706896551724138,1.1485148514851484
55533,/images/a27b451d-44a6-4740-861a-9e7e99915563.png,11,186,126,307,115,121,red blood cell,13915,1.0521739130434782,0.9504132231404959
54782,/images/b6364a57-72a9-43f3-8d02-9f53a992dc95.png,165,320,262,419,97,99,red blood cell,9603,1.0206185567010309,0.9797979797979798
55834,/images/68f34a9c-f73d-4238-8f55-4b05a8a2154c.png,222,1155,305,1250,83,95,red blood cell,7885,1.144578313253012,0.8736842105263158
24085,/images/505355c9-23bf-4f90-8ebc-6a7ef50964d0.png,314,83,424,195,110,112,red blood cell,12320,1.018181818181818,0.9821428571428571
33290,/images/5721e41b-90ef-4851-8587-8dc71227ef90.png,292,123,418,267,126,144,red blood cell,18144,1.1428571428571428,0.875
58752,/images/e4827c85-311a-4df1-89c2-99dad0c3558c.png,33,752,112,829,79,77,red blood cell,6083,0.9746835443037974,1.025974025974026
6761,/images/672e4ecf-a56b-462e-b83b-76f4efaa6634.png,120,849,227,962,107,113,red blood cell,12091,1.0560747663551402,0.9469026548672567
24322,/images/4d8a4ce8-0f9c-4f21-8844-4cf0e5514bbf.png,636,748,734,830,98,82,red blood cell,8036,0.8367346938775511,1.1951219512195121
61527,/images/7e837856-3519-4dc0-b357-4cdcfd30b4eb.png,863,963,963,1061,100,98,red blood cell,9800,0.98,1.0204081632653061
17053,/images/57e1879e-4294-45e7-9c1b-627e8cca0271.png,307,1074,419,1198,112,124,red blood cell,13888,1.1071428571428572,0.9032258064516129
29941,/images/f2a8a483-b254-43aa-817f-7d525adb8911.png,233,1118,357,1247,124,129,red blood cell,15996,1.0403225806451613,0.9612403100775194
57131,/images/7d041c38-11f2-4186-8a24-29d7d0f5c3cf.png,279,350,370,432,91,82,red blood cell,7462,0.9010989010989011,1.1097560975609757
13270,/images/030f3421-ed3f-4bf1-8f27-4d02590bffbc.png,757,911,855,1014,98,103,red blood cell,10094,1.0510204081632653,0.9514563106796117
13997,/images/eaf4b781-b3aa-41ce-8c5e-287979b4e15a.png,203,153,314,280,111,127,red blood cell,14097,1.1441441441441442,0.8740157480314961
50448,/images/a2de1248-7bc0-44dc-b508-70a357eedd68.png,350,239,441,344,91,105,red blood cell,9555,1.1538461538461537,0.8666666666666667
15569,/images/169d541c-daed-468e-8b41-0f1abccdf319.png,522,1211,629,1327,107,116,red blood cell,12412,1.0841121495327102,0.9224137931034483
8682,/images/92e4fd7b-79ef-49c2-a52b-9ef13dd720ef.png,15,245,121,355,106,110,red blood cell,11660,1.0377358490566038,0.9636363636363636
49951,/images/05804cf0-f854-4099-97c2-df287f7c8a8c.png,562,1057,696,1168,134,111,red blood cell,14874,0.8283582089552238,1.2072072072072073
41864,/images/783ae4ad-6a35-4b3c-b19f-754974b67b2d.png,239,1117,356,1241,117,124,red blood cell,14508,1.0598290598290598,0.9435483870967742
22380,/images/78c35732-7e31-4153-842e-55ab1cd656f6.png,201,267,288,356,87,89,red blood cell,7743,1.0229885057471264,0.9775280898876404
59907,/images/1519257c-e3e5-4474-908f-8665b3cf1258.png,796,461,877,559,81,98,red blood cell,7938,1.2098765432098766,0.826530612244898
41609,/images/0fcd1ebe-ee4a-40a0-b787-29cee18bfa1b.png,359,274,456,368,97,94,red blood cell,9118,0.9690721649484536,1.0319148936170213
52841,/images/58f7e1da-3478-48f4-958c-e9b1cb8696aa.png,885,1005,998,1110,113,105,red blood cell,11865,0.9292035398230089,1.0761904761904761
41564,/images/0fcd1ebe-ee4a-40a0-b787-29cee18bfa1b.png,387,1038,473,1116,86,78,red blood cell,6708,0.9069767441860465,1.1025641025641026
18969,/images/e9e78ff8-831b-46e9-9785-3eee9acbfcd8.png,498,777,585,866,87,89,red blood cell,7743,1.0229885057471264,0.9775280898876404
13100,/images/711f6b3f-cd63-46d1-834a-bc8e9aa9b43e.png,197,1386,290,1493,93,107,red blood cell,9951,1.1505376344086022,0.8691588785046729
58241,/images/319c9c52-f316-49f3-baad-4444ab19f85b.png,885,12,990,120,105,108,red blood cell,11340,1.0285714285714285,0.9722222222222222
35190,/images/a9159b11-ba49-4885-902e-00c8d5095b98.png,1063,1114,1164,1213,101,99,red blood cell,9999,0.9801980198019802,1.02020202020202
60381,/images/1c87b997-a8e6-48ca-bf40-19b9a7fd6a96.png,628,0,720,79,92,79,red blood cell,7268,0.8586956521739131,1.1645569620253164
30152,/images/a1669b59-fe09-4fe6-ba9f-06bec6725502.png,1039,350,1148,456,109,106,red blood cell,11554,0.9724770642201835,1.028301886792453
44096,/images/8b494b40-cab5-49d3-893d-c805000fbe88.png,383,1034,516,1164,133,130,red blood cell,17290,0.9774436090225563,1.023076923076923
25791,/images/14b68d86-ac7f-419d-b4a5-6b0b1d9aaa18.png,522,1046,640,1151,118,105,red blood cell,12390,0.8898305084745762,1.1238095238095238
23609,/images/79d7a014-21ff-40f1-9ac4-a69839390654.png,1,1324,112,1425,111,101,red blood cell,11211,0.9099099099099099,1.099009900990099
9372,/images/e3a4b3e7-9500-4b6c-a402-b6d3f45e714b.png,158,60,281,173,123,113,red blood cell,13899,0.9186991869918699,1.0884955752212389
62471,/images/7dfbfeaf-e3b1-4159-8dcd-d7f731280ac8.png,704,413,811,513,107,100,red blood cell,10700,0.9345794392523364,1.07
48091,/images/05717db9-f1ef-4101-a9f7-7a007e83b1c9.png,759,290,858,393,99,103,red blood cell,10197,1.0404040404040404,0.9611650485436893
51984,/images/4f62b14e-c6f4-4155-8f50-881558f83fae.png,719,1303,805,1396,86,93,red blood cell,7998,1.0813953488372092,0.9247311827956989
66040,/images/c8af0297-ce1f-40ea-bf44-9256dcdae4e9.png,250,927,372,1035,122,108,red blood cell,13176,0.8852459016393442,1.1296296296296295
29595,/images/42845335-4ab2-4963-806d-0985d1382a31.png,809,912,929,1047,120,135,red blood cell,16200,1.125,0.8888888888888888
75598,/images/c35ee701-fde2-46b5-b178-1fe3f1ea7da2.png,669,367,782,469,113,102,red blood cell,11526,0.9026548672566371,1.107843137254902
12096,/images/984caf56-f400-4a29-be97-a4d6b9d1468d.png,921,431,1060,558,139,127,red blood cell,17653,0.9136690647482014,1.094488188976378
51315,/images/216f9d43-6869-4ba1-9106-4f5ea6aac223.png,533,1507,628,1598,95,91,red blood cell,8645,0.9578947368421052,1.043956043956044
28711,/images/151f3af5-5e6e-4bcd-9389-4974fc68813e.png,699,1265,790,1355,91,90,red blood cell,8190,0.989010989010989,1.011111111111111
60798,/images/645cd195-af50-409f-8da9-6e7c7f18ea09.png,278,1192,390,1318,112,126,red blood cell,14112,1.125,0.8888888888888888
67565,/images/59542a24-b409-4c95-8608-d9691a741526.png,287,1465,393,1568,106,103,red blood cell,10918,0.9716981132075472,1.029126213592233
50044,/images/b1145408-feae-4637-b4cf-3e70b99cc62d.png,353,1423,442,1522,89,99,red blood cell,8811,1.1123595505617978,0.898989898989899
4832,/images/c6ab535c-30e5-4b6b-8273-1ec8d78cdd13.png,271,785,396,918,125,133,red blood cell,16625,1.064,0.9398496240601504
71483,/images/191071ab-6515-428c-9f05-8e4309542b75.png,809,1193,898,1293,89,100,red blood cell,8900,1.1235955056179776,0.89
13697,/images/0b04ec46-5119-4cda-8c35-c4e5b6f0eed0.png,703,303,803,418,100,115,red blood cell,11500,1.15,0.8695652173913043
439,/images/84c88143-940d-4b62-bbd2-7acc4cadcb6b.png,440,180,551,281,111,101,red blood cell,11211,0.9099099099099099,1.099009900990099
31833,/images/f62d4fb6-df7c-446c-94a8-d5aede0b1e0c.png,1000,1122,1101,1233,101,111,red blood cell,11211,1.099009900990099,0.9099099099099099
79821,/images/fc15659f-6264-4dd5-ab17-43d89fb297b9.png,690,66,795,188,105,122,red blood cell,12810,1.161904761904762,0.860655737704918
46150,/images/d8632217-ec33-4d0a-98e6-427824c58869.png,879,1168,995,1289,116,121,red blood cell,14036,1.043103448275862,0.9586776859504132
77862,/images/6bc7b53c-5a98-48ef-a9de-59a476707ea4.png,9,1478,126,1582,117,104,red blood cell,12168,0.8888888888888888,1.125
59251,/images/03c8da48-04b9-4520-b674-44a0ecd35688.png,992,230,1113,346,121,116,red blood cell,14036,0.9586776859504132,1.043103448275862
69835,/images/2bd15b6e-fe2d-49f3-b394-940d024d1f91.png,699,690,772,772,73,82,red blood cell,5986,1.1232876712328768,0.8902439024390244
35577,/images/a1ff36df-71df-4e6e-a65f-ced9a2b381c3.png,774,1245,885,1353,111,108,red blood cell,11988,0.972972972972973,1.0277777777777777
14523,/images/458cb2e9-5a7f-437c-ac5d-a56f98a3efdf.png,347,105,463,206,116,101,red blood cell,11716,0.8706896551724138,1.1485148514851484
71980,/images/6ad3efc9-4392-4cee-98a5-186564a96373.png,521,1317,641,1434,120,117,red blood cell,14040,0.975,1.0256410256410255
70348,/images/90246988-0d6d-4bf8-8a76-94107de4121e.png,493,1083,569,1174,76,91,red blood cell,6916,1.1973684210526316,0.8351648351648352
17409,/images/6f4ffe7b-395f-41ea-ad61-df5e0cbd531c.png,268,1175,404,1289,136,114,red blood cell,15504,0.8382352941176471,1.1929824561403508
39649,/images/04d21589-b777-43c2-86b5-038cbf8c3a4e.png,824,997,917,1098,93,101,red blood cell,9393,1.086021505376344,0.9207920792079208
17015,/images/57e1879e-4294-45e7-9c1b-627e8cca0271.png,836,691,962,806,126,115,red blood cell,14490,0.9126984126984127,1.0956521739130434
37338,/images/4d88e2d2-5aad-410c-9bbc-702ee9496995.png,279,145,400,270,121,125,red blood cell,15125,1.0330578512396693,0.968
56070,/images/ffb7be9a-65df-4f0b-99ae-cfd34e81cd34.png,764,960,875,1074,111,114,red blood cell,12654,1.027027027027027,0.9736842105263158
46097,/images/72088c26-d2dd-4906-b791-b8947fc7fbe4.png,1060,663,1170,756,110,93,red blood cell,10230,0.8454545454545455,1.1827956989247312
22337,/images/78c35732-7e31-4153-842e-55ab1cd656f6.png,658,373,752,466,94,93,red blood cell,8742,0.9893617021276596,1.010752688172043
50067,/images/e98baeb2-aa58-4cce-8c61-66685dd2b239.png,707,1441,812,1557,105,116,red blood cell,12180,1.1047619047619048,0.9051724137931034
74195,/images/4e43fc22-dc08-4cde-b3ce-ce8a4f377c47.png,409,429,515,545,106,116,red blood cell,12296,1.0943396226415094,0.9137931034482759
28754,/images/151f3af5-5e6e-4bcd-9389-4974fc68813e.png,486,1,591,85,105,84,red blood cell,8820,0.8,1.25
32320,/images/1c406ce1-023b-47fc-a2cd-5ea2e255de65.png,220,1455,355,1577,135,122,red blood cell,16470,0.9037037037037037,1.1065573770491803
74554,/images/bbedfcbe-9528-4ba9-9d86-4ebba7589ac5.png,728,637,842,749,114,112,red blood cell,12768,0.9824561403508771,1.0178571428571428
16641,/images/bc377041-e098-45c4-9651-2b1ea90d1d7e.png,22,1158,137,1283,115,125,red blood cell,14375,1.0869565217391304,0.92
60066,/images/e63e1607-f344-43d6-a0d8-e10cf2e5054a.png,823,509,929,623,106,114,red blood cell,12084,1.0754716981132075,0.9298245614035088
57296,/images/aaade430-4c49-4038-97b7-f8cdd937db57.png,372,199,496,323,124,124,red blood cell,15376,1.0,1.0
18751,/images/f6f8a69a-3fd2-4684-ac77-3e83ea0fb36d.png,891,961,1014,1091,123,130,red blood cell,15990,1.056910569105691,0.9461538461538461
36679,/images/21f001d6-f568-4ea4-82da-fab54c77c419.png,540,1374,636,1468,96,94,red blood cell,9024,0.9791666666666666,1.0212765957446808
79056,/images/036e008f-07a1-4e92-899d-1822dc390ccb.png,247,555,350,673,103,118,red blood cell,12154,1.145631067961165,0.8728813559322034
64478,/images/34a70114-d3e3-4351-b8db-f6caab17e743.png,142,1017,226,1105,84,88,red blood cell,7392,1.0476190476190477,0.9545454545454546
848,/images/c7a2d648-47cb-4b39-afa4-1b7fcfe51934.png,36,83,147,219,111,136,red blood cell,15096,1.2252252252252251,0.8161764705882353
13081,/images/9691c57a-ccf8-47f9-a8e9-9a324974585b.png,660,1157,788,1263,128,106,red blood cell,13568,0.828125,1.2075471698113207
19678,/images/627d6331-7bb9-4d1a-b20d-e6541af4d0f9.png,996,860,1129,985,133,125,red blood cell,16625,0.9398496240601504,1.064
62174,/images/a72cd558-b7ac-4bf2-a344-2ce6c73a354e.png,355,868,466,977,111,109,red blood cell,12099,0.9819819819819819,1.018348623853211
35106,/images/a6ba808f-ec60-42a5-ad91-7b32412ab708.png,753,74,857,191,104,117,red blood cell,12168,1.125,0.8888888888888888
55637,/images/c32b8bb8-c89d-4ae9-9c77-5b9356ca35a1.png,6,392,127,517,121,125,red blood cell,15125,1.0330578512396693,0.968
26314,/images/d33bc9fc-3444-4f26-8082-307f9fccc52b.png,694,190,835,309,141,119,red blood cell,16779,0.8439716312056738,1.184873949579832
75903,/images/3006096f-ceeb-42be-b69e-785179d7438b.png,754,569,862,662,108,93,red blood cell,10044,0.8611111111111112,1.1612903225806452
31765,/images/ab59c9e4-3e50-48b9-874d-060d317410cc.png,229,959,357,1084,128,125,red blood cell,16000,0.9765625,1.024
71988,/images/6ad3efc9-4392-4cee-98a5-186564a96373.png,685,143,787,245,102,102,red blood cell,10404,1.0,1.0
35835,/images/bb2042c5-35e1-43cc-8171-7de81b764361.png,1108,57,1196,139,88,82,red blood cell,7216,0.9318181818181818,1.0731707317073171
67779,/images/48e2f0bd-2164-40c3-af43-1f2708359978.png,935,1178,1017,1267,82,89,red blood cell,7298,1.0853658536585367,0.9213483146067416
21720,/images/f68ae8e9-e760-4106-88e0-4bdef2785f06.png,389,753,505,881,116,128,red blood cell,14848,1.103448275862069,0.90625
54476,/images/22a464ef-c3da-4d56-b37e-e22e95d945e7.png,836,1228,927,1320,91,92,red blood cell,8372,1.010989010989011,0.9891304347826086
18702,/images/f6f8a69a-3fd2-4684-ac77-3e83ea0fb36d.png,182,523,302,647,120,124,red blood cell,14880,1.0333333333333334,0.967741935483871
36571,/images/21f001d6-f568-4ea4-82da-fab54c77c419.png,690,1408,794,1512,104,104,red blood cell,10816,1.0,1.0
63777,/images/06401963-8b02-46c5-ab2a-3d70bd01623f.png,7,1464,107,1568,100,104,red blood cell,10400,1.04,0.9615384615384616
49867,/images/5e17f8e6-fd8d-426c-b444-1515d14f04b7.png,853,1406,965,1520,112,114,red blood cell,12768,1.0178571428571428,0.9824561403508771
75225,/images/61dfc937-a428-44b4-94fb-d682bdb8dff0.png,979,70,1086,169,107,99,red blood cell,10593,0.9252336448598131,1.0808080808080809
45654,/images/584d62ed-4329-45dd-94ce-e929d8b2bb74.png,7,43,117,155,110,112,red blood cell,12320,1.018181818181818,0.9821428571428571
37360,/images/08f5a524-0554-49c2-83a8-ae9a6d51e8fd.png,425,1395,538,1507,113,112,red blood cell,12656,0.9911504424778761,1.0089285714285714
49665,/images/9842445c-5899-4189-9f2e-3a3a179fdad3.png,571,215,686,337,115,122,red blood cell,14030,1.0608695652173914,0.9426229508196722
47367,/images/477e541c-0519-4542-9b13-8ee7922644d3.png,869,742,985,847,116,105,red blood cell,12180,0.9051724137931034,1.1047619047619048
60334,/images/1c87b997-a8e6-48ca-bf40-19b9a7fd6a96.png,511,213,614,327,103,114,red blood cell,11742,1.1067961165048543,0.9035087719298246
12746,/images/b634137b-bc8b-4e88-b0e3-b536ad6e7e18.png,144,688,243,780,99,92,red blood cell,9108,0.9292929292929293,1.076086956521739
26352,/images/ef1419e0-3a3a-458a-b3b2-7efddac50404.png,1,974,118,1089,117,115,red blood cell,13455,0.9829059829059829,1.017391304347826
60846,/images/0ab56f9a-846d-49e2-a617-c6cc477fdfad.png,245,227,376,363,131,136,red blood cell,17816,1.0381679389312977,0.9632352941176471
60695,/images/45651e76-4bd0-45e5-895b-edec65f51987.png,1067,503,1179,611,112,108,red blood cell,12096,0.9642857142857143,1.037037037037037
47884,/images/ab27173b-6e30-4957-bd68-29194328fd39.png,804,1070,908,1183,104,113,red blood cell,11752,1.0865384615384615,0.9203539823008849
34080,/images/de5d19b7-e670-4ac7-843b-7ce7bcebdf45.png,375,1210,494,1340,119,130,red blood cell,15470,1.0924369747899159,0.9153846153846154
59344,/images/565513be-2c20-4ee3-94f3-093869515d3d.png,819,1417,921,1513,102,96,red blood cell,9792,0.9411764705882353,1.0625
50694,/images/6b4c79f5-b194-4586-be9f-e339c5af4188.png,126,358,243,486,117,128,red blood cell,14976,1.0940170940170941,0.9140625
70171,/images/b338766f-19b9-4874-bcc5-ae22b3c533e6.png,469,827,562,928,93,101,red blood cell,9393,1.086021505376344,0.9207920792079208
51668,/images/592c941a-aa54-4971-b499-dc47356f80a3.png,643,1262,756,1381,113,119,red blood cell,13447,1.0530973451327434,0.9495798319327731
21921,/images/d57b3894-c912-47e8-b00a-e1a2a7aba644.png,303,342,425,464,122,122,red blood cell,14884,1.0,1.0
76161,/images/16244280-6c74-47d3-b544-9fd6831a6bf9.png,296,1454,405,1558,109,104,red blood cell,11336,0.9541284403669725,1.0480769230769231
3574,/images/25132962-ff5d-4737-995f-c54d8490539b.png,567,134,664,239,97,105,red blood cell,10185,1.0824742268041236,0.9238095238095239
16565,/images/69565501-6e77-4f40-bd80-caa3dda34d8b.png,796,70,924,192,128,122,red blood cell,15616,0.953125,1.0491803278688525
47957,/images/eba73bff-fbe1-436d-9a5f-0a61331a0ea2.png,37,1268,149,1368,112,100,red blood cell,11200,0.8928571428571429,1.12
43676,/images/a4851ed0-1499-4eae-9157-dcd34773254f.png,372,579,486,696,114,117,red blood cell,13338,1.0263157894736843,0.9743589743589743
44398,/images/edd3862f-04e1-49cf-97dd-ca566d17e71a.png,339,309,451,418,112,109,red blood cell,12208,0.9732142857142857,1.0275229357798166
50281,/images/3d32a988-449d-4d58-b71f-abbfdc3f2fbc.png,642,850,736,967,94,117,red blood cell,10998,1.2446808510638299,0.8034188034188035
6206,/images/effd6334-516f-4d48-9f3c-5272a99780fb.png,649,173,766,292,117,119,red blood cell,13923,1.017094017094017,0.9831932773109243
32369,/images/a6526894-e290-482d-ac43-f1df34864817.png,986,513,1102,632,116,119,red blood cell,13804,1.0258620689655173,0.9747899159663865
64088,/images/0d3c2521-da55-4df5-bf06-56b3bd4fb2fc.png,581,544,680,656,99,112,red blood cell,11088,1.1313131313131313,0.8839285714285714
35562,/images/a1ff36df-71df-4e6e-a65f-ced9a2b381c3.png,820,459,939,564,119,105,red blood cell,12495,0.8823529411764706,1.1333333333333333
47769,/images/6b5ed184-cb15-4d54-93bb-9a3ca00184a1.png,1022,174,1133,300,111,126,red blood cell,13986,1.135135135135135,0.8809523809523809
42071,/images/46a03374-64c7-49ac-81c9-c3d62542bbf3.png,155,985,247,1074,92,89,red blood cell,8188,0.967391304347826,1.0337078651685394
58420,/images/7eae1169-e294-4594-8e03-1366d23ff2d1.png,460,80,563,185,103,105,red blood cell,10815,1.0194174757281553,0.9809523809523809
49839,/images/5e17f8e6-fd8d-426c-b444-1515d14f04b7.png,260,695,377,812,117,117,red blood cell,13689,1.0,1.0
79857,/images/a054a8e2-55f2-4508-97df-207f76b89be2.png,418,1093,543,1216,125,123,red blood cell,15375,0.984,1.016260162601626
25712,/images/412c9fa5-fcf4-402b-b1e4-3271f775058e.png,90,511,211,642,121,131,red blood cell,15851,1.0826446280991735,0.9236641221374046
16234,/images/acdc6e12-73d9-44ba-be8c-2a56aaffef4f.png,1000,157,1120,277,120,120,red blood cell,14400,1.0,1.0
65605,/images/01b38a56-13eb-447b-89ee-fc21cb40dcc1.png,51,980,148,1101,97,121,red blood cell,11737,1.2474226804123711,0.8016528925619835
14611,/images/c649e1cb-4029-4433-b231-d67d68f7391a.png,89,223,208,336,119,113,red blood cell,13447,0.9495798319327731,1.0530973451327434
4932,/images/755e5bf8-e8e1-492b-a32f-f7d87cccaa40.png,296,819,419,939,123,120,red blood cell,14760,0.975609756097561,1.025
443,/images/84c88143-940d-4b62-bbd2-7acc4cadcb6b.png,605,371,721,488,116,117,red blood cell,13572,1.0086206896551724,0.9914529914529915
75016,/images/9147a21d-0de2-4c04-88da-b788311696ac.png,1012,612,1120,723,108,111,red blood cell,11988,1.0277777777777777,0.972972972972973
73955,/images/2ae3e6e6-7482-4ab8-ad73-b530b5c2ee3b.png,241,1067,321,1163,80,96,red blood cell,7680,1.2,0.8333333333333334
63302,/images/43bc935a-f655-45e1-a64d-fcb8b78267a6.png,387,588,498,697,111,109,red blood cell,12099,0.9819819819819819,1.018348623853211
40582,/images/29861cf9-9a1e-4733-8309-4bd10706b4a3.png,82,336,202,457,120,121,red blood cell,14520,1.0083333333333333,0.9917355371900827
28774,/images/686ed568-d5f8-475e-81ad-edab9dd473a0.png,1040,1362,1160,1467,120,105,red blood cell,12600,0.875,1.1428571428571428
44510,/images/b6573be3-9e04-49c3-9f48-6a145d065363.png,880,1050,970,1151,90,101,red blood cell,9090,1.1222222222222222,0.8910891089108911
72500,/images/22516db4-8687-4051-90c4-2bb1ca3204a5.png,732,407,846,517,114,110,red blood cell,12540,0.9649122807017544,1.0363636363636364
7680,/images/9f959520-e15e-45c2-bc29-ef3c19154d1c.png,979,804,1089,918,110,114,red blood cell,12540,1.0363636363636364,0.9649122807017544
4951,/images/755e5bf8-e8e1-492b-a32f-f7d87cccaa40.png,35,714,160,821,125,107,red blood cell,13375,0.856,1.1682242990654206
23185,/images/3dcd4f1b-ce43-4a34-b1ed-076bb42963b1.png,700,367,783,468,83,101,red blood cell,8383,1.216867469879518,0.8217821782178217
5624,/images/afa470d9-c74c-41cd-b4dc-7bf93fde8263.png,658,421,770,514,112,93,red blood cell,10416,0.8303571428571429,1.2043010752688172
68532,/images/74261741-4d6e-4dba-8ad4-4fbdf919c30f.png,1012,1103,1106,1184,94,81,red blood cell,7614,0.8617021276595744,1.1604938271604939
62817,/images/631340cc-cedf-4bca-a3d8-a0731a5482b4.png,406,899,504,1007,98,108,red blood cell,10584,1.1020408163265305,0.9074074074074074
30641,/images/f939782b-f5a2-40a3-9c22-6c6d7e18edc3.png,997,1187,1113,1312,116,125,red blood cell,14500,1.0775862068965518,0.928
31440,/images/6695a204-e39c-4418-b904-3f080fdbe7e8.png,781,708,886,819,105,111,red blood cell,11655,1.0571428571428572,0.9459459459459459
36074,/images/ca9626bc-21a4-46f4-ba94-e7ee7a4cf735.png,416,832,534,942,118,110,red blood cell,12980,0.9322033898305084,1.0727272727272728
24841,/images/93f7e207-0d8e-47f8-8258-09a0e03dbdd6.png,836,1281,957,1410,121,129,red blood cell,15609,1.0661157024793388,0.937984496124031
66075,/images/c8af0297-ce1f-40ea-bf44-9256dcdae4e9.png,670,377,777,480,107,103,red blood cell,11021,0.9626168224299065,1.0388349514563107
63833,/images/6013bff0-dc4b-4bde-9409-0f6139c3495c.png,918,1193,1022,1280,104,87,red blood cell,9048,0.8365384615384616,1.1954022988505748
20747,/images/79b3a64f-2fb9-46e0-85d4-2bdd59c2075e.png,716,800,820,899,104,99,red blood cell,10296,0.9519230769230769,1.0505050505050506
11313,/images/2f6224be-50d0-4e85-94ef-88315df561b6.png,1048,447,1174,556,126,109,red blood cell,13734,0.8650793650793651,1.1559633027522935
17687,/images/b5143aae-6e98-4dc6-b546-980cb472de67.png,786,430,889,544,103,114,red blood cell,11742,1.1067961165048543,0.9035087719298246
17431,/images/f329e01b-fbd3-4fb5-9738-a7ff4c8622b8.png,1047,1355,1177,1461,130,106,red blood cell,13780,0.8153846153846154,1.2264150943396226
40070,/images/6fd30823-3b77-40c9-ba5d-e1eda9660674.png,537,837,658,952,121,115,red blood cell,13915,0.9504132231404959,1.0521739130434782
18868,/images/d1b48634-9ad5-46e8-b816-42d1d97c93cd.png,5,348,128,470,123,122,red blood cell,15006,0.991869918699187,1.0081967213114753
62243,/images/a72cd558-b7ac-4bf2-a344-2ce6c73a354e.png,2,969,92,1066,90,97,red blood cell,8730,1.0777777777777777,0.9278350515463918
16633,/images/bc377041-e098-45c4-9651-2b1ea90d1d7e.png,516,1378,624,1502,108,124,red blood cell,13392,1.1481481481481481,0.8709677419354839
10707,/images/20d4f65e-6c63-433a-935c-d568d577967b.png,892,279,987,364,95,85,red blood cell,8075,0.8947368421052632,1.1176470588235294
54706,/images/6473ddb6-ad56-48a2-81e8-c7cb45f06825.png,755,1338,826,1417,71,79,red blood cell,5609,1.1126760563380282,0.8987341772151899
55203,/images/9c5f48c0-0544-4c0c-92b4-59b7d7b7814c.png,581,1430,679,1540,98,110,red blood cell,10780,1.1224489795918366,0.8909090909090909
53970,/images/540a5fee-175b-4b92-bf62-1ea9b59c86c6.png,73,907,165,1022,92,115,red blood cell,10580,1.25,0.8
16071,/images/7e25ced3-5caf-47f8-ad0c-42946bd4468b.png,16,247,123,362,107,115,red blood cell,12305,1.074766355140187,0.9304347826086956
19960,/images/0ca25c88-457f-4f03-bbc1-98fb6663f1d1.png,551,129,664,240,113,111,red blood cell,12543,0.9823008849557522,1.018018018018018
61451,/images/7e837856-3519-4dc0-b357-4cdcfd30b4eb.png,279,1359,390,1476,111,117,red blood cell,12987,1.054054054054054,0.9487179487179487
32729,/images/0154dd8e-72f8-4d78-a4dd-93e139577bd1.png,508,942,629,1058,121,116,red blood cell,14036,0.9586776859504132,1.043103448275862
33653,/images/84ee2ea3-9edd-4672-a1b3-f09c607d833a.png,576,1345,682,1453,106,108,red blood cell,11448,1.0188679245283019,0.9814814814814815
74762,/images/c53fd511-31bd-4901-baac-3b44891f6744.png,504,1121,624,1229,120,108,red blood cell,12960,0.9,1.1111111111111112
69488,/images/664c570b-4822-413c-9724-11b1d91fac44.png,513,747,608,851,95,104,red blood cell,9880,1.0947368421052632,0.9134615384615384
79375,/images/dcb21739-3c36-459d-b3cc-1be5871d6fe7.png,141,1267,246,1376,105,109,red blood cell,11445,1.0380952380952382,0.963302752293578
73017,/images/2bd26501-2fbc-4c1a-bef0-4ad57e02b4d0.png,673,455,790,579,117,124,red blood cell,14508,1.0598290598290598,0.9435483870967742
43320,/images/36569710-a574-40be-ad42-897a6e74a128.png,574,243,695,370,121,127,red blood cell,15367,1.0495867768595042,0.952755905511811
73687,/images/f11d05e4-538a-4024-8711-b08a4ce3c540.png,1078,242,1194,345,116,103,red blood cell,11948,0.8879310344827587,1.1262135922330097
4251,/images/882b91b7-5906-4091-bad4-688d4375eeb5.png,1003,1298,1104,1414,101,116,red blood cell,11716,1.1485148514851484,0.8706896551724138
12116,/images/984caf56-f400-4a29-be97-a4d6b9d1468d.png,100,1491,207,1600,107,109,red blood cell,11663,1.0186915887850467,0.981651376146789
55295,/images/4fb83278-adc5-4424-9f45-b6d0db2955b6.png,769,265,882,380,113,115,red blood cell,12995,1.0176991150442478,0.9826086956521739
28211,/images/c244166d-12ca-445f-9ed9-a13d9caa412f.png,625,949,745,1079,120,130,red blood cell,15600,1.0833333333333333,0.9230769230769231
49402,/images/f2574be3-81c6-4fc3-8a40-0230d1264f52.png,388,744,501,867,113,123,red blood cell,13899,1.0884955752212389,0.9186991869918699
71478,/images/191071ab-6515-428c-9f05-8e4309542b75.png,418,542,519,645,101,103,red blood cell,10403,1.0198019801980198,0.9805825242718447
76909,/images/25ddc1ca-d368-4fff-b1ad-1dbf1e7c97aa.png,508,854,644,964,136,110,red blood cell,14960,0.8088235294117647,1.2363636363636363
31332,/images/31c749e8-18d1-4105-b7e6-8319cceddae0.png,1056,381,1160,497,104,116,red blood cell,12064,1.1153846153846154,0.896551724137931
5576,/images/75c243e2-610d-4d5a-bc5a-4c53d99d9ae9.png,63,1249,198,1371,135,122,red blood cell,16470,0.9037037037037037,1.1065573770491803
24583,/images/c03d9b87-e19b-402b-ad86-b30d6e8aeb59.png,456,1104,558,1208,102,104,red blood cell,10608,1.0196078431372548,0.9807692307692307
12100,/images/984caf56-f400-4a29-be97-a4d6b9d1468d.png,451,1013,595,1143,144,130,red blood cell,18720,0.9027777777777778,1.1076923076923078
26139,/images/27388ff2-4000-4c9a-a2e3-addc448a5f92.png,707,456,831,590,124,134,red blood cell,16616,1.0806451612903225,0.9253731343283582
39833,/images/af2e63a3-9fde-46aa-a867-81c5c259d1dc.png,224,1262,340,1375,116,113,red blood cell,13108,0.9741379310344828,1.0265486725663717
17602,/images/70a95e58-ba60-4c1f-adcd-49c198dc2ba0.png,807,467,900,563,93,96,red blood cell,8928,1.032258064516129,0.96875
63204,/images/f0804a5e-e7f5-4cf2-a5df-b65e66502bf1.png,519,1320,632,1431,113,111,red blood cell,12543,0.9823008849557522,1.018018018018018
6462,/images/640c4a52-3742-4f57-aee3-9e3dc0887622.png,714,408,831,524,117,116,red blood cell,13572,0.9914529914529915,1.0086206896551724
71876,/images/61575482-91e1-4db9-83c7-687b7ddbbfc4.png,1007,673,1095,764,88,91,red blood cell,8008,1.0340909090909092,0.967032967032967
1079,/images/edcb4d77-a4d3-465d-9b59-eb3087766b1c.png,548,1167,669,1292,121,125,red blood cell,15125,1.0330578512396693,0.968
43242,/images/fe1ee954-ba71-47b3-954a-d20ab940cd7b.png,921,1025,1040,1146,119,121,red blood cell,14399,1.0168067226890756,0.9834710743801653
27246,/images/9f38055f-4fe6-47fd-a6dd-c0743db4eccf.png,521,1290,622,1413,101,123,red blood cell,12423,1.2178217821782178,0.8211382113821138
28001,/images/c4d34e35-4db2-41de-ba77-1a94aa9ef788.png,87,782,199,904,112,122,red blood cell,13664,1.0892857142857142,0.9180327868852459
44818,/images/6795acae-e84d-4e97-b9a1-b4f4f0a72cfd.png,970,77,1080,188,110,111,red blood cell,12210,1.009090909090909,0.990990990990991
19860,/images/b318889c-3c60-477c-b8f6-d18cb01a59df.png,235,120,360,222,125,102,red blood cell,12750,0.816,1.2254901960784315
70404,/images/4876c9d0-b386-48fb-84e8-91bf87529161.png,440,301,532,399,92,98,red blood cell,9016,1.065217391304348,0.9387755102040817
25099,/images/9e74feb8-017d-4d53-8896-9ebda4327dd1.png,380,1336,507,1452,127,116,red blood cell,14732,0.9133858267716536,1.0948275862068966
30529,/images/7d9c1422-6332-44e9-b134-3ac94f07b0f0.png,365,450,462,541,97,91,red blood cell,8827,0.9381443298969072,1.065934065934066
33816,/images/cb08956d-dd6a-4e13-817b-40a0a93068f1.png,1023,1144,1129,1236,106,92,red blood cell,9752,0.8679245283018868,1.1521739130434783
5617,/images/afa470d9-c74c-41cd-b4dc-7bf93fde8263.png,447,366,554,470,107,104,red blood cell,11128,0.9719626168224299,1.0288461538461537
55458,/images/d67655e6-0a80-4a86-b552-1f5e85788377.png,518,619,612,703,94,84,red blood cell,7896,0.8936170212765957,1.119047619047619
35453,/images/3722d213-f2a9-46d5-aa76-9183b443e455.png,309,1151,430,1276,121,125,red blood cell,15125,1.0330578512396693,0.968
11327,/images/2f6224be-50d0-4e85-94ef-88315df561b6.png,907,264,1033,388,126,124,red blood cell,15624,0.9841269841269841,1.0161290322580645
77592,/images/f20a4fcf-ea8e-4c14-883d-d26a9e08ce25.png,148,725,246,840,98,115,red blood cell,11270,1.1734693877551021,0.8521739130434782
72574,/images/a63ce82f-f3d1-4818-9035-d3d230e5f686.png,592,944,695,1046,103,102,red blood cell,10506,0.9902912621359223,1.0098039215686274
55577,/images/a27b451d-44a6-4740-861a-9e7e99915563.png,1052,1189,1143,1286,91,97,red blood cell,8827,1.065934065934066,0.9381443298969072
73102,/images/f39e2289-fedd-4d12-9e64-ffdafb89247e.png,640,185,741,298,101,113,red blood cell,11413,1.118811881188119,0.8938053097345132
67,/images/8d02117d-6c71-4e47-b50a-6cc8d5eb1d55.png,336,682,439,776,103,94,red blood cell,9682,0.912621359223301,1.0957446808510638
71615,/images/390ad256-e1ed-476a-9f14-2dc34e0da632.png,25,167,138,281,113,114,red blood cell,12882,1.008849557522124,0.9912280701754386
27584,/images/715761a2-745e-4743-9849-956a034ad3c4.png,1074,739,1181,848,107,109,red blood cell,11663,1.0186915887850467,0.981651376146789
18296,/images/9ca20b10-e2fd-4bd2-93ef-78298f763ed5.png,583,1177,709,1301,126,124,red blood cell,15624,0.9841269841269841,1.0161290322580645
54408,/images/22a464ef-c3da-4d56-b37e-e22e95d945e7.png,123,576,224,679,101,103,red blood cell,10403,1.0198019801980198,0.9805825242718447
28905,/images/686ed568-d5f8-475e-81ad-edab9dd473a0.png,117,1415,210,1495,93,80,red blood cell,7440,0.8602150537634409,1.1625
44012,/images/de81bf7a-7a56-437f-a068-4d9c3e01134c.png,813,632,929,734,116,102,red blood cell,11832,0.8793103448275862,1.1372549019607843
9709,/images/53afd70c-08a7-4b9a-b137-7003b2ecbeab.png,613,1424,733,1543,120,119,red blood cell,14280,0.9916666666666667,1.0084033613445378
66572,/images/087f2c9c-188d-43cc-a94c-0eb8f10ac092.png,410,209,525,308,115,99,red blood cell,11385,0.8608695652173913,1.1616161616161615
62725,/images/9e1b0217-0926-4fd1-bb9e-a815c05deb59.png,89,894,181,972,92,78,red blood cell,7176,0.8478260869565217,1.1794871794871795
3476,/images/ad36bd67-594b-4f63-93e3-886af0bc618e.png,961,746,1092,851,131,105,red blood cell,13755,0.8015267175572519,1.2476190476190476
75811,/images/c4c7ed75-dbdf-4bb6-b6ba-718903cf7264.png,955,979,1073,1098,118,119,red blood cell,14042,1.0084745762711864,0.9915966386554622
27664,/images/18dbe7c4-89d2-42a6-a969-1e951ab313b1.png,996,1309,1094,1413,98,104,red blood cell,10192,1.0612244897959184,0.9423076923076923
34488,/images/fa1f9f89-cecb-4972-842c-d14c632f89a9.png,26,1203,153,1320,127,117,red blood cell,14859,0.9212598425196851,1.0854700854700854
59172,/images/4736f545-1f1f-4d77-9241-d69cbf4dae35.png,908,1427,1018,1516,110,89,red blood cell,9790,0.8090909090909091,1.2359550561797752
58399,/images/7eae1169-e294-4594-8e03-1366d23ff2d1.png,373,1175,467,1282,94,107,red blood cell,10058,1.1382978723404256,0.8785046728971962
39057,/images/8f96ee1f-4ef7-4279-a610-316319bedcf9.png,221,1135,350,1257,129,122,red blood cell,15738,0.9457364341085271,1.0573770491803278
36159,/images/749df49e-5212-49ea-9e88-7d66f258f1df.png,59,788,163,889,104,101,red blood cell,10504,0.9711538461538461,1.0297029702970297
29325,/images/3850f2a5-ab62-49d3-8135-68d60baa676b.png,550,783,667,888,117,105,red blood cell,12285,0.8974358974358975,1.1142857142857143
44715,/images/ccb4b13d-ab20-4222-892f-5adf70249aaa.png,165,480,293,609,128,129,red blood cell,16512,1.0078125,0.9922480620155039
2512,/images/a23f5539-bfe6-4885-9a0e-dba972475ea9.png,455,441,547,525,92,84,red blood cell,7728,0.9130434782608695,1.0952380952380953
2356,/images/fe851c88-692d-4199-87e0-d19d9c4eb591.png,1083,974,1184,1072,101,98,red blood cell,9898,0.9702970297029703,1.030612244897959
7158,/images/56551792-4aa1-4301-9f8f-8bfebcd20050.png,49,597,166,696,117,99,red blood cell,11583,0.8461538461538461,1.1818181818181819
56656,/images/4adcaa26-aa1f-47b5-bdf0-18c9f814f576.png,552,1468,678,1583,126,115,red blood cell,14490,0.9126984126984127,1.0956521739130434
68263,/images/a6391703-0820-4913-a7cd-e843ff0d84ba.png,707,378,832,488,125,110,red blood cell,13750,0.88,1.1363636363636365
11721,/images/082e1f81-4f49-44ad-b5bb-9dfc155b2ed8.png,16,49,127,156,111,107,red blood cell,11877,0.963963963963964,1.0373831775700935
29489,/images/8cc6fe77-5f2f-4670-b4ac-1b49550241a8.png,350,958,470,1088,120,130,red blood cell,15600,1.0833333333333333,0.9230769230769231
48944,/images/5dec0204-af81-44ef-a942-8a173669c123.png,92,77,199,182,107,105,red blood cell,11235,0.9813084112149533,1.019047619047619
20800,/images/c2ec116f-f091-422c-926c-70b548a8f6ef.png,409,992,508,1104,99,112,red blood cell,11088,1.1313131313131313,0.8839285714285714
67755,/images/48e2f0bd-2164-40c3-af43-1f2708359978.png,228,333,340,440,112,107,red blood cell,11984,0.9553571428571429,1.0467289719626167
23904,/images/3d8fb5bf-3315-48fb-8ab1-802eafd550bc.png,547,185,641,291,94,106,red blood cell,9964,1.127659574468085,0.8867924528301887
3306,/images/b901c906-91be-48c4-88ec-2c527544a258.png,393,701,505,834,112,133,red blood cell,14896,1.1875,0.8421052631578947
63223,/images/d3283f5b-3b3a-40ea-800b-79960ca851cb.png,576,857,693,978,117,121,red blood cell,14157,1.0341880341880343,0.9669421487603306
7280,/images/89f10192-d3dd-4996-a571-4c851dbdc983.png,361,898,457,999,96,101,red blood cell,9696,1.0520833333333333,0.9504950495049505
6176,/images/27cdd837-e40f-491e-8adb-61e493189832.png,721,445,840,565,119,120,red blood cell,14280,1.0084033613445378,0.9916666666666667
58389,/images/7eae1169-e294-4594-8e03-1366d23ff2d1.png,286,215,379,301,93,86,red blood cell,7998,0.9247311827956989,1.0813953488372092
7646,/images/21cc498b-8cb2-42ed-8f80-bfa27b86ef11.png,515,888,649,1008,134,120,red blood cell,16080,0.8955223880597015,1.1166666666666667
73641,/images/a51d6c18-f9e8-4714-9dbb-38e1577445f2.png,631,419,723,506,92,87,red blood cell,8004,0.9456521739130435,1.0574712643678161
57433,/images/00d04a90-80e5-4bce-9511-1b64eabb7a47.png,593,218,693,321,100,103,red blood cell,10300,1.03,0.970873786407767
24809,/images/65054b19-5c6a-4870-99a9-eef994721d3a.png,730,659,841,789,111,130,red blood cell,14430,1.1711711711711712,0.8538461538461538
51550,/images/6afb3717-f197-4668-929a-4fab389ae6e8.png,102,483,204,595,102,112,red blood cell,11424,1.0980392156862746,0.9107142857142857
58294,/images/319c9c52-f316-49f3-baad-4444ab19f85b.png,774,781,872,887,98,106,red blood cell,10388,1.0816326530612246,0.9245283018867925
47321,/images/1dd3e6dd-343f-4cc9-b0ed-e4d27fb36f0a.png,163,173,281,290,118,117,red blood cell,13806,0.9915254237288136,1.0085470085470085
34520,/images/fa1f9f89-cecb-4972-842c-d14c632f89a9.png,1014,1188,1115,1301,101,113,red blood cell,11413,1.118811881188119,0.8938053097345132
17688,/images/b5143aae-6e98-4dc6-b546-980cb472de67.png,205,1161,329,1277,124,116,red blood cell,14384,0.9354838709677419,1.0689655172413792
67319,/images/49c4dbd3-6269-4d4c-9648-a2146c57bab1.png,256,421,357,527,101,106,red blood cell,10706,1.0495049504950495,0.9528301886792453
17347,/images/04018590-4e66-4cb9-ad2d-83570f1b29ae.png,734,1172,849,1302,115,130,red blood cell,14950,1.1304347826086956,0.8846153846153846
29798,/images/7ef90770-6aeb-45eb-9744-49c5247dde30.png,1076,1290,1181,1397,105,107,red blood cell,11235,1.019047619047619,0.9813084112149533
49186,/images/a9daf82a-a46d-4296-bd72-2c374ed0a193.png,718,567,840,690,122,123,red blood cell,15006,1.0081967213114753,0.991869918699187
2637,/images/a2ccbf70-e444-49a9-8b7e-9797a05220d8.png,1009,543,1142,670,133,127,red blood cell,16891,0.9548872180451128,1.047244094488189
65219,/images/50715879-2300-4dba-8f4a-3314ff8cfcce.png,213,796,305,889,92,93,red blood cell,8556,1.0108695652173914,0.989247311827957
79800,/images/fc15659f-6264-4dd5-ab17-43d89fb297b9.png,14,971,115,1070,101,99,red blood cell,9999,0.9801980198019802,1.02020202020202
17724,/images/b5143aae-6e98-4dc6-b546-980cb472de67.png,55,533,177,643,122,110,red blood cell,13420,0.9016393442622951,1.1090909090909091
8141,/images/694222bb-cddf-469a-9526-f873c6fba58e.png,96,468,187,555,91,87,red blood cell,7917,0.9560439560439561,1.0459770114942528
60469,/images/93b47b14-7f78-4b31-8897-d63a81fdab01.png,180,790,299,906,119,116,red blood cell,13804,0.9747899159663865,1.0258620689655173
67679,/images/2b128a1a-95ed-408b-b9f8-8795cc814d80.png,902,588,1002,692,100,104,red blood cell,10400,1.04,0.9615384615384616
68957,/images/bbaa004f-05dc-4cb8-8768-e148085bb0f9.png,383,271,475,379,92,108,red blood cell,9936,1.173913043478261,0.8518518518518519
12582,/images/8e4bdd0d-1c72-4836-ae3e-05e2e50e4983.png,1055,187,1149,303,94,116,red blood cell,10904,1.2340425531914894,0.8103448275862069
52547,/images/d1144956-5a0c-4bd2-b67d-8498c82d6a12.png,1109,679,1199,789,90,110,red blood cell,9900,1.2222222222222223,0.8181818181818182
10398,/images/46a2d369-4bea-4405-ac78-91bbe130b9a7.png,661,311,754,413,93,102,red blood cell,9486,1.096774193548387,0.9117647058823529
48696,/images/03359d4d-69cb-4146-8286-ca7399366f97.png,358,759,471,885,113,126,red blood cell,14238,1.1150442477876106,0.8968253968253969
58402,/images/7eae1169-e294-4594-8e03-1366d23ff2d1.png,596,282,720,389,124,107,red blood cell,13268,0.8629032258064516,1.158878504672897
54280,/images/3b5a8060-dec6-4a83-b7f2-b604e4e69dfc.png,121,1178,236,1276,115,98,red blood cell,11270,0.8521739130434782,1.1734693877551021
57106,/images/7d041c38-11f2-4186-8a24-29d7d0f5c3cf.png,187,289,279,379,92,90,red blood cell,8280,0.9782608695652174,1.0222222222222221
41956,/images/46a03374-64c7-49ac-81c9-c3d62542bbf3.png,608,511,706,609,98,98,red blood cell,9604,1.0,1.0
73745,/images/22cbf509-c9bf-46ec-bfce-f079c6b76c8c.png,365,308,483,410,118,102,red blood cell,12036,0.864406779661017,1.1568627450980393
34919,/images/a4fbb9f2-9b75-4fdc-877d-2feaafac25b3.png,643,923,739,1032,96,109,red blood cell,10464,1.1354166666666667,0.8807339449541285
47030,/images/997eabd9-55bf-4683-83c4-4cee4673a4ef.png,971,460,1073,553,102,93,red blood cell,9486,0.9117647058823529,1.096774193548387
25014,/images/ed0bee2f-05e0-4392-8357-19750cec577c.png,784,425,880,540,96,115,red blood cell,11040,1.1979166666666667,0.8347826086956521
34025,/images/1012abf2-cb05-4337-86c5-513ec4ca904d.png,651,954,772,1082,121,128,red blood cell,15488,1.0578512396694215,0.9453125
73842,/images/3eba916c-998b-40a7-993c-7ed916c2a04c.png,562,1429,651,1517,89,88,red blood cell,7832,0.9887640449438202,1.0113636363636365
35248,/images/a9159b11-ba49-4885-902e-00c8d5095b98.png,3,921,99,1021,96,100,red blood cell,9600,1.0416666666666667,0.96
28795,/images/686ed568-d5f8-475e-81ad-edab9dd473a0.png,404,1248,504,1344,100,96,red blood cell,9600,0.96,1.0416666666666667
75314,/images/9ec1dcec-87c2-4aca-8e6b-0db3cd05509c.png,492,189,604,292,112,103,red blood cell,11536,0.9196428571428571,1.087378640776699
69301,/images/3f8c5ae1-b9fd-464b-8e91-98143ddd8d29.png,653,1059,778,1170,125,111,red blood cell,13875,0.888,1.1261261261261262
39641,/images/04d21589-b777-43c2-86b5-038cbf8c3a4e.png,793,5,913,114,120,109,red blood cell,13080,0.9083333333333333,1.1009174311926606
8133,/images/694222bb-cddf-469a-9526-f873c6fba58e.png,745,773,846,869,101,96,red blood cell,9696,0.9504950495049505,1.0520833333333333
47185,/images/3d1b889e-bb4a-4ee6-b899-974ee7d956a7.png,1107,807,1199,913,92,106,red blood cell,9752,1.1521739130434783,0.8679245283018868
46975,/images/9ebd623d-5534-4dd9-bff8-cdedf322db35.png,620,1083,727,1183,107,100,red blood cell,10700,0.9345794392523364,1.07
8775,/images/29dc8176-dfe1-40e0-8247-2dc3c530057e.png,126,60,233,179,107,119,red blood cell,12733,1.1121495327102804,0.8991596638655462
78577,/images/c5084fb8-2b62-464c-8a77-1a07ea653266.png,823,282,950,418,127,136,red blood cell,17272,1.0708661417322836,0.9338235294117647
17522,/images/56077789-8580-41b4-89d6-deea227e5c60.png,854,92,959,213,105,121,red blood cell,12705,1.1523809523809523,0.8677685950413223
34537,/images/fa1f9f89-cecb-4972-842c-d14c632f89a9.png,583,431,690,548,107,117,red blood cell,12519,1.0934579439252337,0.9145299145299145
40296,/images/eb86033f-4f1c-4e8c-ae84-e8e4c7e08626.png,261,1110,368,1217,107,107,red blood cell,11449,1.0,1.0
77845,/images/6bc7b53c-5a98-48ef-a9de-59a476707ea4.png,836,1407,957,1515,121,108,red blood cell,13068,0.8925619834710744,1.1203703703703705
64880,/images/dec61ae1-5037-4c3a-8952-15371becca7d.png,763,401,852,480,89,79,red blood cell,7031,0.8876404494382022,1.1265822784810127
72900,/images/a20d0b4b-6e2e-4507-bc22-f321dedc4ed9.png,383,654,494,755,111,101,red blood cell,11211,0.9099099099099099,1.099009900990099
45181,/images/2596eb32-1323-41e9-8c0f-64819abcfc73.png,804,1008,913,1114,109,106,red blood cell,11554,0.9724770642201835,1.028301886792453
9177,/images/6e7ed596-1b76-4998-8147-a846d53d91c5.png,736,360,853,479,117,119,red blood cell,13923,1.017094017094017,0.9831932773109243
13870,/images/7d65d296-0f7b-41cc-9073-a547e24326c8.png,570,104,681,220,111,116,red blood cell,12876,1.045045045045045,0.9568965517241379
71816,/images/093a831a-bf71-4333-bc06-942ae70cb164.png,310,522,407,629,97,107,red blood cell,10379,1.1030927835051547,0.9065420560747663
41377,/images/a065c50b-341d-4803-b4b0-0fe8f04fdbb5.png,900,107,999,199,99,92,red blood cell,9108,0.9292929292929293,1.076086956521739
26294,/images/d33bc9fc-3444-4f26-8082-307f9fccc52b.png,589,338,705,454,116,116,red blood cell,13456,1.0,1.0
54140,/images/c415532c-4cce-4580-9fcd-623c172a1abd.png,826,1005,952,1133,126,128,red blood cell,16128,1.0158730158730158,0.984375
35317,/images/516bf1d5-5d00-4985-926c-3993e9bc3ff5.png,584,544,727,669,143,125,red blood cell,17875,0.8741258741258742,1.144
67766,/images/48e2f0bd-2164-40c3-af43-1f2708359978.png,849,565,948,682,99,117,red blood cell,11583,1.1818181818181819,0.8461538461538461
54288,/images/3b5a8060-dec6-4a83-b7f2-b604e4e69dfc.png,905,1108,997,1193,92,85,red blood cell,7820,0.9239130434782609,1.0823529411764705
28934,/images/b12ae3b1-613c-4c0e-9163-3c5cc314abf5.png,9,1341,119,1443,110,102,red blood cell,11220,0.9272727272727272,1.0784313725490196
49911,/images/5e17f8e6-fd8d-426c-b444-1515d14f04b7.png,121,1358,228,1481,107,123,red blood cell,13161,1.1495327102803738,0.8699186991869918
70403,/images/4876c9d0-b386-48fb-84e8-91bf87529161.png,188,1295,288,1394,100,99,red blood cell,9900,0.99,1.0101010101010102
47797,/images/5a105b89-c592-4d78-b208-7db6c6572752.png,703,1136,807,1234,104,98,red blood cell,10192,0.9423076923076923,1.0612244897959184
36483,/images/cfe6086f-eb0b-4cb0-a430-8cd7de6556e2.png,654,733,752,844,98,111,red blood cell,10878,1.1326530612244898,0.8828828828828829
2973,/images/00a02700-2ea2-4590-9e15-ffc9160fd3de.png,1014,935,1130,1060,116,125,red blood cell,14500,1.0775862068965518,0.928
65139,/images/5e042380-6ef2-496f-8231-0ca550fbfa71.png,319,851,406,954,87,103,red blood cell,8961,1.1839080459770115,0.8446601941747572
25065,/images/b02f6804-1697-4a5e-9be7-61931903ab55.png,34,684,155,810,121,126,red blood cell,15246,1.0413223140495869,0.9603174603174603
14721,/images/1fdf99d1-a494-4174-bcd7-efbe457ab899.png,381,1110,493,1239,112,129,red blood cell,14448,1.1517857142857142,0.8682170542635659
12260,/images/3b55c42f-ad59-422f-ba99-4f4f4ca9cb2e.png,548,647,628,743,80,96,red blood cell,7680,1.2,0.8333333333333334
56091,/images/ffb7be9a-65df-4f0b-99ae-cfd34e81cd34.png,854,775,986,905,132,130,red blood cell,17160,0.9848484848484849,1.0153846153846153
48639,/images/55836297-fc8e-4e00-9767-0d12b86e4604.png,527,497,623,604,96,107,red blood cell,10272,1.1145833333333333,0.897196261682243
74056,/images/fe436c09-b680-4f4c-8faf-aa10a55a335b.png,181,1091,296,1206,115,115,red blood cell,13225,1.0,1.0
32743,/images/eef2ac0b-42de-4bc3-a3c3-d5fcd597fbe4.png,959,375,1067,486,108,111,red blood cell,11988,1.0277777777777777,0.972972972972973
18077,/images/947348fe-4c70-468e-8009-3c14daeca69b.png,63,1080,185,1197,122,117,red blood cell,14274,0.9590163934426229,1.0427350427350428
2701,/images/a89cace5-c818-4f23-a432-052b3433b81e.png,976,399,1077,505,101,106,red blood cell,10706,1.0495049504950495,0.9528301886792453
70034,/images/3e36698f-8c09-4c8b-8948-737310bf97e5.png,824,353,916,448,92,95,red blood cell,8740,1.0326086956521738,0.968421052631579
24962,/images/ed0bee2f-05e0-4392-8357-19750cec577c.png,289,29,388,144,99,115,red blood cell,11385,1.1616161616161615,0.8608695652173913
611,/images/065af549-320a-4862-b92a-8ef750d7b5fb.png,53,746,174,864,121,118,red blood cell,14278,0.9752066115702479,1.0254237288135593
60977,/images/5397d8e2-bb09-42e7-9861-65ffad0fe94e.png,1000,224,1115,323,115,99,red blood cell,11385,0.8608695652173913,1.1616161616161615
21912,/images/d57b3894-c912-47e8-b00a-e1a2a7aba644.png,258,1096,359,1204,101,108,red blood cell,10908,1.0693069306930694,0.9351851851851852
72058,/images/64b0e49a-0e48-447d-8872-c1dd255e7a21.png,195,197,296,297,101,100,red blood cell,10100,0.9900990099009901,1.01
16388,/images/e474a20b-2769-48f1-a520-4f6ef5a0dbf5.png,205,91,312,192,107,101,red blood cell,10807,0.9439252336448598,1.0594059405940595
36229,/images/c3209548-7f7c-4afd-b47c-b42a72b1ebf7.png,538,375,663,515,125,140,red blood cell,17500,1.12,0.8928571428571429
8103,/images/694222bb-cddf-469a-9526-f873c6fba58e.png,1067,1063,1157,1141,90,78,red blood cell,7020,0.8666666666666667,1.1538461538461537
33685,/images/84ee2ea3-9edd-4672-a1b3-f09c607d833a.png,386,639,495,762,109,123,red blood cell,13407,1.128440366972477,0.8861788617886179
45339,/images/e4eea7ea-8989-46a9-9c98-25a178146b28.png,149,1376,242,1461,93,85,red blood cell,7905,0.9139784946236559,1.0941176470588236
76725,/images/3317d733-ec0d-45e6-b631-40457392f343.png,12,489,136,599,124,110,red blood cell,13640,0.8870967741935484,1.1272727272727272
27494,/images/f5869ba8-6253-426b-93f3-82af59a86144.png,364,1439,461,1541,97,102,red blood cell,9894,1.0515463917525774,0.9509803921568627
5320,/images/06df7bbe-60d4-4f7c-ba4a-5a42ac4be91b.png,78,914,201,1039,123,125,red blood cell,15375,1.016260162601626,0.984
17352,/images/04018590-4e66-4cb9-ad2d-83570f1b29ae.png,456,1464,580,1588,124,124,red blood cell,15376,1.0,1.0
71773,/images/093a831a-bf71-4333-bc06-942ae70cb164.png,878,364,984,465,106,101,red blood cell,10706,0.9528301886792453,1.0495049504950495
34893,/images/a4fbb9f2-9b75-4fdc-877d-2feaafac25b3.png,359,1120,461,1223,102,103,red blood cell,10506,1.0098039215686274,0.9902912621359223
38009,/images/e3e9c2de-0a24-4c7e-8a69-3d3093d5bdab.png,254,1336,369,1439,115,103,red blood cell,11845,0.8956521739130435,1.116504854368932
106,/images/10be6380-cbbb-4886-8b9e-ff56b1710576.png,262,571,378,691,116,120,red blood cell,13920,1.0344827586206897,0.9666666666666667
42877,/images/a7b6894d-eeea-4ed5-bc0e-785d6c6da8df.png,1050,662,1171,787,121,125,red blood cell,15125,1.0330578512396693,0.968
57052,/images/9e82c996-2cfa-418d-9482-8ee23e9d0a5d.png,168,1030,264,1140,96,110,red blood cell,10560,1.1458333333333333,0.8727272727272727
12273,/images/3b55c42f-ad59-422f-ba99-4f4f4ca9cb2e.png,263,810,375,908,112,98,red blood cell,10976,0.875,1.1428571428571428
3696,/images/dacf7e3f-1d8c-42a0-8539-3abe3971c956.png,842,235,972,355,130,120,red blood cell,15600,0.9230769230769231,1.0833333333333333
14488,/images/458cb2e9-5a7f-437c-ac5d-a56f98a3efdf.png,568,735,687,845,119,110,red blood cell,13090,0.9243697478991597,1.0818181818181818
48679,/images/03359d4d-69cb-4146-8286-ca7399366f97.png,780,1242,915,1351,135,109,red blood cell,14715,0.8074074074074075,1.238532110091743
50761,/images/db0a1123-0b35-48d7-8337-3b1ebd6af0cc.png,763,615,882,730,119,115,red blood cell,13685,0.9663865546218487,1.0347826086956522
35521,/images/3e33ee12-ef02-4287-8318-7ad3b284a617.png,1060,1104,1166,1211,106,107,red blood cell,11342,1.009433962264151,0.9906542056074766
78778,/images/9174f910-3859-4839-8e30-2c3b25269322.png,478,1279,585,1388,107,109,red blood cell,11663,1.0186915887850467,0.981651376146789
9418,/images/e3a4b3e7-9500-4b6c-a402-b6d3f45e714b.png,10,665,119,783,109,118,red blood cell,12862,1.0825688073394495,0.923728813559322
47332,/images/1dd3e6dd-343f-4cc9-b0ed-e4d27fb36f0a.png,588,115,700,240,112,125,red blood cell,14000,1.1160714285714286,0.896
46876,/images/9e0e1928-d19a-4100-b093-0b962ac09e05.png,244,220,340,302,96,82,red blood cell,7872,0.8541666666666666,1.170731707317073
34671,/images/8d989997-038c-4924-b2d3-d02629a7cdf5.png,22,68,142,173,120,105,red blood cell,12600,0.875,1.1428571428571428
72155,/images/005e60b6-77b8-458c-b57c-bfe0c7e7df78.png,54,283,180,397,126,114,red blood cell,14364,0.9047619047619048,1.105263157894737
68361,/images/040112be-3c8d-49aa-93f1-522f94a592ff.png,465,178,576,293,111,115,red blood cell,12765,1.0360360360360361,0.9652173913043478
38390,/images/674b0fd3-f247-4b7f-97f7-3e6c57c9ba9e.png,553,1159,670,1257,117,98,red blood cell,11466,0.8376068376068376,1.1938775510204083
1083,/images/edcb4d77-a4d3-465d-9b59-eb3087766b1c.png,739,476,857,588,118,112,red blood cell,13216,0.9491525423728814,1.0535714285714286
55006,/images/7beee655-6156-43b8-b185-dbae0eaf7f45.png,30,603,140,717,110,114,red blood cell,12540,1.0363636363636364,0.9649122807017544
7933,/images/933e7e07-fc3d-42eb-be0c-6b1623ee60fa.png,102,863,205,966,103,103,red blood cell,10609,1.0,1.0
5815,/images/143f5959-5b6d-4f95-bcee-9e110450fc22.png,576,49,695,155,119,106,red blood cell,12614,0.8907563025210085,1.1226415094339623
7811,/images/e726dac6-f962-449c-acff-4dd56847b685.png,245,1400,343,1495,98,95,red blood cell,9310,0.9693877551020408,1.0315789473684212
77958,/images/c691c8ef-d3c7-47b6-a941-f6a1089f21a9.png,213,1066,300,1156,87,90,red blood cell,7830,1.0344827586206897,0.9666666666666667
44246,/images/4257342d-6d77-4671-a84b-1f0c36ccb367.png,1017,778,1111,886,94,108,red blood cell,10152,1.148936170212766,0.8703703703703703
46866,/images/63055d1b-5221-4c80-8b39-37ac069a1b5c.png,42,468,160,568,118,100,red blood cell,11800,0.847457627118644,1.18
73170,/images/85546330-4efd-43e2-87aa-d53a30220bfc.png,124,764,239,873,115,109,red blood cell,12535,0.9478260869565217,1.055045871559633
37571,/images/205306da-0ed8-475a-ace6-f2f81d4be88a.png,900,389,1000,496,100,107,red blood cell,10700,1.07,0.9345794392523364
32001,/images/9eb66577-7857-43dc-a879-8f2c9d7f780f.png,233,922,321,1016,88,94,red blood cell,8272,1.0681818181818181,0.9361702127659575
2253,/images/fe851c88-692d-4199-87e0-d19d9c4eb591.png,235,622,353,728,118,106,red blood cell,12508,0.8983050847457628,1.1132075471698113
33958,/images/701206c5-aaac-4b99-9cc0-4a6854359457.png,123,797,246,905,123,108,red blood cell,13284,0.8780487804878049,1.1388888888888888
46238,/images/815bf40c-371a-4d34-aa41-c549c8221881.png,96,774,227,885,131,111,red blood cell,14541,0.8473282442748091,1.1801801801801801
79625,/images/a4409217-be11-4478-90a5-b406057d154d.png,982,559,1090,665,108,106,red blood cell,11448,0.9814814814814815,1.0188679245283019
36185,/images/749df49e-5212-49ea-9e88-7d66f258f1df.png,724,1109,827,1226,103,117,red blood cell,12051,1.1359223300970873,0.8803418803418803
36329,/images/4a0a05e1-11ad-4bfc-bfa3-adf3b9bd0b56.png,511,116,612,221,101,105,red blood cell,10605,1.0396039603960396,0.9619047619047619
32060,/images/b8a4d467-c40c-4ebf-91dd-1c19d0f2a7ae.png,42,547,130,628,88,81,red blood cell,7128,0.9204545454545454,1.0864197530864197
1566,/images/0ac747cd-ff32-49bf-bc1a-3e9b7702ce9c.png,388,1022,498,1127,110,105,red blood cell,11550,0.9545454545454546,1.0476190476190477
20174,/images/bb337c84-f727-42a5-9c3d-934323a16c6a.png,445,403,574,527,129,124,red blood cell,15996,0.9612403100775194,1.0403225806451613
49387,/images/f2574be3-81c6-4fc3-8a40-0230d1264f52.png,119,640,214,739,95,99,red blood cell,9405,1.0421052631578946,0.9595959595959596
45705,/images/584d62ed-4329-45dd-94ce-e929d8b2bb74.png,270,49,389,154,119,105,red blood cell,12495,0.8823529411764706,1.1333333333333333
33748,/images/441d7843-b20b-4c10-84e3-e6d32621e880.png,382,188,477,285,95,97,red blood cell,9215,1.0210526315789474,0.979381443298969
62644,/images/f7a4334a-4332-4de8-b39b-22da907976f2.png,1107,100,1199,188,92,88,red blood cell,8096,0.9565217391304348,1.0454545454545454
1895,/images/02ea7aa8-c142-4a3d-939f-e77689741341.png,212,1155,338,1259,126,104,red blood cell,13104,0.8253968253968254,1.2115384615384615
38158,/images/33bdb7b5-ad5b-4a73-bbc2-3350f8c2ac0c.png,733,1155,849,1289,116,134,red blood cell,15544,1.1551724137931034,0.8656716417910447
59906,/images/1519257c-e3e5-4474-908f-8665b3cf1258.png,804,1441,909,1548,105,107,red blood cell,11235,1.019047619047619,0.9813084112149533
35937,/images/f8242b97-b8d5-48b5-b808-0b0f75a5de97.png,1028,311,1150,416,122,105,red blood cell,12810,0.860655737704918,1.161904761904762
57210,/images/ca5e6a15-ba65-48ea-8913-2d986e71bf3a.png,107,1356,214,1456,107,100,red blood cell,10700,0.9345794392523364,1.07
30713,/images/8e0dfc1f-e3eb-4a3f-a1c4-249bdfbfaa27.png,322,329,416,431,94,102,red blood cell,9588,1.0851063829787233,0.9215686274509803
68735,/images/dcf7a19a-ec3d-44ef-8d7c-33b1e91fb9af.png,416,433,527,549,111,116,red blood cell,12876,1.045045045045045,0.9568965517241379
54003,/images/5e4f7425-11e6-4f9e-be2d-5a27deb9d1b4.png,486,914,604,1024,118,110,red blood cell,12980,0.9322033898305084,1.0727272727272728
19576,/images/883d9731-a04d-4f84-83c9-d3bef954759d.png,511,1065,631,1182,120,117,red blood cell,14040,0.975,1.0256410256410255
22300,/images/49b03a6e-6b26-4a96-a061-e05647a02138.png,965,153,1079,264,114,111,red blood cell,12654,0.9736842105263158,1.027027027027027
58513,/images/5cac6ddf-c8c6-45de-bce0-a1db64b14fb5.png,914,709,1025,839,111,130,red blood cell,14430,1.1711711711711712,0.8538461538461538
76740,/images/3317d733-ec0d-45e6-b631-40457392f343.png,2,205,101,321,99,116,red blood cell,11484,1.1717171717171717,0.853448275862069
71030,/images/59daa25e-85d6-42f2-8f39-cc9f9d5d252e.png,620,1370,738,1496,118,126,red blood cell,14868,1.0677966101694916,0.9365079365079365
9880,/images/b4261fa5-876d-48ea-b6da-ec7ca5b48fe2.png,1011,923,1124,1039,113,116,red blood cell,13108,1.0265486725663717,0.9741379310344828
12485,/images/cc94eabb-a3dc-4cfc-9fff-55c76b5b4a71.png,826,710,916,809,90,99,red blood cell,8910,1.1,0.9090909090909091
64170,/images/2a91387a-d30f-418d-ac3a-f7cfa6836261.png,755,819,850,911,95,92,red blood cell,8740,0.968421052631579,1.0326086956521738
79088,/images/1c90231b-2830-42d9-884e-7301edb16933.png,40,299,154,422,114,123,red blood cell,14022,1.0789473684210527,0.926829268292683
75256,/images/2afe2750-c963-46f9-a1ad-9260e80679ca.png,310,407,427,531,117,124,red blood cell,14508,1.0598290598290598,0.9435483870967742
9964,/images/b9ccf7ca-953f-4832-9575-5e70b2a8c224.png,770,284,883,401,113,117,red blood cell,13221,1.0353982300884956,0.9658119658119658
3929,/images/f09acb0c-b270-4e91-99f8-410adfa7f34a.png,277,836,372,944,95,108,red blood cell,10260,1.1368421052631579,0.8796296296296297
71692,/images/5c99cd97-39f6-4809-9528-9d380cc16b16.png,349,1346,429,1438,80,92,red blood cell,7360,1.15,0.8695652173913043
14947,/images/5d1418d3-1559-4725-ad4a-9afb6eaecdfd.png,227,902,318,992,91,90,red blood cell,8190,0.989010989010989,1.011111111111111
58022,/images/a7c91b63-b97c-4f4b-8d34-7ad2b08d7a17.png,281,990,384,1103,103,113,red blood cell,11639,1.0970873786407767,0.911504424778761
58812,/images/434523fd-d4d9-4961-a7c2-d71d6ae68e13.png,283,289,394,392,111,103,red blood cell,11433,0.9279279279279279,1.0776699029126213
59829,/images/acb16781-11ad-4327-874a-5c9c35dcb085.png,959,1212,1058,1330,99,118,red blood cell,11682,1.1919191919191918,0.8389830508474576
79510,/images/a2fc0093-8645-43c7-bdee-ec8ca9484815.png,922,49,1017,152,95,103,red blood cell,9785,1.0842105263157895,0.9223300970873787
6261,/images/f4a27dfd-4c52-459f-96b5-ee6b452a3395.png,962,1315,1085,1442,123,127,red blood cell,15621,1.032520325203252,0.968503937007874
58460,/images/5cac6ddf-c8c6-45de-bce0-a1db64b14fb5.png,781,204,893,311,112,107,red blood cell,11984,0.9553571428571429,1.0467289719626167
51082,/images/93f40356-5676-45d3-8e83-8028708c93ba.png,941,366,1047,487,106,121,red blood cell,12826,1.1415094339622642,0.8760330578512396
76687,/images/3317d733-ec0d-45e6-b631-40457392f343.png,477,912,587,1021,110,109,red blood cell,11990,0.990909090909091,1.0091743119266054
44824,/images/83ec8923-6232-40d7-ba1f-a1b8bf7cb66c.png,500,593,605,699,105,106,red blood cell,11130,1.0095238095238095,0.9905660377358491
58653,/images/a4d7a7e1-5ae1-486d-b6ee-c9af1476ccad.png,161,820,249,927,88,107,red blood cell,9416,1.2159090909090908,0.822429906542056
33992,/images/701206c5-aaac-4b99-9cc0-4a6854359457.png,43,1090,152,1197,109,107,red blood cell,11663,0.981651376146789,1.0186915887850467
9301,/images/261562a8-ffd8-4e0e-919b-22e267000b74.png,260,447,379,555,119,108,red blood cell,12852,0.907563025210084,1.1018518518518519
40454,/images/db249e5a-4142-432c-8288-bacd10d7273d.png,434,998,544,1103,110,105,red blood cell,11550,0.9545454545454546,1.0476190476190477
48327,/images/6fa2b30f-9b89-46ac-9b79-c0bc105d4271.png,422,440,543,555,121,115,red blood cell,13915,0.9504132231404959,1.0521739130434782
36504,/images/bd856928-96ee-4fc4-a377-f2fc4e84448b.png,805,151,913,263,108,112,red blood cell,12096,1.037037037037037,0.9642857142857143
41985,/images/46a03374-64c7-49ac-81c9-c3d62542bbf3.png,199,1115,320,1214,121,99,red blood cell,11979,0.8181818181818182,1.2222222222222223
18847,/images/d1b48634-9ad5-46e8-b816-42d1d97c93cd.png,533,942,645,1071,112,129,red blood cell,14448,1.1517857142857142,0.8682170542635659
252,/images/0dcca702-a4ef-4fb3-a940-9c0c140b21c7.png,883,1009,1006,1134,123,125,red blood cell,15375,1.016260162601626,0.984
68079,/images/29d40b60-cde1-45b5-b403-692437a77ac1.png,343,112,460,229,117,117,red blood cell,13689,1.0,1.0
19096,/images/6e39fb0a-aa41-4b16-b783-7589e97bf289.png,418,1245,539,1365,121,120,red blood cell,14520,0.9917355371900827,1.0083333333333333
58242,/images/319c9c52-f316-49f3-baad-4444ab19f85b.png,342,533,444,640,102,107,red blood cell,10914,1.0490196078431373,0.9532710280373832
62797,/images/631340cc-cedf-4bca-a3d8-a0731a5482b4.png,858,32,973,142,115,110,red blood cell,12650,0.9565217391304348,1.0454545454545454
42752,/images/a6f8a029-44ee-4fe3-b807-38d137347729.png,513,1096,643,1207,130,111,red blood cell,14430,0.8538461538461538,1.1711711711711712
3892,/images/65e865f3-acfb-4d01-a75f-ff5a535ffa6a.png,476,1238,615,1360,139,122,red blood cell,16958,0.8776978417266187,1.139344262295082
31697,/images/bd432159-5956-457c-bdeb-1b5e702ba513.png,397,1207,512,1300,115,93,red blood cell,10695,0.808695652173913,1.2365591397849462
59006,/images/597bbff8-6592-41cf-8946-e59b0d1f289a.png,418,535,518,641,100,106,red blood cell,10600,1.06,0.9433962264150944
314,/images/0dcca702-a4ef-4fb3-a940-9c0c140b21c7.png,336,9,443,100,107,91,red blood cell,9737,0.8504672897196262,1.1758241758241759
53739,/images/6f67a66b-56ec-4c36-ae7c-f250d3b86a23.png,155,809,249,901,94,92,red blood cell,8648,0.9787234042553191,1.0217391304347827
57960,/images/7942691b-6376-4c75-ae8a-ddf65454dcb2.png,751,1348,874,1467,123,119,red blood cell,14637,0.967479674796748,1.0336134453781514
33301,/images/5721e41b-90ef-4851-8587-8dc71227ef90.png,555,33,684,137,129,104,red blood cell,13416,0.8062015503875969,1.2403846153846154
55239,/images/8ad7ba46-5db8-4ba9-b3e0-3cac52f7efc3.png,551,356,660,468,109,112,red blood cell,12208,1.0275229357798166,0.9732142857142857
46160,/images/d8632217-ec33-4d0a-98e6-427824c58869.png,1021,833,1131,952,110,119,red blood cell,13090,1.0818181818181818,0.9243697478991597
28842,/images/686ed568-d5f8-475e-81ad-edab9dd473a0.png,414,978,519,1096,105,118,red blood cell,12390,1.1238095238095238,0.8898305084745762
341,/images/7c66d2fd-68ee-4628-b860-9d7ad25b2a80.png,374,607,483,707,109,100,red blood cell,10900,0.9174311926605505,1.09
45131,/images/56fbae44-4677-47f8-9c3a-22dac043c115.png,613,1354,715,1463,102,109,red blood cell,11118,1.0686274509803921,0.9357798165137615
66163,/images/191f87a4-6f2d-49e7-bba0-08e3aa78ddaf.png,604,890,684,978,80,88,red blood cell,7040,1.1,0.9090909090909091
30778,/images/8e0dfc1f-e3eb-4a3f-a1c4-249bdfbfaa27.png,802,184,888,286,86,102,red blood cell,8772,1.186046511627907,0.8431372549019608
53515,/images/43158031-a335-4533-9c20-48bebba90123.png,1097,1030,1189,1125,92,95,red blood cell,8740,1.0326086956521738,0.968421052631579
48765,/images/fed6ba05-36a5-45dc-a4e1-9baa7de2c622.png,196,446,294,539,98,93,red blood cell,9114,0.9489795918367347,1.053763440860215
28117,/images/cd2774a0-dab2-4d68-aae9-7568b9f3d2a6.png,168,124,294,248,126,124,red blood cell,15624,0.9841269841269841,1.0161290322580645
62669,/images/f7a4334a-4332-4de8-b39b-22da907976f2.png,501,5,601,107,100,102,red blood cell,10200,1.02,0.9803921568627451
76577,/images/38c69905-8a4f-451a-8d0a-b855dc88dd16.png,938,421,1030,497,92,76,red blood cell,6992,0.8260869565217391,1.2105263157894737
75701,/images/d12c5f45-6b20-46d6-a66f-c5a4683c25b3.png,683,462,784,565,101,103,red blood cell,10403,1.0198019801980198,0.9805825242718447
64041,/images/03cbfcf2-8da6-462c-b30d-16d63357371f.png,777,549,881,665,104,116,red blood cell,12064,1.1153846153846154,0.896551724137931
29137,/images/4c13e22e-dfd1-4fa1-b373-be9d0c272c0f.png,736,1074,828,1173,92,99,red blood cell,9108,1.076086956521739,0.9292929292929293
20547,/images/cbde7f7e-2458-4dda-9db2-3d5ccf950ced.png,975,809,1096,935,121,126,red blood cell,15246,1.0413223140495869,0.9603174603174603
61498,/images/7e837856-3519-4dc0-b357-4cdcfd30b4eb.png,201,519,282,610,81,91,red blood cell,7371,1.123456790123457,0.8901098901098901
72725,/images/6ab870ba-b24b-49a9-9570-8eafe63aa74e.png,1089,66,1168,155,79,89,red blood cell,7031,1.1265822784810127,0.8876404494382022
58290,/images/319c9c52-f316-49f3-baad-4444ab19f85b.png,292,353,395,448,103,95,red blood cell,9785,0.9223300970873787,1.0842105263157895
8114,/images/694222bb-cddf-469a-9526-f873c6fba58e.png,21,1211,121,1323,100,112,red blood cell,11200,1.12,0.8928571428571429
37305,/images/4d88e2d2-5aad-410c-9bbc-702ee9496995.png,117,395,239,534,122,139,red blood cell,16958,1.139344262295082,0.8776978417266187
18981,/images/e9e78ff8-831b-46e9-9785-3eee9acbfcd8.png,964,704,1068,790,104,86,red blood cell,8944,0.8269230769230769,1.2093023255813953
71383,/images/bcb447c9-5d37-414f-a513-d7076b04a532.png,148,603,236,708,88,105,red blood cell,9240,1.1931818181818181,0.8380952380952381
64795,/images/a74b6d6a-7e04-40ac-9292-d62f13f7ded3.png,348,362,446,456,98,94,red blood cell,9212,0.9591836734693877,1.0425531914893618
9864,/images/3859deaf-6ae1-49a3-9051-898d0f0d7de6.png,608,1365,693,1451,85,86,red blood cell,7310,1.011764705882353,0.9883720930232558
34096,/images/de5d19b7-e670-4ac7-843b-7ce7bcebdf45.png,1035,191,1132,287,97,96,red blood cell,9312,0.9896907216494846,1.0104166666666667
68453,/images/040112be-3c8d-49aa-93f1-522f94a592ff.png,733,1361,821,1437,88,76,red blood cell,6688,0.8636363636363636,1.1578947368421053
67064,/images/4272cbd7-5b0a-4bf7-b690-dee1c128f07b.png,885,36,990,143,105,107,red blood cell,11235,1.019047619047619,0.9813084112149533
64961,/images/dec61ae1-5037-4c3a-8952-15371becca7d.png,1047,387,1122,471,75,84,red blood cell,6300,1.12,0.8928571428571429
64426,/images/34a70114-d3e3-4351-b8db-f6caab17e743.png,274,348,394,466,120,118,red blood cell,14160,0.9833333333333333,1.0169491525423728
40623,/images/252071ac-e9f2-41d2-abbb-87ef01b8a997.png,7,380,96,460,89,80,red blood cell,7120,0.898876404494382,1.1125
3206,/images/c3215597-a032-46be-9058-d6de1e5191d7.png,179,778,298,886,119,108,red blood cell,12852,0.907563025210084,1.1018518518518519
68454,/images/040112be-3c8d-49aa-93f1-522f94a592ff.png,695,1383,779,1465,84,82,red blood cell,6888,0.9761904761904762,1.024390243902439
31915,/images/9eb66577-7857-43dc-a879-8f2c9d7f780f.png,212,1318,310,1408,98,90,red blood cell,8820,0.9183673469387755,1.0888888888888888
7467,/images/37a94c0f-e5d4-46fc-b4f8-994d477995fd.png,309,415,420,508,111,93,red blood cell,10323,0.8378378378378378,1.1935483870967742
67514,/images/45902b63-be9a-49ae-9ede-3a8015671bc4.png,1001,1376,1111,1472,110,96,red blood cell,10560,0.8727272727272727,1.1458333333333333
46900,/images/9e0e1928-d19a-4100-b093-0b962ac09e05.png,612,689,704,796,92,107,red blood cell,9844,1.1630434782608696,0.8598130841121495
24836,/images/93f7e207-0d8e-47f8-8258-09a0e03dbdd6.png,326,495,460,608,134,113,red blood cell,15142,0.8432835820895522,1.1858407079646018
48933,/images/5dec0204-af81-44ef-a942-8a173669c123.png,836,15,950,122,114,107,red blood cell,12198,0.9385964912280702,1.0654205607476634
34074,/images/de5d19b7-e670-4ac7-843b-7ce7bcebdf45.png,935,57,1029,161,94,104,red blood cell,9776,1.1063829787234043,0.9038461538461539
6395,/images/1ecb0405-a6e9-4485-819e-2fbbf2b718aa.png,192,1006,306,1120,114,114,red blood cell,12996,1.0,1.0
68647,/images/31653d0f-c4e6-4e12-8005-518c2de34687.png,893,431,976,512,83,81,red blood cell,6723,0.9759036144578314,1.0246913580246915
5929,/images/e0e6b676-c39c-4542-8adf-de257a8e92e2.png,259,1030,374,1148,115,118,red blood cell,13570,1.0260869565217392,0.9745762711864406
61102,/images/80da32ce-8c22-470e-9f35-558c5f7a5df9.png,472,905,590,1022,118,117,red blood cell,13806,0.9915254237288136,1.0085470085470085
38344,/images/674b0fd3-f247-4b7f-97f7-3e6c57c9ba9e.png,429,858,531,978,102,120,red blood cell,12240,1.1764705882352942,0.85
3188,/images/c3215597-a032-46be-9058-d6de1e5191d7.png,350,192,480,312,130,120,red blood cell,15600,0.9230769230769231,1.0833333333333333
74008,/images/99a21c5c-f5a7-4c07-9cb6-5dda2d388f48.png,967,1324,1058,1410,91,86,red blood cell,7826,0.945054945054945,1.058139534883721
78200,/images/2bed2796-75a9-4d93-bb2d-e3ccbe1a5cbe.png,544,903,651,1018,107,115,red blood cell,12305,1.074766355140187,0.9304347826086956
34596,/images/a0eedcb9-b85c-4612-b945-7e8227f53c35.png,423,360,521,455,98,95,red blood cell,9310,0.9693877551020408,1.0315789473684212
62297,/images/e0ff3476-226f-4125-b182-8e524d5503dd.png,756,214,875,326,119,112,red blood cell,13328,0.9411764705882353,1.0625
36502,/images/bd856928-96ee-4fc4-a377-f2fc4e84448b.png,595,1263,698,1355,103,92,red blood cell,9476,0.8932038834951457,1.1195652173913044
42411,/images/1a27ebe9-93a1-4898-af69-f276057d4012.png,1070,561,1196,675,126,114,red blood cell,14364,0.9047619047619048,1.105263157894737
52952,/images/e81bf478-27ff-458c-ac30-9e1f8480bc5c.png,773,1335,881,1423,108,88,red blood cell,9504,0.8148148148148148,1.2272727272727273
33721,/images/441d7843-b20b-4c10-84e3-e6d32621e880.png,206,138,307,261,101,123,red blood cell,12423,1.2178217821782178,0.8211382113821138
58743,/images/e4827c85-311a-4df1-89c2-99dad0c3558c.png,826,802,925,901,99,99,red blood cell,9801,1.0,1.0
18301,/images/9ca20b10-e2fd-4bd2-93ef-78298f763ed5.png,376,1337,491,1456,115,119,red blood cell,13685,1.0347826086956522,0.9663865546218487
37598,/images/205306da-0ed8-475a-ace6-f2f81d4be88a.png,558,21,647,121,89,100,red blood cell,8900,1.1235955056179776,0.89
29464,/images/8cc6fe77-5f2f-4670-b4ac-1b49550241a8.png,1092,923,1192,1031,100,108,red blood cell,10800,1.08,0.9259259259259259
33462,/images/9bd40bc6-4949-42d3-b38f-d60422932f65.png,935,1177,1056,1305,121,128,red blood cell,15488,1.0578512396694215,0.9453125
36509,/images/bd856928-96ee-4fc4-a377-f2fc4e84448b.png,425,923,547,1041,122,118,red blood cell,14396,0.9672131147540983,1.0338983050847457
66277,/images/e8058bed-c362-4e1c-85dc-62f80f32938f.png,808,673,912,782,104,109,red blood cell,11336,1.0480769230769231,0.9541284403669725
75177,/images/7fdc8be8-7579-4a5c-b369-8a07ee0a8b7d.png,563,1325,674,1421,111,96,red blood cell,10656,0.8648648648648649,1.15625
11868,/images/3cdcb09b-6a8c-43ca-b1d0-c1a289202f65.png,899,1433,1020,1543,121,110,red blood cell,13310,0.9090909090909091,1.1
31473,/images/6695a204-e39c-4418-b904-3f080fdbe7e8.png,695,203,819,315,124,112,red blood cell,13888,0.9032258064516129,1.1071428571428572
66007,/images/25c6cfb1-01d0-4864-87f9-02b7593683c7.png,1098,349,1187,444,89,95,red blood cell,8455,1.0674157303370786,0.9368421052631579
4209,/images/ac3358f1-ef9a-4ccc-b66c-da5e47e352e0.png,523,1006,659,1115,136,109,red blood cell,14824,0.8014705882352942,1.2477064220183487
64489,/images/6ba5d0b8-cdc7-4266-9d78-db76faa312e9.png,871,298,966,405,95,107,red blood cell,10165,1.1263157894736842,0.8878504672897196
52478,/images/a2a20600-f851-4db7-90f9-6f7be027c8b5.png,827,1251,936,1362,109,111,red blood cell,12099,1.018348623853211,0.9819819819819819
22199,/images/3d4d7ba7-6c7c-4ddd-b282-31fb5d80edb5.png,924,1092,1023,1182,99,90,red blood cell,8910,0.9090909090909091,1.1
39593,/images/04d21589-b777-43c2-86b5-038cbf8c3a4e.png,555,495,655,589,100,94,red blood cell,9400,0.94,1.0638297872340425
66290,/images/e8058bed-c362-4e1c-85dc-62f80f32938f.png,805,553,892,651,87,98,red blood cell,8526,1.1264367816091954,0.8877551020408163
14842,/images/f8b6a868-60e9-4569-ae69-638a0c39834d.png,834,1117,968,1247,134,130,red blood cell,17420,0.9701492537313433,1.0307692307692307
79201,/images/eb0173a3-7e5e-4f53-8124-03d9d6317844.png,744,514,879,639,135,125,red blood cell,16875,0.9259259259259259,1.08
14652,/images/9d155086-acf5-4c86-a9e1-94b587c46e87.png,1032,161,1133,269,101,108,red blood cell,10908,1.0693069306930694,0.9351851851851852
58373,/images/50f2f514-6c8e-4c79-b3b3-0be56dd0b78b.png,346,176,451,275,105,99,red blood cell,10395,0.9428571428571428,1.0606060606060606
20803,/images/c2ec116f-f091-422c-926c-70b548a8f6ef.png,629,1474,733,1574,104,100,red blood cell,10400,0.9615384615384616,1.04
27219,/images/9f38055f-4fe6-47fd-a6dd-c0743db4eccf.png,743,976,847,1083,104,107,red blood cell,11128,1.0288461538461537,0.9719626168224299
37853,/images/56a57a8d-c9b9-432a-a3b0-32a09355806c.png,923,246,1050,375,127,129,red blood cell,16383,1.015748031496063,0.9844961240310077
72097,/images/64b0e49a-0e48-447d-8872-c1dd255e7a21.png,471,761,555,857,84,96,red blood cell,8064,1.1428571428571428,0.875
75201,/images/61dfc937-a428-44b4-94fb-d682bdb8dff0.png,114,919,235,1036,121,117,red blood cell,14157,0.9669421487603306,1.0341880341880343
53470,/images/43158031-a335-4533-9c20-48bebba90123.png,888,656,1009,771,121,115,red blood cell,13915,0.9504132231404959,1.0521739130434782
70169,/images/b338766f-19b9-4874-bcc5-ae22b3c533e6.png,852,191,954,293,102,102,red blood cell,10404,1.0,1.0
38143,/images/33bdb7b5-ad5b-4a73-bbc2-3350f8c2ac0c.png,1004,101,1120,213,116,112,red blood cell,12992,0.9655172413793104,1.0357142857142858
56956,/images/a93c35ba-1690-4358-8837-669bcd850bb7.png,982,1119,1097,1233,115,114,red blood cell,13110,0.991304347826087,1.0087719298245614
61596,/images/4a717a39-80f8-4b75-a25e-c46d65d7dcd5.png,1061,183,1154,298,93,115,red blood cell,10695,1.2365591397849462,0.808695652173913
13816,/images/345cb914-7583-49df-96e3-3cf19c2ba8f1.png,210,1418,343,1544,133,126,red blood cell,16758,0.9473684210526315,1.0555555555555556
6015,/images/72732579-a812-4496-b2dd-ea1556924337.png,840,1413,959,1543,119,130,red blood cell,15470,1.0924369747899159,0.9153846153846154
16282,/images/d5009906-bce1-4353-90b4-f4c79362f4cf.png,426,587,537,691,111,104,red blood cell,11544,0.9369369369369369,1.0673076923076923
14823,/images/f8b6a868-60e9-4569-ae69-638a0c39834d.png,1070,1275,1196,1406,126,131,red blood cell,16506,1.0396825396825398,0.9618320610687023
50642,/images/c956e531-6805-4fe1-b61c-8b96a9815a77.png,294,548,402,660,108,112,red blood cell,12096,1.037037037037037,0.9642857142857143
44591,/images/6388e241-09a2-4fbe-a712-07d8fe714c51.png,1104,168,1200,274,96,106,red blood cell,10176,1.1041666666666667,0.9056603773584906
3784,/images/c9499a06-fb31-4552-a9e2-fb4ebb440859.png,874,695,1001,825,127,130,red blood cell,16510,1.0236220472440944,0.9769230769230769
47716,/images/afbb264e-ff60-443a-83f5-49d09be1b835.png,53,651,195,779,142,128,red blood cell,18176,0.9014084507042254,1.109375
46224,/images/d8632217-ec33-4d0a-98e6-427824c58869.png,338,1314,437,1421,99,107,red blood cell,10593,1.0808080808080809,0.9252336448598131
76484,/images/34df8890-272d-423a-ae78-ff8d068d3306.png,622,1301,703,1398,81,97,red blood cell,7857,1.1975308641975309,0.8350515463917526
51630,/images/d0347b49-8f98-4632-a384-1a4f57ac6374.png,402,484,497,581,95,97,red blood cell,9215,1.0210526315789474,0.979381443298969
22647,/images/4ab47131-c2ac-461f-b95c-ac19ce24edbd.png,236,657,335,764,99,107,red blood cell,10593,1.0808080808080809,0.9252336448598131
56546,/images/ac8df764-c8d8-4312-916d-70bfb37574b4.png,7,596,114,697,107,101,red blood cell,10807,0.9439252336448598,1.0594059405940595
32537,/images/318de807-7232-4ab1-843e-a901547c0125.png,219,1019,305,1117,86,98,red blood cell,8428,1.1395348837209303,0.8775510204081632
40457,/images/db249e5a-4142-432c-8288-bacd10d7273d.png,991,394,1088,499,97,105,red blood cell,10185,1.0824742268041236,0.9238095238095239
29847,/images/9cdee92c-6267-4188-a41e-125bc0abb9ae.png,1044,265,1161,383,117,118,red blood cell,13806,1.0085470085470085,0.9915254237288136
4,/images/8d02117d-6c71-4e47-b50a-6cc8d5eb1d55.png,198,881,312,1003,114,122,red blood cell,13908,1.0701754385964912,0.9344262295081968
79432,/images/dcb21739-3c36-459d-b3cc-1be5871d6fe7.png,316,1124,399,1217,83,93,red blood cell,7719,1.1204819277108433,0.8924731182795699
35198,/images/a9159b11-ba49-4885-902e-00c8d5095b98.png,77,1224,171,1324,94,100,red blood cell,9400,1.0638297872340425,0.94
4591,/images/f1de7c7e-e7d3-45ae-a66c-58538bf6cac1.png,36,113,144,229,108,116,red blood cell,12528,1.0740740740740742,0.9310344827586207
8284,/images/65e3d6a6-012c-4b40-9a42-83078eb85e31.png,416,668,512,773,96,105,red blood cell,10080,1.09375,0.9142857142857143
63226,/images/d3283f5b-3b3a-40ea-800b-79960ca851cb.png,493,449,592,554,99,105,red blood cell,10395,1.0606060606060606,0.9428571428571428
77266,/images/07a80340-f65e-4f58-9317-94bb6ebd5a28.png,547,234,651,357,104,123,red blood cell,12792,1.1826923076923077,0.8455284552845529
75146,/images/7fdc8be8-7579-4a5c-b369-8a07ee0a8b7d.png,248,223,360,341,112,118,red blood cell,13216,1.0535714285714286,0.9491525423728814
12874,/images/b10ea12f-cd36-4f2c-994a-67d1665269ab.png,1044,264,1145,370,101,106,red blood cell,10706,1.0495049504950495,0.9528301886792453
64422,/images/0a7bfa8a-ee52-4f7a-b9c5-2919ecfa93ef.png,950,92,1039,200,89,108,red blood cell,9612,1.2134831460674158,0.8240740740740741
14900,/images/3090a362-1f3d-49e9-a76e-ce76ff9c2276.png,497,1373,596,1486,99,113,red blood cell,11187,1.1414141414141414,0.8761061946902655
228,/images/2559636b-f01a-4414-93da-210c3b12d153.png,42,2,132,100,90,98,red blood cell,8820,1.0888888888888888,0.9183673469387755
25167,/images/90171428-f208-428a-b40e-f57ee3bea457.png,1048,1296,1155,1407,107,111,red blood cell,11877,1.0373831775700935,0.963963963963964
60789,/images/645cd195-af50-409f-8da9-6e7c7f18ea09.png,1002,29,1094,129,92,100,red blood cell,9200,1.0869565217391304,0.92
38578,/images/f8b14fc4-dd6b-4ad0-a96d-c62845f48681.png,221,110,337,221,116,111,red blood cell,12876,0.9568965517241379,1.045045045045045
78659,/images/fd1c4c7a-24bc-43f2-b84f-fee182207aee.png,776,317,880,425,104,108,red blood cell,11232,1.0384615384615385,0.9629629629629629
58544,/images/7fd2d254-b062-4f3d-8970-687e73c5a00a.png,80,592,197,705,117,113,red blood cell,13221,0.9658119658119658,1.0353982300884956
45611,/images/582e4b8b-404e-4b30-9df3-66f2afb3cdb3.png,814,594,946,720,132,126,red blood cell,16632,0.9545454545454546,1.0476190476190477
75320,/images/9ec1dcec-87c2-4aca-8e6b-0db3cd05509c.png,22,1325,117,1411,95,86,red blood cell,8170,0.9052631578947369,1.1046511627906976
68339,/images/0f735cca-051c-4048-a1fa-cb36f389e12f.png,780,185,867,292,87,107,red blood cell,9309,1.2298850574712643,0.8130841121495327
1988,/images/b95ceeeb-8870-4492-9037-2091ff268c5a.png,955,963,1093,1115,138,152,red blood cell,20976,1.1014492753623188,0.9078947368421053
2176,/images/e94a811d-3145-4313-ba42-2d5ed283179f.png,709,328,820,434,111,106,red blood cell,11766,0.954954954954955,1.0471698113207548
52581,/images/0546d843-d778-4aca-b8b5-bfe23d7c87da.png,231,880,330,983,99,103,red blood cell,10197,1.0404040404040404,0.9611650485436893
12219,/images/313ed8d9-3c00-4415-9de0-0eda07c60ad9.png,637,1402,763,1528,126,126,red blood cell,15876,1.0,1.0
57795,/images/c9ad92d4-b408-4506-916e-def47b2e6ed0.png,105,245,212,356,107,111,red blood cell,11877,1.0373831775700935,0.963963963963964
37726,/images/003a89b0-a095-417a-8dd6-f408339bbc68.png,1079,633,1194,748,115,115,red blood cell,13225,1.0,1.0
64602,/images/6dfafdf1-f588-4e80-8cf8-0126e1bf7af9.png,353,1431,467,1530,114,99,red blood cell,11286,0.868421052631579,1.1515151515151516
45631,/images/582e4b8b-404e-4b30-9df3-66f2afb3cdb3.png,99,1431,215,1547,116,116,red blood cell,13456,1.0,1.0
21723,/images/f68ae8e9-e760-4106-88e0-4bdef2785f06.png,680,1462,775,1570,95,108,red blood cell,10260,1.1368421052631579,0.8796296296296297
59614,/images/faead1c7-bb2c-4adf-bfce-9ff36cd2cf6a.png,855,203,982,314,127,111,red blood cell,14097,0.8740157480314961,1.1441441441441442
30241,/images/f81806a8-5883-446c-be78-f0145b12dbdd.png,825,147,961,275,136,128,red blood cell,17408,0.9411764705882353,1.0625
28147,/images/cd2774a0-dab2-4d68-aae9-7568b9f3d2a6.png,463,296,563,393,100,97,red blood cell,9700,0.97,1.0309278350515463
46927,/images/9e0e1928-d19a-4100-b093-0b962ac09e05.png,961,938,1075,1030,114,92,red blood cell,10488,0.8070175438596491,1.2391304347826086
7209,/images/89f10192-d3dd-4996-a571-4c851dbdc983.png,989,109,1110,228,121,119,red blood cell,14399,0.9834710743801653,1.0168067226890756
69890,/images/9edba799-e169-46cd-b100-c9f8fc7a8c7d.png,846,454,954,565,108,111,red blood cell,11988,1.0277777777777777,0.972972972972973
42897,/images/a7b6894d-eeea-4ed5-bc0e-785d6c6da8df.png,496,1183,631,1310,135,127,red blood cell,17145,0.9407407407407408,1.062992125984252
931,/images/a8cb75ba-3f2f-40d8-8bc7-c79ebd1b9603.png,995,70,1096,182,101,112,red blood cell,11312,1.108910891089109,0.9017857142857143
59369,/images/565513be-2c20-4ee3-94f3-093869515d3d.png,121,759,222,844,101,85,red blood cell,8585,0.8415841584158416,1.188235294117647
19737,/images/627d6331-7bb9-4d1a-b20d-e6541af4d0f9.png,43,1199,156,1316,113,117,red blood cell,13221,1.0353982300884956,0.9658119658119658
35764,/images/bb2042c5-35e1-43cc-8171-7de81b764361.png,1073,358,1187,464,114,106,red blood cell,12084,0.9298245614035088,1.0754716981132075
25067,/images/b02f6804-1697-4a5e-9be7-61931903ab55.png,686,546,795,672,109,126,red blood cell,13734,1.1559633027522935,0.8650793650793651
43394,/images/aabca37c-f9ef-4415-aab6-3246caa348e9.png,683,1452,804,1568,121,116,red blood cell,14036,0.9586776859504132,1.043103448275862
60241,/images/abf4cf2a-4532-4772-9f0f-9e123cc1713d.png,831,1065,950,1187,119,122,red blood cell,14518,1.0252100840336134,0.9754098360655737
20271,/images/c66cb6b2-1480-446a-a9d2-b8032a3de0d7.png,551,567,681,674,130,107,red blood cell,13910,0.823076923076923,1.2149532710280373
38952,/images/5939f341-a886-4f63-ae87-2219d000a1d4.png,5,40,120,183,115,143,red blood cell,16445,1.2434782608695651,0.8041958041958042
35669,/images/4063945d-03fc-4ce3-a04c-17435dce8f91.png,635,1270,743,1387,108,117,red blood cell,12636,1.0833333333333333,0.9230769230769231
24370,/images/4d8a4ce8-0f9c-4f21-8844-4cf0e5514bbf.png,659,1096,748,1203,89,107,red blood cell,9523,1.202247191011236,0.8317757009345794
45519,/images/94b5a9a1-1c88-4400-aca4-3d56f543fc4a.png,981,827,1084,938,103,111,red blood cell,11433,1.0776699029126213,0.9279279279279279
25926,/images/4811fdf2-d7e8-475e-a840-45dda5282bf3.png,82,452,193,590,111,138,red blood cell,15318,1.2432432432432432,0.8043478260869565
79305,/images/05ac7b2a-6a77-4464-926b-8570f7c01693.png,584,479,677,583,93,104,red blood cell,9672,1.118279569892473,0.8942307692307693
16108,/images/66557580-fd38-4d4b-80d8-88611ecc78c6.png,102,909,229,1018,127,109,red blood cell,13843,0.8582677165354331,1.165137614678899
33855,/images/b9de8b1a-f96a-4eb5-bc05-84ad43a054f3.png,515,1007,627,1117,112,110,red blood cell,12320,0.9821428571428571,1.018181818181818
33125,/images/6231d81d-9e84-4a5a-8cb8-47c6a37a0176.png,121,971,206,1065,85,94,red blood cell,7990,1.1058823529411765,0.9042553191489362
6020,/images/72732579-a812-4496-b2dd-ea1556924337.png,861,255,1004,382,143,127,red blood cell,18161,0.8881118881118881,1.125984251968504
64023,/images/03cbfcf2-8da6-462c-b30d-16d63357371f.png,1075,1334,1166,1437,91,103,red blood cell,9373,1.1318681318681318,0.883495145631068
40974,/images/bbe65c18-8a56-4dfe-875c-94e124a84125.png,945,84,1068,217,123,133,red blood cell,16359,1.08130081300813,0.924812030075188
55953,/images/afd39466-aafa-4d81-9520-483727418723.png,367,43,451,118,84,75,red blood cell,6300,0.8928571428571429,1.12
12581,/images/8e4bdd0d-1c72-4836-ae3e-05e2e50e4983.png,602,82,704,182,102,100,red blood cell,10200,0.9803921568627451,1.02
496,/images/f65a1633-9935-4984-a285-a60d30aa1707.png,37,889,151,1015,114,126,red blood cell,14364,1.105263157894737,0.9047619047619048
74536,/images/cbb58718-6319-48db-b84b-78ac9b12ff89.png,536,1107,619,1185,83,78,red blood cell,6474,0.9397590361445783,1.064102564102564
47340,/images/1dd3e6dd-343f-4cc9-b0ed-e4d27fb36f0a.png,938,87,1062,225,124,138,red blood cell,17112,1.1129032258064515,0.8985507246376812
24958,/images/ed0bee2f-05e0-4392-8357-19750cec577c.png,139,1054,229,1157,90,103,red blood cell,9270,1.1444444444444444,0.8737864077669902
61357,/images/e16c0dab-780d-4035-872e-1bb91e49f9d2.png,979,1283,1071,1388,92,105,red blood cell,9660,1.141304347826087,0.8761904761904762
42379,/images/1a27ebe9-93a1-4898-af69-f276057d4012.png,349,577,459,703,110,126,red blood cell,13860,1.1454545454545455,0.873015873015873
53226,/images/d8f7e159-b7e3-49e4-86e8-aed8c5fbcd97.png,316,1413,416,1509,100,96,red blood cell,9600,0.96,1.0416666666666667
20817,/images/c2ec116f-f091-422c-926c-70b548a8f6ef.png,894,1343,992,1442,98,99,red blood cell,9702,1.010204081632653,0.98989898989899
34097,/images/de5d19b7-e670-4ac7-843b-7ce7bcebdf45.png,1020,846,1115,939,95,93,red blood cell,8835,0.9789473684210527,1.021505376344086
37291,/images/2fdbd9bc-bbaf-44c2-b40c-d193709639fa.png,913,104,1032,211,119,107,red blood cell,12733,0.8991596638655462,1.1121495327102804
24643,/images/30948737-0d0d-4b68-b9ab-50577e0fe026.png,623,660,744,779,121,119,red blood cell,14399,0.9834710743801653,1.0168067226890756
42444,/images/29648565-fe28-4517-ba72-68df0c82c9c5.png,568,331,670,436,102,105,red blood cell,10710,1.0294117647058822,0.9714285714285714
15793,/images/64113b22-03b1-4ab8-89ab-b2f32154fbbd.png,457,27,582,145,125,118,red blood cell,14750,0.944,1.0593220338983051
48237,/images/71204a6d-814e-44b6-9cee-7b979f478021.png,505,1315,620,1433,115,118,red blood cell,13570,1.0260869565217392,0.9745762711864406
38029,/images/e3e9c2de-0a24-4c7e-8a69-3d3093d5bdab.png,24,856,121,952,97,96,red blood cell,9312,0.9896907216494846,1.0104166666666667
36344,/images/4a0a05e1-11ad-4bfc-bfa3-adf3b9bd0b56.png,125,459,226,573,101,114,red blood cell,11514,1.1287128712871286,0.8859649122807017
24551,/images/c03d9b87-e19b-402b-ad86-b30d6e8aeb59.png,550,1157,648,1262,98,105,red blood cell,10290,1.0714285714285714,0.9333333333333333
22646,/images/4ab47131-c2ac-461f-b95c-ac19ce24edbd.png,1012,262,1134,395,122,133,red blood cell,16226,1.0901639344262295,0.9172932330827067
3142,/images/729a38d6-66db-48e5-a00d-7d90d224290f.png,71,81,198,206,127,125,red blood cell,15875,0.984251968503937,1.016
47802,/images/5a105b89-c592-4d78-b208-7db6c6572752.png,114,501,209,607,95,106,red blood cell,10070,1.1157894736842104,0.8962264150943396
57423,/images/00d04a90-80e5-4bce-9511-1b64eabb7a47.png,961,324,1061,431,100,107,red blood cell,10700,1.07,0.9345794392523364
62080,/images/7f528918-27d4-421f-ab57-0cf9c693e697.png,323,1301,446,1418,123,117,red blood cell,14391,0.9512195121951219,1.0512820512820513
62896,/images/4b346035-b8c0-46ca-8fdb-a01b1421ee4a.png,837,917,935,1020,98,103,red blood cell,10094,1.0510204081632653,0.9514563106796117
3731,/images/dacf7e3f-1d8c-42a0-8539-3abe3971c956.png,503,64,632,191,129,127,red blood cell,16383,0.9844961240310077,1.015748031496063
71919,/images/61575482-91e1-4db9-83c7-687b7ddbbfc4.png,205,1337,303,1452,98,115,red blood cell,11270,1.1734693877551021,0.8521739130434782
71993,/images/6ad3efc9-4392-4cee-98a5-186564a96373.png,1071,1069,1176,1191,105,122,red blood cell,12810,1.161904761904762,0.860655737704918
63799,/images/6013bff0-dc4b-4bde-9409-0f6139c3495c.png,662,714,755,814,93,100,red blood cell,9300,1.075268817204301,0.93
33973,/images/701206c5-aaac-4b99-9cc0-4a6854359457.png,964,1383,1086,1496,122,113,red blood cell,13786,0.9262295081967213,1.079646017699115
25628,/images/770b8ca4-8377-479b-9ad5-5455ec3b44f8.png,1079,1434,1198,1553,119,119,red blood cell,14161,1.0,1.0
48741,/images/bc832bde-d3ea-4a8e-be90-7a3329dcc314.png,311,729,439,854,128,125,red blood cell,16000,0.9765625,1.024
2731,/images/a89cace5-c818-4f23-a432-052b3433b81e.png,537,404,652,524,115,120,red blood cell,13800,1.0434782608695652,0.9583333333333334
37863,/images/56a57a8d-c9b9-432a-a3b0-32a09355806c.png,586,1379,699,1486,113,107,red blood cell,12091,0.9469026548672567,1.0560747663551402
38227,/images/1d9d4dac-66f9-4c87-b714-d723d5b15fa9.png,1057,1119,1155,1237,98,118,red blood cell,11564,1.2040816326530612,0.8305084745762712
12221,/images/313ed8d9-3c00-4415-9de0-0eda07c60ad9.png,118,1464,243,1590,125,126,red blood cell,15750,1.008,0.9920634920634921
32638,/images/ed0d8763-e734-4506-b61b-53fc32a8d8c9.png,161,573,286,690,125,117,red blood cell,14625,0.936,1.0683760683760684
16892,/images/4823c1fe-a7f9-4b92-959f-0d9be09cd14b.png,894,1268,983,1378,89,110,red blood cell,9790,1.2359550561797752,0.8090909090909091
11732,/images/082e1f81-4f49-44ad-b5bb-9dfc155b2ed8.png,723,834,839,940,116,106,red blood cell,12296,0.9137931034482759,1.0943396226415094
75928,/images/3006096f-ceeb-42be-b69e-785179d7438b.png,1093,151,1200,257,107,106,red blood cell,11342,0.9906542056074766,1.009433962264151
42769,/images/7c68c343-a7d3-4d26-b330-a5bb97ab8d9c.png,669,862,781,973,112,111,red blood cell,12432,0.9910714285714286,1.009009009009009
55462,/images/d67655e6-0a80-4a86-b552-1f5e85788377.png,815,1491,931,1600,116,109,red blood cell,12644,0.9396551724137931,1.0642201834862386
34385,/images/1a48cbc1-5423-47e5-8ca5-2ab4f83a05a5.png,645,212,752,324,107,112,red blood cell,11984,1.0467289719626167,0.9553571428571429
46514,/images/dd944a6b-c1d3-4f9f-bbdc-3709707984f7.png,688,1411,803,1525,115,114,red blood cell,13110,0.991304347826087,1.0087719298245614
70004,/images/3e36698f-8c09-4c8b-8948-737310bf97e5.png,583,1087,682,1187,99,100,red blood cell,9900,1.0101010101010102,0.99
36202,/images/17c06a23-bb77-49cb-9ffb-fbfc75fcc715.png,35,251,145,356,110,105,red blood cell,11550,0.9545454545454546,1.0476190476190477
46793,/images/63055d1b-5221-4c80-8b39-37ac069a1b5c.png,833,622,926,723,93,101,red blood cell,9393,1.086021505376344,0.9207920792079208
65927,/images/d7581cb0-7a12-471d-a3d8-68dcea362213.png,320,1,424,107,104,106,red blood cell,11024,1.0192307692307692,0.9811320754716981
45934,/images/0d098413-6911-4535-b70a-3c3effd8cf49.png,460,846,574,964,114,118,red blood cell,13452,1.0350877192982457,0.9661016949152542
40688,/images/252071ac-e9f2-41d2-abbb-87ef01b8a997.png,662,877,756,978,94,101,red blood cell,9494,1.074468085106383,0.9306930693069307
72330,/images/ee57e743-a876-4f69-9fe5-bf5d01b44689.png,138,823,238,907,100,84,red blood cell,8400,0.84,1.1904761904761905
40331,/images/eb86033f-4f1c-4e8c-ae84-e8e4c7e08626.png,811,1074,915,1185,104,111,red blood cell,11544,1.0673076923076923,0.9369369369369369
40090,/images/6fd30823-3b77-40c9-ba5d-e1eda9660674.png,377,867,488,987,111,120,red blood cell,13320,1.0810810810810811,0.925
79794,/images/fc15659f-6264-4dd5-ab17-43d89fb297b9.png,792,1339,905,1445,113,106,red blood cell,11978,0.9380530973451328,1.0660377358490567
29477,/images/8cc6fe77-5f2f-4670-b4ac-1b49550241a8.png,934,704,1040,811,106,107,red blood cell,11342,1.009433962264151,0.9906542056074766
75723,/images/d12c5f45-6b20-46d6-a66f-c5a4683c25b3.png,581,1393,686,1504,105,111,red blood cell,11655,1.0571428571428572,0.9459459459459459
27720,/images/e3c1442a-717f-41dd-bf97-81e1233ac9fa.png,180,1052,272,1156,92,104,red blood cell,9568,1.1304347826086956,0.8846153846153846
42689,/images/3abbc4d3-1d7e-40c9-9963-33732da7cc50.png,450,358,525,446,75,88,red blood cell,6600,1.1733333333333333,0.8522727272727273
25205,/images/90171428-f208-428a-b40e-f57ee3bea457.png,330,183,426,267,96,84,red blood cell,8064,0.875,1.1428571428571428
76463,/images/34df8890-272d-423a-ae78-ff8d068d3306.png,767,412,863,494,96,82,red blood cell,7872,0.8541666666666666,1.170731707317073
30018,/images/deeaa5b3-3895-4aec-a2ce-ed6404862cdf.png,158,396,279,516,121,120,red blood cell,14520,0.9917355371900827,1.0083333333333333
49833,/images/5e17f8e6-fd8d-426c-b444-1515d14f04b7.png,76,1289,165,1371,89,82,red blood cell,7298,0.9213483146067416,1.0853658536585367
55701,/images/c32b8bb8-c89d-4ae9-9c77-5b9356ca35a1.png,857,80,965,172,108,92,red blood cell,9936,0.8518518518518519,1.173913043478261
60706,/images/45651e76-4bd0-45e5-895b-edec65f51987.png,223,110,333,218,110,108,red blood cell,11880,0.9818181818181818,1.0185185185185186
541,/images/67acd5bc-4658-4c6e-a9b9-cd8ea3a03418.png,20,994,150,1107,130,113,red blood cell,14690,0.8692307692307693,1.1504424778761062
63167,/images/f0804a5e-e7f5-4cf2-a5df-b65e66502bf1.png,84,1135,217,1244,133,109,red blood cell,14497,0.8195488721804511,1.2201834862385321
78528,/images/c94827ce-d619-4705-a68a-df63a2c95ffa.png,330,1458,445,1556,115,98,red blood cell,11270,0.8521739130434782,1.1734693877551021
75142,/images/7fdc8be8-7579-4a5c-b369-8a07ee0a8b7d.png,819,647,908,735,89,88,red blood cell,7832,0.9887640449438202,1.0113636363636365
22787,/images/8490c623-3d88-4532-baf5-0d266a45b16f.png,704,649,788,751,84,102,red blood cell,8568,1.2142857142857142,0.8235294117647058
45734,/images/584d62ed-4329-45dd-94ce-e929d8b2bb74.png,968,786,1060,886,92,100,red blood cell,9200,1.0869565217391304,0.92
54071,/images/d9345456-b76d-46cc-b81e-46d4a0a7b652.png,682,762,788,885,106,123,red blood cell,13038,1.1603773584905661,0.8617886178861789
57188,/images/7c870293-2665-4a6b-a4fa-336959051dfc.png,185,1095,304,1208,119,113,red blood cell,13447,0.9495798319327731,1.0530973451327434
59126,/images/4736f545-1f1f-4d77-9241-d69cbf4dae35.png,502,678,617,789,115,111,red blood cell,12765,0.9652173913043478,1.0360360360360361
60097,/images/e63e1607-f344-43d6-a0d8-e10cf2e5054a.png,1084,1314,1195,1427,111,113,red blood cell,12543,1.018018018018018,0.9823008849557522
56272,/images/6b473806-e936-4b19-98cf-a2b94cac35ff.png,910,272,1008,378,98,106,red blood cell,10388,1.0816326530612246,0.9245283018867925
5610,/images/75c243e2-610d-4d5a-bc5a-4c53d99d9ae9.png,139,476,252,610,113,134,red blood cell,15142,1.1858407079646018,0.8432835820895522
22008,/images/c5acd0ad-b0f2-478d-b0ad-5aa733aa7b32.png,585,95,694,206,109,111,red blood cell,12099,1.018348623853211,0.9819819819819819
1880,/images/8855c685-5a8c-4967-a356-942ed89e3471.png,395,548,511,655,116,107,red blood cell,12412,0.9224137931034483,1.0841121495327102
19739,/images/68e69cfb-1a07-48d2-8abe-46b46fe264ed.png,717,800,817,914,100,114,red blood cell,11400,1.14,0.8771929824561403
75955,/images/034c8d57-04d5-4786-93a4-6ae8fde2c258.png,231,864,326,950,95,86,red blood cell,8170,0.9052631578947369,1.1046511627906976
76627,/images/4184a235-d209-4151-86e9-6c77e7938dab.png,370,819,465,926,95,107,red blood cell,10165,1.1263157894736842,0.8878504672897196
52744,/images/9dc6ed5d-6698-48cf-aab3-fd156673729c.png,478,133,590,231,112,98,red blood cell,10976,0.875,1.1428571428571428
39592,/images/04d21589-b777-43c2-86b5-038cbf8c3a4e.png,287,480,383,575,96,95,red blood cell,9120,0.9895833333333334,1.0105263157894737
72557,/images/01b99da8-b66b-464b-a7ee-1cadab8db18b.png,1047,705,1164,822,117,117,red blood cell,13689,1.0,1.0
4159,/images/ac3358f1-ef9a-4ccc-b66c-da5e47e352e0.png,55,680,177,805,122,125,red blood cell,15250,1.0245901639344261,0.976
21948,/images/d57b3894-c912-47e8-b00a-e1a2a7aba644.png,452,1297,561,1410,109,113,red blood cell,12317,1.036697247706422,0.9646017699115044
65991,/images/25c6cfb1-01d0-4864-87f9-02b7593683c7.png,368,292,471,397,103,105,red blood cell,10815,1.0194174757281553,0.9809523809523809
72424,/images/a15e0fa8-2620-4f66-896e-175115c9dc3d.png,695,1272,793,1377,98,105,red blood cell,10290,1.0714285714285714,0.9333333333333333
31980,/images/9eb66577-7857-43dc-a879-8f2c9d7f780f.png,613,1138,714,1239,101,101,red blood cell,10201,1.0,1.0
79378,/images/dcb21739-3c36-459d-b3cc-1be5871d6fe7.png,584,234,666,324,82,90,red blood cell,7380,1.0975609756097562,0.9111111111111111
48073,/images/1d4f06e1-9c9b-487e-84cd-e7e50cc754da.png,357,158,481,271,124,113,red blood cell,14012,0.9112903225806451,1.0973451327433628
44461,/images/edd3862f-04e1-49cf-97dd-ca566d17e71a.png,229,1185,352,1301,123,116,red blood cell,14268,0.943089430894309,1.0603448275862069
2273,/images/fe851c88-692d-4199-87e0-d19d9c4eb591.png,404,1372,500,1479,96,107,red blood cell,10272,1.1145833333333333,0.897196261682243
67647,/images/59542a24-b409-4c95-8608-d9691a741526.png,434,297,527,383,93,86,red blood cell,7998,0.9247311827956989,1.0813953488372092
32167,/images/25cfca07-2101-484f-b312-a927395f2651.png,695,168,831,286,136,118,red blood cell,16048,0.8676470588235294,1.152542372881356
75112,/images/073c10c9-5749-44b5-b08b-1be556a960f0.png,688,759,777,852,89,93,red blood cell,8277,1.0449438202247192,0.956989247311828
49579,/images/bd7937db-fca2-44d0-8538-460110210927.png,512,658,650,772,138,114,red blood cell,15732,0.8260869565217391,1.2105263157894737
23170,/images/c94a5851-b846-4fde-8c89-05bec3a8ac53.png,883,92,999,192,116,100,red blood cell,11600,0.8620689655172413,1.16
41219,/images/eed298b3-35f2-4127-88ad-0c4a9062207b.png,438,725,534,830,96,105,red blood cell,10080,1.09375,0.9142857142857143
18934,/images/e9e78ff8-831b-46e9-9785-3eee9acbfcd8.png,575,296,655,385,80,89,red blood cell,7120,1.1125,0.898876404494382
19070,/images/6e39fb0a-aa41-4b16-b783-7589e97bf289.png,776,379,890,492,114,113,red blood cell,12882,0.9912280701754386,1.008849557522124
18971,/images/e9e78ff8-831b-46e9-9785-3eee9acbfcd8.png,750,1235,847,1339,97,104,red blood cell,10088,1.0721649484536082,0.9326923076923077
3110,/images/14efbfc8-39f6-4599-9994-a8cc95605b9c.png,410,523,547,650,137,127,red blood cell,17399,0.927007299270073,1.078740157480315
49488,/images/9f33e0ea-065b-4703-9df9-15829b891860.png,518,1152,633,1267,115,115,red blood cell,13225,1.0,1.0
10700,/images/20d4f65e-6c63-433a-935c-d568d577967b.png,697,859,784,960,87,101,red blood cell,8787,1.160919540229885,0.8613861386138614
74964,/images/b4c52960-bbee-439e-83dc-f89ddaade71b.png,638,861,764,982,126,121,red blood cell,15246,0.9603174603174603,1.0413223140495869
1651,/images/5f783f43-0090-4f8a-bd75-9562f4aa2dd5.png,107,926,223,1033,116,107,red blood cell,12412,0.9224137931034483,1.0841121495327102
13931,/images/de00f9a5-aa8b-4679-8ec6-85528a942d6f.png,610,1110,735,1251,125,141,red blood cell,17625,1.128,0.8865248226950354
43206,/images/fe1ee954-ba71-47b3-954a-d20ab940cd7b.png,208,480,318,586,110,106,red blood cell,11660,0.9636363636363636,1.0377358490566038
24651,/images/30948737-0d0d-4b68-b9ab-50577e0fe026.png,882,89,1004,214,122,125,red blood cell,15250,1.0245901639344261,0.976
29223,/images/6274fe0d-0d71-40be-b61b-f0bd5b5df1e2.png,194,233,273,322,79,89,red blood cell,7031,1.1265822784810127,0.8876404494382022
55294,/images/4fb83278-adc5-4424-9f45-b6d0db2955b6.png,800,91,902,204,102,113,red blood cell,11526,1.107843137254902,0.9026548672566371
43619,/images/a4851ed0-1499-4eae-9157-dcd34773254f.png,870,220,970,333,100,113,red blood cell,11300,1.13,0.8849557522123894
42429,/images/1a27ebe9-93a1-4898-af69-f276057d4012.png,651,749,759,877,108,128,red blood cell,13824,1.1851851851851851,0.84375
21899,/images/d57b3894-c912-47e8-b00a-e1a2a7aba644.png,16,1015,122,1142,106,127,red blood cell,13462,1.1981132075471699,0.8346456692913385
70108,/images/c742ee2c-6814-46cd-af56-ae87bb9972f4.png,528,287,619,381,91,94,red blood cell,8554,1.032967032967033,0.9680851063829787
30800,/images/93a306b8-594a-4c7f-8b4a-127fb6ad8f1a.png,699,1445,816,1558,117,113,red blood cell,13221,0.9658119658119658,1.0353982300884956
9091,/images/21c2a8aa-407c-4569-8212-96fcafa84138.png,84,887,231,1011,147,124,red blood cell,18228,0.8435374149659864,1.185483870967742
56178,/images/137d540f-d71e-47e8-bd9b-6cd0a6433c33.png,439,512,536,598,97,86,red blood cell,8342,0.8865979381443299,1.127906976744186
34024,/images/1012abf2-cb05-4337-86c5-513ec4ca904d.png,389,554,488,647,99,93,red blood cell,9207,0.9393939393939394,1.064516129032258
1407,/images/6d91d1f0-636b-4f5a-a526-7c17fc857190.png,267,1076,357,1159,90,83,red blood cell,7470,0.9222222222222223,1.0843373493975903
64625,/images/6dfafdf1-f588-4e80-8cf8-0126e1bf7af9.png,476,829,591,924,115,95,red blood cell,10925,0.8260869565217391,1.2105263157894737
63025,/images/f234a2de-f3c8-4521-a306-8cfdf52dd597.png,68,1183,156,1274,88,91,red blood cell,8008,1.0340909090909092,0.967032967032967
47641,/images/4b3a49bc-8536-4760-9553-440a6f64db37.png,845,1396,948,1507,103,111,red blood cell,11433,1.0776699029126213,0.9279279279279279
23367,/images/a7688988-2bcc-4458-83d3-5e482da5f87b.png,405,1098,507,1196,102,98,red blood cell,9996,0.9607843137254902,1.0408163265306123
5003,/images/b7d0ae11-a393-4aec-8f68-6ba07147f78a.png,287,1476,397,1599,110,123,red blood cell,13530,1.1181818181818182,0.8943089430894309
67693,/images/2b128a1a-95ed-408b-b9f8-8795cc814d80.png,375,1330,484,1447,109,117,red blood cell,12753,1.073394495412844,0.9316239316239316
13325,/images/030f3421-ed3f-4bf1-8f27-4d02590bffbc.png,419,1188,496,1269,77,81,red blood cell,6237,1.051948051948052,0.9506172839506173
916,/images/dce55b59-c6c3-4693-aa75-6b348c8f52cd.png,812,527,898,622,86,95,red blood cell,8170,1.1046511627906976,0.9052631578947369
73372,/images/c890ee00-daa5-4b20-9cd5-930748ecc4e0.png,929,846,1034,948,105,102,red blood cell,10710,0.9714285714285714,1.0294117647058822
5238,/images/729733ff-a349-4a96-b636-ccabe7d7e167.png,255,1355,366,1476,111,121,red blood cell,13431,1.09009009009009,0.9173553719008265
60862,/images/11b72c7b-5c52-44b7-adb7-21eacc25e441.png,660,1062,753,1158,93,96,red blood cell,8928,1.032258064516129,0.96875
16860,/images/4823c1fe-a7f9-4b92-959f-0d9be09cd14b.png,729,917,812,996,83,79,red blood cell,6557,0.9518072289156626,1.0506329113924051
7675,/images/9f959520-e15e-45c2-bc29-ef3c19154d1c.png,396,402,505,505,109,103,red blood cell,11227,0.944954128440367,1.058252427184466
49941,/images/05804cf0-f854-4099-97c2-df287f7c8a8c.png,663,1213,772,1321,109,108,red blood cell,11772,0.9908256880733946,1.0092592592592593
53674,/images/6f67a66b-56ec-4c36-ae7c-f250d3b86a23.png,490,1146,594,1256,104,110,red blood cell,11440,1.0576923076923077,0.9454545454545454
33185,/images/6231d81d-9e84-4a5a-8cb8-47c6a37a0176.png,1084,978,1170,1083,86,105,red blood cell,9030,1.2209302325581395,0.819047619047619
24638,/images/30948737-0d0d-4b68-b9ab-50577e0fe026.png,315,1413,440,1527,125,114,red blood cell,14250,0.912,1.0964912280701755
14774,/images/1fdf99d1-a494-4174-bcd7-efbe457ab899.png,107,145,231,266,124,121,red blood cell,15004,0.9758064516129032,1.024793388429752
74406,/images/06a3effb-996c-4767-afd2-6aa3b697cb4e.png,727,497,823,603,96,106,red blood cell,10176,1.1041666666666667,0.9056603773584906
15583,/images/169d541c-daed-468e-8b41-0f1abccdf319.png,1019,359,1143,478,124,119,red blood cell,14756,0.9596774193548387,1.0420168067226891
68559,/images/32700bc7-7a86-49d3-aded-ccaaed4ddc5c.png,699,1438,809,1538,110,100,red blood cell,11000,0.9090909090909091,1.1
46108,/images/72088c26-d2dd-4906-b791-b8947fc7fbe4.png,526,1461,620,1559,94,98,red blood cell,9212,1.0425531914893618,0.9591836734693877
25071,/images/b02f6804-1697-4a5e-9be7-61931903ab55.png,592,1020,725,1134,133,114,red blood cell,15162,0.8571428571428571,1.1666666666666667
66773,/images/334bf865-e3fb-4200-bd53-d9ff5808ed9f.png,938,340,1022,435,84,95,red blood cell,7980,1.130952380952381,0.8842105263157894
79681,/images/a4409217-be11-4478-90a5-b406057d154d.png,1035,247,1139,357,104,110,red blood cell,11440,1.0576923076923077,0.9454545454545454
64927,/images/dec61ae1-5037-4c3a-8952-15371becca7d.png,84,367,177,468,93,101,red blood cell,9393,1.086021505376344,0.9207920792079208
52318,/images/a86e0647-ae41-4b75-9d45-dd58f5ea65f5.png,1048,848,1157,948,109,100,red blood cell,10900,0.9174311926605505,1.09
38663,/images/b5acf759-1115-42f0-a753-656736192528.png,95,682,193,787,98,105,red blood cell,10290,1.0714285714285714,0.9333333333333333
13735,/images/1b369bcf-ced4-4ae2-9196-2664bd2b1738.png,959,676,1068,797,109,121,red blood cell,13189,1.110091743119266,0.9008264462809917
42241,/images/ca734448-0d52-42fa-b41c-17b2939e58ae.png,783,185,891,293,108,108,red blood cell,11664,1.0,1.0
70645,/images/7521ec48-57b5-48a8-a5d6-8280ad5da19c.png,204,961,297,1072,93,111,red blood cell,10323,1.1935483870967742,0.8378378378378378
41841,/images/c3b07675-9d02-477c-91fe-f0737867049b.png,325,437,443,556,118,119,red blood cell,14042,1.0084745762711864,0.9915966386554622
74920,/images/dd090806-e4ac-4a78-b2ee-55a30626369c.png,775,761,870,866,95,105,red blood cell,9975,1.105263157894737,0.9047619047619048
22935,/images/ecd68ba2-48af-4866-826a-7cd1c147c055.png,329,825,443,942,114,117,red blood cell,13338,1.0263157894736843,0.9743589743589743
11094,/images/98175327-da9e-4e0c-8912-ee68490a4672.png,595,397,704,499,109,102,red blood cell,11118,0.9357798165137615,1.0686274509803921
26047,/images/71925778-a26e-483e-a07c-f3aaf740122a.png,159,1436,264,1556,105,120,red blood cell,12600,1.1428571428571428,0.875
28275,/images/ffd59802-46c6-4b58-80fe-e534e39781a7.png,1001,54,1106,157,105,103,red blood cell,10815,0.9809523809523809,1.0194174757281553
45393,/images/e4eea7ea-8989-46a9-9c98-25a178146b28.png,263,1136,372,1228,109,92,red blood cell,10028,0.8440366972477065,1.184782608695652
51579,/images/d0347b49-8f98-4632-a384-1a4f57ac6374.png,106,1316,208,1430,102,114,red blood cell,11628,1.1176470588235294,0.8947368421052632
47577,/images/06cd484f-e864-4fee-8819-688b45eed98e.png,437,1061,555,1177,118,116,red blood cell,13688,0.9830508474576272,1.0172413793103448
36146,/images/749df49e-5212-49ea-9e88-7d66f258f1df.png,227,1324,345,1431,118,107,red blood cell,12626,0.9067796610169492,1.102803738317757
14668,/images/9d155086-acf5-4c86-a9e1-94b587c46e87.png,768,351,862,466,94,115,red blood cell,10810,1.2234042553191489,0.8173913043478261
73192,/images/85546330-4efd-43e2-87aa-d53a30220bfc.png,387,1071,500,1170,113,99,red blood cell,11187,0.8761061946902655,1.1414141414141414
22192,/images/ca677c3c-083f-4d54-9dec-39f79f6a17d8.png,590,349,680,456,90,107,red blood cell,9630,1.1888888888888889,0.8411214953271028
4684,/images/b91b1641-ee06-44d8-94cc-24cdb583cc37.png,171,1135,289,1258,118,123,red blood cell,14514,1.0423728813559323,0.959349593495935
41033,/images/e871f52c-77a6-4813-80d4-95bd97985f1a.png,11,1416,122,1529,111,113,red blood cell,12543,1.018018018018018,0.9823008849557522
58914,/images/8a7deb24-d2b4-4acf-86c4-3aadd39157fa.png,300,1444,425,1559,125,115,red blood cell,14375,0.92,1.0869565217391304
72265,/images/ee57e743-a876-4f69-9fe5-bf5d01b44689.png,1044,1152,1151,1251,107,99,red blood cell,10593,0.9252336448598131,1.0808080808080809
22459,/images/99d6a7e5-128e-4455-841d-8fbd1663905e.png,1071,1354,1199,1476,128,122,red blood cell,15616,0.953125,1.0491803278688525
21493,/images/7625dfc4-858a-4c8e-907c-8943d665e9a7.png,1072,1293,1179,1417,107,124,red blood cell,13268,1.158878504672897,0.8629032258064516
33990,/images/701206c5-aaac-4b99-9cc0-4a6854359457.png,883,315,1012,431,129,116,red blood cell,14964,0.8992248062015504,1.1120689655172413
1603,/images/7094c11a-1e62-4f98-894e-d17d138a88e9.png,30,26,141,143,111,117,red blood cell,12987,1.054054054054054,0.9487179487179487
28460,/images/c3042130-a6e2-458f-9fde-bb012f68f5f2.png,580,1219,707,1342,127,123,red blood cell,15621,0.968503937007874,1.032520325203252
40435,/images/db249e5a-4142-432c-8288-bacd10d7273d.png,323,1260,443,1384,120,124,red blood cell,14880,1.0333333333333334,0.967741935483871
64849,/images/a74b6d6a-7e04-40ac-9292-d62f13f7ded3.png,529,71,637,170,108,99,red blood cell,10692,0.9166666666666666,1.0909090909090908
13782,/images/1b369bcf-ced4-4ae2-9196-2664bd2b1738.png,819,1272,950,1401,131,129,red blood cell,16899,0.9847328244274809,1.0155038759689923
29555,/images/8cc6fe77-5f2f-4670-b4ac-1b49550241a8.png,465,1260,573,1360,108,100,red blood cell,10800,0.9259259259259259,1.08
10970,/images/c442e2d6-aaf9-417a-9905-4737a1115f33.png,991,458,1100,566,109,108,red blood cell,11772,0.9908256880733946,1.0092592592592593
76884,/images/2165fe38-b474-467d-be11-d1d728085efd.png,574,480,672,581,98,101,red blood cell,9898,1.030612244897959,0.9702970297029703
17849,/images/eb77e4a9-acb0-4d83-8055-2c5fcaa54b45.png,451,452,561,551,110,99,red blood cell,10890,0.9,1.1111111111111112
66991,/images/3b4440f7-a69b-4042-a9d0-d6958abcdf4e.png,2,1209,97,1321,95,112,red blood cell,10640,1.1789473684210525,0.8482142857142857
18087,/images/947348fe-4c70-468e-8009-3c14daeca69b.png,820,864,926,968,106,104,red blood cell,11024,0.9811320754716981,1.0192307692307692
65499,/images/da49db57-0c2f-4213-b322-c88c19fb9296.png,70,203,166,307,96,104,red blood cell,9984,1.0833333333333333,0.9230769230769231
59550,/images/6bfe6a90-8a69-4171-8e7f-42dc9417c6d9.png,768,318,848,402,80,84,red blood cell,6720,1.05,0.9523809523809523
62810,/images/631340cc-cedf-4bca-a3d8-a0731a5482b4.png,384,1244,480,1350,96,106,red blood cell,10176,1.1041666666666667,0.9056603773584906
65043,/images/ff3b9d4d-373c-48ef-a75a-d23e2c2ade87.png,1082,1194,1172,1294,90,100,red blood cell,9000,1.1111111111111112,0.9
75204,/images/61dfc937-a428-44b4-94fb-d682bdb8dff0.png,140,1437,243,1533,103,96,red blood cell,9888,0.9320388349514563,1.0729166666666667
67773,/images/48e2f0bd-2164-40c3-af43-1f2708359978.png,347,703,432,782,85,79,red blood cell,6715,0.9294117647058824,1.0759493670886076
58665,/images/a4d7a7e1-5ae1-486d-b6ee-c9af1476ccad.png,1065,636,1150,717,85,81,red blood cell,6885,0.9529411764705882,1.0493827160493827
37950,/images/56a57a8d-c9b9-432a-a3b0-32a09355806c.png,862,832,956,932,94,100,red blood cell,9400,1.0638297872340425,0.94
59068,/images/5e2cea49-0823-49d1-83cf-8fd1559cdd93.png,733,884,839,989,106,105,red blood cell,11130,0.9905660377358491,1.0095238095238095
4699,/images/b91b1641-ee06-44d8-94cc-24cdb583cc37.png,521,1161,650,1275,129,114,red blood cell,14706,0.8837209302325582,1.131578947368421
42407,/images/1a27ebe9-93a1-4898-af69-f276057d4012.png,877,1255,1007,1384,130,129,red blood cell,16770,0.9923076923076923,1.0077519379844961
7497,/images/37a94c0f-e5d4-46fc-b4f8-994d477995fd.png,832,132,948,226,116,94,red blood cell,10904,0.8103448275862069,1.2340425531914894
51381,/images/b4f3b2a4-f4b9-48de-ac5d-0e681b77be27.png,554,1462,677,1561,123,99,red blood cell,12177,0.8048780487804879,1.2424242424242424
57583,/images/8190ec37-9a5e-419f-89ed-fbfb079370db.png,570,495,662,576,92,81,red blood cell,7452,0.8804347826086957,1.1358024691358024
6367,/images/f06ba705-5509-479b-8067-127ffb37c5b6.png,750,755,869,861,119,106,red blood cell,12614,0.8907563025210085,1.1226415094339623
6679,/images/95fea6d8-413f-421e-b331-5d51c31df150.png,793,1053,907,1175,114,122,red blood cell,13908,1.0701754385964912,0.9344262295081968
32302,/images/1c406ce1-023b-47fc-a2cd-5ea2e255de65.png,914,215,1032,337,118,122,red blood cell,14396,1.0338983050847457,0.9672131147540983
71485,/images/191071ab-6515-428c-9f05-8e4309542b75.png,872,1030,964,1132,92,102,red blood cell,9384,1.108695652173913,0.9019607843137255
27149,/images/f232eec3-02c0-43f9-bf32-3e60245397e2.png,125,1162,250,1292,125,130,red blood cell,16250,1.04,0.9615384615384616
63335,/images/9f4bc3b4-abb0-4bcb-baa8-ec9f25e2b9c6.png,366,259,467,350,101,91,red blood cell,9191,0.900990099009901,1.10989010989011
673,/images/e61e6af2-7f8b-47b0-bbe7-acb2ed0299ab.png,276,1489,385,1598,109,109,red blood cell,11881,1.0,1.0
19755,/images/68e69cfb-1a07-48d2-8abe-46b46fe264ed.png,841,54,954,149,113,95,red blood cell,10735,0.8407079646017699,1.1894736842105262
15366,/images/035f6c4b-0897-46ab-9c3b-5f3b0feff043.png,649,719,755,833,106,114,red blood cell,12084,1.0754716981132075,0.9298245614035088
35886,/images/33068c1a-48f7-470b-8e49-e2f0888042e9.png,774,461,889,582,115,121,red blood cell,13915,1.0521739130434782,0.9504132231404959
58376,/images/50f2f514-6c8e-4c79-b3b3-0be56dd0b78b.png,0,1259,132,1379,132,120,red blood cell,15840,0.9090909090909091,1.1
48513,/images/f3d84be2-8af0-4d62-9f72-23d3dc08cbbe.png,82,616,204,733,122,117,red blood cell,14274,0.9590163934426229,1.0427350427350428
47570,/images/06cd484f-e864-4fee-8819-688b45eed98e.png,75,36,208,179,133,143,red blood cell,19019,1.0751879699248121,0.9300699300699301
53906,/images/540a5fee-175b-4b92-bf62-1ea9b59c86c6.png,953,229,1045,318,92,89,red blood cell,8188,0.967391304347826,1.0337078651685394
70686,/images/8ab5c462-045e-4b59-b53a-9b2bc3ed2487.png,493,344,610,454,117,110,red blood cell,12870,0.9401709401709402,1.0636363636363637
72225,/images/7d4d0646-26b5-46fa-ab25-452d986e887b.png,40,1371,118,1455,78,84,red blood cell,6552,1.0769230769230769,0.9285714285714286
8709,/images/92e4fd7b-79ef-49c2-a52b-9ef13dd720ef.png,338,1042,469,1158,131,116,red blood cell,15196,0.8854961832061069,1.1293103448275863
69269,/images/f274b784-b995-4a7e-a2c2-6cc31c24c4b4.png,203,722,304,831,101,109,red blood cell,11009,1.0792079207920793,0.926605504587156
11685,/images/0ed416f9-7c20-4829-9016-559e4009568e.png,852,660,960,780,108,120,red blood cell,12960,1.1111111111111112,0.9
35060,/images/67582df6-bf13-4c83-a531-1214692b70de.png,376,1385,481,1498,105,113,red blood cell,11865,1.0761904761904761,0.9292035398230089
36551,/images/21f001d6-f568-4ea4-82da-fab54c77c419.png,606,549,718,654,112,105,red blood cell,11760,0.9375,1.0666666666666667
7833,/images/1493d140-c9d5-4c3a-9caf-3eafb290a49b.png,993,684,1090,793,97,109,red blood cell,10573,1.1237113402061856,0.8899082568807339
57289,/images/aaade430-4c49-4038-97b7-f8cdd937db57.png,276,174,371,286,95,112,red blood cell,10640,1.1789473684210525,0.8482142857142857
63477,/images/b9d65ef3-1adc-4479-abee-2e422f5a613a.png,153,1430,237,1510,84,80,red blood cell,6720,0.9523809523809523,1.05
78619,/images/3612aa3b-2906-44a6-9c80-6144511a35ce.png,389,349,510,471,121,122,red blood cell,14762,1.0082644628099173,0.9918032786885246
79859,/images/a054a8e2-55f2-4508-97df-207f76b89be2.png,813,1155,915,1269,102,114,red blood cell,11628,1.1176470588235294,0.8947368421052632
39070,/images/8f96ee1f-4ef7-4279-a610-316319bedcf9.png,978,134,1102,248,124,114,red blood cell,14136,0.9193548387096774,1.087719298245614
21074,/images/c680004e-6ee2-43d7-877c-edc9b5ebeecc.png,830,1275,942,1395,112,120,red blood cell,13440,1.0714285714285714,0.9333333333333333
20024,/images/ebfd9f67-138e-49f0-9cef-a0352069eedb.png,148,779,248,877,100,98,red blood cell,9800,0.98,1.0204081632653061
866,/images/dce55b59-c6c3-4693-aa75-6b348c8f52cd.png,452,1201,557,1316,105,115,red blood cell,12075,1.0952380952380953,0.9130434782608695
47224,/images/58ced55c-bf0d-4204-b6b2-4f8992d92779.png,855,1003,969,1112,114,109,red blood cell,12426,0.956140350877193,1.0458715596330275
39783,/images/5c68070c-3391-4db6-8c01-94175105dbea.png,116,694,213,799,97,105,red blood cell,10185,1.0824742268041236,0.9238095238095239
43183,/images/fe1ee954-ba71-47b3-954a-d20ab940cd7b.png,4,88,122,200,118,112,red blood cell,13216,0.9491525423728814,1.0535714285714286
31718,/images/bd432159-5956-457c-bdeb-1b5e702ba513.png,26,1497,129,1593,103,96,red blood cell,9888,0.9320388349514563,1.0729166666666667
3419,/images/fd1302e2-3cd2-4a1a-9c13-00f810a9c41b.png,807,1310,925,1426,118,116,red blood cell,13688,0.9830508474576272,1.0172413793103448
37829,/images/56a57a8d-c9b9-432a-a3b0-32a09355806c.png,1008,492,1108,591,100,99,red blood cell,9900,0.99,1.0101010101010102
74934,/images/dd090806-e4ac-4a78-b2ee-55a30626369c.png,87,421,185,520,98,99,red blood cell,9702,1.010204081632653,0.98989898989899
5856,/images/a30da226-b452-408a-a556-bfae4d521464.png,764,799,878,925,114,126,red blood cell,14364,1.105263157894737,0.9047619047619048
27003,/images/1f337b61-1b0d-4539-91f9-73d4a0798a4a.png,782,7,880,129,98,122,red blood cell,11956,1.2448979591836735,0.8032786885245902
3338,/images/b1100ae1-0ac8-4fc2-b0ff-8819f7fbe724.png,558,566,673,679,115,113,red blood cell,12995,0.9826086956521739,1.0176991150442478
13633,/images/d47cd049-d78b-4ba3-a7d4-399be4dd1dde.png,172,670,283,760,111,90,red blood cell,9990,0.8108108108108109,1.2333333333333334
14330,/images/f5eb7c5e-bd77-4638-ba9f-58d42f87476b.png,296,612,413,719,117,107,red blood cell,12519,0.9145299145299145,1.0934579439252337
45755,/images/584d62ed-4329-45dd-94ce-e929d8b2bb74.png,1047,180,1149,292,102,112,red blood cell,11424,1.0980392156862746,0.9107142857142857
70734,/images/8ab5c462-045e-4b59-b53a-9b2bc3ed2487.png,266,391,355,475,89,84,red blood cell,7476,0.9438202247191011,1.0595238095238095
18761,/images/f6f8a69a-3fd2-4684-ac77-3e83ea0fb36d.png,603,397,712,514,109,117,red blood cell,12753,1.073394495412844,0.9316239316239316
67431,/images/8e72e20e-e714-4db6-a1da-c05a409257d4.png,834,116,938,213,104,97,red blood cell,10088,0.9326923076923077,1.0721649484536082
67684,/images/2b128a1a-95ed-408b-b9f8-8795cc814d80.png,498,230,594,317,96,87,red blood cell,8352,0.90625,1.103448275862069
75425,/images/468c261d-f5d8-423f-883e-48af2bbbc5d1.png,912,957,996,1041,84,84,red blood cell,7056,1.0,1.0
70417,/images/4876c9d0-b386-48fb-84e8-91bf87529161.png,624,1093,721,1174,97,81,red blood cell,7857,0.8350515463917526,1.1975308641975309
67871,/images/41ebf9a1-24dc-454e-8bf8-508218f5ee57.png,371,311,472,418,101,107,red blood cell,10807,1.0594059405940595,0.9439252336448598
58266,/images/319c9c52-f316-49f3-baad-4444ab19f85b.png,949,1161,1050,1263,101,102,red blood cell,10302,1.00990099009901,0.9901960784313726
48526,/images/f3d84be2-8af0-4d62-9f72-23d3dc08cbbe.png,1062,1266,1163,1383,101,117,red blood cell,11817,1.1584158415841583,0.8632478632478633
66278,/images/e8058bed-c362-4e1c-85dc-62f80f32938f.png,1091,1115,1195,1232,104,117,red blood cell,12168,1.125,0.8888888888888888
14706,/images/4e2873dd-651e-4ecc-ac70-7335cf21a469.png,663,283,800,420,137,137,red blood cell,18769,1.0,1.0
75247,/images/61dfc937-a428-44b4-94fb-d682bdb8dff0.png,1078,1478,1176,1593,98,115,red blood cell,11270,1.1734693877551021,0.8521739130434782
36112,/images/cb2fac19-90b0-48b4-bdc5-7dbbd58756d1.png,257,749,361,873,104,124,red blood cell,12896,1.1923076923076923,0.8387096774193549
77601,/images/f20a4fcf-ea8e-4c14-883d-d26a9e08ce25.png,936,588,1034,704,98,116,red blood cell,11368,1.183673469387755,0.8448275862068966
22279,/images/787abd97-dd37-4212-8b43-61696eb3abc0.png,636,604,784,729,148,125,red blood cell,18500,0.8445945945945946,1.184
40213,/images/ef1a9020-5e45-450d-a237-165114308592.png,532,1455,652,1580,120,125,red blood cell,15000,1.0416666666666667,0.96
77630,/images/07d15855-eb9b-46a9-b894-7cfe4d097826.png,961,832,1078,966,117,134,red blood cell,15678,1.1452991452991452,0.8731343283582089
15086,/images/3a8f468f-f9de-46a8-a7c8-f2be239fa207.png,335,1164,443,1255,108,91,red blood cell,9828,0.8425925925925926,1.1868131868131868
62002,/images/bdb5d571-27bc-4a42-ae45-aa5a9af40a81.png,113,133,230,239,117,106,red blood cell,12402,0.905982905982906,1.1037735849056605
44207,/images/8b494b40-cab5-49d3-893d-c805000fbe88.png,544,770,638,873,94,103,red blood cell,9682,1.0957446808510638,0.912621359223301
18149,/images/947348fe-4c70-468e-8009-3c14daeca69b.png,704,1385,838,1508,134,123,red blood cell,16482,0.917910447761194,1.089430894308943
69925,/images/9edba799-e169-46cd-b100-c9f8fc7a8c7d.png,58,1256,160,1345,102,89,red blood cell,9078,0.8725490196078431,1.146067415730337
2665,/images/a2ccbf70-e444-49a9-8b7e-9797a05220d8.png,345,1024,450,1113,105,89,red blood cell,9345,0.8476190476190476,1.1797752808988764
47533,/images/adff132d-3af0-4cef-942c-58fc09729bee.png,767,379,892,502,125,123,red blood cell,15375,0.984,1.016260162601626
3051,/images/5a386082-397f-4524-a6f9-c2b8efe5014d.png,206,73,327,192,121,119,red blood cell,14399,0.9834710743801653,1.0168067226890756
37781,/images/fe0c5e48-f65e-488c-9c3c-1ea7c7835c0c.png,507,1272,620,1366,113,94,red blood cell,10622,0.831858407079646,1.202127659574468
15017,/images/3003252a-2d2e-4687-ad30-9c38d68f1394.png,423,156,545,280,122,124,red blood cell,15128,1.0163934426229508,0.9838709677419355
8999,/images/ef815e3a-02a6-4cf8-9262-45bc74c50b00.png,289,1068,403,1168,114,100,red blood cell,11400,0.8771929824561403,1.14
31825,/images/f62d4fb6-df7c-446c-94a8-d5aede0b1e0c.png,828,327,974,450,146,123,red blood cell,17958,0.8424657534246576,1.1869918699186992
65532,/images/da49db57-0c2f-4213-b322-c88c19fb9296.png,663,571,754,658,91,87,red blood cell,7917,0.9560439560439561,1.0459770114942528
17290,/images/3d302619-473d-4c5b-af43-8833ff94233f.png,175,888,280,1008,105,120,red blood cell,12600,1.1428571428571428,0.875
46112,/images/72088c26-d2dd-4906-b791-b8947fc7fbe4.png,885,1118,997,1214,112,96,red blood cell,10752,0.8571428571428571,1.1666666666666667
34475,/images/b4bde4e8-f48b-4ae2-be01-86d8c91d0af9.png,553,880,663,988,110,108,red blood cell,11880,0.9818181818181818,1.0185185185185186
46671,/images/da111ca5-520f-4ea8-97ad-ae5fce58ee91.png,230,1478,338,1579,108,101,red blood cell,10908,0.9351851851851852,1.0693069306930694
2640,/images/a2ccbf70-e444-49a9-8b7e-9797a05220d8.png,454,913,571,1036,117,123,red blood cell,14391,1.0512820512820513,0.9512195121951219
4077,/images/e02edd82-c424-4dee-98a7-575640655d9b.png,210,42,331,169,121,127,red blood cell,15367,1.0495867768595042,0.952755905511811
39520,/images/5a631871-2fc7-4a68-9c39-f3b9a0bf4a04.png,685,554,790,663,105,109,red blood cell,11445,1.0380952380952382,0.963302752293578
71556,/images/b9c6db13-ca3a-4937-8ecf-e537047ed858.png,37,1452,149,1548,112,96,red blood cell,10752,0.8571428571428571,1.1666666666666667
20247,/images/c66cb6b2-1480-446a-a9d2-b8032a3de0d7.png,455,1035,553,1140,98,105,red blood cell,10290,1.0714285714285714,0.9333333333333333
50009,/images/b1145408-feae-4637-b4cf-3e70b99cc62d.png,163,656,251,760,88,104,red blood cell,9152,1.1818181818181819,0.8461538461538461
47590,/images/06cd484f-e864-4fee-8819-688b45eed98e.png,988,668,1118,810,130,142,red blood cell,18460,1.0923076923076922,0.9154929577464789
45306,/images/9e793460-d94c-47ac-b3a7-0d6ad86357da.png,777,321,884,415,107,94,red blood cell,10058,0.8785046728971962,1.1382978723404256
12186,/images/87d6343b-70dd-4cdd-939f-d3ac0ca2e700.png,233,1396,345,1501,112,105,red blood cell,11760,0.9375,1.0666666666666667
60210,/images/214f1d15-a081-476e-992d-6c3a77f03d59.png,1014,1469,1112,1591,98,122,red blood cell,11956,1.2448979591836735,0.8032786885245902
25006,/images/ed0bee2f-05e0-4392-8357-19750cec577c.png,729,59,804,148,75,89,red blood cell,6675,1.1866666666666668,0.8426966292134831
55620,/images/c32b8bb8-c89d-4ae9-9c77-5b9356ca35a1.png,964,950,1079,1068,115,118,red blood cell,13570,1.0260869565217392,0.9745762711864406
64516,/images/6ba5d0b8-cdc7-4266-9d78-db76faa312e9.png,98,1406,211,1514,113,108,red blood cell,12204,0.9557522123893806,1.0462962962962963
41403,/images/65e8b0cd-05d1-4c8d-8efd-24bf71df3167.png,759,1047,864,1166,105,119,red blood cell,12495,1.1333333333333333,0.8823529411764706
41464,/images/c4494d4f-732f-431a-8a9d-62403f0b74fe.png,24,1406,137,1522,113,116,red blood cell,13108,1.0265486725663717,0.9741379310344828
51491,/images/baa87bf8-786c-444c-81e8-9fa0a41d8149.png,48,632,150,735,102,103,red blood cell,10506,1.0098039215686274,0.9902912621359223
58735,/images/e4827c85-311a-4df1-89c2-99dad0c3558c.png,100,34,197,125,97,91,red blood cell,8827,0.9381443298969072,1.065934065934066
39886,/images/af2e63a3-9fde-46aa-a867-81c5c259d1dc.png,933,41,1027,133,94,92,red blood cell,8648,0.9787234042553191,1.0217391304347827
30844,/images/fbc1f360-4382-48bb-a32e-3f5f2f9dbe57.png,763,1049,895,1178,132,129,red blood cell,17028,0.9772727272727273,1.0232558139534884
74377,/images/06a3effb-996c-4767-afd2-6aa3b697cb4e.png,941,816,1033,903,92,87,red blood cell,8004,0.9456521739130435,1.0574712643678161
54421,/images/22a464ef-c3da-4d56-b37e-e22e95d945e7.png,953,786,1042,886,89,100,red blood cell,8900,1.1235955056179776,0.89
7044,/images/8be185e7-2a1a-441c-a5c7-b50a9eb926cb.png,441,247,542,350,101,103,red blood cell,10403,1.0198019801980198,0.9805825242718447
73449,/images/58594235-0d32-4a4e-91cd-4c800eaaaa73.png,1053,1115,1155,1236,102,121,red blood cell,12342,1.1862745098039216,0.8429752066115702
30822,/images/93a306b8-594a-4c7f-8b4a-127fb6ad8f1a.png,345,463,439,564,94,101,red blood cell,9494,1.074468085106383,0.9306930693069307
18698,/images/f6f8a69a-3fd2-4684-ac77-3e83ea0fb36d.png,456,1114,571,1233,115,119,red blood cell,13685,1.0347826086956522,0.9663865546218487
62993,/images/f234a2de-f3c8-4521-a306-8cfdf52dd597.png,126,1221,210,1320,84,99,red blood cell,8316,1.1785714285714286,0.8484848484848485
11066,/images/85a4d82e-cfb7-4983-b272-626c9e8c7583.png,674,1089,810,1214,136,125,red blood cell,17000,0.9191176470588235,1.088
21656,/images/66183740-e1e5-43c9-8539-a87028bb3621.png,1082,890,1194,1003,112,113,red blood cell,12656,1.0089285714285714,0.9911504424778761
11405,/images/b5513d5b-46fc-4f44-a616-791087fbd608.png,918,488,1028,592,110,104,red blood cell,11440,0.9454545454545454,1.0576923076923077
45184,/images/2596eb32-1323-41e9-8c0f-64819abcfc73.png,877,1087,975,1189,98,102,red blood cell,9996,1.0408163265306123,0.9607843137254902
79630,/images/a4409217-be11-4478-90a5-b406057d154d.png,868,473,970,582,102,109,red blood cell,11118,1.0686274509803921,0.9357798165137615
23634,/images/79d7a014-21ff-40f1-9ac4-a69839390654.png,633,632,749,746,116,114,red blood cell,13224,0.9827586206896551,1.0175438596491229
51998,/images/4f62b14e-c6f4-4155-8f50-881558f83fae.png,179,793,277,880,98,87,red blood cell,8526,0.8877551020408163,1.1264367816091954
28379,/images/34e024a5-5698-42d4-972f-fee234b4bd64.png,510,494,648,616,138,122,red blood cell,16836,0.8840579710144928,1.1311475409836065
65086,/images/5e042380-6ef2-496f-8231-0ca550fbfa71.png,1066,1116,1166,1215,100,99,red blood cell,9900,0.99,1.0101010101010102
16578,/images/c7045ab6-230e-4c1e-a8e0-f624d41a00d9.png,978,899,1081,1010,103,111,red blood cell,11433,1.0776699029126213,0.9279279279279279
20493,/images/b809b407-7b69-4334-873d-d6c49135f04a.png,788,1176,908,1295,120,119,red blood cell,14280,0.9916666666666667,1.0084033613445378
35840,/images/027ab174-e47a-44f8-b85b-372449eeb7d8.png,936,1376,1057,1480,121,104,red blood cell,12584,0.859504132231405,1.1634615384615385
57781,/images/5c037ffc-f515-48b3-b231-c110fbd2b8ca.png,236,386,332,501,96,115,red blood cell,11040,1.1979166666666667,0.8347826086956521
25891,/images/4811fdf2-d7e8-475e-a840-45dda5282bf3.png,434,146,523,257,89,111,red blood cell,9879,1.247191011235955,0.8018018018018018
18691,/images/f6f8a69a-3fd2-4684-ac77-3e83ea0fb36d.png,419,372,533,487,114,115,red blood cell,13110,1.0087719298245614,0.991304347826087
63036,/images/6afd8203-d61a-4e9b-a4cf-dcb53a16b57c.png,882,77,976,173,94,96,red blood cell,9024,1.0212765957446808,0.9791666666666666
40804,/images/252071ac-e9f2-41d2-abbb-87ef01b8a997.png,587,1111,688,1214,101,103,red blood cell,10403,1.0198019801980198,0.9805825242718447
79281,/images/05ac7b2a-6a77-4464-926b-8570f7c01693.png,254,1096,340,1196,86,100,red blood cell,8600,1.1627906976744187,0.86
69670,/images/f0713bee-2a71-4ced-b953-4041ea99496a.png,237,901,359,1018,122,117,red blood cell,14274,0.9590163934426229,1.0427350427350428
10778,/images/fac4b0e2-6b52-4c0e-b762-4fa65d552856.png,401,744,506,853,105,109,red blood cell,11445,1.0380952380952382,0.963302752293578
78125,/images/bb137718-20ba-457d-8ffe-4f9420ecaab6.png,688,789,791,897,103,108,red blood cell,11124,1.0485436893203883,0.9537037037037037
32810,/images/67f5ca94-d84e-490e-bf0d-4ffba7bdbe30.png,551,459,647,555,96,96,red blood cell,9216,1.0,1.0
12827,/images/b634137b-bc8b-4e88-b0e3-b536ad6e7e18.png,1,268,103,356,102,88,red blood cell,8976,0.8627450980392157,1.1590909090909092
74334,/images/8939e14b-fcdf-48b1-acb9-6514a2fc2fc0.png,1091,1230,1196,1317,105,87,red blood cell,9135,0.8285714285714286,1.206896551724138
5470,/images/3f106606-9a21-40d5-b849-273866fe0f49.png,856,390,980,516,124,126,red blood cell,15624,1.0161290322580645,0.9841269841269841
24247,/images/bb3ae957-0f6d-4615-bfe5-24fbca50b459.png,487,1076,603,1182,116,106,red blood cell,12296,0.9137931034482759,1.0943396226415094
56599,/images/a824b499-3736-4581-bbdc-be1b3b4cf756.png,899,66,999,171,100,105,red blood cell,10500,1.05,0.9523809523809523
32724,/images/0154dd8e-72f8-4d78-a4dd-93e139577bd1.png,663,757,775,851,112,94,red blood cell,10528,0.8392857142857143,1.1914893617021276
4200,/images/ac3358f1-ef9a-4ccc-b66c-da5e47e352e0.png,0,571,109,675,109,104,red blood cell,11336,0.9541284403669725,1.0480769230769231
48654,/images/55836297-fc8e-4e00-9767-0d12b86e4604.png,782,777,874,869,92,92,red blood cell,8464,1.0,1.0
30936,/images/533c47c9-02a6-419b-961b-81797f022f6c.png,1034,205,1142,325,108,120,red blood cell,12960,1.1111111111111112,0.9
26041,/images/612bdd3c-da43-4321-a76b-c73c614928d1.png,366,621,489,726,123,105,red blood cell,12915,0.8536585365853658,1.1714285714285715
53705,/images/6f67a66b-56ec-4c36-ae7c-f250d3b86a23.png,402,1235,512,1342,110,107,red blood cell,11770,0.9727272727272728,1.02803738317757
19589,/images/883d9731-a04d-4f84-83c9-d3bef954759d.png,353,853,479,983,126,130,red blood cell,16380,1.0317460317460319,0.9692307692307692
35728,/images/4063945d-03fc-4ce3-a04c-17435dce8f91.png,1066,640,1175,752,109,112,red blood cell,12208,1.0275229357798166,0.9732142857142857
54381,/images/19370afd-f897-47d8-bfae-c0d257bbf795.png,1110,612,1200,698,90,86,red blood cell,7740,0.9555555555555556,1.0465116279069768
7146,/images/56551792-4aa1-4301-9f8f-8bfebcd20050.png,219,388,333,506,114,118,red blood cell,13452,1.0350877192982457,0.9661016949152542
73474,/images/5f2b32bd-fdca-4d6f-b13a-ee9f83626c8d.png,696,942,807,1050,111,108,red blood cell,11988,0.972972972972973,1.0277777777777777
20739,/images/79b3a64f-2fb9-46e0-85d4-2bdd59c2075e.png,14,357,127,456,113,99,red blood cell,11187,0.8761061946902655,1.1414141414141414
21014,/images/666601e7-608d-4d19-999f-8fc6ab373a55.png,873,884,994,985,121,101,red blood cell,12221,0.8347107438016529,1.198019801980198
59794,/images/f77d7469-d083-4c2d-a4ea-5a9ff162e3e2.png,1064,1140,1151,1233,87,93,red blood cell,8091,1.0689655172413792,0.9354838709677419
25145,/images/9e74feb8-017d-4d53-8896-9ebda4327dd1.png,126,922,239,1032,113,110,red blood cell,12430,0.9734513274336283,1.0272727272727273
17118,/images/dc3bdfe9-1565-4cda-9c4e-0979846dab60.png,286,404,389,510,103,106,red blood cell,10918,1.029126213592233,0.9716981132075472
62754,/images/e1937e32-85d5-4cd8-bb4a-b9cf8ee7ceeb.png,1005,974,1112,1077,107,103,red blood cell,11021,0.9626168224299065,1.0388349514563107
30217,/images/f81806a8-5883-446c-be78-f0145b12dbdd.png,905,433,1029,547,124,114,red blood cell,14136,0.9193548387096774,1.087719298245614
35108,/images/a6ba808f-ec60-42a5-ad91-7b32412ab708.png,7,706,112,816,105,110,red blood cell,11550,1.0476190476190477,0.9545454545454546
18431,/images/39cc33be-d752-40fe-b7a8-2e69a3517205.png,653,1424,763,1553,110,129,red blood cell,14190,1.1727272727272726,0.8527131782945736
1055,/images/63d36d2c-43a9-49ac-9504-028b4968c860.png,878,1124,999,1231,121,107,red blood cell,12947,0.8842975206611571,1.1308411214953271
15874,/images/c7c1b873-0548-4a73-9618-f60912e164df.png,242,377,347,482,105,105,red blood cell,11025,1.0,1.0
30759,/images/8e0dfc1f-e3eb-4a3f-a1c4-249bdfbfaa27.png,525,1072,619,1172,94,100,red blood cell,9400,1.0638297872340425,0.94
20147,/images/df49578a-60d4-4a3b-9ee0-79d9d59bc72a.png,391,653,537,789,146,136,red blood cell,19856,0.9315068493150684,1.0735294117647058
9860,/images/3859deaf-6ae1-49a3-9051-898d0f0d7de6.png,389,1428,476,1516,87,88,red blood cell,7656,1.0114942528735633,0.9886363636363636
68069,/images/29d40b60-cde1-45b5-b403-692437a77ac1.png,920,1135,1049,1255,129,120,red blood cell,15480,0.9302325581395349,1.075
70501,/images/8cca114a-ed05-4b87-95b7-fae02487f08c.png,141,641,251,756,110,115,red blood cell,12650,1.0454545454545454,0.9565217391304348
23447,/images/8757be1e-b832-407a-8e95-62abae485b24.png,822,1204,914,1293,92,89,red blood cell,8188,0.967391304347826,1.0337078651685394
78503,/images/c94827ce-d619-4705-a68a-df63a2c95ffa.png,451,1096,559,1207,108,111,red blood cell,11988,1.0277777777777777,0.972972972972973
26674,/images/c1423156-82b3-4dd3-8e74-08eb7ed8e1d6.png,929,1304,1056,1419,127,115,red blood cell,14605,0.905511811023622,1.1043478260869566
59210,/images/4736f545-1f1f-4d77-9241-d69cbf4dae35.png,428,20,508,93,80,73,red blood cell,5840,0.9125,1.095890410958904
48883,/images/fed6ba05-36a5-45dc-a4e1-9baa7de2c622.png,668,82,770,174,102,92,red blood cell,9384,0.9019607843137255,1.108695652173913
66426,/images/5f66d20c-fbfe-44ec-a01b-8a09da24807e.png,363,618,482,727,119,109,red blood cell,12971,0.9159663865546218,1.091743119266055
19686,/images/627d6331-7bb9-4d1a-b20d-e6541af4d0f9.png,23,496,123,608,100,112,red blood cell,11200,1.12,0.8928571428571429
69197,/images/f274b784-b995-4a7e-a2c2-6cc31c24c4b4.png,58,1335,168,1448,110,113,red blood cell,12430,1.0272727272727273,0.9734513274336283
32956,/images/d1924af6-7512-4ccc-9c6b-adbbaa8db41f.png,100,1365,202,1475,102,110,red blood cell,11220,1.0784313725490196,0.9272727272727272
62855,/images/4b346035-b8c0-46ca-8fdb-a01b1421ee4a.png,872,1139,981,1259,109,120,red blood cell,13080,1.1009174311926606,0.9083333333333333
73631,/images/a51d6c18-f9e8-4714-9dbb-38e1577445f2.png,393,518,479,609,86,91,red blood cell,7826,1.058139534883721,0.945054945054945
12561,/images/8e4bdd0d-1c72-4836-ae3e-05e2e50e4983.png,917,270,1035,365,118,95,red blood cell,11210,0.8050847457627118,1.2421052631578948
38173,/images/33bdb7b5-ad5b-4a73-bbc2-3350f8c2ac0c.png,670,840,773,958,103,118,red blood cell,12154,1.145631067961165,0.8728813559322034
64888,/images/dec61ae1-5037-4c3a-8952-15371becca7d.png,354,640,441,742,87,102,red blood cell,8874,1.1724137931034482,0.8529411764705882
18628,/images/c22f7031-9cf8-48ce-b03b-1b12d0db4951.png,638,1319,741,1408,103,89,red blood cell,9167,0.8640776699029126,1.1573033707865168
15877,/images/c7c1b873-0548-4a73-9618-f60912e164df.png,89,921,178,1012,89,91,red blood cell,8099,1.0224719101123596,0.978021978021978
74788,/images/91e93160-eb8d-4de0-b6bc-b98ec33d1663.png,507,1489,614,1578,107,89,red blood cell,9523,0.8317757009345794,1.202247191011236
67973,/images/bcaefb02-682a-41b9-acc7-e6cc010f5b30.png,873,407,964,497,91,90,red blood cell,8190,0.989010989010989,1.011111111111111
48288,/images/71204a6d-814e-44b6-9cee-7b979f478021.png,1075,1356,1170,1472,95,116,red blood cell,11020,1.2210526315789474,0.8189655172413793
7700,/images/9f959520-e15e-45c2-bc29-ef3c19154d1c.png,408,891,505,1007,97,116,red blood cell,11252,1.1958762886597938,0.8362068965517241
13151,/images/711f6b3f-cd63-46d1-834a-bc8e9aa9b43e.png,635,1172,725,1282,90,110,red blood cell,9900,1.2222222222222223,0.8181818181818182
28281,/images/ffd59802-46c6-4b58-80fe-e534e39781a7.png,197,1206,297,1319,100,113,red blood cell,11300,1.13,0.8849557522123894
50949,/images/ef8fcfa4-8466-4186-8c69-f5f4904eb489.png,1071,478,1168,585,97,107,red blood cell,10379,1.1030927835051547,0.9065420560747663
52227,/images/f4c00b8c-d675-4255-8277-ca65bd757f51.png,117,193,207,286,90,93,red blood cell,8370,1.0333333333333334,0.967741935483871
27588,/images/715761a2-745e-4743-9849-956a034ad3c4.png,915,268,1014,359,99,91,red blood cell,9009,0.9191919191919192,1.0879120879120878
681,/images/e61e6af2-7f8b-47b0-bbe7-acb2ed0299ab.png,593,1007,685,1097,92,90,red blood cell,8280,0.9782608695652174,1.0222222222222221
20694,/images/e6d7c5e1-43fc-4712-86d5-aa70252b978f.png,262,925,374,1037,112,112,red blood cell,12544,1.0,1.0
8800,/images/ae17a099-18b5-4a42-a901-850ea056423e.png,521,554,635,659,114,105,red blood cell,11970,0.9210526315789473,1.0857142857142856
21817,/images/9b3fd401-dab0-440f-8498-eb3cc9ffa970.png,990,367,1116,489,126,122,red blood cell,15372,0.9682539682539683,1.0327868852459017
1117,/images/edcb4d77-a4d3-465d-9b59-eb3087766b1c.png,387,575,486,678,99,103,red blood cell,10197,1.0404040404040404,0.9611650485436893
55317,/images/4fb83278-adc5-4424-9f45-b6d0db2955b6.png,897,1101,999,1202,102,101,red blood cell,10302,0.9901960784313726,1.00990099009901
65768,/images/daea4860-a296-4f6d-acef-996ab0882676.png,143,1055,255,1161,112,106,red blood cell,11872,0.9464285714285714,1.0566037735849056
65609,/images/01b38a56-13eb-447b-89ee-fc21cb40dcc1.png,907,468,998,556,91,88,red blood cell,8008,0.967032967032967,1.0340909090909092
15832,/images/c7c1b873-0548-4a73-9618-f60912e164df.png,1038,679,1129,764,91,85,red blood cell,7735,0.9340659340659341,1.0705882352941176
49991,/images/b1145408-feae-4637-b4cf-3e70b99cc62d.png,1035,112,1155,221,120,109,red blood cell,13080,0.9083333333333333,1.1009174311926606
3164,/images/729a38d6-66db-48e5-a00d-7d90d224290f.png,387,1229,517,1361,130,132,red blood cell,17160,1.0153846153846153,0.9848484848484849
2856,/images/521a26aa-0a31-4c07-b4d0-fac08eb08344.png,831,842,981,975,150,133,red blood cell,19950,0.8866666666666667,1.1278195488721805
66981,/images/3b4440f7-a69b-4042-a9d0-d6958abcdf4e.png,650,1269,761,1368,111,99,red blood cell,10989,0.8918918918918919,1.121212121212121
51063,/images/93f40356-5676-45d3-8e83-8028708c93ba.png,442,306,562,436,120,130,red blood cell,15600,1.0833333333333333,0.9230769230769231
25730,/images/1f8edb2a-40bc-4beb-aa6b-884d2473df0f.png,799,401,911,528,112,127,red blood cell,14224,1.1339285714285714,0.8818897637795275
42281,/images/ca734448-0d52-42fa-b41c-17b2939e58ae.png,345,642,427,739,82,97,red blood cell,7954,1.1829268292682926,0.845360824742268
65665,/images/397f37bc-a3a4-4257-9430-c8fc5716f8b1.png,243,433,342,531,99,98,red blood cell,9702,0.98989898989899,1.010204081632653
17667,/images/b5143aae-6e98-4dc6-b546-980cb472de67.png,67,450,157,543,90,93,red blood cell,8370,1.0333333333333334,0.967741935483871
31442,/images/6695a204-e39c-4418-b904-3f080fdbe7e8.png,561,1318,673,1440,112,122,red blood cell,13664,1.0892857142857142,0.9180327868852459
69735,/images/2bd15b6e-fe2d-49f3-b394-940d024d1f91.png,126,874,252,982,126,108,red blood cell,13608,0.8571428571428571,1.1666666666666667
31406,/images/6695a204-e39c-4418-b904-3f080fdbe7e8.png,1041,1059,1142,1170,101,111,red blood cell,11211,1.099009900990099,0.9099099099099099
3497,/images/ad36bd67-594b-4f63-93e3-886af0bc618e.png,525,184,662,297,137,113,red blood cell,15481,0.8248175182481752,1.2123893805309736
64660,/images/6dfafdf1-f588-4e80-8cf8-0126e1bf7af9.png,930,754,1017,859,87,105,red blood cell,9135,1.206896551724138,0.8285714285714286
62172,/images/a72cd558-b7ac-4bf2-a344-2ce6c73a354e.png,270,267,373,360,103,93,red blood cell,9579,0.9029126213592233,1.10752688172043
80040,/images/38d1b930-dd97-4248-9160-e9389a1a8dd7.png,1061,615,1176,731,115,116,red blood cell,13340,1.008695652173913,0.9913793103448276
57038,/images/9e82c996-2cfa-418d-9482-8ee23e9d0a5d.png,321,732,434,838,113,106,red blood cell,11978,0.9380530973451328,1.0660377358490567
5257,/images/729733ff-a349-4a96-b636-ccabe7d7e167.png,823,1244,937,1345,114,101,red blood cell,11514,0.8859649122807017,1.1287128712871286
35697,/images/4063945d-03fc-4ce3-a04c-17435dce8f91.png,592,77,684,187,92,110,red blood cell,10120,1.1956521739130435,0.8363636363636363
43517,/images/2d857091-efcd-41c0-ba3f-226de90445c4.png,700,374,801,473,101,99,red blood cell,9999,0.9801980198019802,1.02020202020202
47450,/images/f7231477-f2c1-439a-9c8b-204de07686a4.png,656,1268,787,1383,131,115,red blood cell,15065,0.8778625954198473,1.1391304347826088
71665,/images/5c99cd97-39f6-4809-9528-9d380cc16b16.png,903,781,1001,885,98,104,red blood cell,10192,1.0612244897959184,0.9423076923076923
33883,/images/1a332b2c-9d49-4ff2-810c-5633d2314527.png,563,395,668,483,105,88,red blood cell,9240,0.8380952380952381,1.1931818181818181
56203,/images/b600b38d-225b-46a5-b6f8-b607430f6a10.png,974,240,1075,340,101,100,red blood cell,10100,0.9900990099009901,1.01
11615,/images/b4dc3088-3fe2-4688-be24-70664a64e022.png,760,1302,874,1424,114,122,red blood cell,13908,1.0701754385964912,0.9344262295081968
72190,/images/005e60b6-77b8-458c-b57c-bfe0c7e7df78.png,604,1487,711,1599,107,112,red blood cell,11984,1.0467289719626167,0.9553571428571429
51312,/images/216f9d43-6869-4ba1-9106-4f5ea6aac223.png,364,523,445,607,81,84,red blood cell,6804,1.037037037037037,0.9642857142857143
42866,/images/a7b6894d-eeea-4ed5-bc0e-785d6c6da8df.png,776,1290,884,1406,108,116,red blood cell,12528,1.0740740740740742,0.9310344827586207
61904,/images/f32b21ae-5ca7-490b-bc40-6db9396d933c.png,630,70,724,158,94,88,red blood cell,8272,0.9361702127659575,1.0681818181818181
57634,/images/d32022fa-e492-4b31-a776-9435cfdef6d6.png,202,884,312,985,110,101,red blood cell,11110,0.9181818181818182,1.0891089108910892
40206,/images/ef1a9020-5e45-450d-a237-165114308592.png,738,1163,847,1289,109,126,red blood cell,13734,1.1559633027522935,0.8650793650793651
23388,/images/a7688988-2bcc-4458-83d3-5e482da5f87b.png,615,1325,729,1437,114,112,red blood cell,12768,0.9824561403508771,1.0178571428571428
61210,/images/0da07970-3146-479c-8a07-f61ed32814a9.png,30,513,145,619,115,106,red blood cell,12190,0.9217391304347826,1.0849056603773586
20790,/images/c2ec116f-f091-422c-926c-70b548a8f6ef.png,685,1437,800,1540,115,103,red blood cell,11845,0.8956521739130435,1.116504854368932
23123,/images/be5bb7d0-7c3f-4bb9-8bb4-f8bc8d875943.png,501,444,614,553,113,109,red blood cell,12317,0.9646017699115044,1.036697247706422
77527,/images/2d2e81f3-e329-4765-9ba1-2c95f12dc9f3.png,25,405,119,517,94,112,red blood cell,10528,1.1914893617021276,0.8392857142857143
60190,/images/214f1d15-a081-476e-992d-6c3a77f03d59.png,263,1374,361,1469,98,95,red blood cell,9310,0.9693877551020408,1.0315789473684212
39139,/images/7bde7de1-889b-4218-b0e1-e2c04f6a7986.png,844,423,959,529,115,106,red blood cell,12190,0.9217391304347826,1.0849056603773586
40247,/images/f05ffdca-dc3a-47bd-a231-2a0d9bd1d50e.png,933,51,1062,172,129,121,red blood cell,15609,0.937984496124031,1.0661157024793388
39366,/images/fbcb2ef0-3c97-4d7a-8b96-0147c73f3941.png,119,193,217,284,98,91,red blood cell,8918,0.9285714285714286,1.0769230769230769
40473,/images/db249e5a-4142-432c-8288-bacd10d7273d.png,708,663,819,770,111,107,red blood cell,11877,0.963963963963964,1.0373831775700935
58449,/images/5cac6ddf-c8c6-45de-bce0-a1db64b14fb5.png,127,144,227,253,100,109,red blood cell,10900,1.09,0.9174311926605505
73447,/images/58594235-0d32-4a4e-91cd-4c800eaaaa73.png,1030,994,1155,1114,125,120,red blood cell,15000,0.96,1.0416666666666667
46811,/images/63055d1b-5221-4c80-8b39-37ac069a1b5c.png,902,538,1017,656,115,118,red blood cell,13570,1.0260869565217392,0.9745762711864406
20883,/images/c2ec116f-f091-422c-926c-70b548a8f6ef.png,997,0,1111,99,114,99,red blood cell,11286,0.868421052631579,1.1515151515151516
75497,/images/fa4f8d1a-cb3a-4722-a566-6c7072f30606.png,752,809,865,930,113,121,red blood cell,13673,1.0707964601769913,0.9338842975206612
41515,/images/2f3ebec8-ef64-420d-9aa0-c2fcadc27d74.png,1008,165,1126,265,118,100,red blood cell,11800,0.847457627118644,1.18
38168,/images/33bdb7b5-ad5b-4a73-bbc2-3350f8c2ac0c.png,1068,704,1184,812,116,108,red blood cell,12528,0.9310344827586207,1.0740740740740742
20120,/images/81a2748d-51c9-4439-995d-f747871d6544.png,833,213,954,328,121,115,red blood cell,13915,0.9504132231404959,1.0521739130434782
28437,/images/c3042130-a6e2-458f-9fde-bb012f68f5f2.png,438,736,561,869,123,133,red blood cell,16359,1.08130081300813,0.924812030075188
50256,/images/3d32a988-449d-4d58-b71f-abbfdc3f2fbc.png,819,1250,914,1345,95,95,red blood cell,9025,1.0,1.0
79379,/images/dcb21739-3c36-459d-b3cc-1be5871d6fe7.png,1077,234,1174,340,97,106,red blood cell,10282,1.092783505154639,0.9150943396226415
21428,/images/b701b5c5-b922-4315-b12a-aac4ec65ee8b.png,212,1349,321,1461,109,112,red blood cell,12208,1.0275229357798166,0.9732142857142857
22903,/images/be779f52-0bfa-4c01-a16f-b7f0bc92ed7c.png,616,1165,729,1275,113,110,red blood cell,12430,0.9734513274336283,1.0272727272727273
55714,/images/c32b8bb8-c89d-4ae9-9c77-5b9356ca35a1.png,983,228,1093,318,110,90,red blood cell,9900,0.8181818181818182,1.2222222222222223
63884,/images/5e974892-0ebe-4037-8427-ea8616d6d3b8.png,603,1415,697,1513,94,98,red blood cell,9212,1.0425531914893618,0.9591836734693877
53019,/images/42e87148-a015-4148-923a-fb83016f64e7.png,455,1332,544,1425,89,93,red blood cell,8277,1.0449438202247192,0.956989247311828
73261,/images/67a4fb91-6f38-4ca2-8f20-6b2f5f1b29a7.png,284,482,375,585,91,103,red blood cell,9373,1.1318681318681318,0.883495145631068
54885,/images/8f84a2c9-ca38-4405-a488-12fcd101278b.png,70,809,187,927,117,118,red blood cell,13806,1.0085470085470085,0.9915254237288136
19886,/images/b318889c-3c60-477c-b8f6-d18cb01a59df.png,313,206,419,320,106,114,red blood cell,12084,1.0754716981132075,0.9298245614035088
5401,/images/75579b27-8191-4044-859b-268be969c42b.png,160,604,290,725,130,121,red blood cell,15730,0.9307692307692308,1.0743801652892562
21530,/images/7625dfc4-858a-4c8e-907c-8943d665e9a7.png,629,563,742,672,113,109,red blood cell,12317,0.9646017699115044,1.036697247706422
40693,/images/252071ac-e9f2-41d2-abbb-87ef01b8a997.png,491,955,590,1061,99,106,red blood cell,10494,1.0707070707070707,0.9339622641509434
18243,/images/947348fe-4c70-468e-8009-3c14daeca69b.png,146,203,256,315,110,112,red blood cell,12320,1.018181818181818,0.9821428571428571
12606,/images/0901f9d1-be4f-4c19-8e83-dd724dded9f5.png,62,148,183,265,121,117,red blood cell,14157,0.9669421487603306,1.0341880341880343
280,/images/0dcca702-a4ef-4fb3-a940-9c0c140b21c7.png,711,231,845,353,134,122,red blood cell,16348,0.9104477611940298,1.098360655737705
72464,/images/a15e0fa8-2620-4f66-896e-175115c9dc3d.png,867,980,984,1083,117,103,red blood cell,12051,0.8803418803418803,1.1359223300970873
49594,/images/bd7937db-fca2-44d0-8538-460110210927.png,542,932,656,1067,114,135,red blood cell,15390,1.1842105263157894,0.8444444444444444
66825,/images/9106a6bb-1352-411f-ac26-0d6fe48c16a8.png,530,1362,646,1477,116,115,red blood cell,13340,0.9913793103448276,1.008695652173913
18580,/images/c22f7031-9cf8-48ce-b03b-1b12d0db4951.png,1071,960,1183,1053,112,93,red blood cell,10416,0.8303571428571429,1.2043010752688172
64166,/images/0d3c2521-da55-4df5-bf06-56b3bd4fb2fc.png,770,284,865,385,95,101,red blood cell,9595,1.063157894736842,0.9405940594059405
34640,/images/a0eedcb9-b85c-4612-b945-7e8227f53c35.png,501,1321,606,1434,105,113,red blood cell,11865,1.0761904761904761,0.9292035398230089
60244,/images/abf4cf2a-4532-4772-9f0f-9e123cc1713d.png,419,737,526,854,107,117,red blood cell,12519,1.0934579439252337,0.9145299145299145
2148,/images/e94a811d-3145-4313-ba42-2d5ed283179f.png,52,658,147,743,95,85,red blood cell,8075,0.8947368421052632,1.1176470588235294
30819,/images/93a306b8-594a-4c7f-8b4a-127fb6ad8f1a.png,79,1399,192,1531,113,132,red blood cell,14916,1.168141592920354,0.8560606060606061
41917,/images/783ae4ad-6a35-4b3c-b19f-754974b67b2d.png,1006,474,1113,580,107,106,red blood cell,11342,0.9906542056074766,1.009433962264151
71795,/images/093a831a-bf71-4333-bc06-942ae70cb164.png,680,517,779,604,99,87,red blood cell,8613,0.8787878787878788,1.1379310344827587
34823,/images/4fc9a597-aaa8-43b0-ad1c-2eabbe442e84.png,612,188,731,317,119,129,red blood cell,15351,1.084033613445378,0.9224806201550387
49601,/images/bd7937db-fca2-44d0-8538-460110210927.png,969,1116,1086,1228,117,112,red blood cell,13104,0.9572649572649573,1.0446428571428572
45802,/images/584d62ed-4329-45dd-94ce-e929d8b2bb74.png,891,396,971,491,80,95,red blood cell,7600,1.1875,0.8421052631578947
18615,/images/c22f7031-9cf8-48ce-b03b-1b12d0db4951.png,764,199,857,295,93,96,red blood cell,8928,1.032258064516129,0.96875
6849,/images/b21f6c6e-4b45-407a-b4c7-034a115f3ee4.png,746,1016,855,1128,109,112,red blood cell,12208,1.0275229357798166,0.9732142857142857
28015,/images/c4d34e35-4db2-41de-ba77-1a94aa9ef788.png,212,442,350,566,138,124,red blood cell,17112,0.8985507246376812,1.1129032258064515
10545,/images/9fbf38ab-44b9-4096-a818-603017a4300e.png,380,870,500,997,120,127,red blood cell,15240,1.0583333333333333,0.9448818897637795
25795,/images/14b68d86-ac7f-419d-b4a5-6b0b1d9aaa18.png,389,693,505,789,116,96,red blood cell,11136,0.8275862068965517,1.2083333333333333
31837,/images/f62d4fb6-df7c-446c-94a8-d5aede0b1e0c.png,939,211,1045,323,106,112,red blood cell,11872,1.0566037735849056,0.9464285714285714
79703,/images/03b9d6ad-39ca-4097-a98b-77f02b3c00a7.png,785,933,898,1057,113,124,red blood cell,14012,1.0973451327433628,0.9112903225806451
26815,/images/2518f6e4-29cc-4ae4-a914-b215a4c56099.png,576,635,677,741,101,106,red blood cell,10706,1.0495049504950495,0.9528301886792453
72673,/images/6ab870ba-b24b-49a9-9570-8eafe63aa74e.png,483,430,602,548,119,118,red blood cell,14042,0.9915966386554622,1.0084745762711864
43600,/images/e0ef520d-7b65-485d-9888-e6859f189f70.png,4,389,125,500,121,111,red blood cell,13431,0.9173553719008265,1.09009009009009
35193,/images/a9159b11-ba49-4885-902e-00c8d5095b98.png,251,522,356,631,105,109,red blood cell,11445,1.0380952380952382,0.963302752293578
40836,/images/bf20d04d-ff8a-4910-91d7-94054c267d1b.png,528,1485,650,1597,122,112,red blood cell,13664,0.9180327868852459,1.0892857142857142
9751,/images/3859deaf-6ae1-49a3-9051-898d0f0d7de6.png,465,856,569,956,104,100,red blood cell,10400,0.9615384615384616,1.04
63529,/images/44b4a765-104e-4182-8871-e933c83c91ef.png,916,1185,1026,1303,110,118,red blood cell,12980,1.0727272727272728,0.9322033898305084
12326,/images/3b55c42f-ad59-422f-ba99-4f4f4ca9cb2e.png,904,305,1013,428,109,123,red blood cell,13407,1.128440366972477,0.8861788617886179
29606,/images/42845335-4ab2-4963-806d-0985d1382a31.png,257,525,365,626,108,101,red blood cell,10908,0.9351851851851852,1.0693069306930694
26433,/images/d532e31c-10ce-4313-9a36-bd5e01230254.png,801,231,905,344,104,113,red blood cell,11752,1.0865384615384615,0.9203539823008849
74101,/images/9fe8bdc8-847d-434e-93e5-ae14ff3b45e1.png,773,434,874,535,101,101,red blood cell,10201,1.0,1.0
18600,/images/c22f7031-9cf8-48ce-b03b-1b12d0db4951.png,12,561,114,675,102,114,red blood cell,11628,1.1176470588235294,0.8947368421052632
50906,/images/0906111b-bac7-4541-a6dc-da435c0724a8.png,555,1169,646,1262,91,93,red blood cell,8463,1.021978021978022,0.978494623655914
61529,/images/7e837856-3519-4dc0-b357-4cdcfd30b4eb.png,390,1154,478,1246,88,92,red blood cell,8096,1.0454545454545454,0.9565217391304348
67788,/images/48e2f0bd-2164-40c3-af43-1f2708359978.png,185,1006,267,1091,82,85,red blood cell,6970,1.0365853658536586,0.9647058823529412
61361,/images/e16c0dab-780d-4035-872e-1bb91e49f9d2.png,99,825,217,936,118,111,red blood cell,13098,0.940677966101695,1.063063063063063
6657,/images/95fea6d8-413f-421e-b331-5d51c31df150.png,1025,498,1144,611,119,113,red blood cell,13447,0.9495798319327731,1.0530973451327434
50961,/images/ef8fcfa4-8466-4186-8c69-f5f4904eb489.png,436,37,531,129,95,92,red blood cell,8740,0.968421052631579,1.0326086956521738
2620,/images/a23f5539-bfe6-4885-9a0e-dba972475ea9.png,393,277,505,389,112,112,red blood cell,12544,1.0,1.0
52782,/images/0a747cb3-c720-4572-a661-ab5670a5c42e.png,1045,877,1157,992,112,115,red blood cell,12880,1.0267857142857142,0.9739130434782609
60062,/images/e63e1607-f344-43d6-a0d8-e10cf2e5054a.png,396,818,502,916,106,98,red blood cell,10388,0.9245283018867925,1.0816326530612246
3734,/images/dacf7e3f-1d8c-42a0-8539-3abe3971c956.png,800,111,919,237,119,126,red blood cell,14994,1.0588235294117647,0.9444444444444444
77572,/images/2d2e81f3-e329-4765-9ba1-2c95f12dc9f3.png,1038,265,1104,344,66,79,red blood cell,5214,1.196969696969697,0.8354430379746836
31755,/images/ab59c9e4-3e50-48b9-874d-060d317410cc.png,475,673,608,792,133,119,red blood cell,15827,0.8947368421052632,1.1176470588235294
78411,/images/fe00fa09-d3c8-485b-9d0f-3cce556c9edd.png,1046,146,1171,264,125,118,red blood cell,14750,0.944,1.0593220338983051
60372,/images/1c87b997-a8e6-48ca-bf40-19b9a7fd6a96.png,80,561,161,649,81,88,red blood cell,7128,1.0864197530864197,0.9204545454545454
22502,/images/bfe65b11-8aff-46aa-908b-1e989d25fdc4.png,197,53,312,167,115,114,red blood cell,13110,0.991304347826087,1.0087719298245614
34066,/images/de5d19b7-e670-4ac7-843b-7ce7bcebdf45.png,963,1406,1088,1532,125,126,red blood cell,15750,1.008,0.9920634920634921
23142,/images/c94a5851-b846-4fde-8c89-05bec3a8ac53.png,1001,744,1108,854,107,110,red blood cell,11770,1.02803738317757,0.9727272727272728
2948,/images/00a02700-2ea2-4590-9e15-ffc9160fd3de.png,286,129,387,245,101,116,red blood cell,11716,1.1485148514851484,0.8706896551724138
138,/images/6b14c855-8561-417c-97a4-63fa552842fd.png,702,747,820,865,118,118,red blood cell,13924,1.0,1.0
2103,/images/e94a811d-3145-4313-ba42-2d5ed283179f.png,792,597,910,707,118,110,red blood cell,12980,0.9322033898305084,1.0727272727272728
13157,/images/711f6b3f-cd63-46d1-834a-bc8e9aa9b43e.png,882,111,975,205,93,94,red blood cell,8742,1.010752688172043,0.9893617021276596
29037,/images/4c13e22e-dfd1-4fa1-b373-be9d0c272c0f.png,177,130,283,233,106,103,red blood cell,10918,0.9716981132075472,1.029126213592233
62311,/images/e0ff3476-226f-4125-b182-8e524d5503dd.png,618,1223,723,1330,105,107,red blood cell,11235,1.019047619047619,0.9813084112149533
9491,/images/f1faab5f-3033-45ea-9673-8b816fea5ce8.png,891,760,1005,875,114,115,red blood cell,13110,1.0087719298245614,0.991304347826087
15854,/images/c7c1b873-0548-4a73-9618-f60912e164df.png,553,1313,682,1427,129,114,red blood cell,14706,0.8837209302325582,1.131578947368421
303,/images/0dcca702-a4ef-4fb3-a940-9c0c140b21c7.png,284,571,400,674,116,103,red blood cell,11948,0.8879310344827587,1.1262135922330097
8187,/images/6bb4892c-27a9-4642-aba1-4b73f38f757c.png,1051,624,1160,733,109,109,red blood cell,11881,1.0,1.0
40,/images/8d02117d-6c71-4e47-b50a-6cc8d5eb1d55.png,1021,1029,1121,1109,100,80,red blood cell,8000,0.8,1.25
13148,/images/711f6b3f-cd63-46d1-834a-bc8e9aa9b43e.png,1050,663,1154,762,104,99,red blood cell,10296,0.9519230769230769,1.0505050505050506
77431,/images/c7ec51d5-9f45-4209-8357-39e9a984a733.png,8,1274,113,1366,105,92,red blood cell,9660,0.8761904761904762,1.141304347826087
40327,/images/eb86033f-4f1c-4e8c-ae84-e8e4c7e08626.png,89,1153,193,1273,104,120,red blood cell,12480,1.1538461538461537,0.8666666666666667
75892,/images/3006096f-ceeb-42be-b69e-785179d7438b.png,10,1266,116,1386,106,120,red blood cell,12720,1.1320754716981132,0.8833333333333333
15868,/images/c7c1b873-0548-4a73-9618-f60912e164df.png,221,1258,330,1378,109,120,red blood cell,13080,1.1009174311926606,0.9083333333333333
68794,/images/aa3ad405-828e-4986-8251-20fd981f34d3.png,262,20,356,125,94,105,red blood cell,9870,1.1170212765957446,0.8952380952380953
34317,/images/0d2aba33-6920-4001-bd54-59fe0bf9f50e.png,8,55,125,172,117,117,red blood cell,13689,1.0,1.0
48693,/images/03359d4d-69cb-4146-8286-ca7399366f97.png,571,1389,700,1493,129,104,red blood cell,13416,0.8062015503875969,1.2403846153846154
20510,/images/cbde7f7e-2458-4dda-9db2-3d5ccf950ced.png,608,1302,731,1422,123,120,red blood cell,14760,0.975609756097561,1.025
76311,/images/1574565f-f45b-4160-947e-25ce1a81aaca.png,276,884,393,1013,117,129,red blood cell,15093,1.1025641025641026,0.9069767441860465
56038,/images/177a3141-fa93-426a-9b52-7da71547ce44.png,1038,1320,1150,1415,112,95,red blood cell,10640,0.8482142857142857,1.1789473684210525
40319,/images/eb86033f-4f1c-4e8c-ae84-e8e4c7e08626.png,832,978,941,1087,109,109,red blood cell,11881,1.0,1.0
29456,/images/8cc6fe77-5f2f-4670-b4ac-1b49550241a8.png,844,499,944,614,100,115,red blood cell,11500,1.15,0.8695652173913043
41979,/images/46a03374-64c7-49ac-81c9-c3d62542bbf3.png,736,120,852,221,116,101,red blood cell,11716,0.8706896551724138,1.1485148514851484
79441,/images/a2fc0093-8645-43c7-bdee-ec8ca9484815.png,185,1353,308,1460,123,107,red blood cell,13161,0.8699186991869918,1.1495327102803738
24993,/images/ed0bee2f-05e0-4392-8357-19750cec577c.png,21,1124,121,1211,100,87,red blood cell,8700,0.87,1.1494252873563218
54650,/images/6473ddb6-ad56-48a2-81e8-c7cb45f06825.png,1048,103,1139,215,91,112,red blood cell,10192,1.2307692307692308,0.8125
57110,/images/7d041c38-11f2-4186-8a24-29d7d0f5c3cf.png,5,1250,100,1338,95,88,red blood cell,8360,0.9263157894736842,1.0795454545454546
19961,/images/0ca25c88-457f-4f03-bbc1-98fb6663f1d1.png,621,79,718,179,97,100,red blood cell,9700,1.0309278350515463,0.97
12258,/images/3b55c42f-ad59-422f-ba99-4f4f4ca9cb2e.png,102,956,231,1071,129,115,red blood cell,14835,0.8914728682170543,1.1217391304347826
60813,/images/0ab56f9a-846d-49e2-a617-c6cc477fdfad.png,76,778,195,895,119,117,red blood cell,13923,0.9831932773109243,1.017094017094017
47096,/images/820bbfea-3dae-46fc-b61a-3d0ed2ea01c2.png,336,970,446,1083,110,113,red blood cell,12430,1.0272727272727273,0.9734513274336283
20821,/images/c2ec116f-f091-422c-926c-70b548a8f6ef.png,856,879,967,981,111,102,red blood cell,11322,0.918918918918919,1.088235294117647
34343,/images/1a48cbc1-5423-47e5-8ca5-2ab4f83a05a5.png,165,814,274,919,109,105,red blood cell,11445,0.963302752293578,1.0380952380952382
24508,/images/109fbb82-bc3c-41ac-984d-e2da86202873.png,51,519,163,638,112,119,red blood cell,13328,1.0625,0.9411764705882353
9771,/images/3859deaf-6ae1-49a3-9051-898d0f0d7de6.png,308,698,421,807,113,109,red blood cell,12317,0.9646017699115044,1.036697247706422
38061,/images/e3e9c2de-0a24-4c7e-8a69-3d3093d5bdab.png,241,131,332,224,91,93,red blood cell,8463,1.021978021978022,0.978494623655914
8207,/images/6bb4892c-27a9-4642-aba1-4b73f38f757c.png,277,302,394,427,117,125,red blood cell,14625,1.0683760683760684,0.936
15895,/images/c7c1b873-0548-4a73-9618-f60912e164df.png,219,1083,311,1177,92,94,red blood cell,8648,1.0217391304347827,0.9787234042553191
63766,/images/06401963-8b02-46c5-ab2a-3d70bd01623f.png,487,134,558,213,71,79,red blood cell,5609,1.1126760563380282,0.8987341772151899
39061,/images/8f96ee1f-4ef7-4279-a610-316319bedcf9.png,182,851,292,955,110,104,red blood cell,11440,0.9454545454545454,1.0576923076923077
25260,/images/587e5464-d70b-4279-8562-010279f6efbd.png,63,622,194,734,131,112,red blood cell,14672,0.8549618320610687,1.1696428571428572
75834,/images/c4c7ed75-dbdf-4bb6-b6ba-718903cf7264.png,702,688,819,803,117,115,red blood cell,13455,0.9829059829059829,1.017391304347826
18441,/images/39cc33be-d752-40fe-b7a8-2e69a3517205.png,540,1383,638,1502,98,119,red blood cell,11662,1.2142857142857142,0.8235294117647058
70234,/images/a5c3b3f8-7ceb-4573-a400-a76b9479af46.png,379,106,488,217,109,111,red blood cell,12099,1.018348623853211,0.9819819819819819
64545,/images/6ba5d0b8-cdc7-4266-9d78-db76faa312e9.png,871,135,964,228,93,93,red blood cell,8649,1.0,1.0
64933,/images/dec61ae1-5037-4c3a-8952-15371becca7d.png,946,1123,1034,1220,88,97,red blood cell,8536,1.1022727272727273,0.9072164948453608
15290,/images/2d0f600d-f94e-4907-b712-52fb37d9ed52.png,640,788,748,902,108,114,red blood cell,12312,1.0555555555555556,0.9473684210526315
10423,/images/46a2d369-4bea-4405-ac78-91bbe130b9a7.png,1049,1493,1156,1599,107,106,red blood cell,11342,0.9906542056074766,1.009433962264151
24716,/images/78a5d1c3-44dd-44bc-ad5b-5e25bdcc4fae.png,68,567,175,683,107,116,red blood cell,12412,1.0841121495327102,0.9224137931034483
41846,/images/c3b07675-9d02-477c-91fe-f0737867049b.png,759,984,875,1110,116,126,red blood cell,14616,1.0862068965517242,0.9206349206349206
62422,/images/9af1ee02-87fd-42bc-963e-fa9ac3eb45bb.png,290,83,393,174,103,91,red blood cell,9373,0.883495145631068,1.1318681318681318
4409,/images/21ea4841-8998-4c04-b345-bc99cd8ecee6.png,1032,359,1144,465,112,106,red blood cell,11872,0.9464285714285714,1.0566037735849056
79881,/images/a054a8e2-55f2-4508-97df-207f76b89be2.png,0,1258,97,1352,97,94,red blood cell,9118,0.9690721649484536,1.0319148936170213
8109,/images/694222bb-cddf-469a-9526-f873c6fba58e.png,581,418,690,514,109,96,red blood cell,10464,0.8807339449541285,1.1354166666666667
68774,/images/eb5f4f2f-2275-4a80-84a5-78a1eaf4ce4d.png,810,441,927,559,117,118,red blood cell,13806,1.0085470085470085,0.9915254237288136
33790,/images/cb08956d-dd6a-4e13-817b-40a0a93068f1.png,124,900,225,1003,101,103,red blood cell,10403,1.0198019801980198,0.9805825242718447
57204,/images/ca5e6a15-ba65-48ea-8913-2d986e71bf3a.png,1064,1037,1176,1165,112,128,red blood cell,14336,1.1428571428571428,0.875
73354,/images/c890ee00-daa5-4b20-9cd5-930748ecc4e0.png,428,689,524,791,96,102,red blood cell,9792,1.0625,0.9411764705882353
7,/images/8d02117d-6c71-4e47-b50a-6cc8d5eb1d55.png,430,302,533,392,103,90,red blood cell,9270,0.8737864077669902,1.1444444444444444
31010,/images/b59dc3a0-3d54-4e3b-a485-33b3e43966de.png,343,1091,471,1203,128,112,red blood cell,14336,0.875,1.1428571428571428
52643,/images/a6fe423a-5204-4378-bcfa-d6d298a3e9aa.png,433,1077,554,1184,121,107,red blood cell,12947,0.8842975206611571,1.1308411214953271
65848,/images/daea4860-a296-4f6d-acef-996ab0882676.png,743,1109,830,1196,87,87,red blood cell,7569,1.0,1.0
26210,/images/7ba9db7e-9d3f-413c-b672-2bba5fb5b415.png,970,507,1075,630,105,123,red blood cell,12915,1.1714285714285715,0.8536585365853658
55720,/images/c32b8bb8-c89d-4ae9-9c77-5b9356ca35a1.png,597,334,697,421,100,87,red blood cell,8700,0.87,1.1494252873563218
16434,/images/e474a20b-2769-48f1-a520-4f6ef5a0dbf5.png,0,643,97,751,97,108,red blood cell,10476,1.1134020618556701,0.8981481481481481
9536,/images/a18f122f-3a3e-4478-8ac4-91b83e050e65.png,354,625,489,743,135,118,red blood cell,15930,0.8740740740740741,1.1440677966101696
55586,/images/a27b451d-44a6-4740-861a-9e7e99915563.png,666,301,758,385,92,84,red blood cell,7728,0.9130434782608695,1.0952380952380953
56967,/images/a93c35ba-1690-4358-8837-669bcd850bb7.png,913,1014,1039,1128,126,114,red blood cell,14364,0.9047619047619048,1.105263157894737
45093,/images/56fbae44-4677-47f8-9c3a-22dac043c115.png,865,735,969,852,104,117,red blood cell,12168,1.125,0.8888888888888888
68012,/images/bcaefb02-682a-41b9-acc7-e6cc010f5b30.png,1034,1338,1123,1412,89,74,red blood cell,6586,0.8314606741573034,1.2027027027027026
72692,/images/6ab870ba-b24b-49a9-9570-8eafe63aa74e.png,686,746,789,839,103,93,red blood cell,9579,0.9029126213592233,1.10752688172043
63940,/images/5e974892-0ebe-4037-8427-ea8616d6d3b8.png,1063,1386,1198,1512,135,126,red blood cell,17010,0.9333333333333333,1.0714285714285714
39341,/images/17ef5841-bd19-4610-ba47-7d321231847b.png,130,831,234,940,104,109,red blood cell,11336,1.0480769230769231,0.9541284403669725
43588,/images/e0ef520d-7b65-485d-9888-e6859f189f70.png,578,1218,702,1346,124,128,red blood cell,15872,1.032258064516129,0.96875
47353,/images/477e541c-0519-4542-9b13-8ee7922644d3.png,143,24,256,136,113,112,red blood cell,12656,0.9911504424778761,1.0089285714285714
62565,/images/9ecf2006-8d49-4ae8-a14b-ed8b3b14ee7c.png,960,1029,1095,1139,135,110,red blood cell,14850,0.8148148148148148,1.2272727272727273
4759,/images/3fa1a4e3-c80d-49da-8f7b-a1abb0424f48.png,607,714,711,824,104,110,red blood cell,11440,1.0576923076923077,0.9454545454545454
75726,/images/d12c5f45-6b20-46d6-a66f-c5a4683c25b3.png,843,1191,955,1296,112,105,red blood cell,11760,0.9375,1.0666666666666667
59381,/images/565513be-2c20-4ee3-94f3-093869515d3d.png,693,1007,799,1093,106,86,red blood cell,9116,0.8113207547169812,1.2325581395348837
36000,/images/5836500a-221e-40ca-a8be-caaa37f7d300.png,1073,693,1188,798,115,105,red blood cell,12075,0.9130434782608695,1.0952380952380953
39510,/images/5a631871-2fc7-4a68-9c39-f3b9a0bf4a04.png,519,813,637,928,118,115,red blood cell,13570,0.9745762711864406,1.0260869565217392
27379,/images/9f38055f-4fe6-47fd-a6dd-c0743db4eccf.png,405,928,491,1015,86,87,red blood cell,7482,1.0116279069767442,0.9885057471264368
54244,/images/3b5a8060-dec6-4a83-b7f2-b604e4e69dfc.png,36,992,131,1092,95,100,red blood cell,9500,1.0526315789473684,0.95
23273,/images/157ac97a-396e-4f6c-94c6-72a4d06ccc5f.png,708,15,833,139,125,124,red blood cell,15500,0.992,1.0080645161290323
63895,/images/5e974892-0ebe-4037-8427-ea8616d6d3b8.png,1075,59,1187,180,112,121,red blood cell,13552,1.0803571428571428,0.9256198347107438
69985,/images/3e36698f-8c09-4c8b-8948-737310bf97e5.png,490,1355,599,1461,109,106,red blood cell,11554,0.9724770642201835,1.028301886792453
16272,/images/d5009906-bce1-4353-90b4-f4c79362f4cf.png,962,1144,1078,1262,116,118,red blood cell,13688,1.0172413793103448,0.9830508474576272
77963,/images/c691c8ef-d3c7-47b6-a941-f6a1089f21a9.png,906,1076,1016,1191,110,115,red blood cell,12650,1.0454545454545454,0.9565217391304348
7434,/images/37a94c0f-e5d4-46fc-b4f8-994d477995fd.png,466,1314,584,1418,118,104,red blood cell,12272,0.8813559322033898,1.1346153846153846
7406,/images/76dbce7f-dc3e-4a29-b1fe-ab9dce583080.png,480,1331,605,1454,125,123,red blood cell,15375,0.984,1.016260162601626
39980,/images/8271d0d8-9985-43eb-94b3-c702adca139f.png,670,953,787,1078,117,125,red blood cell,14625,1.0683760683760684,0.936
35241,/images/a9159b11-ba49-4885-902e-00c8d5095b98.png,1093,629,1179,731,86,102,red blood cell,8772,1.186046511627907,0.8431372549019608
53187,/images/801296d9-3403-426f-859e-5c532858e025.png,757,210,894,326,137,116,red blood cell,15892,0.8467153284671532,1.1810344827586208
37778,/images/fe0c5e48-f65e-488c-9c3c-1ea7c7835c0c.png,823,742,927,846,104,104,red blood cell,10816,1.0,1.0
27603,/images/715761a2-745e-4743-9849-956a034ad3c4.png,1090,1431,1199,1538,109,107,red blood cell,11663,0.981651376146789,1.0186915887850467
40862,/images/bf20d04d-ff8a-4910-91d7-94054c267d1b.png,343,1471,466,1600,123,129,red blood cell,15867,1.048780487804878,0.9534883720930233
56327,/images/4372709c-f356-4906-be17-415384d916e8.png,633,1233,745,1334,112,101,red blood cell,11312,0.9017857142857143,1.108910891089109
73937,/images/2ae3e6e6-7482-4ab8-ad73-b530b5c2ee3b.png,477,354,564,443,87,89,red blood cell,7743,1.0229885057471264,0.9775280898876404
72736,/images/caeb2d62-1166-43f0-8eac-5b8fc48f02eb.png,437,847,557,973,120,126,red blood cell,15120,1.05,0.9523809523809523
61568,/images/4a717a39-80f8-4b75-a25e-c46d65d7dcd5.png,257,732,355,833,98,101,red blood cell,9898,1.030612244897959,0.9702970297029703
9942,/images/b9ccf7ca-953f-4832-9575-5e70b2a8c224.png,817,403,919,503,102,100,red blood cell,10200,0.9803921568627451,1.02
32166,/images/25cfca07-2101-484f-b312-a927395f2651.png,893,4,1006,115,113,111,red blood cell,12543,0.9823008849557522,1.018018018018018
28332,/images/34e024a5-5698-42d4-972f-fee234b4bd64.png,681,877,792,994,111,117,red blood cell,12987,1.054054054054054,0.9487179487179487
61838,/images/5f300fd1-7eec-41ac-bbd1-0f4a943c757c.png,812,1056,918,1163,106,107,red blood cell,11342,1.009433962264151,0.9906542056074766
66329,/images/fcdf6632-c03f-49a8-9fb3-42e87c99b9d0.png,403,890,517,994,114,104,red blood cell,11856,0.9122807017543859,1.0961538461538463
67244,/images/5f491efd-a21c-4a80-aaba-70b8876238ac.png,319,1410,419,1528,100,118,red blood cell,11800,1.18,0.847457627118644
67653,/images/59542a24-b409-4c95-8608-d9691a741526.png,669,1062,763,1161,94,99,red blood cell,9306,1.053191489361702,0.9494949494949495
61649,/images/a3c0a876-be12-4ede-8aed-18b32a64401b.png,746,620,852,732,106,112,red blood cell,11872,1.0566037735849056,0.9464285714285714
36353,/images/4a0a05e1-11ad-4bfc-bfa3-adf3b9bd0b56.png,911,1467,1026,1594,115,127,red blood cell,14605,1.1043478260869566,0.905511811023622
38527,/images/c3ae7090-fc68-41b4-85a1-8d9bce9825a7.png,422,386,529,512,107,126,red blood cell,13482,1.1775700934579438,0.8492063492063492
16018,/images/7e25ced3-5caf-47f8-ad0c-42946bd4468b.png,406,59,538,173,132,114,red blood cell,15048,0.8636363636363636,1.1578947368421053
72745,/images/caeb2d62-1166-43f0-8eac-5b8fc48f02eb.png,277,952,374,1046,97,94,red blood cell,9118,0.9690721649484536,1.0319148936170213
45818,/images/584d62ed-4329-45dd-94ce-e929d8b2bb74.png,325,526,430,622,105,96,red blood cell,10080,0.9142857142857143,1.09375
20073,/images/ebfd9f67-138e-49f0-9cef-a0352069eedb.png,107,578,220,691,113,113,red blood cell,12769,1.0,1.0
68330,/images/0f735cca-051c-4048-a1fa-cb36f389e12f.png,540,683,654,810,114,127,red blood cell,14478,1.1140350877192982,0.8976377952755905
77708,/images/4849866a-73a2-4fcf-a407-2d0a25a09a89.png,276,648,395,767,119,119,red blood cell,14161,1.0,1.0
60613,/images/724e0c34-32cd-41f1-ae37-586038bc67ab.png,530,80,635,178,105,98,red blood cell,10290,0.9333333333333333,1.0714285714285714
45903,/images/939ad732-d7c5-4339-b087-4335b49d6a3c.png,391,544,510,656,119,112,red blood cell,13328,0.9411764705882353,1.0625
42099,/images/46a03374-64c7-49ac-81c9-c3d62542bbf3.png,407,1323,510,1424,103,101,red blood cell,10403,0.9805825242718447,1.0198019801980198
54920,/images/f1872d08-f8a6-4b21-aa29-f56bbf607883.png,866,1323,969,1426,103,103,red blood cell,10609,1.0,1.0
9009,/images/ef815e3a-02a6-4cf8-9262-45bc74c50b00.png,146,816,264,925,118,109,red blood cell,12862,0.923728813559322,1.0825688073394495
27174,/images/f232eec3-02c0-43f9-bf32-3e60245397e2.png,1004,1412,1123,1523,119,111,red blood cell,13209,0.9327731092436975,1.072072072072072
64394,/images/0a7bfa8a-ee52-4f7a-b9c5-2919ecfa93ef.png,303,1417,387,1501,84,84,red blood cell,7056,1.0,1.0
52032,/images/6c3f81d7-5670-46bd-9eaa-9b426413abb7.png,446,1218,557,1326,111,108,red blood cell,11988,0.972972972972973,1.0277777777777777
39945,/images/8271d0d8-9985-43eb-94b3-c702adca139f.png,202,288,325,421,123,133,red blood cell,16359,1.08130081300813,0.924812030075188
47389,/images/477e541c-0519-4542-9b13-8ee7922644d3.png,594,672,719,774,125,102,red blood cell,12750,0.816,1.2254901960784315
9230,/images/261562a8-ffd8-4e0e-919b-22e267000b74.png,995,689,1104,798,109,109,red blood cell,11881,1.0,1.0
58500,/images/5cac6ddf-c8c6-45de-bce0-a1db64b14fb5.png,1081,126,1185,250,104,124,red blood cell,12896,1.1923076923076923,0.8387096774193549
3404,/images/fd1302e2-3cd2-4a1a-9c13-00f810a9c41b.png,295,123,395,221,100,98,red blood cell,9800,0.98,1.0204081632653061
65201,/images/50715879-2300-4dba-8f4a-3314ff8cfcce.png,1054,748,1164,854,110,106,red blood cell,11660,0.9636363636363636,1.0377358490566038
33381,/images/f632981c-1330-4078-8a12-691beb2dab02.png,773,755,884,868,111,113,red blood cell,12543,1.018018018018018,0.9823008849557522
10655,/images/20d4f65e-6c63-433a-935c-d568d577967b.png,302,81,395,174,93,93,red blood cell,8649,1.0,1.0
41427,/images/c4494d4f-732f-431a-8a9d-62403f0b74fe.png,99,129,200,231,101,102,red blood cell,10302,1.00990099009901,0.9901960784313726
67506,/images/75660b56-51c2-45a9-9c15-e18d12a3af8c.png,129,640,256,756,127,116,red blood cell,14732,0.9133858267716536,1.0948275862068966
29949,/images/deeaa5b3-3895-4aec-a2ce-ed6404862cdf.png,269,49,387,151,118,102,red blood cell,12036,0.864406779661017,1.1568627450980393
74045,/images/fe436c09-b680-4f4c-8faf-aa10a55a335b.png,696,1332,790,1441,94,109,red blood cell,10246,1.1595744680851063,0.8623853211009175
19584,/images/883d9731-a04d-4f84-83c9-d3bef954759d.png,701,44,821,171,120,127,red blood cell,15240,1.0583333333333333,0.9448818897637795
79460,/images/a2fc0093-8645-43c7-bdee-ec8ca9484815.png,762,145,865,251,103,106,red blood cell,10918,1.029126213592233,0.9716981132075472
10567,/images/9fbf38ab-44b9-4096-a818-603017a4300e.png,833,0,967,118,134,118,red blood cell,15812,0.8805970149253731,1.1355932203389831
1299,/images/6d91d1f0-636b-4f5a-a526-7c17fc857190.png,16,176,107,280,91,104,red blood cell,9464,1.1428571428571428,0.875
17009,/images/57e1879e-4294-45e7-9c1b-627e8cca0271.png,378,1332,480,1434,102,102,red blood cell,10404,1.0,1.0
21522,/images/7625dfc4-858a-4c8e-907c-8943d665e9a7.png,400,205,496,302,96,97,red blood cell,9312,1.0104166666666667,0.9896907216494846
15696,/images/3892b776-f49a-4368-b0fa-7e855e76ccec.png,813,963,917,1073,104,110,red blood cell,11440,1.0576923076923077,0.9454545454545454
9777,/images/3859deaf-6ae1-49a3-9051-898d0f0d7de6.png,812,1334,914,1420,102,86,red blood cell,8772,0.8431372549019608,1.186046511627907
38873,/images/d79b4e90-c45d-4f5d-a498-49c3e323c291.png,353,657,458,768,105,111,red blood cell,11655,1.0571428571428572,0.9459459459459459
18444,/images/39cc33be-d752-40fe-b7a8-2e69a3517205.png,983,734,1116,882,133,148,red blood cell,19684,1.112781954887218,0.8986486486486487
31366,/images/04fb49a2-07b8-4cdf-b6f7-df5c3688e5f8.png,521,254,627,350,106,96,red blood cell,10176,0.9056603773584906,1.1041666666666667
18380,/images/39cc33be-d752-40fe-b7a8-2e69a3517205.png,121,1141,245,1252,124,111,red blood cell,13764,0.8951612903225806,1.117117117117117
75610,/images/c35ee701-fde2-46b5-b178-1fe3f1ea7da2.png,151,224,255,326,104,102,red blood cell,10608,0.9807692307692307,1.0196078431372548
22511,/images/bfe65b11-8aff-46aa-908b-1e989d25fdc4.png,982,211,1100,314,118,103,red blood cell,12154,0.8728813559322034,1.145631067961165
46406,/images/bbecf1a8-a728-4c83-87f8-4dfbac0a1e03.png,502,1460,619,1588,117,128,red blood cell,14976,1.0940170940170941,0.9140625
42448,/images/29648565-fe28-4517-ba72-68df0c82c9c5.png,147,653,272,777,125,124,red blood cell,15500,0.992,1.0080645161290323
58706,/images/e4827c85-311a-4df1-89c2-99dad0c3558c.png,1042,1309,1144,1413,102,104,red blood cell,10608,1.0196078431372548,0.9807692307692307
59283,/images/03c8da48-04b9-4520-b674-44a0ecd35688.png,190,1158,279,1268,89,110,red blood cell,9790,1.2359550561797752,0.8090909090909091
54464,/images/22a464ef-c3da-4d56-b37e-e22e95d945e7.png,1088,843,1176,923,88,80,red blood cell,7040,0.9090909090909091,1.1
75996,/images/034c8d57-04d5-4786-93a4-6ae8fde2c258.png,247,1411,325,1492,78,81,red blood cell,6318,1.0384615384615385,0.9629629629629629
73101,/images/f39e2289-fedd-4d12-9e64-ffdafb89247e.png,242,631,341,734,99,103,red blood cell,10197,1.0404040404040404,0.9611650485436893
54741,/images/10891eed-b0f2-4dd0-90cb-da185f6761b2.png,597,1101,700,1202,103,101,red blood cell,10403,0.9805825242718447,1.0198019801980198
33067,/images/6231d81d-9e84-4a5a-8cb8-47c6a37a0176.png,515,1470,603,1572,88,102,red blood cell,8976,1.1590909090909092,0.8627450980392157
30129,/images/81c3c8f0-d5a9-4dda-afd5-e86f6afd9424.png,528,193,627,291,99,98,red blood cell,9702,0.98989898989899,1.010204081632653
712,/images/dcc1a193-7b74-44f8-ad8d-813751d8fa6b.png,401,758,506,857,105,99,red blood cell,10395,0.9428571428571428,1.0606060606060606
36445,/images/cfe6086f-eb0b-4cb0-a430-8cd7de6556e2.png,361,416,462,529,101,113,red blood cell,11413,1.118811881188119,0.8938053097345132
55244,/images/8ad7ba46-5db8-4ba9-b3e0-3cac52f7efc3.png,242,373,357,488,115,115,red blood cell,13225,1.0,1.0
15840,/images/c7c1b873-0548-4a73-9618-f60912e164df.png,12,823,102,922,90,99,red blood cell,8910,1.1,0.9090909090909091
22460,/images/99d6a7e5-128e-4455-841d-8fbd1663905e.png,345,704,469,823,124,119,red blood cell,14756,0.9596774193548387,1.0420168067226891
60368,/images/1c87b997-a8e6-48ca-bf40-19b9a7fd6a96.png,554,1075,662,1181,108,106,red blood cell,11448,0.9814814814814815,1.0188679245283019
62844,/images/4b346035-b8c0-46ca-8fdb-a01b1421ee4a.png,361,286,471,397,110,111,red blood cell,12210,1.009090909090909,0.990990990990991
46782,/images/02fb5e19-6f94-4787-bb78-e550a29a3cbd.png,916,1047,1042,1169,126,122,red blood cell,15372,0.9682539682539683,1.0327868852459017
26213,/images/7ba9db7e-9d3f-413c-b672-2bba5fb5b415.png,962,141,1094,273,132,132,red blood cell,17424,1.0,1.0
51410,/images/b4f3b2a4-f4b9-48de-ac5d-0e681b77be27.png,17,1435,110,1539,93,104,red blood cell,9672,1.118279569892473,0.8942307692307693
72650,/images/6ab870ba-b24b-49a9-9570-8eafe63aa74e.png,532,863,635,962,103,99,red blood cell,10197,0.9611650485436893,1.0404040404040404
60288,/images/7abc0d26-dd66-4ef4-8c4e-4a661e589a7f.png,406,179,504,274,98,95,red blood cell,9310,0.9693877551020408,1.0315789473684212
35744,/images/4063945d-03fc-4ce3-a04c-17435dce8f91.png,538,635,668,762,130,127,red blood cell,16510,0.9769230769230769,1.0236220472440944
16453,/images/e474a20b-2769-48f1-a520-4f6ef5a0dbf5.png,732,741,830,834,98,93,red blood cell,9114,0.9489795918367347,1.053763440860215
44667,/images/8002cb71-0f25-4fa4-a46f-b49e5aeded0c.png,843,1389,961,1501,118,112,red blood cell,13216,0.9491525423728814,1.0535714285714286
54431,/images/22a464ef-c3da-4d56-b37e-e22e95d945e7.png,408,1082,507,1166,99,84,red blood cell,8316,0.8484848484848485,1.1785714285714286
26635,/images/16ec6e1f-5020-40b3-ba26-51c340d03ee7.png,952,95,1071,218,119,123,red blood cell,14637,1.0336134453781514,0.967479674796748
49247,/images/989d86a1-6d76-4089-85cf-2f2ca0a8456c.png,885,1204,996,1301,111,97,red blood cell,10767,0.8738738738738738,1.1443298969072164
65704,/images/c54fcef1-0c51-4426-9a93-15ec5f2bf58a.png,998,1034,1113,1151,115,117,red blood cell,13455,1.017391304347826,0.9829059829059829
14720,/images/1fdf99d1-a494-4174-bcd7-efbe457ab899.png,135,816,253,949,118,133,red blood cell,15694,1.1271186440677967,0.8872180451127819
68597,/images/31653d0f-c4e6-4e12-8005-518c2de34687.png,770,559,879,671,109,112,red blood cell,12208,1.0275229357798166,0.9732142857142857
70090,/images/b8339d7b-85ec-48d0-83e8-c8f831070459.png,113,1390,209,1485,96,95,red blood cell,9120,0.9895833333333334,1.0105263157894737
4387,/images/84041bf9-dace-4066-9fe0-52170d08f826.png,960,156,1052,263,92,107,red blood cell,9844,1.1630434782608696,0.8598130841121495
63228,/images/d3283f5b-3b3a-40ea-800b-79960ca851cb.png,749,1221,860,1335,111,114,red blood cell,12654,1.027027027027027,0.9736842105263158
14432,/images/3b13e20f-ec0d-44ec-b2f4-eaebfa09150e.png,680,543,808,662,128,119,red blood cell,15232,0.9296875,1.0756302521008403
6908,/images/b21f6c6e-4b45-407a-b4c7-034a115f3ee4.png,764,1493,860,1596,96,103,red blood cell,9888,1.0729166666666667,0.9320388349514563
61474,/images/7e837856-3519-4dc0-b357-4cdcfd30b4eb.png,280,1466,376,1575,96,109,red blood cell,10464,1.1354166666666667,0.8807339449541285
78098,/images/105af41b-13cc-4ad1-8a1f-8bc4d47cdd94.png,702,333,794,426,92,93,red blood cell,8556,1.0108695652173914,0.989247311827957
60087,/images/e63e1607-f344-43d6-a0d8-e10cf2e5054a.png,22,84,151,207,129,123,red blood cell,15867,0.9534883720930233,1.048780487804878
21626,/images/66183740-e1e5-43c9-8539-a87028bb3621.png,116,240,221,341,105,101,red blood cell,10605,0.9619047619047619,1.0396039603960396
2605,/images/a23f5539-bfe6-4885-9a0e-dba972475ea9.png,983,1012,1077,1106,94,94,red blood cell,8836,1.0,1.0
38000,/images/e3e9c2de-0a24-4c7e-8a69-3d3093d5bdab.png,56,142,158,237,102,95,red blood cell,9690,0.9313725490196079,1.0736842105263158
67022,/images/1fe1e118-adb8-4b10-a41e-1e5814e8f067.png,848,952,976,1081,128,129,red blood cell,16512,1.0078125,0.9922480620155039
5625,/images/afa470d9-c74c-41cd-b4dc-7bf93fde8263.png,716,525,830,644,114,119,red blood cell,13566,1.043859649122807,0.957983193277311
55382,/images/4fb83278-adc5-4424-9f45-b6d0db2955b6.png,199,892,302,997,103,105,red blood cell,10815,1.0194174757281553,0.9809523809523809
52130,/images/94d9fa50-d3e4-4eaf-acfc-92e7f2ed9ea5.png,511,630,603,735,92,105,red blood cell,9660,1.141304347826087,0.8761904761904762
51578,/images/d0347b49-8f98-4632-a384-1a4f57ac6374.png,1078,1079,1185,1175,107,96,red blood cell,10272,0.897196261682243,1.1145833333333333
42595,/images/184b376b-03cb-4c2d-af51-fc1a62196293.png,681,1011,776,1111,95,100,red blood cell,9500,1.0526315789473684,0.95
39187,/images/2aeb7b85-7df9-4a63-8d37-2eecaaa190e7.png,831,844,932,956,101,112,red blood cell,11312,1.108910891089109,0.9017857142857143
47602,/images/06cd484f-e864-4fee-8819-688b45eed98e.png,835,127,942,236,107,109,red blood cell,11663,1.0186915887850467,0.981651376146789
2115,/images/e94a811d-3145-4313-ba42-2d5ed283179f.png,357,1241,463,1340,106,99,red blood cell,10494,0.9339622641509434,1.0707070707070707
38403,/images/674b0fd3-f247-4b7f-97f7-3e6c57c9ba9e.png,795,1467,885,1575,90,108,red blood cell,9720,1.2,0.8333333333333334
46115,/images/72088c26-d2dd-4906-b791-b8947fc7fbe4.png,960,2,1058,101,98,99,red blood cell,9702,1.010204081632653,0.98989898989899
41819,/images/c3b07675-9d02-477c-91fe-f0737867049b.png,428,1033,567,1162,139,129,red blood cell,17931,0.9280575539568345,1.0775193798449612
17744,/images/b5143aae-6e98-4dc6-b546-980cb472de67.png,1012,247,1141,366,129,119,red blood cell,15351,0.9224806201550387,1.084033613445378
43367,/images/aabca37c-f9ef-4415-aab6-3246caa348e9.png,598,556,717,676,119,120,red blood cell,14280,1.0084033613445378,0.9916666666666667
77618,/images/f20a4fcf-ea8e-4c14-883d-d26a9e08ce25.png,635,655,751,775,116,120,red blood cell,13920,1.0344827586206897,0.9666666666666667
63872,/images/5e974892-0ebe-4037-8427-ea8616d6d3b8.png,201,865,301,984,100,119,red blood cell,11900,1.19,0.8403361344537815
73030,/images/2bd26501-2fbc-4c1a-bef0-4ad57e02b4d0.png,492,801,574,890,82,89,red blood cell,7298,1.0853658536585367,0.9213483146067416
2838,/images/e79bd81b-f878-4bee-9be2-d91a722c031e.png,310,485,424,580,114,95,red blood cell,10830,0.8333333333333334,1.2
48497,/images/9c4cb048-d64a-4b7f-84ff-ca28a8084fc7.png,689,487,801,610,112,123,red blood cell,13776,1.0982142857142858,0.9105691056910569
29708,/images/f25a2ac8-cb6e-4e05-a0cd-cc00ac47718a.png,143,461,260,578,117,117,red blood cell,13689,1.0,1.0
58574,/images/7fd2d254-b062-4f3d-8970-687e73c5a00a.png,1014,1007,1125,1120,111,113,red blood cell,12543,1.018018018018018,0.9823008849557522
20559,/images/cbde7f7e-2458-4dda-9db2-3d5ccf950ced.png,1001,112,1117,233,116,121,red blood cell,14036,1.043103448275862,0.9586776859504132
78989,/images/6144887d-a1c1-46db-91a1-f7ff5bf8c8a5.png,978,164,1066,256,88,92,red blood cell,8096,1.0454545454545454,0.9565217391304348
69860,/images/9edba799-e169-46cd-b100-c9f8fc7a8c7d.png,470,839,578,944,108,105,red blood cell,11340,0.9722222222222222,1.0285714285714285
59924,/images/1519257c-e3e5-4474-908f-8665b3cf1258.png,1113,684,1200,772,87,88,red blood cell,7656,1.0114942528735633,0.9886363636363636
27842,/images/948c94ad-395c-41f4-9a68-8a1dcb76888c.png,208,703,314,802,106,99,red blood cell,10494,0.9339622641509434,1.0707070707070707
29512,/images/8cc6fe77-5f2f-4670-b4ac-1b49550241a8.png,1,1233,107,1345,106,112,red blood cell,11872,1.0566037735849056,0.9464285714285714
6838,/images/e36cb882-c6d0-4467-812e-d18c169a9a47.png,274,1219,370,1320,96,101,red blood cell,9696,1.0520833333333333,0.9504950495049505
12587,/images/8e4bdd0d-1c72-4836-ae3e-05e2e50e4983.png,469,537,547,626,78,89,red blood cell,6942,1.141025641025641,0.8764044943820225
9150,/images/d3ed519e-2152-4e30-838d-a3ea23be512f.png,398,1020,500,1137,102,117,red blood cell,11934,1.1470588235294117,0.8717948717948718
59082,/images/5e2cea49-0823-49d1-83cf-8fd1559cdd93.png,387,853,480,952,93,99,red blood cell,9207,1.064516129032258,0.9393939393939394
66946,/images/9acf303a-fcba-4e52-be3e-8d061aa5e72a.png,477,116,570,194,93,78,red blood cell,7254,0.8387096774193549,1.1923076923076923
51740,/images/592c941a-aa54-4971-b499-dc47356f80a3.png,188,630,295,716,107,86,red blood cell,9202,0.8037383177570093,1.244186046511628
27906,/images/46f5bd4f-8bea-48d1-a1da-4dea28e3b814.png,308,332,418,447,110,115,red blood cell,12650,1.0454545454545454,0.9565217391304348
46486,/images/21417261-475a-456f-b03f-57ac85a6e106.png,933,1103,1057,1230,124,127,red blood cell,15748,1.0241935483870968,0.9763779527559056
30769,/images/8e0dfc1f-e3eb-4a3f-a1c4-249bdfbfaa27.png,776,1487,887,1600,111,113,red blood cell,12543,1.018018018018018,0.9823008849557522
20733,/images/79b3a64f-2fb9-46e0-85d4-2bdd59c2075e.png,590,1102,709,1212,119,110,red blood cell,13090,0.9243697478991597,1.0818181818181818
71696,/images/5c99cd97-39f6-4809-9528-9d380cc16b16.png,215,317,300,410,85,93,red blood cell,7905,1.0941176470588236,0.9139784946236559
8706,/images/92e4fd7b-79ef-49c2-a52b-9ef13dd720ef.png,813,1419,944,1556,131,137,red blood cell,17947,1.0458015267175573,0.9562043795620438
77928,/images/464055b6-3351-4636-a919-8be9840fb850.png,24,679,117,764,93,85,red blood cell,7905,0.9139784946236559,1.0941176470588236
58788,/images/e4827c85-311a-4df1-89c2-99dad0c3558c.png,1124,986,1199,1065,75,79,red blood cell,5925,1.0533333333333332,0.9493670886075949
63644,/images/d9c9479e-f1ea-4d6e-861f-843ff9a90d19.png,897,1284,991,1383,94,99,red blood cell,9306,1.053191489361702,0.9494949494949495
30024,/images/deeaa5b3-3895-4aec-a2ce-ed6404862cdf.png,776,340,897,443,121,103,red blood cell,12463,0.8512396694214877,1.174757281553398
78450,/images/72029aca-f0bc-477f-b790-f345f86228ce.png,716,1038,812,1138,96,100,red blood cell,9600,1.0416666666666667,0.96
17270,/images/3d302619-473d-4c5b-af43-8833ff94233f.png,1059,64,1154,173,95,109,red blood cell,10355,1.1473684210526316,0.8715596330275229
19131,/images/2196389c-45ec-46b5-bc6c-1f4a33df7f7c.png,314,1366,441,1481,127,115,red blood cell,14605,0.905511811023622,1.1043478260869566
32850,/images/2a6370b0-08f1-4c11-a639-265d4419c9a3.png,901,389,1011,501,110,112,red blood cell,12320,1.018181818181818,0.9821428571428571
1455,/images/5f17d2fb-22fa-4aa6-9dad-6a1d50c03815.png,876,241,988,354,112,113,red blood cell,12656,1.0089285714285714,0.9911504424778761
21540,/images/49efc89d-9cba-44f7-8257-7f911b73f68a.png,641,257,740,360,99,103,red blood cell,10197,1.0404040404040404,0.9611650485436893
55896,/images/afd39466-aafa-4d81-9520-483727418723.png,514,375,615,486,101,111,red blood cell,11211,1.099009900990099,0.9099099099099099
79876,/images/a054a8e2-55f2-4508-97df-207f76b89be2.png,31,0,138,94,107,94,red blood cell,10058,0.8785046728971962,1.1382978723404256
60007,/images/49288109-80e9-4ec8-96d1-26a0166b8883.png,411,485,513,598,102,113,red blood cell,11526,1.107843137254902,0.9026548672566371
75305,/images/9ec1dcec-87c2-4aca-8e6b-0db3cd05509c.png,486,1453,599,1576,113,123,red blood cell,13899,1.0884955752212389,0.9186991869918699
80037,/images/38d1b930-dd97-4248-9160-e9389a1a8dd7.png,413,1170,536,1275,123,105,red blood cell,12915,0.8536585365853658,1.1714285714285715
38919,/images/d79b4e90-c45d-4f5d-a498-49c3e323c291.png,441,537,542,632,101,95,red blood cell,9595,0.9405940594059405,1.063157894736842
13607,/images/d47cd049-d78b-4ba3-a7d4-399be4dd1dde.png,337,619,457,739,120,120,red blood cell,14400,1.0,1.0
20623,/images/0f2a6cda-afec-437b-8803-8d3176b072c1.png,1019,278,1118,386,99,108,red blood cell,10692,1.0909090909090908,0.9166666666666666
24012,/images/5107dcb7-164f-4e10-bbff-822b39b76efc.png,431,459,547,577,116,118,red blood cell,13688,1.0172413793103448,0.9830508474576272
75678,/images/50d7c6c9-3230-48fe-947c-7dcfd0aad710.png,1043,183,1152,272,109,89,red blood cell,9701,0.8165137614678899,1.2247191011235956
71314,/images/bcb447c9-5d37-414f-a513-d7076b04a532.png,495,1286,593,1374,98,88,red blood cell,8624,0.8979591836734694,1.1136363636363635
23262,/images/3dcd4f1b-ce43-4a34-b1ed-076bb42963b1.png,543,943,642,1048,99,105,red blood cell,10395,1.0606060606060606,0.9428571428571428
63334,/images/9f4bc3b4-abb0-4bcb-baa8-ec9f25e2b9c6.png,1024,30,1128,129,104,99,red blood cell,10296,0.9519230769230769,1.0505050505050506
14829,/images/f8b6a868-60e9-4569-ae69-638a0c39834d.png,547,270,687,392,140,122,red blood cell,17080,0.8714285714285714,1.1475409836065573
5138,/images/a777e78c-ad1f-4380-9ab2-b4f9f32b2d78.png,154,945,236,1046,82,101,red blood cell,8282,1.2317073170731707,0.8118811881188119
60919,/images/11b72c7b-5c52-44b7-adb7-21eacc25e441.png,936,929,1021,1017,85,88,red blood cell,7480,1.035294117647059,0.9659090909090909
19220,/images/b4d22412-a495-43a9-bec0-73a2322f8dad.png,717,647,838,755,121,108,red blood cell,13068,0.8925619834710744,1.1203703703703705
31767,/images/ab59c9e4-3e50-48b9-874d-060d317410cc.png,963,1457,1073,1578,110,121,red blood cell,13310,1.1,0.9090909090909091
10048,/images/26799d2b-a289-4eff-9218-0aad77e05e41.png,661,414,786,539,125,125,red blood cell,15625,1.0,1.0
30189,/images/a1669b59-fe09-4fe6-ba9f-06bec6725502.png,530,1121,659,1235,129,114,red blood cell,14706,0.8837209302325582,1.131578947368421
59736,/images/f77d7469-d083-4c2d-a4ea-5a9ff162e3e2.png,453,1473,564,1574,111,101,red blood cell,11211,0.9099099099099099,1.099009900990099
41885,/images/783ae4ad-6a35-4b3c-b19f-754974b67b2d.png,326,686,428,786,102,100,red blood cell,10200,0.9803921568627451,1.02
39733,/images/56adbb1e-96a8-40a5-a5a2-243c97ea889b.png,794,167,923,297,129,130,red blood cell,16770,1.0077519379844961,0.9923076923076923
52791,/images/0a747cb3-c720-4572-a661-ab5670a5c42e.png,358,147,488,267,130,120,red blood cell,15600,0.9230769230769231,1.0833333333333333
31448,/images/6695a204-e39c-4418-b904-3f080fdbe7e8.png,428,1341,531,1452,103,111,red blood cell,11433,1.0776699029126213,0.9279279279279279
73378,/images/c890ee00-daa5-4b20-9cd5-930748ecc4e0.png,721,383,812,483,91,100,red blood cell,9100,1.098901098901099,0.91
23865,/images/c17523c5-90a0-4a6b-9b33-2b4a6cf58d36.png,609,912,713,1022,104,110,red blood cell,11440,1.0576923076923077,0.9454545454545454
39142,/images/7bde7de1-889b-4218-b0e1-e2c04f6a7986.png,396,1439,506,1554,110,115,red blood cell,12650,1.0454545454545454,0.9565217391304348
29353,/images/3850f2a5-ab62-49d3-8135-68d60baa676b.png,129,283,252,390,123,107,red blood cell,13161,0.8699186991869918,1.1495327102803738
76473,/images/34df8890-272d-423a-ae78-ff8d068d3306.png,50,567,154,667,104,100,red blood cell,10400,0.9615384615384616,1.04
70464,/images/8cca114a-ed05-4b87-95b7-fae02487f08c.png,759,872,857,979,98,107,red blood cell,10486,1.0918367346938775,0.9158878504672897
66958,/images/9acf303a-fcba-4e52-be3e-8d061aa5e72a.png,574,1194,662,1277,88,83,red blood cell,7304,0.9431818181818182,1.0602409638554218
45000,/images/13bab3c3-3f79-44d9-a287-0ae6d71eff31.png,889,1146,1005,1258,116,112,red blood cell,12992,0.9655172413793104,1.0357142857142858
75120,/images/7fdc8be8-7579-4a5c-b369-8a07ee0a8b7d.png,1023,892,1141,1014,118,122,red blood cell,14396,1.0338983050847457,0.9672131147540983
25100,/images/9e74feb8-017d-4d53-8896-9ebda4327dd1.png,856,689,969,785,113,96,red blood cell,10848,0.8495575221238938,1.1770833333333333
1844,/images/8855c685-5a8c-4967-a356-942ed89e3471.png,495,612,607,740,112,128,red blood cell,14336,1.1428571428571428,0.875
48165,/images/913099c5-8085-4908-bf4b-1f098bbfcf66.png,936,548,1036,657,100,109,red blood cell,10900,1.09,0.9174311926605505
26730,/images/2518f6e4-29cc-4ae4-a914-b215a4c56099.png,934,1279,1022,1375,88,96,red blood cell,8448,1.0909090909090908,0.9166666666666666
74225,/images/4e43fc22-dc08-4cde-b3ce-ce8a4f377c47.png,825,1401,919,1493,94,92,red blood cell,8648,0.9787234042553191,1.0217391304347827
52175,/images/f4c00b8c-d675-4255-8277-ca65bd757f51.png,22,1411,110,1510,88,99,red blood cell,8712,1.125,0.8888888888888888
67402,/images/266180ed-77a3-4284-8292-50a49fc47fce.png,316,1224,422,1314,106,90,red blood cell,9540,0.8490566037735849,1.1777777777777778
34873,/images/a4fbb9f2-9b75-4fdc-877d-2feaafac25b3.png,44,631,145,737,101,106,red blood cell,10706,1.0495049504950495,0.9528301886792453
30543,/images/7d9c1422-6332-44e9-b134-3ac94f07b0f0.png,562,51,678,159,116,108,red blood cell,12528,0.9310344827586207,1.0740740740740742
78461,/images/72029aca-f0bc-477f-b790-f345f86228ce.png,257,226,368,345,111,119,red blood cell,13209,1.072072072072072,0.9327731092436975
79683,/images/a4409217-be11-4478-90a5-b406057d154d.png,713,2,812,100,99,98,red blood cell,9702,0.98989898989899,1.010204081632653
69740,/images/2bd15b6e-fe2d-49f3-b394-940d024d1f91.png,916,1201,1045,1319,129,118,red blood cell,15222,0.9147286821705426,1.0932203389830508
53560,/images/7c1cd7c7-7452-4428-a98e-dd7675c8ddea.png,662,238,787,361,125,123,red blood cell,15375,0.984,1.016260162601626
28445,/images/c3042130-a6e2-458f-9fde-bb012f68f5f2.png,641,522,752,631,111,109,red blood cell,12099,0.9819819819819819,1.018348623853211
14236,/images/6382976c-ee87-4916-b798-4ef1373b2df0.png,414,739,510,844,96,105,red blood cell,10080,1.09375,0.9142857142857143
29667,/images/b85fc640-de49-4f7e-afc0-978ff020f2e2.png,867,1140,980,1260,113,120,red blood cell,13560,1.0619469026548674,0.9416666666666667
15945,/images/c7c1b873-0548-4a73-9618-f60912e164df.png,428,165,526,286,98,121,red blood cell,11858,1.2346938775510203,0.8099173553719008
39910,/images/71cf2467-77d3-4fac-ac6e-1d8767717c34.png,287,998,404,1112,117,114,red blood cell,13338,0.9743589743589743,1.0263157894736843
57095,/images/7d041c38-11f2-4186-8a24-29d7d0f5c3cf.png,202,187,296,290,94,103,red blood cell,9682,1.0957446808510638,0.912621359223301
64617,/images/6dfafdf1-f588-4e80-8cf8-0126e1bf7af9.png,1035,1365,1127,1459,92,94,red blood cell,8648,1.0217391304347827,0.9787234042553191
17184,/images/471f75c6-bd5d-4c20-bcc1-258e836f4d69.png,1066,798,1176,899,110,101,red blood cell,11110,0.9181818181818182,1.0891089108910892
30135,/images/81c3c8f0-d5a9-4dda-afd5-e86f6afd9424.png,308,1221,421,1315,113,94,red blood cell,10622,0.831858407079646,1.202127659574468
64161,/images/0d3c2521-da55-4df5-bf06-56b3bd4fb2fc.png,454,499,546,587,92,88,red blood cell,8096,0.9565217391304348,1.0454545454545454
69085,/images/de2b8835-552c-4f01-98b7-67bc4910062e.png,734,422,831,527,97,105,red blood cell,10185,1.0824742268041236,0.9238095238095239
6436,/images/1ecb0405-a6e9-4485-819e-2fbbf2b718aa.png,642,438,746,539,104,101,red blood cell,10504,0.9711538461538461,1.0297029702970297
17084,/images/883b726a-f61c-4382-9f1b-2fff302beba6.png,567,426,682,555,115,129,red blood cell,14835,1.1217391304347826,0.8914728682170543
65166,/images/5e042380-6ef2-496f-8231-0ca550fbfa71.png,206,546,295,648,89,102,red blood cell,9078,1.146067415730337,0.8725490196078431
58509,/images/5cac6ddf-c8c6-45de-bce0-a1db64b14fb5.png,186,1426,299,1558,113,132,red blood cell,14916,1.168141592920354,0.8560606060606061
78873,/images/4d0a1598-e4dd-45c4-8a90-dd7c780fe1da.png,204,978,307,1077,103,99,red blood cell,10197,0.9611650485436893,1.0404040404040404
28037,/images/c4d34e35-4db2-41de-ba77-1a94aa9ef788.png,87,651,207,780,120,129,red blood cell,15480,1.075,0.9302325581395349
26320,/images/580210c2-a8ed-4720-b71c-a77945968abc.png,745,532,866,653,121,121,red blood cell,14641,1.0,1.0
52190,/images/f4c00b8c-d675-4255-8277-ca65bd757f51.png,82,21,193,134,111,113,red blood cell,12543,1.018018018018018,0.9823008849557522
42880,/images/a7b6894d-eeea-4ed5-bc0e-785d6c6da8df.png,293,668,411,796,118,128,red blood cell,15104,1.0847457627118644,0.921875
8723,/images/92e4fd7b-79ef-49c2-a52b-9ef13dd720ef.png,806,761,921,873,115,112,red blood cell,12880,0.9739130434782609,1.0267857142857142
47595,/images/06cd484f-e864-4fee-8819-688b45eed98e.png,168,1085,280,1190,112,105,red blood cell,11760,0.9375,1.0666666666666667
48884,/images/fed6ba05-36a5-45dc-a4e1-9baa7de2c622.png,940,377,1024,469,84,92,red blood cell,7728,1.0952380952380953,0.9130434782608695
1054,/images/63d36d2c-43a9-49ac-9504-028b4968c860.png,947,1295,1086,1412,139,117,red blood cell,16263,0.841726618705036,1.188034188034188
8312,/images/65e3d6a6-012c-4b40-9a42-83078eb85e31.png,1013,1205,1125,1296,112,91,red blood cell,10192,0.8125,1.2307692307692308
78253,/images/adff6e1d-ba9d-4c7b-a8fe-1ec458eaeeb8.png,950,171,1054,269,104,98,red blood cell,10192,0.9423076923076923,1.0612244897959184
25590,/images/770b8ca4-8377-479b-9ad5-5455ec3b44f8.png,526,881,639,1010,113,129,red blood cell,14577,1.1415929203539823,0.875968992248062
14460,/images/3b13e20f-ec0d-44ec-b2f4-eaebfa09150e.png,28,936,116,1021,88,85,red blood cell,7480,0.9659090909090909,1.035294117647059
42796,/images/7029feb3-9ffe-46e4-9883-6a9df84f7b62.png,666,482,793,605,127,123,red blood cell,15621,0.968503937007874,1.032520325203252
50210,/images/8b89b3fc-95ef-4f2e-b94b-0291dbffe0f4.png,273,511,392,636,119,125,red blood cell,14875,1.050420168067227,0.952
17737,/images/b5143aae-6e98-4dc6-b546-980cb472de67.png,569,53,681,172,112,119,red blood cell,13328,1.0625,0.9411764705882353
54133,/images/c415532c-4cce-4580-9fcd-623c172a1abd.png,480,1132,595,1248,115,116,red blood cell,13340,1.008695652173913,0.9913793103448276
33231,/images/877d5e7f-19b6-40e7-81bd-c92f25e72503.png,1037,1492,1150,1599,113,107,red blood cell,12091,0.9469026548672567,1.0560747663551402
7568,/images/071901eb-4c3f-404b-a747-3d0b9d0a5158.png,408,725,503,819,95,94,red blood cell,8930,0.9894736842105263,1.0106382978723405
13560,/images/370277f8-436b-4103-8210-b4feb5ab95ea.png,964,994,1060,1077,96,83,red blood cell,7968,0.8645833333333334,1.1566265060240963
59819,/images/acb16781-11ad-4327-874a-5c9c35dcb085.png,681,903,791,1010,110,107,red blood cell,11770,0.9727272727272728,1.02803738317757
46006,/images/72088c26-d2dd-4906-b791-b8947fc7fbe4.png,577,679,690,782,113,103,red blood cell,11639,0.911504424778761,1.0970873786407767
11657,/images/0ed416f9-7c20-4829-9016-559e4009568e.png,922,1193,1031,1310,109,117,red blood cell,12753,1.073394495412844,0.9316239316239316
7689,/images/9f959520-e15e-45c2-bc29-ef3c19154d1c.png,68,384,169,484,101,100,red blood cell,10100,0.9900990099009901,1.01
65391,/images/24418314-f7a4-49fc-a03e-ec597ca6796e.png,535,367,619,446,84,79,red blood cell,6636,0.9404761904761905,1.0632911392405062
30311,/images/cecbf663-0751-4e7f-b298-770c88afc2c1.png,888,64,999,173,111,109,red blood cell,12099,0.9819819819819819,1.018348623853211
75471,/images/6c20abb2-c4bb-4de0-8774-03f4d30ce93d.png,682,30,784,124,102,94,red blood cell,9588,0.9215686274509803,1.0851063829787233
66235,/images/e8058bed-c362-4e1c-85dc-62f80f32938f.png,233,1212,339,1313,106,101,red blood cell,10706,0.9528301886792453,1.0495049504950495
30597,/images/f939782b-f5a2-40a3-9c22-6c6d7e18edc3.png,472,906,579,1023,107,117,red blood cell,12519,1.0934579439252337,0.9145299145299145
75085,/images/073c10c9-5749-44b5-b08b-1be556a960f0.png,152,586,272,694,120,108,red blood cell,12960,0.9,1.1111111111111112
20481,/images/b809b407-7b69-4334-873d-d6c49135f04a.png,433,1253,558,1384,125,131,red blood cell,16375,1.048,0.9541984732824428
61672,/images/a3c0a876-be12-4ede-8aed-18b32a64401b.png,279,257,378,363,99,106,red blood cell,10494,1.0707070707070707,0.9339622641509434
10134,/images/09ecf7be-28e2-4531-b9e2-07e01c44097d.png,55,978,161,1087,106,109,red blood cell,11554,1.028301886792453,0.9724770642201835
46308,/images/e11515b4-9527-4c23-a0ba-43719bacca0d.png,403,597,514,707,111,110,red blood cell,12210,0.990990990990991,1.009090909090909
15035,/images/3003252a-2d2e-4687-ad30-9c38d68f1394.png,479,721,611,843,132,122,red blood cell,16104,0.9242424242424242,1.0819672131147542
59208,/images/4736f545-1f1f-4d77-9241-d69cbf4dae35.png,179,249,261,324,82,75,red blood cell,6150,0.9146341463414634,1.0933333333333333
45515,/images/94b5a9a1-1c88-4400-aca4-3d56f543fc4a.png,849,167,934,263,85,96,red blood cell,8160,1.1294117647058823,0.8854166666666666
67723,/images/2b128a1a-95ed-408b-b9f8-8795cc814d80.png,783,464,882,553,99,89,red blood cell,8811,0.898989898989899,1.1123595505617978
63011,/images/f234a2de-f3c8-4521-a306-8cfdf52dd597.png,53,690,137,793,84,103,red blood cell,8652,1.2261904761904763,0.8155339805825242
41886,/images/783ae4ad-6a35-4b3c-b19f-754974b67b2d.png,814,74,926,183,112,109,red blood cell,12208,0.9732142857142857,1.0275229357798166
6174,/images/27cdd837-e40f-491e-8adb-61e493189832.png,903,1254,1029,1364,126,110,red blood cell,13860,0.873015873015873,1.1454545454545455
54481,/images/22a464ef-c3da-4d56-b37e-e22e95d945e7.png,955,701,1058,793,103,92,red blood cell,9476,0.8932038834951457,1.1195652173913044
33850,/images/b9de8b1a-f96a-4eb5-bc05-84ad43a054f3.png,409,1365,534,1479,125,114,red blood cell,14250,0.912,1.0964912280701755
58004,/images/a7c91b63-b97c-4f4b-8d34-7ad2b08d7a17.png,60,771,156,868,96,97,red blood cell,9312,1.0104166666666667,0.9896907216494846
71531,/images/191071ab-6515-428c-9f05-8e4309542b75.png,907,137,1005,238,98,101,red blood cell,9898,1.030612244897959,0.9702970297029703
78221,/images/adff6e1d-ba9d-4c7b-a8fe-1ec458eaeeb8.png,427,404,533,498,106,94,red blood cell,9964,0.8867924528301887,1.127659574468085
50703,/images/6b4c79f5-b194-4586-be9f-e339c5af4188.png,1048,791,1171,923,123,132,red blood cell,16236,1.0731707317073171,0.9318181818181818
52365,/images/a2a20600-f851-4db7-90f9-6f7be027c8b5.png,507,980,601,1075,94,95,red blood cell,8930,1.0106382978723405,0.9894736842105263
1160,/images/4411fea2-d785-4eeb-80c6-c739ab6114c4.png,830,993,955,1101,125,108,red blood cell,13500,0.864,1.1574074074074074
72149,/images/005e60b6-77b8-458c-b57c-bfe0c7e7df78.png,636,420,746,541,110,121,red blood cell,13310,1.1,0.9090909090909091
42491,/images/29648565-fe28-4517-ba72-68df0c82c9c5.png,507,1042,601,1143,94,101,red blood cell,9494,1.074468085106383,0.9306930693069307
64049,/images/03cbfcf2-8da6-462c-b30d-16d63357371f.png,1014,1267,1116,1362,102,95,red blood cell,9690,0.9313725490196079,1.0736842105263158
58499,/images/5cac6ddf-c8c6-45de-bce0-a1db64b14fb5.png,698,278,781,362,83,84,red blood cell,6972,1.0120481927710843,0.9880952380952381
34827,/images/4fc9a597-aaa8-43b0-ad1c-2eabbe442e84.png,327,1344,452,1451,125,107,red blood cell,13375,0.856,1.1682242990654206
74022,/images/fe436c09-b680-4f4c-8faf-aa10a55a335b.png,282,1346,399,1467,117,121,red blood cell,14157,1.0341880341880343,0.9669421487603306
53954,/images/540a5fee-175b-4b92-bf62-1ea9b59c86c6.png,1105,47,1199,150,94,103,red blood cell,9682,1.0957446808510638,0.912621359223301
15075,/images/3a8f468f-f9de-46a8-a7c8-f2be239fa207.png,336,1019,429,1104,93,85,red blood cell,7905,0.9139784946236559,1.0941176470588236
14593,/images/c649e1cb-4029-4433-b231-d67d68f7391a.png,235,629,343,728,108,99,red blood cell,10692,0.9166666666666666,1.0909090909090908
55826,/images/68f34a9c-f73d-4238-8f55-4b05a8a2154c.png,357,86,445,161,88,75,red blood cell,6600,0.8522727272727273,1.1733333333333333
37452,/images/c6530038-6d4e-49e1-8427-d1d3acc9fa21.png,534,1329,665,1447,131,118,red blood cell,15458,0.9007633587786259,1.1101694915254237
19443,/images/5487faad-24a7-46b6-92d8-479d3a8d229f.png,332,295,434,394,102,99,red blood cell,10098,0.9705882352941176,1.0303030303030303
46405,/images/bbecf1a8-a728-4c83-87f8-4dfbac0a1e03.png,995,265,1095,386,100,121,red blood cell,12100,1.21,0.8264462809917356
51548,/images/6afb3717-f197-4668-929a-4fab389ae6e8.png,54,388,168,504,114,116,red blood cell,13224,1.0175438596491229,0.9827586206896551
69685,/images/f0713bee-2a71-4ced-b953-4041ea99496a.png,422,335,529,440,107,105,red blood cell,11235,0.9813084112149533,1.019047619047619
35760,/images/bb2042c5-35e1-43cc-8171-7de81b764361.png,340,1279,450,1391,110,112,red blood cell,12320,1.018181818181818,0.9821428571428571
70188,/images/b338766f-19b9-4874-bcc5-ae22b3c533e6.png,656,813,763,920,107,107,red blood cell,11449,1.0,1.0
19632,/images/a3ada657-de00-44db-b1e2-54ba17e39983.png,280,708,386,819,106,111,red blood cell,11766,1.0471698113207548,0.954954954954955
68424,/images/040112be-3c8d-49aa-93f1-522f94a592ff.png,127,547,209,628,82,81,red blood cell,6642,0.9878048780487805,1.0123456790123457
44588,/images/6388e241-09a2-4fbe-a712-07d8fe714c51.png,450,970,574,1094,124,124,red blood cell,15376,1.0,1.0
3775,/images/c9499a06-fb31-4552-a9e2-fb4ebb440859.png,1007,379,1118,513,111,134,red blood cell,14874,1.2072072072072073,0.8283582089552238
56440,/images/d75933ed-d26e-4d1f-bda3-96bc0d77fb36.png,633,845,736,953,103,108,red blood cell,11124,1.0485436893203883,0.9537037037037037
50976,/images/ef8fcfa4-8466-4186-8c69-f5f4904eb489.png,775,1132,891,1249,116,117,red blood cell,13572,1.0086206896551724,0.9914529914529915
66046,/images/c8af0297-ce1f-40ea-bf44-9256dcdae4e9.png,38,1084,144,1205,106,121,red blood cell,12826,1.1415094339622642,0.8760330578512396
67705,/images/2b128a1a-95ed-408b-b9f8-8795cc814d80.png,435,1453,554,1560,119,107,red blood cell,12733,0.8991596638655462,1.1121495327102804
3070,/images/5a386082-397f-4524-a6f9-c2b8efe5014d.png,126,1440,233,1545,107,105,red blood cell,11235,0.9813084112149533,1.019047619047619
31965,/images/9eb66577-7857-43dc-a879-8f2c9d7f780f.png,841,443,954,550,113,107,red blood cell,12091,0.9469026548672567,1.0560747663551402
4899,/images/61cd8c7d-394d-42d3-9ed4-e09559110bed.png,68,1256,186,1372,118,116,red blood cell,13688,0.9830508474576272,1.0172413793103448
36817,/images/dfac6c92-8f0f-429a-8caf-9b7732bf78da.png,469,548,593,658,124,110,red blood cell,13640,0.8870967741935484,1.1272727272727272
72533,/images/01b99da8-b66b-464b-a7ee-1cadab8db18b.png,1071,142,1178,253,107,111,red blood cell,11877,1.0373831775700935,0.963963963963964
10973,/images/c442e2d6-aaf9-417a-9905-4737a1115f33.png,948,560,1067,684,119,124,red blood cell,14756,1.0420168067226891,0.9596774193548387
71467,/images/191071ab-6515-428c-9f05-8e4309542b75.png,82,537,200,658,118,121,red blood cell,14278,1.0254237288135593,0.9752066115702479
21631,/images/66183740-e1e5-43c9-8539-a87028bb3621.png,788,886,902,1011,114,125,red blood cell,14250,1.0964912280701755,0.912
42127,/images/c63f190a-e860-44fc-a2db-7980e1c80519.png,12,981,131,1105,119,124,red blood cell,14756,1.0420168067226891,0.9596774193548387
19796,/images/d67fb447-4dd7-4a82-a305-2b70927b69bb.png,1040,520,1144,636,104,116,red blood cell,12064,1.1153846153846154,0.896551724137931
30580,/images/7d9c1422-6332-44e9-b134-3ac94f07b0f0.png,104,482,213,582,109,100,red blood cell,10900,0.9174311926605505,1.09
34908,/images/a4fbb9f2-9b75-4fdc-877d-2feaafac25b3.png,1096,898,1198,990,102,92,red blood cell,9384,0.9019607843137255,1.108695652173913
71895,/images/61575482-91e1-4db9-83c7-687b7ddbbfc4.png,922,905,1008,1004,86,99,red blood cell,8514,1.1511627906976745,0.8686868686868687
16867,/images/4823c1fe-a7f9-4b92-959f-0d9be09cd14b.png,1068,743,1157,834,89,91,red blood cell,8099,1.0224719101123596,0.978021978021978
46570,/images/edd09b2e-2673-4405-8ac0-e476e003e96a.png,697,806,808,924,111,118,red blood cell,13098,1.063063063063063,0.940677966101695
33670,/images/84ee2ea3-9edd-4672-a1b3-f09c607d833a.png,141,58,247,172,106,114,red blood cell,12084,1.0754716981132075,0.9298245614035088
71509,/images/191071ab-6515-428c-9f05-8e4309542b75.png,985,1288,1073,1381,88,93,red blood cell,8184,1.0568181818181819,0.946236559139785
52271,/images/4903d9c7-de88-426a-b42d-a7e797e5ebcd.png,613,1459,741,1577,128,118,red blood cell,15104,0.921875,1.0847457627118644
67219,/images/5f491efd-a21c-4a80-aaba-70b8876238ac.png,186,1064,295,1168,109,104,red blood cell,11336,0.9541284403669725,1.0480769230769231
39606,/images/04d21589-b777-43c2-86b5-038cbf8c3a4e.png,492,1210,608,1341,116,131,red blood cell,15196,1.1293103448275863,0.8854961832061069
51599,/images/d0347b49-8f98-4632-a384-1a4f57ac6374.png,405,763,515,875,110,112,red blood cell,12320,1.018181818181818,0.9821428571428571
41058,/images/e871f52c-77a6-4813-80d4-95bd97985f1a.png,646,1411,766,1540,120,129,red blood cell,15480,1.075,0.9302325581395349
15434,/images/1b7f47fc-26cd-4273-b848-88a7cbfd9f85.png,471,61,573,167,102,106,red blood cell,10812,1.0392156862745099,0.9622641509433962
7109,/images/64a678d4-9048-4491-90c7-1924f38be19a.png,162,887,281,1010,119,123,red blood cell,14637,1.0336134453781514,0.967479674796748
24343,/images/4d8a4ce8-0f9c-4f21-8844-4cf0e5514bbf.png,1066,605,1171,703,105,98,red blood cell,10290,0.9333333333333333,1.0714285714285714
9086,/images/21c2a8aa-407c-4569-8212-96fcafa84138.png,708,1488,838,1599,130,111,red blood cell,14430,0.8538461538461538,1.1711711711711712
53858,/images/540a5fee-175b-4b92-bf62-1ea9b59c86c6.png,363,968,468,1086,105,118,red blood cell,12390,1.1238095238095238,0.8898305084745762
68703,/images/77e76e62-2c71-4b52-9b21-0d1bcde9f9bf.png,581,1288,713,1407,132,119,red blood cell,15708,0.9015151515151515,1.1092436974789917
20358,/images/11e517bf-943b-4928-929a-e9f72c097880.png,168,1139,291,1272,123,133,red blood cell,16359,1.08130081300813,0.924812030075188
4364,/images/84041bf9-dace-4066-9fe0-52170d08f826.png,362,1332,455,1427,93,95,red blood cell,8835,1.021505376344086,0.9789473684210527
64475,/images/34a70114-d3e3-4351-b8db-f6caab17e743.png,338,1469,430,1566,92,97,red blood cell,8924,1.0543478260869565,0.9484536082474226
75651,/images/50d7c6c9-3230-48fe-947c-7dcfd0aad710.png,737,470,835,586,98,116,red blood cell,11368,1.183673469387755,0.8448275862068966
13185,/images/711f6b3f-cd63-46d1-834a-bc8e9aa9b43e.png,729,926,815,1029,86,103,red blood cell,8858,1.197674418604651,0.8349514563106796
10781,/images/fac4b0e2-6b52-4c0e-b762-4fa65d552856.png,164,175,279,308,115,133,red blood cell,15295,1.1565217391304348,0.8646616541353384
76354,/images/3dad6483-ac30-4d2b-b045-9f24fe6ff75e.png,181,804,275,901,94,97,red blood cell,9118,1.0319148936170213,0.9690721649484536
20699,/images/e6d7c5e1-43fc-4712-86d5-aa70252b978f.png,1048,500,1170,619,122,119,red blood cell,14518,0.9754098360655737,1.0252100840336134
40061,/images/6fd30823-3b77-40c9-ba5d-e1eda9660674.png,448,521,562,654,114,133,red blood cell,15162,1.1666666666666667,0.8571428571428571
76596,/images/4184a235-d209-4151-86e9-6c77e7938dab.png,469,182,570,291,101,109,red blood cell,11009,1.0792079207920793,0.926605504587156
3555,/images/25132962-ff5d-4737-995f-c54d8490539b.png,183,935,278,1027,95,92,red blood cell,8740,0.968421052631579,1.0326086956521738
74667,/images/5ccca8ee-abea-458a-a891-bedd31c3ddc3.png,241,1409,337,1514,96,105,red blood cell,10080,1.09375,0.9142857142857143
37955,/images/56a57a8d-c9b9-432a-a3b0-32a09355806c.png,983,684,1081,804,98,120,red blood cell,11760,1.2244897959183674,0.8166666666666667
15958,/images/c7c1b873-0548-4a73-9618-f60912e164df.png,300,357,425,464,125,107,red blood cell,13375,0.856,1.1682242990654206
1926,/images/02ea7aa8-c142-4a3d-939f-e77689741341.png,1056,738,1165,830,109,92,red blood cell,10028,0.8440366972477065,1.184782608695652
10305,/images/f91670db-be74-474c-bd72-68120aed4756.png,597,1110,696,1208,99,98,red blood cell,9702,0.98989898989899,1.010204081632653
2297,/images/fe851c88-692d-4199-87e0-d19d9c4eb591.png,640,1157,747,1259,107,102,red blood cell,10914,0.9532710280373832,1.0490196078431373
65779,/images/daea4860-a296-4f6d-acef-996ab0882676.png,893,46,994,160,101,114,red blood cell,11514,1.1287128712871286,0.8859649122807017
30047,/images/81c3c8f0-d5a9-4dda-afd5-e86f6afd9424.png,231,163,319,261,88,98,red blood cell,8624,1.1136363636363635,0.8979591836734694
12210,/images/313ed8d9-3c00-4415-9de0-0eda07c60ad9.png,650,1134,786,1259,136,125,red blood cell,17000,0.9191176470588235,1.088
22894,/images/be779f52-0bfa-4c01-a16f-b7f0bc92ed7c.png,422,142,541,268,119,126,red blood cell,14994,1.0588235294117647,0.9444444444444444
7202,/images/56551792-4aa1-4301-9f8f-8bfebcd20050.png,192,616,307,722,115,106,red blood cell,12190,0.9217391304347826,1.0849056603773586
63618,/images/d9c9479e-f1ea-4d6e-861f-843ff9a90d19.png,996,1326,1110,1442,114,116,red blood cell,13224,1.0175438596491229,0.9827586206896551
35712,/images/4063945d-03fc-4ce3-a04c-17435dce8f91.png,516,420,635,533,119,113,red blood cell,13447,0.9495798319327731,1.0530973451327434
33346,/images/5721e41b-90ef-4851-8587-8dc71227ef90.png,281,754,391,885,110,131,red blood cell,14410,1.190909090909091,0.8396946564885496
39511,/images/5a631871-2fc7-4a68-9c39-f3b9a0bf4a04.png,342,88,445,187,103,99,red blood cell,10197,0.9611650485436893,1.0404040404040404
23167,/images/c94a5851-b846-4fde-8c89-05bec3a8ac53.png,676,101,774,216,98,115,red blood cell,11270,1.1734693877551021,0.8521739130434782
44894,/images/83ec8923-6232-40d7-ba1f-a1b8bf7cb66c.png,347,1089,436,1187,89,98,red blood cell,8722,1.101123595505618,0.9081632653061225
63473,/images/b9d65ef3-1adc-4479-abee-2e422f5a613a.png,1012,1434,1110,1526,98,92,red blood cell,9016,0.9387755102040817,1.065217391304348
21389,/images/5077f87d-a19f-494c-b911-14ccb03bd230.png,1063,370,1170,478,107,108,red blood cell,11556,1.0093457943925233,0.9907407407407407
25564,/images/f6ab936d-924b-4038-aa47-71b07c26b4e2.png,628,988,752,1093,124,105,red blood cell,13020,0.8467741935483871,1.180952380952381
8832,/images/91827f1a-9b04-4ef0-972c-12e90e60c516.png,60,1148,179,1271,119,123,red blood cell,14637,1.0336134453781514,0.967479674796748
52992,/images/42e87148-a015-4148-923a-fb83016f64e7.png,551,1263,669,1380,118,117,red blood cell,13806,0.9915254237288136,1.0085470085470085
37993,/images/e3e9c2de-0a24-4c7e-8a69-3d3093d5bdab.png,331,148,438,239,107,91,red blood cell,9737,0.8504672897196262,1.1758241758241759
29896,/images/f2a8a483-b254-43aa-817f-7d525adb8911.png,361,237,479,373,118,136,red blood cell,16048,1.152542372881356,0.8676470588235294
38585,/images/f8b14fc4-dd6b-4ad0-a96d-c62845f48681.png,1061,1004,1180,1127,119,123,red blood cell,14637,1.0336134453781514,0.967479674796748
43218,/images/fe1ee954-ba71-47b3-954a-d20ab940cd7b.png,606,644,731,773,125,129,red blood cell,16125,1.032,0.9689922480620154
11407,/images/b5513d5b-46fc-4f44-a616-791087fbd608.png,596,1011,720,1126,124,115,red blood cell,14260,0.9274193548387096,1.0782608695652174
40158,/images/b34e65f6-c32e-42f1-a437-4a037c75a231.png,347,1060,439,1151,92,91,red blood cell,8372,0.9891304347826086,1.010989010989011
52876,/images/abb2f9d6-26fa-4328-983c-959ef6717c05.png,195,795,298,903,103,108,red blood cell,11124,1.0485436893203883,0.9537037037037037
67313,/images/49c4dbd3-6269-4d4c-9648-a2146c57bab1.png,370,696,471,809,101,113,red blood cell,11413,1.118811881188119,0.8938053097345132
45895,/images/939ad732-d7c5-4339-b087-4335b49d6a3c.png,847,1062,968,1183,121,121,red blood cell,14641,1.0,1.0
46491,/images/21417261-475a-456f-b03f-57ac85a6e106.png,1013,1026,1139,1146,126,120,red blood cell,15120,0.9523809523809523,1.05
11610,/images/b4dc3088-3fe2-4688-be24-70664a64e022.png,901,154,1021,278,120,124,red blood cell,14880,1.0333333333333334,0.967741935483871
58636,/images/a4d7a7e1-5ae1-486d-b6ee-c9af1476ccad.png,582,679,678,768,96,89,red blood cell,8544,0.9270833333333334,1.0786516853932584
29386,/images/30167dc1-f739-4036-b5c4-5fad435c2c67.png,927,1017,1055,1139,128,122,red blood cell,15616,0.953125,1.0491803278688525
26289,/images/d33bc9fc-3444-4f26-8082-307f9fccc52b.png,1,95,123,214,122,119,red blood cell,14518,0.9754098360655737,1.0252100840336134
63595,/images/de0321fa-6f7d-4dd1-b96b-186701c3b1d9.png,543,1252,630,1358,87,106,red blood cell,9222,1.2183908045977012,0.8207547169811321
57088,/images/7d041c38-11f2-4186-8a24-29d7d0f5c3cf.png,282,1311,383,1416,101,105,red blood cell,10605,1.0396039603960396,0.9619047619047619
57463,/images/00d04a90-80e5-4bce-9511-1b64eabb7a47.png,372,1474,466,1555,94,81,red blood cell,7614,0.8617021276595744,1.1604938271604939
57765,/images/5c037ffc-f515-48b3-b231-c110fbd2b8ca.png,772,1173,852,1253,80,80,red blood cell,6400,1.0,1.0
5403,/images/75579b27-8191-4044-859b-268be969c42b.png,196,962,308,1063,112,101,red blood cell,11312,0.9017857142857143,1.108910891089109
50991,/images/ef8fcfa4-8466-4186-8c69-f5f4904eb489.png,959,929,1054,1040,95,111,red blood cell,10545,1.168421052631579,0.8558558558558559
45624,/images/582e4b8b-404e-4b30-9df3-66f2afb3cdb3.png,989,967,1116,1092,127,125,red blood cell,15875,0.984251968503937,1.016
20183,/images/bb337c84-f727-42a5-9c3d-934323a16c6a.png,592,1036,715,1157,123,121,red blood cell,14883,0.983739837398374,1.0165289256198347
52094,/images/de6d3020-9347-473b-9146-8909627790f6.png,936,1480,1026,1578,90,98,red blood cell,8820,1.0888888888888888,0.9183673469387755
468,/images/bbf687b5-c6f9-4821-b2e5-a25df1acba47.png,703,377,830,498,127,121,red blood cell,15367,0.952755905511811,1.0495867768595042
76796,/images/2165fe38-b474-467d-be11-d1d728085efd.png,152,838,272,951,120,113,red blood cell,13560,0.9416666666666667,1.0619469026548674
20673,/images/e6d7c5e1-43fc-4712-86d5-aa70252b978f.png,573,901,683,1006,110,105,red blood cell,11550,0.9545454545454546,1.0476190476190477
8789,/images/ae17a099-18b5-4a42-a901-850ea056423e.png,885,292,988,384,103,92,red blood cell,9476,0.8932038834951457,1.1195652173913044
43645,/images/a4851ed0-1499-4eae-9157-dcd34773254f.png,877,1416,984,1510,107,94,red blood cell,10058,0.8785046728971962,1.1382978723404256
61105,/images/80da32ce-8c22-470e-9f35-558c5f7a5df9.png,208,702,312,804,104,102,red blood cell,10608,0.9807692307692307,1.0196078431372548
8199,/images/6bb4892c-27a9-4642-aba1-4b73f38f757c.png,931,1396,1057,1511,126,115,red blood cell,14490,0.9126984126984127,1.0956521739130434
79724,/images/03b9d6ad-39ca-4097-a98b-77f02b3c00a7.png,1043,881,1150,981,107,100,red blood cell,10700,0.9345794392523364,1.07
44779,/images/6795acae-e84d-4e97-b9a1-b4f4f0a72cfd.png,548,1313,664,1434,116,121,red blood cell,14036,1.043103448275862,0.9586776859504132
43873,/images/679ae89f-4a02-4301-862e-1d844cc66cbf.png,782,1113,921,1240,139,127,red blood cell,17653,0.9136690647482014,1.094488188976378
68904,/images/6347dd6a-cfdf-4cb5-bc50-cff5403cfecb.png,876,0,1005,108,129,108,red blood cell,13932,0.8372093023255814,1.1944444444444444
8554,/images/a6aa3b72-2970-4c78-b655-ea8dfe6e018c.png,144,1285,280,1405,136,120,red blood cell,16320,0.8823529411764706,1.1333333333333333
51156,/images/d64cd75a-df26-44d5-ac25-69061a4e4d57.png,189,886,287,969,98,83,red blood cell,8134,0.8469387755102041,1.180722891566265
30488,/images/5955289d-19e5-45ef-a012-c8ea08ef45e2.png,732,1184,861,1331,129,147,red blood cell,18963,1.1395348837209303,0.8775510204081632
19587,/images/883d9731-a04d-4f84-83c9-d3bef954759d.png,83,1225,209,1338,126,113,red blood cell,14238,0.8968253968253969,1.1150442477876106
8976,/images/ef815e3a-02a6-4cf8-9262-45bc74c50b00.png,1078,1410,1164,1512,86,102,red blood cell,8772,1.186046511627907,0.8431372549019608
11388,/images/2f6224be-50d0-4e85-94ef-88315df561b6.png,571,755,661,853,90,98,red blood cell,8820,1.0888888888888888,0.9183673469387755
1355,/images/6d91d1f0-636b-4f5a-a526-7c17fc857190.png,139,460,242,553,103,93,red blood cell,9579,0.9029126213592233,1.10752688172043
42546,/images/9a25f103-1683-47d1-8b07-ac20fe0b3ee9.png,107,17,219,138,112,121,red blood cell,13552,1.0803571428571428,0.9256198347107438
1796,/images/5f783f43-0090-4f8a-bd75-9562f4aa2dd5.png,645,1276,747,1392,102,116,red blood cell,11832,1.1372549019607843,0.8793103448275862
68357,/images/040112be-3c8d-49aa-93f1-522f94a592ff.png,646,490,746,599,100,109,red blood cell,10900,1.09,0.9174311926605505
26561,/images/4935818a-7e7a-4f44-a3b6-b361d1abfe16.png,451,554,575,662,124,108,red blood cell,13392,0.8709677419354839,1.1481481481481481
53912,/images/540a5fee-175b-4b92-bf62-1ea9b59c86c6.png,879,761,992,873,113,112,red blood cell,12656,0.9911504424778761,1.0089285714285714
39883,/images/af2e63a3-9fde-46aa-a867-81c5c259d1dc.png,77,1253,192,1346,115,93,red blood cell,10695,0.808695652173913,1.2365591397849462
79798,/images/fc15659f-6264-4dd5-ab17-43d89fb297b9.png,488,1127,588,1218,100,91,red blood cell,9100,0.91,1.098901098901099
33830,/images/b9de8b1a-f96a-4eb5-bc05-84ad43a054f3.png,528,870,628,980,100,110,red blood cell,11000,1.1,0.9090909090909091
55460,/images/d67655e6-0a80-4a86-b552-1f5e85788377.png,62,1345,143,1435,81,90,red blood cell,7290,1.1111111111111112,0.9
27884,/images/948c94ad-395c-41f4-9a68-8a1dcb76888c.png,237,1052,339,1143,102,91,red blood cell,9282,0.8921568627450981,1.120879120879121
59568,/images/6bfe6a90-8a69-4171-8e7f-42dc9417c6d9.png,147,1287,234,1376,87,89,red blood cell,7743,1.0229885057471264,0.9775280898876404
35414,/images/002f20ad-2ace-499c-9335-c9080bc3e6b5.png,126,137,243,268,117,131,red blood cell,15327,1.1196581196581197,0.8931297709923665
7589,/images/21cc498b-8cb2-42ed-8f80-bfa27b86ef11.png,986,936,1109,1053,123,117,red blood cell,14391,0.9512195121951219,1.0512820512820513
21832,/images/9b3fd401-dab0-440f-8498-eb3cc9ffa970.png,841,1160,952,1278,111,118,red blood cell,13098,1.063063063063063,0.940677966101695
77481,/images/a11ed7d0-12f6-468f-abad-5cba7d968123.png,167,1158,275,1266,108,108,red blood cell,11664,1.0,1.0
12123,/images/87d6343b-70dd-4cdd-939f-d3ac0ca2e700.png,1051,333,1166,451,115,118,red blood cell,13570,1.0260869565217392,0.9745762711864406
46089,/images/72088c26-d2dd-4906-b791-b8947fc7fbe4.png,199,1435,299,1547,100,112,red blood cell,11200,1.12,0.8928571428571429
38748,/images/b426ef1d-4a59-4f90-b593-50226af60a60.png,766,150,859,232,93,82,red blood cell,7626,0.8817204301075269,1.1341463414634145
63048,/images/6afd8203-d61a-4e9b-a4cf-dcb53a16b57c.png,654,649,774,755,120,106,red blood cell,12720,0.8833333333333333,1.1320754716981132
73863,/images/3eba916c-998b-40a7-993c-7ed916c2a04c.png,680,1117,787,1224,107,107,red blood cell,11449,1.0,1.0
62773,/images/631340cc-cedf-4bca-a3d8-a0731a5482b4.png,1052,797,1156,906,104,109,red blood cell,11336,1.0480769230769231,0.9541284403669725
34812,/images/4fc9a597-aaa8-43b0-ad1c-2eabbe442e84.png,483,1015,583,1096,100,81,red blood cell,8100,0.81,1.2345679012345678
2495,/images/a23f5539-bfe6-4885-9a0e-dba972475ea9.png,41,759,144,866,103,107,red blood cell,11021,1.0388349514563107,0.9626168224299065
53907,/images/540a5fee-175b-4b92-bf62-1ea9b59c86c6.png,549,1335,646,1439,97,104,red blood cell,10088,1.0721649484536082,0.9326923076923077
69610,/images/4a49841f-216c-4815-8140-b8762c4f6603.png,622,230,728,338,106,108,red blood cell,11448,1.0188679245283019,0.9814814814814815
69427,/images/fde0fd54-49cc-42e1-90c6-6b612cd062d8.png,501,1314,607,1415,106,101,red blood cell,10706,0.9528301886792453,1.0495049504950495
7763,/images/e726dac6-f962-449c-acff-4dd56847b685.png,722,151,831,273,109,122,red blood cell,13298,1.1192660550458715,0.8934426229508197
16357,/images/69569ecf-cfa1-4ddd-9342-b22c23387fdb.png,466,1387,574,1497,108,110,red blood cell,11880,1.0185185185185186,0.9818181818181818
36077,/images/ca9626bc-21a4-46f4-ba94-e7ee7a4cf735.png,108,667,219,791,111,124,red blood cell,13764,1.117117117117117,0.8951612903225806
4502,/images/0f26699f-a776-4424-b092-27da9a1d12e2.png,348,437,455,537,107,100,red blood cell,10700,0.9345794392523364,1.07
61949,/images/c66a3e52-0f3f-4c81-bab9-0303499549f7.png,133,660,242,775,109,115,red blood cell,12535,1.055045871559633,0.9478260869565217
45507,/images/94b5a9a1-1c88-4400-aca4-3d56f543fc4a.png,948,219,1049,315,101,96,red blood cell,9696,0.9504950495049505,1.0520833333333333
48409,/images/0fa5b35d-6c44-4207-b6f8-d5b355086b5f.png,453,1435,549,1547,96,112,red blood cell,10752,1.1666666666666667,0.8571428571428571
38804,/images/d0d3ae45-b434-4869-a518-427320ebe62d.png,715,1239,838,1366,123,127,red blood cell,15621,1.032520325203252,0.968503937007874
23683,/images/79d7a014-21ff-40f1-9ac4-a69839390654.png,1108,1256,1199,1349,91,93,red blood cell,8463,1.021978021978022,0.978494623655914
28352,/images/34e024a5-5698-42d4-972f-fee234b4bd64.png,721,446,837,549,116,103,red blood cell,11948,0.8879310344827587,1.1262135922330097
10421,/images/46a2d369-4bea-4405-ac78-91bbe130b9a7.png,1093,569,1179,670,86,101,red blood cell,8686,1.1744186046511629,0.8514851485148515
57887,/images/f4c2b43f-a2e7-4746-8034-0b34aebba8ee.png,658,854,760,955,102,101,red blood cell,10302,0.9901960784313726,1.00990099009901
39399,/images/fbcb2ef0-3c97-4d7a-8b96-0147c73f3941.png,610,884,723,991,113,107,red blood cell,12091,0.9469026548672567,1.0560747663551402
37915,/images/56a57a8d-c9b9-432a-a3b0-32a09355806c.png,94,1250,181,1335,87,85,red blood cell,7395,0.9770114942528736,1.0235294117647058
35163,/images/bfc61c48-685d-470b-86b1-e4c7eb85c4fd.png,779,1376,908,1500,129,124,red blood cell,15996,0.9612403100775194,1.0403225806451613
69677,/images/f0713bee-2a71-4ced-b953-4041ea99496a.png,747,337,860,457,113,120,red blood cell,13560,1.0619469026548674,0.9416666666666667
56456,/images/d75933ed-d26e-4d1f-bda3-96bc0d77fb36.png,340,714,442,810,102,96,red blood cell,9792,0.9411764705882353,1.0625
34203,/images/f1cda808-69a9-4d10-ba0a-6607c98e362d.png,723,1057,830,1161,107,104,red blood cell,11128,0.9719626168224299,1.0288461538461537
19263,/images/b4d22412-a495-43a9-bec0-73a2322f8dad.png,67,331,163,438,96,107,red blood cell,10272,1.1145833333333333,0.897196261682243
2407,/images/fe851c88-692d-4199-87e0-d19d9c4eb591.png,320,251,414,364,94,113,red blood cell,10622,1.202127659574468,0.831858407079646
926,/images/a8cb75ba-3f2f-40d8-8bc7-c79ebd1b9603.png,793,1415,909,1531,116,116,red blood cell,13456,1.0,1.0
74696,/images/5ccca8ee-abea-458a-a891-bedd31c3ddc3.png,994,1410,1111,1529,117,119,red blood cell,13923,1.017094017094017,0.9831932773109243
14807,/images/f8b6a868-60e9-4569-ae69-638a0c39834d.png,817,932,949,1056,132,124,red blood cell,16368,0.9393939393939394,1.064516129032258
39388,/images/fbcb2ef0-3c97-4d7a-8b96-0147c73f3941.png,382,1417,490,1517,108,100,red blood cell,10800,0.9259259259259259,1.08
46231,/images/815bf40c-371a-4d34-aa41-c549c8221881.png,145,196,267,316,122,120,red blood cell,14640,0.9836065573770492,1.0166666666666666
64253,/images/83d4e1fe-da84-4175-a9e2-8efc18782dcf.png,370,117,481,228,111,111,red blood cell,12321,1.0,1.0
15860,/images/c7c1b873-0548-4a73-9618-f60912e164df.png,530,599,640,697,110,98,red blood cell,10780,0.8909090909090909,1.1224489795918366
31898,/images/f62d4fb6-df7c-446c-94a8-d5aede0b1e0c.png,308,1033,434,1142,126,109,red blood cell,13734,0.8650793650793651,1.1559633027522935
49512,/images/9f33e0ea-065b-4703-9df9-15829b891860.png,75,570,204,705,129,135,red blood cell,17415,1.0465116279069768,0.9555555555555556
41585,/images/0fcd1ebe-ee4a-40a0-b787-29cee18bfa1b.png,1017,902,1121,997,104,95,red blood cell,9880,0.9134615384615384,1.0947368421052632
580,/images/065af549-320a-4862-b92a-8ef750d7b5fb.png,907,1245,1023,1360,116,115,red blood cell,13340,0.9913793103448276,1.008695652173913
11993,/images/ca16a5ad-b106-4e84-8a43-178710e854ba.png,950,809,1050,915,100,106,red blood cell,10600,1.06,0.9433962264150944
52217,/images/f4c00b8c-d675-4255-8277-ca65bd757f51.png,700,473,798,568,98,95,red blood cell,9310,0.9693877551020408,1.0315789473684212
71109,/images/b666fcc2-d0b2-441e-bc5a-c660345eeb5d.png,459,650,571,757,112,107,red blood cell,11984,0.9553571428571429,1.0467289719626167
19742,/images/68e69cfb-1a07-48d2-8abe-46b46fe264ed.png,34,565,130,674,96,109,red blood cell,10464,1.1354166666666667,0.8807339449541285
5648,/images/afa470d9-c74c-41cd-b4dc-7bf93fde8263.png,759,1432,869,1540,110,108,red blood cell,11880,0.9818181818181818,1.0185185185185186
45171,/images/2596eb32-1323-41e9-8c0f-64819abcfc73.png,2,275,104,392,102,117,red blood cell,11934,1.1470588235294117,0.8717948717948718
35741,/images/4063945d-03fc-4ce3-a04c-17435dce8f91.png,667,1010,770,1129,103,119,red blood cell,12257,1.1553398058252426,0.865546218487395
8094,/images/694222bb-cddf-469a-9526-f873c6fba58e.png,496,551,587,652,91,101,red blood cell,9191,1.10989010989011,0.900990099009901
63224,/images/d3283f5b-3b3a-40ea-800b-79960ca851cb.png,733,743,850,863,117,120,red blood cell,14040,1.0256410256410255,0.975
75911,/images/3006096f-ceeb-42be-b69e-785179d7438b.png,985,182,1075,275,90,93,red blood cell,8370,1.0333333333333334,0.967741935483871
39851,/images/af2e63a3-9fde-46aa-a867-81c5c259d1dc.png,672,1069,773,1181,101,112,red blood cell,11312,1.108910891089109,0.9017857142857143
9502,/images/f1faab5f-3033-45ea-9673-8b816fea5ce8.png,124,1454,228,1573,104,119,red blood cell,12376,1.1442307692307692,0.8739495798319328
36298,/images/81fed4a1-9d48-4938-90c9-c8bf3f5e6b1f.png,1028,1366,1143,1501,115,135,red blood cell,15525,1.173913043478261,0.8518518518518519
47454,/images/f7231477-f2c1-439a-9c8b-204de07686a4.png,698,248,821,365,123,117,red blood cell,14391,0.9512195121951219,1.0512820512820513
68981,/images/b5246b58-6f40-4c9e-8024-f49b0ed6bdbd.png,902,811,1004,915,102,104,red blood cell,10608,1.0196078431372548,0.9807692307692307
72811,/images/31435107-c77d-42f8-a619-75cba6a5161b.png,866,433,975,531,109,98,red blood cell,10682,0.8990825688073395,1.1122448979591837
27069,/images/ec301f62-1302-4407-96f9-fcfe45c150ae.png,498,120,612,231,114,111,red blood cell,12654,0.9736842105263158,1.027027027027027
75495,/images/fa4f8d1a-cb3a-4722-a566-6c7072f30606.png,270,519,362,622,92,103,red blood cell,9476,1.1195652173913044,0.8932038834951457
54593,/images/59dc7da9-35d1-421e-a61b-1e9637bfbfa1.png,194,633,279,734,85,101,red blood cell,8585,1.188235294117647,0.8415841584158416
49910,/images/5e17f8e6-fd8d-426c-b444-1515d14f04b7.png,85,235,183,332,98,97,red blood cell,9506,0.9897959183673469,1.0103092783505154
23676,/images/79d7a014-21ff-40f1-9ac4-a69839390654.png,359,11,474,121,115,110,red blood cell,12650,0.9565217391304348,1.0454545454545454
31157,/images/1976cd04-d24f-457c-b423-7e4cdb05de9e.png,386,355,514,465,128,110,red blood cell,14080,0.859375,1.1636363636363636
73169,/images/85546330-4efd-43e2-87aa-d53a30220bfc.png,383,161,493,256,110,95,red blood cell,10450,0.8636363636363636,1.1578947368421053
33939,/images/1a332b2c-9d49-4ff2-810c-5633d2314527.png,1026,364,1163,511,137,147,red blood cell,20139,1.072992700729927,0.9319727891156463
49907,/images/5e17f8e6-fd8d-426c-b444-1515d14f04b7.png,766,190,859,283,93,93,red blood cell,8649,1.0,1.0
63182,/images/f0804a5e-e7f5-4cf2-a5df-b65e66502bf1.png,731,789,828,885,97,96,red blood cell,9312,0.9896907216494846,1.0104166666666667
74714,/images/5ccca8ee-abea-458a-a891-bedd31c3ddc3.png,94,204,194,286,100,82,red blood cell,8200,0.82,1.2195121951219512
43346,/images/36569710-a574-40be-ad42-897a6e74a128.png,560,38,676,137,116,99,red blood cell,11484,0.853448275862069,1.1717171717171717
44448,/images/edd3862f-04e1-49cf-97dd-ca566d17e71a.png,175,0,293,120,118,120,red blood cell,14160,1.0169491525423728,0.9833333333333333
18707,/images/f6f8a69a-3fd2-4684-ac77-3e83ea0fb36d.png,265,637,364,743,99,106,red blood cell,10494,1.0707070707070707,0.9339622641509434
45474,/images/e4eea7ea-8989-46a9-9c98-25a178146b28.png,578,322,658,420,80,98,red blood cell,7840,1.225,0.8163265306122449
39072,/images/8f96ee1f-4ef7-4279-a610-316319bedcf9.png,43,1144,151,1244,108,100,red blood cell,10800,0.9259259259259259,1.08
17284,/images/3d302619-473d-4c5b-af43-8833ff94233f.png,1085,852,1177,943,92,91,red blood cell,8372,0.9891304347826086,1.010989010989011
8782,/images/ae17a099-18b5-4a42-a901-850ea056423e.png,1074,1133,1176,1235,102,102,red blood cell,10404,1.0,1.0
54165,/images/c415532c-4cce-4580-9fcd-623c172a1abd.png,15,1397,116,1500,101,103,red blood cell,10403,1.0198019801980198,0.9805825242718447
54168,/images/c415532c-4cce-4580-9fcd-623c172a1abd.png,100,1300,192,1390,92,90,red blood cell,8280,0.9782608695652174,1.0222222222222221
65608,/images/01b38a56-13eb-447b-89ee-fc21cb40dcc1.png,757,963,839,1063,82,100,red blood cell,8200,1.2195121951219512,0.82
24712,/images/78a5d1c3-44dd-44bc-ad5b-5e25bdcc4fae.png,687,616,797,713,110,97,red blood cell,10670,0.8818181818181818,1.134020618556701
33082,/images/6231d81d-9e84-4a5a-8cb8-47c6a37a0176.png,712,1274,808,1379,96,105,red blood cell,10080,1.09375,0.9142857142857143
75388,/images/468c261d-f5d8-423f-883e-48af2bbbc5d1.png,41,1067,154,1188,113,121,red blood cell,13673,1.0707964601769913,0.9338842975206612
21729,/images/f68ae8e9-e760-4106-88e0-4bdef2785f06.png,512,784,620,899,108,115,red blood cell,12420,1.0648148148148149,0.9391304347826087
29348,/images/3850f2a5-ab62-49d3-8135-68d60baa676b.png,169,23,287,133,118,110,red blood cell,12980,0.9322033898305084,1.0727272727272728
71459,/images/bcb447c9-5d37-414f-a513-d7076b04a532.png,1008,652,1097,731,89,79,red blood cell,7031,0.8876404494382022,1.1265822784810127
53274,/images/d8f7e159-b7e3-49e4-86e8-aed8c5fbcd97.png,121,128,233,238,112,110,red blood cell,12320,0.9821428571428571,1.018181818181818
72278,/images/ee57e743-a876-4f69-9fe5-bf5d01b44689.png,459,292,563,402,104,110,red blood cell,11440,1.0576923076923077,0.9454545454545454
23736,/images/6b2ff7ca-c5b3-415c-9481-7b14efc6d7ef.png,143,835,259,940,116,105,red blood cell,12180,0.9051724137931034,1.1047619047619048
61059,/images/6e86206f-dafe-4c28-bacc-7b83b2d40f0c.png,270,1461,356,1550,86,89,red blood cell,7654,1.0348837209302326,0.9662921348314607
4913,/images/755e5bf8-e8e1-492b-a32f-f7d87cccaa40.png,169,894,293,1018,124,124,red blood cell,15376,1.0,1.0
57624,/images/d32022fa-e492-4b31-a776-9435cfdef6d6.png,706,102,815,205,109,103,red blood cell,11227,0.944954128440367,1.058252427184466
33468,/images/9bd40bc6-4949-42d3-b38f-d60422932f65.png,914,626,1044,747,130,121,red blood cell,15730,0.9307692307692308,1.0743801652892562
111,/images/10be6380-cbbb-4886-8b9e-ff56b1710576.png,167,853,277,957,110,104,red blood cell,11440,0.9454545454545454,1.0576923076923077
61113,/images/80da32ce-8c22-470e-9f35-558c5f7a5df9.png,1032,657,1134,760,102,103,red blood cell,10506,1.0098039215686274,0.9902912621359223
11563,/images/b4dc3088-3fe2-4688-be24-70664a64e022.png,999,479,1124,614,125,135,red blood cell,16875,1.08,0.9259259259259259
59682,/images/a2754679-68b0-40f4-be01-bafad5ac1261.png,910,705,990,788,80,83,red blood cell,6640,1.0375,0.963855421686747
37714,/images/003a89b0-a095-417a-8dd6-f408339bbc68.png,404,1410,523,1531,119,121,red blood cell,14399,1.0168067226890756,0.9834710743801653
70646,/images/7521ec48-57b5-48a8-a5d6-8280ad5da19c.png,154,148,256,255,102,107,red blood cell,10914,1.0490196078431373,0.9532710280373832
72608,/images/a63ce82f-f3d1-4818-9035-d3d230e5f686.png,589,455,697,566,108,111,red blood cell,11988,1.0277777777777777,0.972972972972973
49732,/images/5e17f8e6-fd8d-426c-b444-1515d14f04b7.png,9,1305,136,1432,127,127,red blood cell,16129,1.0,1.0
25120,/images/9e74feb8-017d-4d53-8896-9ebda4327dd1.png,679,24,785,126,106,102,red blood cell,10812,0.9622641509433962,1.0392156862745099
22755,/images/8490c623-3d88-4532-baf5-0d266a45b16f.png,902,1341,1005,1444,103,103,red blood cell,10609,1.0,1.0
26765,/images/2518f6e4-29cc-4ae4-a914-b215a4c56099.png,656,670,764,793,108,123,red blood cell,13284,1.1388888888888888,0.8780487804878049
32488,/images/d31dd2c0-ae8e-4499-86bb-7cabb6e438b9.png,843,1469,961,1587,118,118,red blood cell,13924,1.0,1.0
52776,/images/0a747cb3-c720-4572-a661-ab5670a5c42e.png,781,363,897,479,116,116,red blood cell,13456,1.0,1.0
65057,/images/ff3b9d4d-373c-48ef-a75a-d23e2c2ade87.png,728,1314,819,1403,91,89,red blood cell,8099,0.978021978021978,1.0224719101123596
3919,/images/65e865f3-acfb-4d01-a75f-ff5a535ffa6a.png,861,555,998,671,137,116,red blood cell,15892,0.8467153284671532,1.1810344827586208
38964,/images/5939f341-a886-4f63-ae87-2219d000a1d4.png,1041,1487,1161,1599,120,112,red blood cell,13440,0.9333333333333333,1.0714285714285714
6668,/images/95fea6d8-413f-421e-b331-5d51c31df150.png,360,1214,472,1314,112,100,red blood cell,11200,0.8928571428571429,1.12
9041,/images/ef815e3a-02a6-4cf8-9262-45bc74c50b00.png,58,655,152,751,94,96,red blood cell,9024,1.0212765957446808,0.9791666666666666
37051,/images/b2e34f5f-904e-4473-9dc7-c6bc1ce12640.png,631,852,740,956,109,104,red blood cell,11336,0.9541284403669725,1.0480769230769231
41614,/images/0fcd1ebe-ee4a-40a0-b787-29cee18bfa1b.png,644,555,736,640,92,85,red blood cell,7820,0.9239130434782609,1.0823529411764705
73226,/images/85546330-4efd-43e2-87aa-d53a30220bfc.png,761,916,847,995,86,79,red blood cell,6794,0.9186046511627907,1.0886075949367089
45458,/images/e4eea7ea-8989-46a9-9c98-25a178146b28.png,372,332,478,420,106,88,red blood cell,9328,0.8301886792452831,1.2045454545454546
71399,/images/bcb447c9-5d37-414f-a513-d7076b04a532.png,949,249,1054,350,105,101,red blood cell,10605,0.9619047619047619,1.0396039603960396
57543,/images/8190ec37-9a5e-419f-89ed-fbfb079370db.png,868,1369,975,1482,107,113,red blood cell,12091,1.0560747663551402,0.9469026548672567
66366,/images/e5fd5949-4cd0-4cb6-837a-02c26a5eb87a.png,704,751,799,856,95,105,red blood cell,9975,1.105263157894737,0.9047619047619048
52274,/images/4903d9c7-de88-426a-b42d-a7e797e5ebcd.png,295,296,405,421,110,125,red blood cell,13750,1.1363636363636365,0.88
49283,/images/99b13257-b9d9-422f-8262-802da0bdc510.png,145,339,269,442,124,103,red blood cell,12772,0.8306451612903226,1.203883495145631
45356,/images/e4eea7ea-8989-46a9-9c98-25a178146b28.png,357,1369,450,1468,93,99,red blood cell,9207,1.064516129032258,0.9393939393939394
386,/images/84c88143-940d-4b62-bbd2-7acc4cadcb6b.png,130,1089,242,1215,112,126,red blood cell,14112,1.125,0.8888888888888888
37519,/images/205306da-0ed8-475a-ace6-f2f81d4be88a.png,98,1276,212,1372,114,96,red blood cell,10944,0.8421052631578947,1.1875
44523,/images/419309ef-da3f-4424-93cf-01ff4c52b017.png,180,1216,292,1320,112,104,red blood cell,11648,0.9285714285714286,1.0769230769230769
36349,/images/4a0a05e1-11ad-4bfc-bfa3-adf3b9bd0b56.png,969,262,1081,386,112,124,red blood cell,13888,1.1071428571428572,0.9032258064516129
53517,/images/43158031-a335-4533-9c20-48bebba90123.png,328,1309,419,1401,91,92,red blood cell,8372,1.010989010989011,0.9891304347826086
78008,/images/c691c8ef-d3c7-47b6-a941-f6a1089f21a9.png,490,436,575,531,85,95,red blood cell,8075,1.1176470588235294,0.8947368421052632
7823,/images/e726dac6-f962-449c-acff-4dd56847b685.png,710,1082,821,1174,111,92,red blood cell,10212,0.8288288288288288,1.2065217391304348
68136,/images/5dec94a3-e3ca-4a58-9702-88e5a83ef612.png,998,513,1098,619,100,106,red blood cell,10600,1.06,0.9433962264150944
39288,/images/697bdbc0-6e31-4e48-ac74-ba4ab5760d32.png,428,1466,539,1593,111,127,red blood cell,14097,1.1441441441441442,0.8740157480314961
14790,/images/1fdf99d1-a494-4174-bcd7-efbe457ab899.png,1016,571,1127,680,111,109,red blood cell,12099,0.9819819819819819,1.018348623853211
52549,/images/0546d843-d778-4aca-b8b5-bfe23d7c87da.png,493,1444,605,1544,112,100,red blood cell,11200,0.8928571428571429,1.12
27514,/images/f5869ba8-6253-426b-93f3-82af59a86144.png,517,986,627,1102,110,116,red blood cell,12760,1.0545454545454545,0.9482758620689655
29453,/images/8cc6fe77-5f2f-4670-b4ac-1b49550241a8.png,671,574,772,691,101,117,red blood cell,11817,1.1584158415841583,0.8632478632478633
62635,/images/f7a4334a-4332-4de8-b39b-22da907976f2.png,1097,1116,1186,1206,89,90,red blood cell,8010,1.0112359550561798,0.9888888888888889
16244,/images/acdc6e12-73d9-44ba-be8c-2a56aaffef4f.png,443,493,568,613,125,120,red blood cell,15000,0.96,1.0416666666666667
78712,/images/76a8a5f5-1328-4539-a131-baf877f40cf3.png,255,759,357,868,102,109,red blood cell,11118,1.0686274509803921,0.9357798165137615
49502,/images/9f33e0ea-065b-4703-9df9-15829b891860.png,470,1032,589,1156,119,124,red blood cell,14756,1.0420168067226891,0.9596774193548387
18189,/images/947348fe-4c70-468e-8009-3c14daeca69b.png,2,953,105,1056,103,103,red blood cell,10609,1.0,1.0
44786,/images/6795acae-e84d-4e97-b9a1-b4f4f0a72cfd.png,439,1195,537,1294,98,99,red blood cell,9702,1.010204081632653,0.98989898989899
74559,/images/bbedfcbe-9528-4ba9-9d86-4ebba7589ac5.png,404,90,496,185,92,95,red blood cell,8740,1.0326086956521738,0.968421052631579
56873,/images/a588091c-5e4c-4e61-914d-e96f3ee3e505.png,1088,1100,1181,1205,93,105,red blood cell,9765,1.1290322580645162,0.8857142857142857
77458,/images/a11ed7d0-12f6-468f-abad-5cba7d968123.png,959,1422,1065,1527,106,105,red blood cell,11130,0.9905660377358491,1.0095238095238095
13725,/images/1b369bcf-ced4-4ae2-9196-2664bd2b1738.png,911,243,1027,364,116,121,red blood cell,14036,1.043103448275862,0.9586776859504132
67452,/images/8e72e20e-e714-4db6-a1da-c05a409257d4.png,985,956,1090,1050,105,94,red blood cell,9870,0.8952380952380953,1.1170212765957446
45817,/images/584d62ed-4329-45dd-94ce-e929d8b2bb74.png,308,384,420,475,112,91,red blood cell,10192,0.8125,1.2307692307692308
38149,/images/33bdb7b5-ad5b-4a73-bbc2-3350f8c2ac0c.png,1048,818,1150,928,102,110,red blood cell,11220,1.0784313725490196,0.9272727272727272
59674,/images/a2754679-68b0-40f4-be01-bafad5ac1261.png,139,1379,225,1456,86,77,red blood cell,6622,0.8953488372093024,1.1168831168831168
14534,/images/458cb2e9-5a7f-437c-ac5d-a56f98a3efdf.png,502,200,612,316,110,116,red blood cell,12760,1.0545454545454545,0.9482758620689655
25768,/images/1f8edb2a-40bc-4beb-aa6b-884d2473df0f.png,161,210,281,354,120,144,red blood cell,17280,1.2,0.8333333333333334
32101,/images/b8a4d467-c40c-4ebf-91dd-1c19d0f2a7ae.png,545,109,652,220,107,111,red blood cell,11877,1.0373831775700935,0.963963963963964
1556,/images/0ac747cd-ff32-49bf-bc1a-3e9b7702ce9c.png,510,1291,638,1417,128,126,red blood cell,16128,0.984375,1.0158730158730158
24464,/images/b78ba2c8-ecb3-45b2-9cda-2c8088fa95d1.png,497,1197,616,1327,119,130,red blood cell,15470,1.0924369747899159,0.9153846153846154
16652,/images/bc377041-e098-45c4-9651-2b1ea90d1d7e.png,1085,884,1189,991,104,107,red blood cell,11128,1.0288461538461537,0.9719626168224299
34568,/images/3af90874-59f3-4f0c-a7e6-cc889e80c605.png,379,1338,486,1464,107,126,red blood cell,13482,1.1775700934579438,0.8492063492063492
53119,/images/04a567df-5463-4043-81f1-d726223c19a9.png,510,1363,602,1472,92,109,red blood cell,10028,1.184782608695652,0.8440366972477065
18322,/images/9ca20b10-e2fd-4bd2-93ef-78298f763ed5.png,174,1091,303,1218,129,127,red blood cell,16383,0.9844961240310077,1.015748031496063
25979,/images/e683144c-0465-43a2-86b1-3cf52599d5e0.png,699,497,809,608,110,111,red blood cell,12210,1.009090909090909,0.990990990990991
69725,/images/f0713bee-2a71-4ced-b953-4041ea99496a.png,837,910,950,1016,113,106,red blood cell,11978,0.9380530973451328,1.0660377358490567
23688,/images/79d7a014-21ff-40f1-9ac4-a69839390654.png,944,1203,1055,1321,111,118,red blood cell,13098,1.063063063063063,0.940677966101695
55761,/images/68f34a9c-f73d-4238-8f55-4b05a8a2154c.png,817,303,916,420,99,117,red blood cell,11583,1.1818181818181819,0.8461538461538461
38041,/images/e3e9c2de-0a24-4c7e-8a69-3d3093d5bdab.png,776,1182,864,1292,88,110,red blood cell,9680,1.25,0.8
77286,/images/07a80340-f65e-4f58-9317-94bb6ebd5a28.png,646,567,739,671,93,104,red blood cell,9672,1.118279569892473,0.8942307692307693
26163,/images/04de27ff-0d36-4da3-a829-e93851d76981.png,383,773,501,885,118,112,red blood cell,13216,0.9491525423728814,1.0535714285714286
74795,/images/91e93160-eb8d-4de0-b6bc-b98ec33d1663.png,388,196,503,306,115,110,red blood cell,12650,0.9565217391304348,1.0454545454545454
51203,/images/ad8731b7-0dae-4983-9dc6-dec31767d761.png,530,449,639,561,109,112,red blood cell,12208,1.0275229357798166,0.9732142857142857
14560,/images/458cb2e9-5a7f-437c-ac5d-a56f98a3efdf.png,266,521,371,619,105,98,red blood cell,10290,0.9333333333333333,1.0714285714285714
59184,/images/4736f545-1f1f-4d77-9241-d69cbf4dae35.png,382,668,462,766,80,98,red blood cell,7840,1.225,0.8163265306122449
48139,/images/913099c5-8085-4908-bf4b-1f098bbfcf66.png,560,333,672,445,112,112,red blood cell,12544,1.0,1.0
18649,/images/c22f7031-9cf8-48ce-b03b-1b12d0db4951.png,325,1134,427,1236,102,102,red blood cell,10404,1.0,1.0
60172,/images/214f1d15-a081-476e-992d-6c3a77f03d59.png,1013,1059,1129,1165,116,106,red blood cell,12296,0.9137931034482759,1.0943396226415094
9247,/images/261562a8-ffd8-4e0e-919b-22e267000b74.png,979,47,1079,142,100,95,red blood cell,9500,0.95,1.0526315789473684
27621,/images/a0785022-e82b-4878-b9d4-19cb7b75213f.png,993,934,1107,1034,114,100,red blood cell,11400,0.8771929824561403,1.14
63641,/images/d9c9479e-f1ea-4d6e-861f-843ff9a90d19.png,471,700,566,801,95,101,red blood cell,9595,1.063157894736842,0.9405940594059405
32809,/images/67f5ca94-d84e-490e-bf0d-4ffba7bdbe30.png,198,774,287,872,89,98,red blood cell,8722,1.101123595505618,0.9081632653061225
71242,/images/86495bbf-687b-429c-b9d3-6c2681ade7e2.png,630,963,752,1069,122,106,red blood cell,12932,0.8688524590163934,1.150943396226415
79124,/images/1c90231b-2830-42d9-884e-7301edb16933.png,708,138,809,227,101,89,red blood cell,8989,0.8811881188118812,1.1348314606741574
29937,/images/f2a8a483-b254-43aa-817f-7d525adb8911.png,772,390,900,518,128,128,red blood cell,16384,1.0,1.0
24016,/images/5107dcb7-164f-4e10-bbff-822b39b76efc.png,677,1407,801,1534,124,127,red blood cell,15748,1.0241935483870968,0.9763779527559056
76278,/images/1574565f-f45b-4160-947e-25ce1a81aaca.png,718,125,813,221,95,96,red blood cell,9120,1.0105263157894737,0.9895833333333334
47730,/images/afbb264e-ff60-443a-83f5-49d09be1b835.png,581,415,705,536,124,121,red blood cell,15004,0.9758064516129032,1.024793388429752
35032,/images/67582df6-bf13-4c83-a531-1214692b70de.png,1048,629,1169,749,121,120,red blood cell,14520,0.9917355371900827,1.0083333333333333
72843,/images/31435107-c77d-42f8-a619-75cba6a5161b.png,523,953,612,1057,89,104,red blood cell,9256,1.1685393258426966,0.8557692307692307
45267,/images/9e793460-d94c-47ac-b3a7-0d6ad86357da.png,918,358,1022,474,104,116,red blood cell,12064,1.1153846153846154,0.896551724137931
8234,/images/65e3d6a6-012c-4b40-9a42-83078eb85e31.png,490,1144,585,1246,95,102,red blood cell,9690,1.0736842105263158,0.9313725490196079
43415,/images/367663b2-5d09-4020-ab0a-c2200e7a1c8c.png,345,581,471,696,126,115,red blood cell,14490,0.9126984126984127,1.0956521739130434
22019,/images/c5acd0ad-b0f2-478d-b0ad-5aa733aa7b32.png,694,440,815,550,121,110,red blood cell,13310,0.9090909090909091,1.1
33326,/images/5721e41b-90ef-4851-8587-8dc71227ef90.png,1075,1395,1190,1536,115,141,red blood cell,16215,1.2260869565217392,0.8156028368794326
72086,/images/64b0e49a-0e48-447d-8872-c1dd255e7a21.png,60,553,164,645,104,92,red blood cell,9568,0.8846153846153846,1.1304347826086956
15187,/images/3a8f468f-f9de-46a8-a7c8-f2be239fa207.png,699,276,788,377,89,101,red blood cell,8989,1.1348314606741574,0.8811881188118812
77226,/images/fe691faa-3bc7-475e-b558-aa8fe7b795bc.png,20,37,114,135,94,98,red blood cell,9212,1.0425531914893618,0.9591836734693877
18662,/images/c22f7031-9cf8-48ce-b03b-1b12d0db4951.png,542,773,638,869,96,96,red blood cell,9216,1.0,1.0
25195,/images/90171428-f208-428a-b40e-f57ee3bea457.png,248,1432,343,1515,95,83,red blood cell,7885,0.8736842105263158,1.144578313253012
35282,/images/516bf1d5-5d00-4985-926c-3993e9bc3ff5.png,770,814,895,952,125,138,red blood cell,17250,1.104,0.9057971014492754
3076,/images/5a386082-397f-4524-a6f9-c2b8efe5014d.png,1068,789,1196,912,128,123,red blood cell,15744,0.9609375,1.0406504065040652
50594,/images/e98ea067-82b5-4a0d-87bf-b4bbdc10ddab.png,366,777,466,881,100,104,red blood cell,10400,1.04,0.9615384615384616
3462,/images/ad36bd67-594b-4f63-93e3-886af0bc618e.png,169,342,289,462,120,120,red blood cell,14400,1.0,1.0
59491,/images/a7c3c52f-3b40-4c92-a212-df9462cf25d8.png,907,1504,994,1600,87,96,red blood cell,8352,1.103448275862069,0.90625
13785,/images/1b369bcf-ced4-4ae2-9196-2664bd2b1738.png,219,1032,347,1141,128,109,red blood cell,13952,0.8515625,1.1743119266055047
43301,/images/36569710-a574-40be-ad42-897a6e74a128.png,945,697,1036,798,91,101,red blood cell,9191,1.10989010989011,0.900990099009901
11847,/images/3cdcb09b-6a8c-43ca-b1d0-c1a289202f65.png,534,470,639,587,105,117,red blood cell,12285,1.1142857142857143,0.8974358974358975
24341,/images/4d8a4ce8-0f9c-4f21-8844-4cf0e5514bbf.png,1065,905,1173,1006,108,101,red blood cell,10908,0.9351851851851852,1.0693069306930694
25124,/images/9e74feb8-017d-4d53-8896-9ebda4327dd1.png,775,50,867,152,92,102,red blood cell,9384,1.108695652173913,0.9019607843137255
13343,/images/a7f1bbb1-6058-4642-bd66-cfb90dce762e.png,174,874,270,974,96,100,red blood cell,9600,1.0416666666666667,0.96
2494,/images/a23f5539-bfe6-4885-9a0e-dba972475ea9.png,124,206,247,307,123,101,red blood cell,12423,0.8211382113821138,1.2178217821782178
36835,/images/dfac6c92-8f0f-429a-8caf-9b7732bf78da.png,385,1248,495,1357,110,109,red blood cell,11990,0.990909090909091,1.0091743119266054
71920,/images/61575482-91e1-4db9-83c7-687b7ddbbfc4.png,1037,1430,1124,1527,87,97,red blood cell,8439,1.1149425287356323,0.8969072164948454
37980,/images/e3e9c2de-0a24-4c7e-8a69-3d3093d5bdab.png,427,83,537,198,110,115,red blood cell,12650,1.0454545454545454,0.9565217391304348
29473,/images/8cc6fe77-5f2f-4670-b4ac-1b49550241a8.png,422,863,547,1005,125,142,red blood cell,17750,1.136,0.8802816901408451
35265,/images/a9159b11-ba49-4885-902e-00c8d5095b98.png,114,1113,222,1232,108,119,red blood cell,12852,1.1018518518518519,0.907563025210084
69795,/images/2bd15b6e-fe2d-49f3-b394-940d024d1f91.png,1108,606,1198,705,90,99,red blood cell,8910,1.1,0.9090909090909091
16837,/images/4823c1fe-a7f9-4b92-959f-0d9be09cd14b.png,891,816,981,900,90,84,red blood cell,7560,0.9333333333333333,1.0714285714285714
41067,/images/e871f52c-77a6-4813-80d4-95bd97985f1a.png,77,1128,215,1267,138,139,red blood cell,19182,1.0072463768115942,0.9928057553956835
17664,/images/b5143aae-6e98-4dc6-b546-980cb472de67.png,757,816,880,917,123,101,red blood cell,12423,0.8211382113821138,1.2178217821782178
52212,/images/f4c00b8c-d675-4255-8277-ca65bd757f51.png,282,1089,370,1198,88,109,red blood cell,9592,1.2386363636363635,0.8073394495412844
14090,/images/eaf4b781-b3aa-41ce-8c5e-287979b4e15a.png,677,1220,761,1310,84,90,red blood cell,7560,1.0714285714285714,0.9333333333333333
58889,/images/8a7deb24-d2b4-4acf-86c4-3aadd39157fa.png,661,856,784,981,123,125,red blood cell,15375,1.016260162601626,0.984
65247,/images/45ac9409-5537-44ed-90cd-5c8a1ae0e1e0.png,955,847,1068,959,113,112,red blood cell,12656,0.9911504424778761,1.0089285714285714
21972,/images/393df10a-5d64-476b-88f5-14ac56d6ed60.png,755,780,895,907,140,127,red blood cell,17780,0.9071428571428571,1.1023622047244095
79020,/images/6144887d-a1c1-46db-91a1-f7ff5bf8c8a5.png,1063,1382,1153,1494,90,112,red blood cell,10080,1.2444444444444445,0.8035714285714286
42416,/images/1a27ebe9-93a1-4898-af69-f276057d4012.png,283,359,395,477,112,118,red blood cell,13216,1.0535714285714286,0.9491525423728814
5068,/images/b7f1a1eb-c150-4456-9c47-e7db8a5cb77a.png,461,774,587,892,126,118,red blood cell,14868,0.9365079365079365,1.0677966101694916
11675,/images/0ed416f9-7c20-4829-9016-559e4009568e.png,388,858,488,959,100,101,red blood cell,10100,1.01,0.9900990099009901
12093,/images/984caf56-f400-4a29-be97-a4d6b9d1468d.png,937,272,1072,404,135,132,red blood cell,17820,0.9777777777777777,1.0227272727272727
44721,/images/ccb4b13d-ab20-4222-892f-5adf70249aaa.png,48,280,172,405,124,125,red blood cell,15500,1.0080645161290323,0.992
70338,/images/90246988-0d6d-4bf8-8a76-94107de4121e.png,452,990,546,1088,94,98,red blood cell,9212,1.0425531914893618,0.9591836734693877
72272,/images/ee57e743-a876-4f69-9fe5-bf5d01b44689.png,1035,11,1140,116,105,105,red blood cell,11025,1.0,1.0
22812,/images/72105bb0-8e39-48be-b7f7-5b32f047b99e.png,218,318,327,435,109,117,red blood cell,12753,1.073394495412844,0.9316239316239316
18262,/images/947348fe-4c70-468e-8009-3c14daeca69b.png,503,1289,638,1412,135,123,red blood cell,16605,0.9111111111111111,1.0975609756097562
71408,/images/bcb447c9-5d37-414f-a513-d7076b04a532.png,770,1378,869,1479,99,101,red blood cell,9999,1.02020202020202,0.9801980198019802
826,/images/27fab82c-5bf0-426f-aeb9-47da829b6629.png,1056,915,1158,1033,102,118,red blood cell,12036,1.1568627450980393,0.864406779661017
19520,/images/a85cd1ae-0c94-4387-8305-84ab8d96d137.png,658,294,762,386,104,92,red blood cell,9568,0.8846153846153846,1.1304347826086956
50615,/images/c956e531-6805-4fe1-b61c-8b96a9815a77.png,644,686,774,809,130,123,red blood cell,15990,0.9461538461538461,1.056910569105691
51507,/images/baa87bf8-786c-444c-81e8-9fa0a41d8149.png,259,71,356,175,97,104,red blood cell,10088,1.0721649484536082,0.9326923076923077
50645,/images/c956e531-6805-4fe1-b61c-8b96a9815a77.png,1043,1013,1166,1138,123,125,red blood cell,15375,1.016260162601626,0.984
51256,/images/216f9d43-6869-4ba1-9106-4f5ea6aac223.png,20,860,114,954,94,94,red blood cell,8836,1.0,1.0
72757,/images/caeb2d62-1166-43f0-8eac-5b8fc48f02eb.png,36,525,126,617,90,92,red blood cell,8280,1.0222222222222221,0.9782608695652174
58515,/images/5cac6ddf-c8c6-45de-bce0-a1db64b14fb5.png,298,1473,420,1594,122,121,red blood cell,14762,0.9918032786885246,1.0082644628099173
56181,/images/137d540f-d71e-47e8-bd9b-6cd0a6433c33.png,179,349,271,448,92,99,red blood cell,9108,1.076086956521739,0.9292929292929293
66872,/images/9acf303a-fcba-4e52-be3e-8d061aa5e72a.png,1088,118,1187,224,99,106,red blood cell,10494,1.0707070707070707,0.9339622641509434
37720,/images/003a89b0-a095-417a-8dd6-f408339bbc68.png,560,865,662,977,102,112,red blood cell,11424,1.0980392156862746,0.9107142857142857
63410,/images/289ef1b7-02d5-42e9-a401-687688181306.png,837,1226,948,1336,111,110,red blood cell,12210,0.990990990990991,1.009090909090909
39001,/images/79806898-0214-44bd-ba2c-b570e911be62.png,716,1203,830,1324,114,121,red blood cell,13794,1.0614035087719298,0.9421487603305785
73677,/images/f11d05e4-538a-4024-8711-b08a4ce3c540.png,133,1364,223,1461,90,97,red blood cell,8730,1.0777777777777777,0.9278350515463918
19637,/images/a3ada657-de00-44db-b1e2-54ba17e39983.png,95,888,229,1013,134,125,red blood cell,16750,0.9328358208955224,1.072
63605,/images/de0321fa-6f7d-4dd1-b96b-186701c3b1d9.png,620,286,732,417,112,131,red blood cell,14672,1.1696428571428572,0.8549618320610687
57596,/images/8190ec37-9a5e-419f-89ed-fbfb079370db.png,1098,1457,1185,1541,87,84,red blood cell,7308,0.9655172413793104,1.0357142857142858
56415,/images/c10b125d-10c2-474a-9c6a-5249935c638e.png,1009,707,1118,821,109,114,red blood cell,12426,1.0458715596330275,0.956140350877193
20966,/images/d4fef0c5-6597-48b6-97e9-32ed504488e6.png,326,1194,474,1329,148,135,red blood cell,19980,0.9121621621621622,1.0962962962962963
61620,/images/a3c0a876-be12-4ede-8aed-18b32a64401b.png,774,862,873,968,99,106,red blood cell,10494,1.0707070707070707,0.9339622641509434
47983,/images/eba73bff-fbe1-436d-9a5f-0a61331a0ea2.png,919,370,1045,491,126,121,red blood cell,15246,0.9603174603174603,1.0413223140495869
12649,/images/0901f9d1-be4f-4c19-8e83-dd724dded9f5.png,740,769,867,879,127,110,red blood cell,13970,0.8661417322834646,1.1545454545454545
32439,/images/3911fcd2-4e26-4ad9-aaf0-d1c5bf41defc.png,395,859,503,962,108,103,red blood cell,11124,0.9537037037037037,1.0485436893203883
63030,/images/f234a2de-f3c8-4521-a306-8cfdf52dd597.png,14,662,91,743,77,81,red blood cell,6237,1.051948051948052,0.9506172839506173
42006,/images/46a03374-64c7-49ac-81c9-c3d62542bbf3.png,1033,1211,1125,1289,92,78,red blood cell,7176,0.8478260869565217,1.1794871794871795
4131,/images/d3b79739-aea2-4804-8c7a-183b7ed07de3.png,190,503,286,619,96,116,red blood cell,11136,1.2083333333333333,0.8275862068965517
54231,/images/3b5a8060-dec6-4a83-b7f2-b604e4e69dfc.png,247,1477,345,1589,98,112,red blood cell,10976,1.1428571428571428,0.875
78441,/images/fe00fa09-d3c8-485b-9d0f-3cce556c9edd.png,720,614,819,720,99,106,red blood cell,10494,1.0707070707070707,0.9339622641509434
13040,/images/555c6ea2-c76c-4e71-af57-855d940c2b37.png,188,1062,308,1190,120,128,red blood cell,15360,1.0666666666666667,0.9375
9291,/images/261562a8-ffd8-4e0e-919b-22e267000b74.png,761,1452,887,1553,126,101,red blood cell,12726,0.8015873015873016,1.2475247524752475
9016,/images/ef815e3a-02a6-4cf8-9262-45bc74c50b00.png,627,870,746,969,119,99,red blood cell,11781,0.8319327731092437,1.202020202020202
45577,/images/e597f7ce-46c6-4dce-9063-50a2703fdd45.png,422,1173,524,1272,102,99,red blood cell,10098,0.9705882352941176,1.0303030303030303
74122,/images/9fe8bdc8-847d-434e-93e5-ae14ff3b45e1.png,180,4,280,129,100,125,red blood cell,12500,1.25,0.8
70284,/images/90246988-0d6d-4bf8-8a76-94107de4121e.png,1037,877,1140,990,103,113,red blood cell,11639,1.0970873786407767,0.911504424778761
12862,/images/b10ea12f-cd36-4f2c-994a-67d1665269ab.png,355,201,462,292,107,91,red blood cell,9737,0.8504672897196262,1.1758241758241759
37160,/images/d6942996-5664-4370-ad87-2bdcbd49ac16.png,74,1435,199,1564,125,129,red blood cell,16125,1.032,0.9689922480620154
58023,/images/a7c91b63-b97c-4f4b-8d34-7ad2b08d7a17.png,264,136,362,241,98,105,red blood cell,10290,1.0714285714285714,0.9333333333333333
38302,/images/674b0fd3-f247-4b7f-97f7-3e6c57c9ba9e.png,181,67,283,178,102,111,red blood cell,11322,1.088235294117647,0.918918918918919
59424,/images/a7c3c52f-3b40-4c92-a212-df9462cf25d8.png,106,980,203,1075,97,95,red blood cell,9215,0.979381443298969,1.0210526315789474
42566,/images/184b376b-03cb-4c2d-af51-fc1a62196293.png,386,1346,485,1444,99,98,red blood cell,9702,0.98989898989899,1.010204081632653
6010,/images/72732579-a812-4496-b2dd-ea1556924337.png,191,1447,293,1551,102,104,red blood cell,10608,1.0196078431372548,0.9807692307692307
45368,/images/e4eea7ea-8989-46a9-9c98-25a178146b28.png,356,1246,459,1340,103,94,red blood cell,9682,0.912621359223301,1.0957446808510638
5654,/images/afa470d9-c74c-41cd-b4dc-7bf93fde8263.png,1085,826,1188,920,103,94,red blood cell,9682,0.912621359223301,1.0957446808510638
73227,/images/85546330-4efd-43e2-87aa-d53a30220bfc.png,593,1442,688,1538,95,96,red blood cell,9120,1.0105263157894737,0.9895833333333334
59713,/images/f77d7469-d083-4c2d-a4ea-5a9ff162e3e2.png,1043,829,1144,928,101,99,red blood cell,9999,0.9801980198019802,1.02020202020202
327,/images/0dcca702-a4ef-4fb3-a940-9c0c140b21c7.png,648,1104,740,1204,92,100,red blood cell,9200,1.0869565217391304,0.92
38954,/images/5939f341-a886-4f63-ae87-2219d000a1d4.png,463,463,572,570,109,107,red blood cell,11663,0.981651376146789,1.0186915887850467
51428,/images/b4f3b2a4-f4b9-48de-ac5d-0e681b77be27.png,261,996,354,1084,93,88,red blood cell,8184,0.946236559139785,1.0568181818181819
66370,/images/e5fd5949-4cd0-4cb6-837a-02c26a5eb87a.png,876,964,994,1080,118,116,red blood cell,13688,0.9830508474576272,1.0172413793103448
40270,/images/f05ffdca-dc3a-47bd-a231-2a0d9bd1d50e.png,726,638,853,765,127,127,red blood cell,16129,1.0,1.0
67106,/images/4272cbd7-5b0a-4bf7-b690-dee1c128f07b.png,1082,321,1169,410,87,89,red blood cell,7743,1.0229885057471264,0.9775280898876404
6874,/images/b21f6c6e-4b45-407a-b4c7-034a115f3ee4.png,518,513,635,635,117,122,red blood cell,14274,1.0427350427350428,0.9590163934426229
60627,/images/724e0c34-32cd-41f1-ae37-586038bc67ab.png,925,731,1019,823,94,92,red blood cell,8648,0.9787234042553191,1.0217391304347827
5797,/images/143f5959-5b6d-4f95-bcee-9e110450fc22.png,444,1479,539,1595,95,116,red blood cell,11020,1.2210526315789474,0.8189655172413793
67058,/images/4272cbd7-5b0a-4bf7-b690-dee1c128f07b.png,112,621,218,727,106,106,red blood cell,11236,1.0,1.0
49011,/images/df3d98b9-3dd7-4107-8d4a-ae1b7f247793.png,299,859,394,953,95,94,red blood cell,8930,0.9894736842105263,1.0106382978723405
35807,/images/bb2042c5-35e1-43cc-8171-7de81b764361.png,326,932,435,1021,109,89,red blood cell,9701,0.8165137614678899,1.2247191011235956
79302,/images/05ac7b2a-6a77-4464-926b-8570f7c01693.png,963,512,1064,610,101,98,red blood cell,9898,0.9702970297029703,1.030612244897959
34699,/images/8d989997-038c-4924-b2d3-d02629a7cdf5.png,587,922,725,1041,138,119,red blood cell,16422,0.8623188405797102,1.1596638655462186
20684,/images/e6d7c5e1-43fc-4712-86d5-aa70252b978f.png,586,705,716,830,130,125,red blood cell,16250,0.9615384615384616,1.04
46879,/images/9e0e1928-d19a-4100-b093-0b962ac09e05.png,364,638,454,740,90,102,red blood cell,9180,1.1333333333333333,0.8823529411764706
44028,/images/de81bf7a-7a56-437f-a068-4d9c3e01134c.png,167,588,269,687,102,99,red blood cell,10098,0.9705882352941176,1.0303030303030303
32024,/images/b8a4d467-c40c-4ebf-91dd-1c19d0f2a7ae.png,808,1012,912,1110,104,98,red blood cell,10192,0.9423076923076923,1.0612244897959184
31329,/images/31c749e8-18d1-4105-b7e6-8319cceddae0.png,1052,1384,1169,1492,117,108,red blood cell,12636,0.9230769230769231,1.0833333333333333
53296,/images/d8f7e159-b7e3-49e4-86e8-aed8c5fbcd97.png,80,1504,176,1598,96,94,red blood cell,9024,0.9791666666666666,1.0212765957446808
37408,/images/08f5a524-0554-49c2-83a8-ae9a6d51e8fd.png,921,619,1035,726,114,107,red blood cell,12198,0.9385964912280702,1.0654205607476634
77314,/images/07a80340-f65e-4f58-9317-94bb6ebd5a28.png,422,696,501,782,79,86,red blood cell,6794,1.0886075949367089,0.9186046511627907
63865,/images/5e974892-0ebe-4037-8427-ea8616d6d3b8.png,681,956,776,1037,95,81,red blood cell,7695,0.8526315789473684,1.1728395061728396
25103,/images/9e74feb8-017d-4d53-8896-9ebda4327dd1.png,53,271,156,376,103,105,red blood cell,10815,1.0194174757281553,0.9809523809523809
54329,/images/3b5a8060-dec6-4a83-b7f2-b604e4e69dfc.png,188,60,277,167,89,107,red blood cell,9523,1.202247191011236,0.8317757009345794
31593,/images/0d7bf56f-3b5a-40bd-971c-2ca33dd89b2c.png,860,854,968,960,108,106,red blood cell,11448,0.9814814814814815,1.0188679245283019
1119,/images/edcb4d77-a4d3-465d-9b59-eb3087766b1c.png,267,808,364,918,97,110,red blood cell,10670,1.134020618556701,0.8818181818181818
29578,/images/42845335-4ab2-4963-806d-0985d1382a31.png,511,903,632,1036,121,133,red blood cell,16093,1.0991735537190082,0.9097744360902256
72129,/images/64b0e49a-0e48-447d-8872-c1dd255e7a21.png,191,738,269,830,78,92,red blood cell,7176,1.1794871794871795,0.8478260869565217
14005,/images/eaf4b781-b3aa-41ce-8c5e-287979b4e15a.png,305,1175,401,1267,96,92,red blood cell,8832,0.9583333333333334,1.0434782608695652
61162,/images/80da32ce-8c22-470e-9f35-558c5f7a5df9.png,911,706,990,786,79,80,red blood cell,6320,1.0126582278481013,0.9875
32867,/images/2a6370b0-08f1-4c11-a639-265d4419c9a3.png,1061,431,1153,537,92,106,red blood cell,9752,1.1521739130434783,0.8679245283018868
62241,/images/a72cd558-b7ac-4bf2-a344-2ce6c73a354e.png,12,493,118,598,106,105,red blood cell,11130,0.9905660377358491,1.0095238095238095
18926,/images/e9e78ff8-831b-46e9-9785-3eee9acbfcd8.png,782,1420,892,1521,110,101,red blood cell,11110,0.9181818181818182,1.0891089108910892
75873,/images/3006096f-ceeb-42be-b69e-785179d7438b.png,700,1303,817,1412,117,109,red blood cell,12753,0.9316239316239316,1.073394495412844
12727,/images/68442532-9cd2-4b42-9d4f-ddf8c13bb38c.png,348,535,471,666,123,131,red blood cell,16113,1.065040650406504,0.9389312977099237
31373,/images/04fb49a2-07b8-4cdf-b6f7-df5c3688e5f8.png,134,883,233,995,99,112,red blood cell,11088,1.1313131313131313,0.8839285714285714
33896,/images/1a332b2c-9d49-4ff2-810c-5633d2314527.png,742,1316,850,1441,108,125,red blood cell,13500,1.1574074074074074,0.864
17942,/images/eb77e4a9-acb0-4d83-8055-2c5fcaa54b45.png,706,217,796,309,90,92,red blood cell,8280,1.0222222222222221,0.9782608695652174
14826,/images/f8b6a868-60e9-4569-ae69-638a0c39834d.png,157,1121,283,1246,126,125,red blood cell,15750,0.9920634920634921,1.008
535,/images/67acd5bc-4658-4c6e-a9b9-cd8ea3a03418.png,733,1292,838,1403,105,111,red blood cell,11655,1.0571428571428572,0.9459459459459459
50830,/images/db0a1123-0b35-48d7-8337-3b1ebd6af0cc.png,615,705,717,828,102,123,red blood cell,12546,1.2058823529411764,0.8292682926829268
71707,/images/5c99cd97-39f6-4809-9528-9d380cc16b16.png,833,1448,910,1533,77,85,red blood cell,6545,1.103896103896104,0.9058823529411765
905,/images/dce55b59-c6c3-4693-aa75-6b348c8f52cd.png,155,1339,266,1452,111,113,red blood cell,12543,1.018018018018018,0.9823008849557522
38725,/images/b5acf759-1115-42f0-a753-656736192528.png,318,620,428,757,110,137,red blood cell,15070,1.2454545454545454,0.8029197080291971
7356,/images/89f10192-d3dd-4996-a571-4c851dbdc983.png,393,866,508,958,115,92,red blood cell,10580,0.8,1.25
5326,/images/06df7bbe-60d4-4f7c-ba4a-5a42ac4be91b.png,566,653,683,762,117,109,red blood cell,12753,0.9316239316239316,1.073394495412844
27719,/images/e3c1442a-717f-41dd-bf97-81e1233ac9fa.png,847,738,946,839,99,101,red blood cell,9999,1.02020202020202,0.9801980198019802
34639,/images/a0eedcb9-b85c-4612-b945-7e8227f53c35.png,437,664,537,762,100,98,red blood cell,9800,0.98,1.0204081632653061
59530,/images/6bfe6a90-8a69-4171-8e7f-42dc9417c6d9.png,936,1141,1056,1256,120,115,red blood cell,13800,0.9583333333333334,1.0434782608695652
58258,/images/319c9c52-f316-49f3-baad-4444ab19f85b.png,921,518,1013,619,92,101,red blood cell,9292,1.0978260869565217,0.9108910891089109
60332,/images/1c87b997-a8e6-48ca-bf40-19b9a7fd6a96.png,625,705,718,800,93,95,red blood cell,8835,1.021505376344086,0.9789473684210527
42799,/images/7029feb3-9ffe-46e4-9883-6a9df84f7b62.png,227,82,345,202,118,120,red blood cell,14160,1.0169491525423728,0.9833333333333333
65007,/images/ff3b9d4d-373c-48ef-a75a-d23e2c2ade87.png,162,1194,249,1296,87,102,red blood cell,8874,1.1724137931034482,0.8529411764705882
34737,/images/6294153c-6db3-4f2b-a8ff-9c087225e737.png,1050,1177,1171,1292,121,115,red blood cell,13915,0.9504132231404959,1.0521739130434782
16872,/images/4823c1fe-a7f9-4b92-959f-0d9be09cd14b.png,624,1161,720,1248,96,87,red blood cell,8352,0.90625,1.103448275862069
40593,/images/29861cf9-9a1e-4733-8309-4bd10706b4a3.png,797,135,914,244,117,109,red blood cell,12753,0.9316239316239316,1.073394495412844
17909,/images/eb77e4a9-acb0-4d83-8055-2c5fcaa54b45.png,516,244,631,363,115,119,red blood cell,13685,1.0347826086956522,0.9663865546218487
23210,/images/3dcd4f1b-ce43-4a34-b1ed-076bb42963b1.png,473,276,573,384,100,108,red blood cell,10800,1.08,0.9259259259259259
1206,/images/5ff7c0c8-d208-4e7d-958d-ca3c2260ff39.png,408,1222,537,1347,129,125,red blood cell,16125,0.9689922480620154,1.032
11122,/images/6303f964-98ef-47c6-bb2d-283aa393f918.png,1072,32,1178,127,106,95,red blood cell,10070,0.8962264150943396,1.1157894736842104
5886,/images/a30da226-b452-408a-a556-bfae4d521464.png,888,637,996,746,108,109,red blood cell,11772,1.0092592592592593,0.9908256880733946
3432,/images/fd1302e2-3cd2-4a1a-9c13-00f810a9c41b.png,968,374,1081,490,113,116,red blood cell,13108,1.0265486725663717,0.9741379310344828
1419,/images/6d91d1f0-636b-4f5a-a526-7c17fc857190.png,564,1166,672,1269,108,103,red blood cell,11124,0.9537037037037037,1.0485436893203883
66383,/images/e5fd5949-4cd0-4cb6-837a-02c26a5eb87a.png,42,190,141,303,99,113,red blood cell,11187,1.1414141414141414,0.8761061946902655
68014,/images/bcaefb02-682a-41b9-acc7-e6cc010f5b30.png,299,776,404,882,105,106,red blood cell,11130,1.0095238095238095,0.9905660377358491
44793,/images/6795acae-e84d-4e97-b9a1-b4f4f0a72cfd.png,1062,769,1165,883,103,114,red blood cell,11742,1.1067961165048543,0.9035087719298246
27908,/images/46f5bd4f-8bea-48d1-a1da-4dea28e3b814.png,800,1076,904,1194,104,118,red blood cell,12272,1.1346153846153846,0.8813559322033898
56938,/images/a93c35ba-1690-4358-8837-669bcd850bb7.png,547,761,657,882,110,121,red blood cell,13310,1.1,0.9090909090909091
64980,/images/dec61ae1-5037-4c3a-8952-15371becca7d.png,426,1120,528,1226,102,106,red blood cell,10812,1.0392156862745099,0.9622641509433962
17137,/images/dc3bdfe9-1565-4cda-9c4e-0979846dab60.png,640,896,720,995,80,99,red blood cell,7920,1.2375,0.8080808080808081
10400,/images/46a2d369-4bea-4405-ac78-91bbe130b9a7.png,862,1335,951,1436,89,101,red blood cell,8989,1.1348314606741574,0.8811881188118812
53427,/images/766d5547-8dd2-4c8d-b78e-3007f83932e8.png,853,1061,949,1159,96,98,red blood cell,9408,1.0208333333333333,0.9795918367346939
51031,/images/7eb95580-693f-41b6-9338-174be1430c23.png,921,498,1018,616,97,118,red blood cell,11446,1.2164948453608246,0.8220338983050848
46309,/images/e11515b4-9527-4c23-a0ba-43719bacca0d.png,929,1323,1043,1450,114,127,red blood cell,14478,1.1140350877192982,0.8976377952755905
52185,/images/f4c00b8c-d675-4255-8277-ca65bd757f51.png,778,1247,896,1350,118,103,red blood cell,12154,0.8728813559322034,1.145631067961165
37314,/images/4d88e2d2-5aad-410c-9bbc-702ee9496995.png,1064,695,1194,814,130,119,red blood cell,15470,0.9153846153846154,1.0924369747899159
50332,/images/3d32a988-449d-4d58-b71f-abbfdc3f2fbc.png,126,263,227,359,101,96,red blood cell,9696,0.9504950495049505,1.0520833333333333
10512,/images/46a2d369-4bea-4405-ac78-91bbe130b9a7.png,827,1099,930,1193,103,94,red blood cell,9682,0.912621359223301,1.0957446808510638
79674,/images/a4409217-be11-4478-90a5-b406057d154d.png,1093,741,1199,847,106,106,red blood cell,11236,1.0,1.0
42225,/images/ca734448-0d52-42fa-b41c-17b2939e58ae.png,336,250,439,372,103,122,red blood cell,12566,1.1844660194174756,0.8442622950819673
74757,/images/c53fd511-31bd-4901-baac-3b44891f6744.png,73,153,176,246,103,93,red blood cell,9579,0.9029126213592233,1.10752688172043
37085,/images/d6942996-5664-4370-ad87-2bdcbd49ac16.png,452,1332,568,1441,116,109,red blood cell,12644,0.9396551724137931,1.0642201834862386
59724,/images/f77d7469-d083-4c2d-a4ea-5a9ff162e3e2.png,513,1348,610,1432,97,84,red blood cell,8148,0.865979381443299,1.1547619047619047
30622,/images/f939782b-f5a2-40a3-9c22-6c6d7e18edc3.png,122,1270,245,1373,123,103,red blood cell,12669,0.8373983739837398,1.1941747572815533
8256,/images/65e3d6a6-012c-4b40-9a42-83078eb85e31.png,976,281,1070,375,94,94,red blood cell,8836,1.0,1.0
51044,/images/7eb95580-693f-41b6-9338-174be1430c23.png,610,1239,700,1346,90,107,red blood cell,9630,1.1888888888888889,0.8411214953271028
39682,/images/56adbb1e-96a8-40a5-a5a2-243c97ea889b.png,88,115,210,228,122,113,red blood cell,13786,0.9262295081967213,1.079646017699115
41123,/images/2240b991-48f6-4c59-9b62-5a8b5e541fae.png,728,46,816,148,88,102,red blood cell,8976,1.1590909090909092,0.8627450980392157
41233,/images/eed298b3-35f2-4127-88ad-0c4a9062207b.png,731,355,840,464,109,109,red blood cell,11881,1.0,1.0
22051,/images/6b8048ed-ebd7-4789-ba87-c1ba94801481.png,583,64,714,197,131,133,red blood cell,17423,1.015267175572519,0.9849624060150376
24769,/images/530761d4-1931-44cd-b220-d60db0e228f9.png,444,864,546,983,102,119,red blood cell,12138,1.1666666666666667,0.8571428571428571
15210,/images/3a8f468f-f9de-46a8-a7c8-f2be239fa207.png,594,69,677,165,83,96,red blood cell,7968,1.1566265060240963,0.8645833333333334
79425,/images/dcb21739-3c36-459d-b3cc-1be5871d6fe7.png,512,634,583,708,71,74,red blood cell,5254,1.0422535211267605,0.9594594594594594
41268,/images/2374ae5b-c2df-4db5-afea-c54180aa22e3.png,941,532,1061,650,120,118,red blood cell,14160,0.9833333333333333,1.0169491525423728
3997,/images/a5e05ba8-0c19-41e3-92d5-10e42a03b85e.png,36,134,142,242,106,108,red blood cell,11448,1.0188679245283019,0.9814814814814815
1833,/images/5f783f43-0090-4f8a-bd75-9562f4aa2dd5.png,181,784,277,884,96,100,red blood cell,9600,1.0416666666666667,0.96
12487,/images/cc94eabb-a3dc-4cfc-9fff-55c76b5b4a71.png,355,845,485,1001,130,156,red blood cell,20280,1.2,0.8333333333333334
20061,/images/ebfd9f67-138e-49f0-9cef-a0352069eedb.png,1083,1242,1194,1350,111,108,red blood cell,11988,0.972972972972973,1.0277777777777777
53396,/images/766d5547-8dd2-4c8d-b78e-3007f83932e8.png,589,1390,704,1500,115,110,red blood cell,12650,0.9565217391304348,1.0454545454545454
46243,/images/815bf40c-371a-4d34-aa41-c549c8221881.png,717,1189,859,1313,142,124,red blood cell,17608,0.8732394366197183,1.1451612903225807
13193,/images/711f6b3f-cd63-46d1-834a-bc8e9aa9b43e.png,330,265,436,354,106,89,red blood cell,9434,0.839622641509434,1.1910112359550562
66159,/images/191f87a4-6f2d-49e7-bba0-08e3aa78ddaf.png,914,1301,991,1394,77,93,red blood cell,7161,1.2077922077922079,0.8279569892473119
18874,/images/d1b48634-9ad5-46e8-b816-42d1d97c93cd.png,300,396,402,505,102,109,red blood cell,11118,1.0686274509803921,0.9357798165137615
12217,/images/313ed8d9-3c00-4415-9de0-0eda07c60ad9.png,852,224,965,330,113,106,red blood cell,11978,0.9380530973451328,1.0660377358490567
24304,/images/4d8a4ce8-0f9c-4f21-8844-4cf0e5514bbf.png,119,549,232,659,113,110,red blood cell,12430,0.9734513274336283,1.0272727272727273
53704,/images/6f67a66b-56ec-4c36-ae7c-f250d3b86a23.png,165,876,266,993,101,117,red blood cell,11817,1.1584158415841583,0.8632478632478633
53950,/images/540a5fee-175b-4b92-bf62-1ea9b59c86c6.png,781,856,892,957,111,101,red blood cell,11211,0.9099099099099099,1.099009900990099
62003,/images/bdb5d571-27bc-4a42-ae45-aa5a9af40a81.png,807,249,910,355,103,106,red blood cell,10918,1.029126213592233,0.9716981132075472
70953,/images/deaa1931-5f97-45bf-8c00-be6ddeb37b9a.png,419,306,533,404,114,98,red blood cell,11172,0.8596491228070176,1.163265306122449
39154,/images/7bde7de1-889b-4218-b0e1-e2c04f6a7986.png,56,1001,167,1129,111,128,red blood cell,14208,1.1531531531531531,0.8671875
22035,/images/c5acd0ad-b0f2-478d-b0ad-5aa733aa7b32.png,963,214,1099,328,136,114,red blood cell,15504,0.8382352941176471,1.1929824561403508
17920,/images/eb77e4a9-acb0-4d83-8055-2c5fcaa54b45.png,700,540,796,638,96,98,red blood cell,9408,1.0208333333333333,0.9795918367346939
48490,/images/9c4cb048-d64a-4b7f-84ff-ca28a8084fc7.png,483,1273,610,1377,127,104,red blood cell,13208,0.8188976377952756,1.2211538461538463
29143,/images/cfab01d3-0616-4efb-9290-11f0fd8bf5a3.png,728,1049,832,1165,104,116,red blood cell,12064,1.1153846153846154,0.896551724137931
6310,/images/c6575e75-c8ce-4766-841f-1137b9e0956c.png,391,878,499,1000,108,122,red blood cell,13176,1.1296296296296295,0.8852459016393442
48667,/images/03359d4d-69cb-4146-8286-ca7399366f97.png,146,934,271,1049,125,115,red blood cell,14375,0.92,1.0869565217391304
914,/images/dce55b59-c6c3-4693-aa75-6b348c8f52cd.png,532,312,648,423,116,111,red blood cell,12876,0.9568965517241379,1.045045045045045
67731,/images/48e2f0bd-2164-40c3-af43-1f2708359978.png,548,362,660,472,112,110,red blood cell,12320,0.9821428571428571,1.018181818181818
71475,/images/191071ab-6515-428c-9f05-8e4309542b75.png,482,84,590,198,108,114,red blood cell,12312,1.0555555555555556,0.9473684210526315
16569,/images/c7045ab6-230e-4c1e-a8e0-f624d41a00d9.png,272,322,368,419,96,97,red blood cell,9312,1.0104166666666667,0.9896907216494846
74245,/images/4e43fc22-dc08-4cde-b3ce-ce8a4f377c47.png,891,1231,986,1317,95,86,red blood cell,8170,0.9052631578947369,1.1046511627906976
13964,/images/31af9c31-7868-44a6-8eb4-82ce118af425.png,952,15,1053,119,101,104,red blood cell,10504,1.0297029702970297,0.9711538461538461
12265,/images/3b55c42f-ad59-422f-ba99-4f4f4ca9cb2e.png,695,23,817,126,122,103,red blood cell,12566,0.8442622950819673,1.1844660194174756
59470,/images/a7c3c52f-3b40-4c92-a212-df9462cf25d8.png,509,958,616,1058,107,100,red blood cell,10700,0.9345794392523364,1.07
13828,/images/345cb914-7583-49df-96e3-3cf19c2ba8f1.png,34,1129,150,1251,116,122,red blood cell,14152,1.0517241379310345,0.9508196721311475
28014,/images/c4d34e35-4db2-41de-ba77-1a94aa9ef788.png,1001,1365,1126,1479,125,114,red blood cell,14250,0.912,1.0964912280701755
62191,/images/a72cd558-b7ac-4bf2-a344-2ce6c73a354e.png,863,138,960,249,97,111,red blood cell,10767,1.1443298969072164,0.8738738738738738
46015,/images/72088c26-d2dd-4906-b791-b8947fc7fbe4.png,6,24,117,136,111,112,red blood cell,12432,1.009009009009009,0.9910714285714286
584,/images/065af549-320a-4862-b92a-8ef750d7b5fb.png,93,863,212,973,119,110,red blood cell,13090,0.9243697478991597,1.0818181818181818
30211,/images/a1669b59-fe09-4fe6-ba9f-06bec6725502.png,1004,1208,1090,1296,86,88,red blood cell,7568,1.0232558139534884,0.9772727272727273
76942,/images/25ddc1ca-d368-4fff-b1ad-1dbf1e7c97aa.png,333,1192,448,1287,115,95,red blood cell,10925,0.8260869565217391,1.2105263157894737
18754,/images/f6f8a69a-3fd2-4684-ac77-3e83ea0fb36d.png,990,184,1093,290,103,106,red blood cell,10918,1.029126213592233,0.9716981132075472
35611,/images/45f18ac0-f097-4b20-a99d-8837cf488822.png,807,1186,925,1296,118,110,red blood cell,12980,0.9322033898305084,1.0727272727272728
76791,/images/2165fe38-b474-467d-be11-d1d728085efd.png,251,1054,361,1160,110,106,red blood cell,11660,0.9636363636363636,1.0377358490566038
44090,/images/8b494b40-cab5-49d3-893d-c805000fbe88.png,393,308,498,425,105,117,red blood cell,12285,1.1142857142857143,0.8974358974358975
32931,/images/d1924af6-7512-4ccc-9c6b-adbbaa8db41f.png,1006,728,1121,852,115,124,red blood cell,14260,1.0782608695652174,0.9274193548387096
60759,/images/645cd195-af50-409f-8da9-6e7c7f18ea09.png,921,1181,1032,1291,111,110,red blood cell,12210,0.990990990990991,1.009090909090909
14591,/images/c649e1cb-4029-4433-b231-d67d68f7391a.png,299,34,422,151,123,117,red blood cell,14391,0.9512195121951219,1.0512820512820513
29499,/images/8cc6fe77-5f2f-4670-b4ac-1b49550241a8.png,35,122,158,250,123,128,red blood cell,15744,1.0406504065040652,0.9609375
32251,/images/f4722a74-35e7-42bd-8ef6-dfff04b9cd22.png,1,147,99,260,98,113,red blood cell,11074,1.153061224489796,0.8672566371681416
45986,/images/72088c26-d2dd-4906-b791-b8947fc7fbe4.png,568,804,670,902,102,98,red blood cell,9996,0.9607843137254902,1.0408163265306123
13078,/images/9691c57a-ccf8-47f9-a8e9-9a324974585b.png,927,11,1032,119,105,108,red blood cell,11340,1.0285714285714285,0.9722222222222222
71267,/images/445d0db9-e830-4ceb-a845-b23d819e6097.png,555,469,657,568,102,99,red blood cell,10098,0.9705882352941176,1.0303030303030303
14637,/images/9d155086-acf5-4c86-a9e1-94b587c46e87.png,147,696,268,819,121,123,red blood cell,14883,1.0165289256198347,0.983739837398374
78926,/images/4d0a1598-e4dd-45c4-8a90-dd7c780fe1da.png,936,13,1028,107,92,94,red blood cell,8648,1.0217391304347827,0.9787234042553191
35024,/images/67582df6-bf13-4c83-a531-1214692b70de.png,208,771,326,896,118,125,red blood cell,14750,1.0593220338983051,0.944
69752,/images/2bd15b6e-fe2d-49f3-b394-940d024d1f91.png,737,1183,847,1299,110,116,red blood cell,12760,1.0545454545454545,0.9482758620689655
73088,/images/f39e2289-fedd-4d12-9e64-ffdafb89247e.png,895,1379,1017,1481,122,102,red blood cell,12444,0.8360655737704918,1.196078431372549
56735,/images/b3606d0e-6fe5-478a-bb4b-64d7c4889d86.png,181,1149,295,1264,114,115,red blood cell,13110,1.0087719298245614,0.991304347826087
67317,/images/49c4dbd3-6269-4d4c-9648-a2146c57bab1.png,895,69,998,181,103,112,red blood cell,11536,1.087378640776699,0.9196428571428571
44830,/images/83ec8923-6232-40d7-ba1f-a1b8bf7cb66c.png,89,255,207,357,118,102,red blood cell,12036,0.864406779661017,1.1568627450980393
79394,/images/dcb21739-3c36-459d-b3cc-1be5871d6fe7.png,1047,382,1141,468,94,86,red blood cell,8084,0.9148936170212766,1.0930232558139534
29367,/images/30167dc1-f739-4036-b5c4-5fad435c2c67.png,1059,1399,1169,1525,110,126,red blood cell,13860,1.1454545454545455,0.873015873015873
17262,/images/471f75c6-bd5d-4c20-bcc1-258e836f4d69.png,1107,435,1199,547,92,112,red blood cell,10304,1.2173913043478262,0.8214285714285714
73007,/images/2bd26501-2fbc-4c1a-bef0-4ad57e02b4d0.png,513,1478,616,1591,103,113,red blood cell,11639,1.0970873786407767,0.911504424778761
49376,/images/f2574be3-81c6-4fc3-8a40-0230d1264f52.png,240,830,352,938,112,108,red blood cell,12096,0.9642857142857143,1.037037037037037
12681,/images/5a043d69-f435-46d4-8691-395c1602a76a.png,439,1352,568,1484,129,132,red blood cell,17028,1.0232558139534884,0.9772727272727273
18610,/images/c22f7031-9cf8-48ce-b03b-1b12d0db4951.png,747,150,836,238,89,88,red blood cell,7832,0.9887640449438202,1.0113636363636365
39426,/images/55f8c052-8e49-4423-a4c4-365fc6afb6e1.png,268,920,387,1045,119,125,red blood cell,14875,1.050420168067227,0.952
42140,/images/c63f190a-e860-44fc-a2db-7980e1c80519.png,424,1,549,101,125,100,red blood cell,12500,0.8,1.25
46542,/images/edd09b2e-2673-4405-8ac0-e476e003e96a.png,491,1120,602,1246,111,126,red blood cell,13986,1.135135135135135,0.8809523809523809
71682,/images/5c99cd97-39f6-4809-9528-9d380cc16b16.png,436,966,545,1076,109,110,red blood cell,11990,1.0091743119266054,0.990909090909091
53409,/images/766d5547-8dd2-4c8d-b78e-3007f83932e8.png,100,1472,184,1569,84,97,red blood cell,8148,1.1547619047619047,0.865979381443299
15500,/images/79f63258-24ce-4e69-a5cb-8529635a89a9.png,105,35,208,146,103,111,red blood cell,11433,1.0776699029126213,0.9279279279279279
23601,/images/79d7a014-21ff-40f1-9ac4-a69839390654.png,240,475,320,560,80,85,red blood cell,6800,1.0625,0.9411764705882353
14495,/images/458cb2e9-5a7f-437c-ac5d-a56f98a3efdf.png,1012,386,1114,488,102,102,red blood cell,10404,1.0,1.0
64666,/images/6dfafdf1-f588-4e80-8cf8-0126e1bf7af9.png,900,870,1013,989,113,119,red blood cell,13447,1.0530973451327434,0.9495798319327731
43151,/images/c5db0fc0-b96c-496e-90b4-f9fb1b85b28e.png,612,1334,710,1435,98,101,red blood cell,9898,1.030612244897959,0.9702970297029703
61593,/images/4a717a39-80f8-4b75-a25e-c46d65d7dcd5.png,230,383,316,469,86,86,red blood cell,7396,1.0,1.0
58018,/images/a7c91b63-b97c-4f4b-8d34-7ad2b08d7a17.png,431,475,536,590,105,115,red blood cell,12075,1.0952380952380953,0.9130434782608695
21855,/images/9b3fd401-dab0-440f-8498-eb3cc9ffa970.png,171,222,282,336,111,114,red blood cell,12654,1.027027027027027,0.9736842105263158
26785,/images/2518f6e4-29cc-4ae4-a914-b215a4c56099.png,23,736,120,838,97,102,red blood cell,9894,1.0515463917525774,0.9509803921568627
646,/images/e61e6af2-7f8b-47b0-bbe7-acb2ed0299ab.png,56,351,177,468,121,117,red blood cell,14157,0.9669421487603306,1.0341880341880343
42376,/images/1a27ebe9-93a1-4898-af69-f276057d4012.png,545,1242,681,1365,136,123,red blood cell,16728,0.9044117647058824,1.1056910569105691
49798,/images/5e17f8e6-fd8d-426c-b444-1515d14f04b7.png,969,848,1058,935,89,87,red blood cell,7743,0.9775280898876404,1.0229885057471264
75319,/images/9ec1dcec-87c2-4aca-8e6b-0db3cd05509c.png,718,218,834,325,116,107,red blood cell,12412,0.9224137931034483,1.0841121495327102
69031,/images/b5246b58-6f40-4c9e-8024-f49b0ed6bdbd.png,520,1481,619,1571,99,90,red blood cell,8910,0.9090909090909091,1.1
6597,/images/640c4a52-3742-4f57-aee3-9e3dc0887622.png,204,37,309,124,105,87,red blood cell,9135,0.8285714285714286,1.206896551724138
73752,/images/22cbf509-c9bf-46ec-bfce-f079c6b76c8c.png,375,1102,486,1221,111,119,red blood cell,13209,1.072072072072072,0.9327731092436975
19104,/images/2196389c-45ec-46b5-bc6c-1f4a33df7f7c.png,521,1190,641,1312,120,122,red blood cell,14640,1.0166666666666666,0.9836065573770492
13777,/images/1b369bcf-ced4-4ae2-9196-2664bd2b1738.png,308,1093,424,1204,116,111,red blood cell,12876,0.9568965517241379,1.045045045045045
71272,/images/445d0db9-e830-4ceb-a845-b23d819e6097.png,391,1322,489,1420,98,98,red blood cell,9604,1.0,1.0
35599,/images/45f18ac0-f097-4b20-a99d-8837cf488822.png,928,465,1044,589,116,124,red blood cell,14384,1.0689655172413792,0.9354838709677419
8475,/images/e234ce8b-4ec4-4d93-9068-d7854d77ddf4.png,585,169,703,298,118,129,red blood cell,15222,1.0932203389830508,0.9147286821705426
16719,/images/d6352a03-ef81-421d-915e-226499555d20.png,95,1459,208,1591,113,132,red blood cell,14916,1.168141592920354,0.8560606060606061
71898,/images/61575482-91e1-4db9-83c7-687b7ddbbfc4.png,134,1092,262,1208,128,116,red blood cell,14848,0.90625,1.103448275862069
79766,/images/03b9d6ad-39ca-4097-a98b-77f02b3c00a7.png,878,854,980,968,102,114,red blood cell,11628,1.1176470588235294,0.8947368421052632
25524,/images/f6ab936d-924b-4038-aa47-71b07c26b4e2.png,785,366,893,482,108,116,red blood cell,12528,1.0740740740740742,0.9310344827586207
17717,/images/b5143aae-6e98-4dc6-b546-980cb472de67.png,1059,389,1170,482,111,93,red blood cell,10323,0.8378378378378378,1.1935483870967742
36688,/images/21f001d6-f568-4ea4-82da-fab54c77c419.png,738,441,823,540,85,99,red blood cell,8415,1.1647058823529413,0.8585858585858586
62127,/images/a63fa2c7-3ec8-4bb7-bde6-a39e09d2f806.png,1015,868,1110,966,95,98,red blood cell,9310,1.0315789473684212,0.9693877551020408
46400,/images/bbecf1a8-a728-4c83-87f8-4dfbac0a1e03.png,353,100,462,210,109,110,red blood cell,11990,1.0091743119266054,0.990909090909091
31086,/images/9c48fdf4-621d-4f40-bcd7-6a28cd530de7.png,931,467,1037,580,106,113,red blood cell,11978,1.0660377358490567,0.9380530973451328
43806,/images/c84edeb4-311c-4e82-88f9-ae0505b3ad13.png,528,281,634,392,106,111,red blood cell,11766,1.0471698113207548,0.954954954954955
38169,/images/33bdb7b5-ad5b-4a73-bbc2-3350f8c2ac0c.png,580,103,682,215,102,112,red blood cell,11424,1.0980392156862746,0.9107142857142857
18750,/images/f6f8a69a-3fd2-4684-ac77-3e83ea0fb36d.png,994,145,1101,240,107,95,red blood cell,10165,0.8878504672897196,1.1263157894736842
33699,/images/441d7843-b20b-4c10-84e3-e6d32621e880.png,1043,1181,1156,1284,113,103,red blood cell,11639,0.911504424778761,1.0970873786407767
48403,/images/0fa5b35d-6c44-4207-b6f8-d5b355086b5f.png,343,969,455,1080,112,111,red blood cell,12432,0.9910714285714286,1.009009009009009
66450,/images/5f66d20c-fbfe-44ec-a01b-8a09da24807e.png,882,1410,985,1518,103,108,red blood cell,11124,1.0485436893203883,0.9537037037037037
64591,/images/6dfafdf1-f588-4e80-8cf8-0126e1bf7af9.png,460,706,585,806,125,100,red blood cell,12500,0.8,1.25
16139,/images/66557580-fd38-4d4b-80d8-88611ecc78c6.png,632,823,756,932,124,109,red blood cell,13516,0.8790322580645161,1.1376146788990826
46241,/images/815bf40c-371a-4d34-aa41-c549c8221881.png,671,833,797,950,126,117,red blood cell,14742,0.9285714285714286,1.0769230769230769
71345,/images/bcb447c9-5d37-414f-a513-d7076b04a532.png,1036,108,1146,221,110,113,red blood cell,12430,1.0272727272727273,0.9734513274336283
72266,/images/ee57e743-a876-4f69-9fe5-bf5d01b44689.png,138,927,227,1026,89,99,red blood cell,8811,1.1123595505617978,0.898989898989899
71212,/images/86495bbf-687b-429c-b9d3-6c2681ade7e2.png,879,906,976,1005,97,99,red blood cell,9603,1.0206185567010309,0.9797979797979798
60357,/images/1c87b997-a8e6-48ca-bf40-19b9a7fd6a96.png,571,1142,650,1234,79,92,red blood cell,7268,1.1645569620253164,0.8586956521739131
67453,/images/8e72e20e-e714-4db6-a1da-c05a409257d4.png,1003,883,1089,965,86,82,red blood cell,7052,0.9534883720930233,1.048780487804878
77193,/images/fe691faa-3bc7-475e-b558-aa8fe7b795bc.png,156,738,247,818,91,80,red blood cell,7280,0.8791208791208791,1.1375
3477,/images/ad36bd67-594b-4f63-93e3-886af0bc618e.png,608,209,726,329,118,120,red blood cell,14160,1.0169491525423728,0.9833333333333333
28328,/images/34e024a5-5698-42d4-972f-fee234b4bd64.png,372,589,479,690,107,101,red blood cell,10807,0.9439252336448598,1.0594059405940595
74561,/images/bbedfcbe-9528-4ba9-9d86-4ebba7589ac5.png,1005,844,1110,957,105,113,red blood cell,11865,1.0761904761904761,0.9292035398230089
73556,/images/7624ac36-1cf9-42fb-844d-376078309553.png,912,1382,1007,1482,95,100,red blood cell,9500,1.0526315789473684,0.95
57964,/images/7942691b-6376-4c75-ae8a-ddf65454dcb2.png,280,28,379,124,99,96,red blood cell,9504,0.9696969696969697,1.03125
18128,/images/947348fe-4c70-468e-8009-3c14daeca69b.png,1003,329,1107,420,104,91,red blood cell,9464,0.875,1.1428571428571428
69588,/images/4a49841f-216c-4815-8140-b8762c4f6603.png,983,335,1092,438,109,103,red blood cell,11227,0.944954128440367,1.058252427184466
5053,/images/b7d0ae11-a393-4aec-8f68-6ba07147f78a.png,313,223,437,339,124,116,red blood cell,14384,0.9354838709677419,1.0689655172413792
29436,/images/b4e5e08d-6427-46f3-aca8-a4df165a151d.png,27,21,131,120,104,99,red blood cell,10296,0.9519230769230769,1.0505050505050506
37687,/images/003a89b0-a095-417a-8dd6-f408339bbc68.png,860,415,973,533,113,118,red blood cell,13334,1.0442477876106195,0.9576271186440678
6056,/images/72732579-a812-4496-b2dd-ea1556924337.png,7,941,120,1054,113,113,red blood cell,12769,1.0,1.0
31512,/images/83ec1cb9-1714-4bf1-81f6-115fde84564d.png,391,255,506,377,115,122,red blood cell,14030,1.0608695652173914,0.9426229508196722
7905,/images/98c25ffe-c329-420a-bc22-b082f565eac9.png,272,349,394,495,122,146,red blood cell,17812,1.1967213114754098,0.8356164383561644
12286,/images/3b55c42f-ad59-422f-ba99-4f4f4ca9cb2e.png,635,1237,738,1333,103,96,red blood cell,9888,0.9320388349514563,1.0729166666666667
55694,/images/c32b8bb8-c89d-4ae9-9c77-5b9356ca35a1.png,792,953,898,1075,106,122,red blood cell,12932,1.150943396226415,0.8688524590163934
15739,/images/64113b22-03b1-4ab8-89ab-b2f32154fbbd.png,534,715,652,843,118,128,red blood cell,15104,1.0847457627118644,0.921875
10312,/images/f91670db-be74-474c-bd72-68120aed4756.png,1057,1443,1167,1546,110,103,red blood cell,11330,0.9363636363636364,1.0679611650485437
40095,/images/6fd30823-3b77-40c9-ba5d-e1eda9660674.png,65,1410,196,1527,131,117,red blood cell,15327,0.8931297709923665,1.1196581196581197
44411,/images/edd3862f-04e1-49cf-97dd-ca566d17e71a.png,277,60,380,173,103,113,red blood cell,11639,1.0970873786407767,0.911504424778761
29155,/images/cfab01d3-0616-4efb-9290-11f0fd8bf5a3.png,645,1493,773,1597,128,104,red blood cell,13312,0.8125,1.2307692307692308
54272,/images/3b5a8060-dec6-4a83-b7f2-b604e4e69dfc.png,99,1060,203,1159,104,99,red blood cell,10296,0.9519230769230769,1.0505050505050506
24889,/images/ed0bee2f-05e0-4392-8357-19750cec577c.png,254,548,344,643,90,95,red blood cell,8550,1.0555555555555556,0.9473684210526315
40010,/images/8271d0d8-9985-43eb-94b3-c702adca139f.png,792,950,900,1044,108,94,red blood cell,10152,0.8703703703703703,1.148936170212766
57688,/images/5c037ffc-f515-48b3-b231-c110fbd2b8ca.png,1010,1269,1120,1364,110,95,red blood cell,10450,0.8636363636363636,1.1578947368421053
8143,/images/694222bb-cddf-469a-9526-f873c6fba58e.png,297,574,396,690,99,116,red blood cell,11484,1.1717171717171717,0.853448275862069
31350,/images/04fb49a2-07b8-4cdf-b6f7-df5c3688e5f8.png,1008,120,1127,241,119,121,red blood cell,14399,1.0168067226890756,0.9834710743801653
24159,/images/1d4cdf2e-79a0-41e9-aabe-e437a190dfc4.png,1029,502,1158,616,129,114,red blood cell,14706,0.8837209302325582,1.131578947368421
46168,/images/d8632217-ec33-4d0a-98e6-427824c58869.png,837,1080,937,1186,100,106,red blood cell,10600,1.06,0.9433962264150944
10861,/images/b78b88f0-154a-4b54-8aaf-85d37a42a0f9.png,61,942,185,1074,124,132,red blood cell,16368,1.064516129032258,0.9393939393939394
15128,/images/3a8f468f-f9de-46a8-a7c8-f2be239fa207.png,727,268,824,363,97,95,red blood cell,9215,0.979381443298969,1.0210526315789474
4378,/images/84041bf9-dace-4066-9fe0-52170d08f826.png,732,1311,849,1414,117,103,red blood cell,12051,0.8803418803418803,1.1359223300970873
66436,/images/5f66d20c-fbfe-44ec-a01b-8a09da24807e.png,355,1489,453,1587,98,98,red blood cell,9604,1.0,1.0
56401,/images/c10b125d-10c2-474a-9c6a-5249935c638e.png,823,1127,939,1257,116,130,red blood cell,15080,1.1206896551724137,0.8923076923076924
27797,/images/e3c1442a-717f-41dd-bf97-81e1233ac9fa.png,551,11,661,118,110,107,red blood cell,11770,0.9727272727272728,1.02803738317757
19198,/images/064b84fe-bd21-4c27-b682-0a832272eac4.png,552,886,694,1002,142,116,red blood cell,16472,0.8169014084507042,1.2241379310344827
49292,/images/99b13257-b9d9-422f-8262-802da0bdc510.png,759,4,870,94,111,90,red blood cell,9990,0.8108108108108109,1.2333333333333334
20589,/images/0f2a6cda-afec-437b-8803-8d3176b072c1.png,417,206,529,325,112,119,red blood cell,13328,1.0625,0.9411764705882353
14256,/images/6382976c-ee87-4916-b798-4ef1373b2df0.png,879,1215,978,1321,99,106,red blood cell,10494,1.0707070707070707,0.9339622641509434
19533,/images/2c1eaf87-3fd3-4803-92b8-23bab40bf28c.png,856,384,993,509,137,125,red blood cell,17125,0.9124087591240876,1.096
69239,/images/f274b784-b995-4a7e-a2c2-6cc31c24c4b4.png,932,50,1038,155,106,105,red blood cell,11130,0.9905660377358491,1.0095238095238095
55972,/images/4c460388-e0c1-4970-8527-c9e5b42bea49.png,718,769,829,888,111,119,red blood cell,13209,1.072072072072072,0.9327731092436975
3144,/images/729a38d6-66db-48e5-a00d-7d90d224290f.png,143,577,271,702,128,125,red blood cell,16000,0.9765625,1.024
15923,/images/c7c1b873-0548-4a73-9618-f60912e164df.png,180,846,270,952,90,106,red blood cell,9540,1.1777777777777778,0.8490566037735849
73028,/images/2bd26501-2fbc-4c1a-bef0-4ad57e02b4d0.png,769,324,869,430,100,106,red blood cell,10600,1.06,0.9433962264150944
60449,/images/93b47b14-7f78-4b31-8897-d63a81fdab01.png,330,1328,446,1434,116,106,red blood cell,12296,0.9137931034482759,1.0943396226415094
74247,/images/4e43fc22-dc08-4cde-b3ce-ce8a4f377c47.png,897,1469,993,1546,96,77,red blood cell,7392,0.8020833333333334,1.2467532467532467
18450,/images/9b410534-3b70-4a88-9f93-205cf4e55a05.png,653,860,756,964,103,104,red blood cell,10712,1.0097087378640777,0.9903846153846154
75729,/images/d12c5f45-6b20-46d6-a66f-c5a4683c25b3.png,618,931,725,1032,107,101,red blood cell,10807,0.9439252336448598,1.0594059405940595
45868,/images/939ad732-d7c5-4339-b087-4335b49d6a3c.png,716,158,832,276,116,118,red blood cell,13688,1.0172413793103448,0.9830508474576272
46814,/images/63055d1b-5221-4c80-8b39-37ac069a1b5c.png,1002,711,1112,801,110,90,red blood cell,9900,0.8181818181818182,1.2222222222222223
68562,/images/32700bc7-7a86-49d3-aded-ccaaed4ddc5c.png,352,1112,474,1218,122,106,red blood cell,12932,0.8688524590163934,1.150943396226415
21053,/images/c680004e-6ee2-43d7-877c-edc9b5ebeecc.png,491,979,589,1078,98,99,red blood cell,9702,1.010204081632653,0.98989898989899
73362,/images/c890ee00-daa5-4b20-9cd5-930748ecc4e0.png,90,1257,194,1348,104,91,red blood cell,9464,0.875,1.1428571428571428
77273,/images/07a80340-f65e-4f58-9317-94bb6ebd5a28.png,893,589,995,689,102,100,red blood cell,10200,0.9803921568627451,1.02
4711,/images/b91b1641-ee06-44d8-94cc-24cdb583cc37.png,455,530,585,649,130,119,red blood cell,15470,0.9153846153846154,1.0924369747899159
63709,/images/06401963-8b02-46c5-ab2a-3d70bd01623f.png,913,764,1023,865,110,101,red blood cell,11110,0.9181818181818182,1.0891089108910892
38038,/images/e3e9c2de-0a24-4c7e-8a69-3d3093d5bdab.png,878,1410,976,1502,98,92,red blood cell,9016,0.9387755102040817,1.065217391304348
39984,/images/8271d0d8-9985-43eb-94b3-c702adca139f.png,1049,1163,1170,1314,121,151,red blood cell,18271,1.2479338842975207,0.8013245033112583
14716,/images/1fdf99d1-a494-4174-bcd7-efbe457ab899.png,116,1320,227,1441,111,121,red blood cell,13431,1.09009009009009,0.9173553719008265
8131,/images/694222bb-cddf-469a-9526-f873c6fba58e.png,329,816,409,908,80,92,red blood cell,7360,1.15,0.8695652173913043
77759,/images/4849866a-73a2-4fcf-a407-2d0a25a09a89.png,1095,269,1190,378,95,109,red blood cell,10355,1.1473684210526316,0.8715596330275229
79678,/images/a4409217-be11-4478-90a5-b406057d154d.png,1100,486,1199,596,99,110,red blood cell,10890,1.1111111111111112,0.9
19148,/images/bb795ddf-ce72-42d5-9006-124db4d5cf1c.png,309,1448,411,1551,102,103,red blood cell,10506,1.0098039215686274,0.9902912621359223
65908,/images/d7581cb0-7a12-471d-a3d8-68dcea362213.png,224,353,335,455,111,102,red blood cell,11322,0.918918918918919,1.088235294117647
49197,/images/a9daf82a-a46d-4296-bd72-2c374ed0a193.png,929,821,1033,932,104,111,red blood cell,11544,1.0673076923076923,0.9369369369369369
78353,/images/24115f58-a7d6-4022-a95a-86b515a78d3e.png,853,251,951,363,98,112,red blood cell,10976,1.1428571428571428,0.875
59961,/images/f0fe292d-85ae-4c3a-a676-037dde2594e6.png,277,857,408,990,131,133,red blood cell,17423,1.015267175572519,0.9849624060150376
58359,/images/50f2f514-6c8e-4c79-b3b3-0be56dd0b78b.png,619,1199,744,1309,125,110,red blood cell,13750,0.88,1.1363636363636365
4247,/images/ac3358f1-ef9a-4ccc-b66c-da5e47e352e0.png,814,279,926,382,112,103,red blood cell,11536,0.9196428571428571,1.087378640776699
27759,/images/e3c1442a-717f-41dd-bf97-81e1233ac9fa.png,687,419,813,522,126,103,red blood cell,12978,0.8174603174603174,1.2233009708737863
32913,/images/e40000b4-1b26-42ce-909d-4715e04f0a6e.png,708,674,825,796,117,122,red blood cell,14274,1.0427350427350428,0.9590163934426229
29942,/images/f2a8a483-b254-43aa-817f-7d525adb8911.png,376,541,471,637,95,96,red blood cell,9120,1.0105263157894737,0.9895833333333334
44108,/images/8b494b40-cab5-49d3-893d-c805000fbe88.png,700,649,789,752,89,103,red blood cell,9167,1.1573033707865168,0.8640776699029126
32678,/images/0154dd8e-72f8-4d78-a4dd-93e139577bd1.png,476,454,594,571,118,117,red blood cell,13806,0.9915254237288136,1.0085470085470085
75292,/images/9ec1dcec-87c2-4aca-8e6b-0db3cd05509c.png,740,881,833,976,93,95,red blood cell,8835,1.021505376344086,0.9789473684210527
36134,/images/749df49e-5212-49ea-9e88-7d66f258f1df.png,15,1257,126,1376,111,119,red blood cell,13209,1.072072072072072,0.9327731092436975
35571,/images/a1ff36df-71df-4e6e-a65f-ced9a2b381c3.png,395,301,499,416,104,115,red blood cell,11960,1.1057692307692308,0.9043478260869565
20377,/images/11e517bf-943b-4928-929a-e9f72c097880.png,622,382,734,494,112,112,red blood cell,12544,1.0,1.0
40710,/images/252071ac-e9f2-41d2-abbb-87ef01b8a997.png,318,1083,416,1179,98,96,red blood cell,9408,0.9795918367346939,1.0208333333333333
42170,/images/04c07425-57c7-415c-a0bc-36857bbd4049.png,527,1477,652,1588,125,111,red blood cell,13875,0.888,1.1261261261261262
1947,/images/b95ceeeb-8870-4492-9037-2091ff268c5a.png,1048,502,1153,616,105,114,red blood cell,11970,1.0857142857142856,0.9210526315789473
55986,/images/4c460388-e0c1-4970-8527-c9e5b42bea49.png,282,931,403,1046,121,115,red blood cell,13915,0.9504132231404959,1.0521739130434782
22263,/images/787abd97-dd37-4212-8b43-61696eb3abc0.png,61,148,168,258,107,110,red blood cell,11770,1.02803738317757,0.9727272727272728
74162,/images/4e43fc22-dc08-4cde-b3ce-ce8a4f377c47.png,42,635,160,754,118,119,red blood cell,14042,1.0084745762711864,0.9915966386554622
23662,/images/79d7a014-21ff-40f1-9ac4-a69839390654.png,394,1315,500,1434,106,119,red blood cell,12614,1.1226415094339623,0.8907563025210085
51208,/images/ad8731b7-0dae-4983-9dc6-dec31767d761.png,956,660,1064,776,108,116,red blood cell,12528,1.0740740740740742,0.9310344827586207
31277,/images/db7c5ec1-fefe-4e9d-83c1-da8fb982f1e2.png,723,1328,827,1421,104,93,red blood cell,9672,0.8942307692307693,1.118279569892473
40533,/images/e3ade58d-086c-47fa-9120-76beacb45395.png,72,307,187,417,115,110,red blood cell,12650,0.9565217391304348,1.0454545454545454
34755,/images/6294153c-6db3-4f2b-a8ff-9c087225e737.png,376,43,513,159,137,116,red blood cell,15892,0.8467153284671532,1.1810344827586208
39647,/images/04d21589-b777-43c2-86b5-038cbf8c3a4e.png,887,745,1013,850,126,105,red blood cell,13230,0.8333333333333334,1.2
52596,/images/0546d843-d778-4aca-b8b5-bfe23d7c87da.png,634,1145,749,1244,115,99,red blood cell,11385,0.8608695652173913,1.1616161616161615
26202,/images/7ba9db7e-9d3f-413c-b672-2bba5fb5b415.png,571,326,682,447,111,121,red blood cell,13431,1.09009009009009,0.9173553719008265
45347,/images/e4eea7ea-8989-46a9-9c98-25a178146b28.png,952,801,1063,911,111,110,red blood cell,12210,0.990990990990991,1.009090909090909
35313,/images/516bf1d5-5d00-4985-926c-3993e9bc3ff5.png,905,1170,1049,1297,144,127,red blood cell,18288,0.8819444444444444,1.1338582677165354
66490,/images/5f66d20c-fbfe-44ec-a01b-8a09da24807e.png,1114,1331,1200,1426,86,95,red blood cell,8170,1.1046511627906976,0.9052631578947369
11651,/images/0ed416f9-7c20-4829-9016-559e4009568e.png,1047,407,1160,522,113,115,red blood cell,12995,1.0176991150442478,0.9826086956521739
45226,/images/b7a0d235-2217-43b4-aeff-cde4ccaf6789.png,517,1337,631,1458,114,121,red blood cell,13794,1.0614035087719298,0.9421487603305785
10966,/images/c442e2d6-aaf9-417a-9905-4737a1115f33.png,587,1240,699,1347,112,107,red blood cell,11984,0.9553571428571429,1.0467289719626167
66885,/images/9acf303a-fcba-4e52-be3e-8d061aa5e72a.png,1021,268,1139,374,118,106,red blood cell,12508,0.8983050847457628,1.1132075471698113
60801,/images/645cd195-af50-409f-8da9-6e7c7f18ea09.png,201,1510,297,1598,96,88,red blood cell,8448,0.9166666666666666,1.0909090909090908
40694,/images/252071ac-e9f2-41d2-abbb-87ef01b8a997.png,806,1292,894,1397,88,105,red blood cell,9240,1.1931818181818181,0.8380952380952381
24689,/images/78a5d1c3-44dd-44bc-ad5b-5e25bdcc4fae.png,60,213,189,335,129,122,red blood cell,15738,0.9457364341085271,1.0573770491803278
10066,/images/26799d2b-a289-4eff-9218-0aad77e05e41.png,1066,1226,1187,1341,121,115,red blood cell,13915,0.9504132231404959,1.0521739130434782
60671,/images/45651e76-4bd0-45e5-895b-edec65f51987.png,258,474,368,581,110,107,red blood cell,11770,0.9727272727272728,1.02803738317757
31443,/images/6695a204-e39c-4418-b904-3f080fdbe7e8.png,888,705,999,819,111,114,red blood cell,12654,1.027027027027027,0.9736842105263158
12849,/images/b10ea12f-cd36-4f2c-994a-67d1665269ab.png,1010,1345,1128,1455,118,110,red blood cell,12980,0.9322033898305084,1.0727272727272728
9664,/images/d997337e-e4a8-4ef0-b8ba-975e6c43b62c.png,518,1302,651,1438,133,136,red blood cell,18088,1.0225563909774436,0.9779411764705882
55913,/images/afd39466-aafa-4d81-9520-483727418723.png,501,1066,600,1158,99,92,red blood cell,9108,0.9292929292929293,1.076086956521739
59121,/images/4736f545-1f1f-4d77-9241-d69cbf4dae35.png,911,318,1042,442,131,124,red blood cell,16244,0.9465648854961832,1.0564516129032258
11295,/images/6303f964-98ef-47c6-bb2d-283aa393f918.png,396,740,500,827,104,87,red blood cell,9048,0.8365384615384616,1.1954022988505748
2190,/images/e94a811d-3145-4313-ba42-2d5ed283179f.png,812,1199,923,1311,111,112,red blood cell,12432,1.009009009009009,0.9910714285714286
47770,/images/6b5ed184-cb15-4d54-93bb-9a3ca00184a1.png,771,58,908,190,137,132,red blood cell,18084,0.9635036496350365,1.0378787878787878
33599,/images/00c8364b-8c85-4502-bcfe-64736fe76815.png,806,1262,902,1358,96,96,red blood cell,9216,1.0,1.0
23755,/images/6b2ff7ca-c5b3-415c-9481-7b14efc6d7ef.png,1017,1483,1146,1599,129,116,red blood cell,14964,0.8992248062015504,1.1120689655172413
45336,/images/e4eea7ea-8989-46a9-9c98-25a178146b28.png,554,1404,649,1505,95,101,red blood cell,9595,1.063157894736842,0.9405940594059405
24895,/images/ed0bee2f-05e0-4392-8357-19750cec577c.png,509,356,594,459,85,103,red blood cell,8755,1.2117647058823529,0.8252427184466019
61402,/images/e16c0dab-780d-4035-872e-1bb91e49f9d2.png,780,1502,898,1599,118,97,red blood cell,11446,0.8220338983050848,1.2164948453608246
24902,/images/ed0bee2f-05e0-4392-8357-19750cec577c.png,550,1166,674,1272,124,106,red blood cell,13144,0.8548387096774194,1.169811320754717
20173,/images/bb337c84-f727-42a5-9c3d-934323a16c6a.png,7,712,129,854,122,142,red blood cell,17324,1.1639344262295082,0.8591549295774648
42361,/images/5c5b7965-1a44-44b8-aa43-660823e61821.png,836,1339,935,1446,99,107,red blood cell,10593,1.0808080808080809,0.9252336448598131
33878,/images/1a332b2c-9d49-4ff2-810c-5633d2314527.png,976,1090,1081,1180,105,90,red blood cell,9450,0.8571428571428571,1.1666666666666667
66349,/images/fcdf6632-c03f-49a8-9fb3-42e87c99b9d0.png,882,1240,993,1344,111,104,red blood cell,11544,0.9369369369369369,1.0673076923076923
21968,/images/393df10a-5d64-476b-88f5-14ac56d6ed60.png,893,1167,999,1277,106,110,red blood cell,11660,1.0377358490566038,0.9636363636363636
8888,/images/29539cb0-1c52-46b2-9302-552f8349dc71.png,907,764,1011,875,104,111,red blood cell,11544,1.0673076923076923,0.9369369369369369
43790,/images/ef83ed4c-2724-4d5f-8abe-1a18d25cea35.png,1090,338,1192,452,102,114,red blood cell,11628,1.1176470588235294,0.8947368421052632
40985,/images/bbe65c18-8a56-4dfe-875c-94e124a84125.png,853,316,983,442,130,126,red blood cell,16380,0.9692307692307692,1.0317460317460319
7988,/images/933e7e07-fc3d-42eb-be0c-6b1623ee60fa.png,449,652,565,783,116,131,red blood cell,15196,1.1293103448275863,0.8854961832061069
24020,/images/5107dcb7-164f-4e10-bbff-822b39b76efc.png,883,1037,995,1155,112,118,red blood cell,13216,1.0535714285714286,0.9491525423728814
43527,/images/2d857091-efcd-41c0-ba3f-226de90445c4.png,107,920,213,1034,106,114,red blood cell,12084,1.0754716981132075,0.9298245614035088
8741,/images/29dc8176-dfe1-40e0-8247-2dc3c530057e.png,932,902,1037,1016,105,114,red blood cell,11970,1.0857142857142856,0.9210526315789473
58086,/images/a7c91b63-b97c-4f4b-8d34-7ad2b08d7a17.png,263,806,375,907,112,101,red blood cell,11312,0.9017857142857143,1.108910891089109
10130,/images/09ecf7be-28e2-4531-b9e2-07e01c44097d.png,1022,809,1129,916,107,107,red blood cell,11449,1.0,1.0
57104,/images/7d041c38-11f2-4186-8a24-29d7d0f5c3cf.png,803,1288,907,1394,104,106,red blood cell,11024,1.0192307692307692,0.9811320754716981
51025,/images/cc275c45-7511-4070-84af-10b8ffebda53.png,916,959,1034,1104,118,145,red blood cell,17110,1.228813559322034,0.8137931034482758
10479,/images/46a2d369-4bea-4405-ac78-91bbe130b9a7.png,80,240,171,331,91,91,red blood cell,8281,1.0,1.0
63057,/images/6afd8203-d61a-4e9b-a4cf-dcb53a16b57c.png,857,776,967,884,110,108,red blood cell,11880,0.9818181818181818,1.0185185185185186
4859,/images/c6ab535c-30e5-4b6b-8273-1ec8d78cdd13.png,765,578,887,713,122,135,red blood cell,16470,1.1065573770491803,0.9037037037037037
44310,/images/4257342d-6d77-4671-a84b-1f0c36ccb367.png,236,1378,340,1497,104,119,red blood cell,12376,1.1442307692307692,0.8739495798319328
52481,/images/a2a20600-f851-4db7-90f9-6f7be027c8b5.png,1122,920,1199,1004,77,84,red blood cell,6468,1.0909090909090908,0.9166666666666666
24725,/images/78a5d1c3-44dd-44bc-ad5b-5e25bdcc4fae.png,918,188,1033,312,115,124,red blood cell,14260,1.0782608695652174,0.9274193548387096
74109,/images/9fe8bdc8-847d-434e-93e5-ae14ff3b45e1.png,738,1353,847,1453,109,100,red blood cell,10900,0.9174311926605505,1.09
60326,/images/1c87b997-a8e6-48ca-bf40-19b9a7fd6a96.png,759,721,866,817,107,96,red blood cell,10272,0.897196261682243,1.1145833333333333
28008,/images/c4d34e35-4db2-41de-ba77-1a94aa9ef788.png,131,435,260,563,129,128,red blood cell,16512,0.9922480620155039,1.0078125
10333,/images/affa429c-0315-4c18-a002-13bb3ecab259.png,571,729,680,842,109,113,red blood cell,12317,1.036697247706422,0.9646017699115044
35802,/images/bb2042c5-35e1-43cc-8171-7de81b764361.png,228,946,335,1040,107,94,red blood cell,10058,0.8785046728971962,1.1382978723404256
50831,/images/db0a1123-0b35-48d7-8337-3b1ebd6af0cc.png,480,374,605,495,125,121,red blood cell,15125,0.968,1.0330578512396693
47793,/images/5a105b89-c592-4d78-b208-7db6c6572752.png,917,1429,1028,1538,111,109,red blood cell,12099,0.9819819819819819,1.018348623853211
22036,/images/c5acd0ad-b0f2-478d-b0ad-5aa733aa7b32.png,224,263,355,384,131,121,red blood cell,15851,0.9236641221374046,1.0826446280991735
38456,/images/674b0fd3-f247-4b7f-97f7-3e6c57c9ba9e.png,329,601,434,690,105,89,red blood cell,9345,0.8476190476190476,1.1797752808988764
26776,/images/2518f6e4-29cc-4ae4-a914-b215a4c56099.png,692,409,781,503,89,94,red blood cell,8366,1.0561797752808988,0.9468085106382979
11100,/images/98175327-da9e-4e0c-8912-ee68490a4672.png,178,321,294,449,116,128,red blood cell,14848,1.103448275862069,0.90625
22905,/images/be779f52-0bfa-4c01-a16f-b7f0bc92ed7c.png,8,204,114,315,106,111,red blood cell,11766,1.0471698113207548,0.954954954954955
31033,/images/b59dc3a0-3d54-4e3b-a485-33b3e43966de.png,610,705,719,809,109,104,red blood cell,11336,0.9541284403669725,1.0480769230769231
47377,/images/477e541c-0519-4542-9b13-8ee7922644d3.png,920,67,1034,174,114,107,red blood cell,12198,0.9385964912280702,1.0654205607476634
75846,/images/c4c7ed75-dbdf-4bb6-b6ba-718903cf7264.png,633,658,757,775,124,117,red blood cell,14508,0.9435483870967742,1.0598290598290598
18319,/images/9ca20b10-e2fd-4bd2-93ef-78298f763ed5.png,869,946,968,1054,99,108,red blood cell,10692,1.0909090909090908,0.9166666666666666
33040,/images/6231d81d-9e84-4a5a-8cb8-47c6a37a0176.png,330,646,441,738,111,92,red blood cell,10212,0.8288288288288288,1.2065217391304348
76526,/images/38c69905-8a4f-451a-8d0a-b855dc88dd16.png,100,842,202,942,102,100,red blood cell,10200,0.9803921568627451,1.02
33305,/images/5721e41b-90ef-4851-8587-8dc71227ef90.png,578,484,686,599,108,115,red blood cell,12420,1.0648148148148149,0.9391304347826087
58098,/images/a7c91b63-b97c-4f4b-8d34-7ad2b08d7a17.png,383,1133,471,1222,88,89,red blood cell,7832,1.0113636363636365,0.9887640449438202
70997,/images/deaa1931-5f97-45bf-8c00-be6ddeb37b9a.png,729,1231,832,1323,103,92,red blood cell,9476,0.8932038834951457,1.1195652173913044
35101,/images/a6ba808f-ec60-42a5-ad91-7b32412ab708.png,57,482,183,596,126,114,red blood cell,14364,0.9047619047619048,1.105263157894737
44143,/images/8b494b40-cab5-49d3-893d-c805000fbe88.png,28,628,124,722,96,94,red blood cell,9024,0.9791666666666666,1.0212765957446808
78704,/images/76a8a5f5-1328-4539-a131-baf877f40cf3.png,739,769,857,883,118,114,red blood cell,13452,0.9661016949152542,1.0350877192982457
19667,/images/627d6331-7bb9-4d1a-b20d-e6541af4d0f9.png,656,974,758,1082,102,108,red blood cell,11016,1.0588235294117647,0.9444444444444444
2251,/images/fe851c88-692d-4199-87e0-d19d9c4eb591.png,329,37,452,147,123,110,red blood cell,13530,0.8943089430894309,1.1181818181818182
59900,/images/1519257c-e3e5-4474-908f-8665b3cf1258.png,516,625,609,729,93,104,red blood cell,9672,1.118279569892473,0.8942307692307693
74117,/images/9fe8bdc8-847d-434e-93e5-ae14ff3b45e1.png,438,874,544,978,106,104,red blood cell,11024,0.9811320754716981,1.0192307692307692
31240,/images/1976cd04-d24f-457c-b423-7e4cdb05de9e.png,462,149,576,272,114,123,red blood cell,14022,1.0789473684210527,0.926829268292683
53921,/images/540a5fee-175b-4b92-bf62-1ea9b59c86c6.png,692,771,800,870,108,99,red blood cell,10692,0.9166666666666666,1.0909090909090908
71257,/images/445d0db9-e830-4ceb-a845-b23d819e6097.png,642,181,733,276,91,95,red blood cell,8645,1.043956043956044,0.9578947368421052
27358,/images/9f38055f-4fe6-47fd-a6dd-c0743db4eccf.png,613,1230,709,1324,96,94,red blood cell,9024,0.9791666666666666,1.0212765957446808
66997,/images/3b4440f7-a69b-4042-a9d0-d6958abcdf4e.png,511,1300,614,1404,103,104,red blood cell,10712,1.0097087378640777,0.9903846153846154
53312,/images/d8f7e159-b7e3-49e4-86e8-aed8c5fbcd97.png,693,1259,798,1346,105,87,red blood cell,9135,0.8285714285714286,1.206896551724138
62793,/images/631340cc-cedf-4bca-a3d8-a0731a5482b4.png,914,213,1030,330,116,117,red blood cell,13572,1.0086206896551724,0.9914529914529915
60260,/images/abf4cf2a-4532-4772-9f0f-9e123cc1713d.png,0,1209,127,1340,127,131,red blood cell,16637,1.031496062992126,0.9694656488549618
5809,/images/143f5959-5b6d-4f95-bcee-9e110450fc22.png,458,876,577,989,119,113,red blood cell,13447,0.9495798319327731,1.0530973451327434
32230,/images/f4722a74-35e7-42bd-8ef6-dfff04b9cd22.png,686,1468,810,1599,124,131,red blood cell,16244,1.0564516129032258,0.9465648854961832
30672,/images/f939782b-f5a2-40a3-9c22-6c6d7e18edc3.png,945,415,1056,524,111,109,red blood cell,12099,0.9819819819819819,1.018348623853211
74416,/images/06a3effb-996c-4767-afd2-6aa3b697cb4e.png,771,1110,870,1206,99,96,red blood cell,9504,0.9696969696969697,1.03125
59335,/images/565513be-2c20-4ee3-94f3-093869515d3d.png,734,1089,831,1192,97,103,red blood cell,9991,1.0618556701030928,0.941747572815534
16209,/images/acdc6e12-73d9-44ba-be8c-2a56aaffef4f.png,228,389,342,517,114,128,red blood cell,14592,1.1228070175438596,0.890625
79695,/images/03b9d6ad-39ca-4097-a98b-77f02b3c00a7.png,151,1376,246,1476,95,100,red blood cell,9500,1.0526315789473684,0.95
4926,/images/755e5bf8-e8e1-492b-a32f-f7d87cccaa40.png,907,758,1035,896,128,138,red blood cell,17664,1.078125,0.927536231884058
16238,/images/acdc6e12-73d9-44ba-be8c-2a56aaffef4f.png,91,1178,199,1284,108,106,red blood cell,11448,0.9814814814814815,1.0188679245283019
71060,/images/2dbf6f69-e020-4948-9e49-4b33edb7cebd.png,377,941,488,1057,111,116,red blood cell,12876,1.045045045045045,0.9568965517241379
37207,/images/71881a39-a30c-40c7-8c4a-9f64c93e79d9.png,44,839,150,943,106,104,red blood cell,11024,0.9811320754716981,1.0192307692307692
56393,/images/c10b125d-10c2-474a-9c6a-5249935c638e.png,520,1023,635,1138,115,115,red blood cell,13225,1.0,1.0
67119,/images/4272cbd7-5b0a-4bf7-b690-dee1c128f07b.png,1002,1193,1100,1301,98,108,red blood cell,10584,1.1020408163265305,0.9074074074074074
43782,/images/ef83ed4c-2724-4d5f-8abe-1a18d25cea35.png,684,653,799,792,115,139,red blood cell,15985,1.208695652173913,0.8273381294964028
38094,/images/907650b5-edae-471d-bc54-a825be3d3fac.png,250,971,360,1080,110,109,red blood cell,11990,0.990909090909091,1.0091743119266054
27574,/images/715761a2-745e-4743-9849-956a034ad3c4.png,503,40,602,145,99,105,red blood cell,10395,1.0606060606060606,0.9428571428571428
11380,/images/2f6224be-50d0-4e85-94ef-88315df561b6.png,672,265,785,379,113,114,red blood cell,12882,1.008849557522124,0.9912280701754386
46911,/images/9e0e1928-d19a-4100-b093-0b962ac09e05.png,839,300,944,406,105,106,red blood cell,11130,1.0095238095238095,0.9905660377358491
9057,/images/21c2a8aa-407c-4569-8212-96fcafa84138.png,174,1062,305,1188,131,126,red blood cell,16506,0.9618320610687023,1.0396825396825398
770,/images/27fab82c-5bf0-426f-aeb9-47da829b6629.png,921,191,1022,290,101,99,red blood cell,9999,0.9801980198019802,1.02020202020202
33814,/images/cb08956d-dd6a-4e13-817b-40a0a93068f1.png,669,1309,779,1416,110,107,red blood cell,11770,0.9727272727272728,1.02803738317757
17928,/images/eb77e4a9-acb0-4d83-8055-2c5fcaa54b45.png,725,27,816,120,91,93,red blood cell,8463,1.021978021978022,0.978494623655914
33864,/images/1a332b2c-9d49-4ff2-810c-5633d2314527.png,46,485,161,599,115,114,red blood cell,13110,0.991304347826087,1.0087719298245614
28480,/images/c3042130-a6e2-458f-9fde-bb012f68f5f2.png,1048,59,1186,179,138,120,red blood cell,16560,0.8695652173913043,1.15
37560,/images/205306da-0ed8-475a-ace6-f2f81d4be88a.png,292,661,381,752,89,91,red blood cell,8099,1.0224719101123596,0.978021978021978
43279,/images/36569710-a574-40be-ad42-897a6e74a128.png,977,504,1091,628,114,124,red blood cell,14136,1.087719298245614,0.9193548387096774
17703,/images/b5143aae-6e98-4dc6-b546-980cb472de67.png,773,923,881,1043,108,120,red blood cell,12960,1.1111111111111112,0.9
57729,/images/5c037ffc-f515-48b3-b231-c110fbd2b8ca.png,325,75,432,180,107,105,red blood cell,11235,0.9813084112149533,1.019047619047619
35755,/images/bb2042c5-35e1-43cc-8171-7de81b764361.png,384,1389,481,1499,97,110,red blood cell,10670,1.134020618556701,0.8818181818181818
35288,/images/516bf1d5-5d00-4985-926c-3993e9bc3ff5.png,167,106,285,228,118,122,red blood cell,14396,1.0338983050847457,0.9672131147540983
45085,/images/56fbae44-4677-47f8-9c3a-22dac043c115.png,284,614,400,714,116,100,red blood cell,11600,0.8620689655172413,1.16
35867,/images/2102e5d1-8bec-4ab6-ab35-2705485da1f8.png,359,1268,489,1395,130,127,red blood cell,16510,0.9769230769230769,1.0236220472440944
62857,/images/4b346035-b8c0-46ca-8fdb-a01b1421ee4a.png,374,716,481,824,107,108,red blood cell,11556,1.0093457943925233,0.9907407407407407
46223,/images/d8632217-ec33-4d0a-98e6-427824c58869.png,120,388,224,510,104,122,red blood cell,12688,1.1730769230769231,0.8524590163934426
26169,/images/04de27ff-0d36-4da3-a829-e93851d76981.png,1082,386,1195,499,113,113,red blood cell,12769,1.0,1.0
15894,/images/c7c1b873-0548-4a73-9618-f60912e164df.png,86,421,194,541,108,120,red blood cell,12960,1.1111111111111112,0.9
71124,/images/b666fcc2-d0b2-441e-bc5a-c660345eeb5d.png,437,437,559,566,122,129,red blood cell,15738,1.0573770491803278,0.9457364341085271
6236,/images/effd6334-516f-4d48-9f3c-5272a99780fb.png,579,1422,701,1539,122,117,red blood cell,14274,0.9590163934426229,1.0427350427350428
10260,/images/e3ea07d7-884a-412e-874a-40fd6b856736.png,12,900,120,1019,108,119,red blood cell,12852,1.1018518518518519,0.907563025210084
1032,/images/63d36d2c-43a9-49ac-9504-028b4968c860.png,1048,515,1149,628,101,113,red blood cell,11413,1.118811881188119,0.8938053097345132
19024,/images/e9e78ff8-831b-46e9-9785-3eee9acbfcd8.png,816,798,916,878,100,80,red blood cell,8000,0.8,1.25
74136,/images/9fe8bdc8-847d-434e-93e5-ae14ff3b45e1.png,837,1223,982,1341,145,118,red blood cell,17110,0.8137931034482758,1.228813559322034
62964,/images/f234a2de-f3c8-4521-a306-8cfdf52dd597.png,1015,128,1144,242,129,114,red blood cell,14706,0.8837209302325582,1.131578947368421
71306,/images/bcb447c9-5d37-414f-a513-d7076b04a532.png,310,658,416,757,106,99,red blood cell,10494,0.9339622641509434,1.0707070707070707
79907,/images/0b923ab7-ebff-4079-a4bb-af7da89f374e.png,252,423,373,520,121,97,red blood cell,11737,0.8016528925619835,1.2474226804123711
70379,/images/4876c9d0-b386-48fb-84e8-91bf87529161.png,526,315,633,415,107,100,red blood cell,10700,0.9345794392523364,1.07
2952,/images/00a02700-2ea2-4590-9e15-ffc9160fd3de.png,53,527,166,646,113,119,red blood cell,13447,1.0530973451327434,0.9495798319327731
23807,/images/eeb06e39-482b-443d-8cf6-b9b5c763df78.png,84,644,189,751,105,107,red blood cell,11235,1.019047619047619,0.9813084112149533
4572,/images/0f26699f-a776-4424-b092-27da9a1d12e2.png,149,519,242,617,93,98,red blood cell,9114,1.053763440860215,0.9489795918367347
75764,/images/f48bf825-13c4-42fc-8dd8-10cc4ae6b202.png,819,338,924,434,105,96,red blood cell,10080,0.9142857142857143,1.09375
58312,/images/319c9c52-f316-49f3-baad-4444ab19f85b.png,713,1165,821,1274,108,109,red blood cell,11772,1.0092592592592593,0.9908256880733946
24113,/images/505355c9-23bf-4f90-8ebc-6a7ef50964d0.png,352,791,451,876,99,85,red blood cell,8415,0.8585858585858586,1.1647058823529413
70444,/images/8cca114a-ed05-4b87-95b7-fae02487f08c.png,1027,1375,1133,1496,106,121,red blood cell,12826,1.1415094339622642,0.8760330578512396
11798,/images/082e1f81-4f49-44ad-b5bb-9dfc155b2ed8.png,4,240,101,340,97,100,red blood cell,9700,1.0309278350515463,0.97
21900,/images/d57b3894-c912-47e8-b00a-e1a2a7aba644.png,671,796,784,902,113,106,red blood cell,11978,0.9380530973451328,1.0660377358490567
33293,/images/5721e41b-90ef-4851-8587-8dc71227ef90.png,512,985,624,1083,112,98,red blood cell,10976,0.875,1.1428571428571428
19933,/images/0ca25c88-457f-4f03-bbc1-98fb6663f1d1.png,275,818,402,944,127,126,red blood cell,16002,0.9921259842519685,1.007936507936508
13974,/images/31af9c31-7868-44a6-8eb4-82ce118af425.png,322,1243,431,1360,109,117,red blood cell,12753,1.073394495412844,0.9316239316239316
57696,/images/5c037ffc-f515-48b3-b231-c110fbd2b8ca.png,468,1307,569,1401,101,94,red blood cell,9494,0.9306930693069307,1.074468085106383
14954,/images/5d1418d3-1559-4725-ad4a-9afb6eaecdfd.png,300,34,394,143,94,109,red blood cell,10246,1.1595744680851063,0.8623853211009175
41622,/images/0fcd1ebe-ee4a-40a0-b787-29cee18bfa1b.png,619,916,723,1005,104,89,red blood cell,9256,0.8557692307692307,1.1685393258426966
47329,/images/1dd3e6dd-343f-4cc9-b0ed-e4d27fb36f0a.png,488,227,613,348,125,121,red blood cell,15125,0.968,1.0330578512396693
58958,/images/a0eeeb10-d0cb-48d9-8c22-2c3a3c908d00.png,165,119,286,247,121,128,red blood cell,15488,1.0578512396694215,0.9453125
56794,/images/0dcbf2c9-f959-4703-a72b-f6a81e66c2ea.png,901,623,1004,715,103,92,red blood cell,9476,0.8932038834951457,1.1195652173913044
38039,/images/e3e9c2de-0a24-4c7e-8a69-3d3093d5bdab.png,238,828,347,935,109,107,red blood cell,11663,0.981651376146789,1.0186915887850467
39758,/images/5c68070c-3391-4db6-8c01-94175105dbea.png,213,154,332,276,119,122,red blood cell,14518,1.0252100840336134,0.9754098360655737
56437,/images/d75933ed-d26e-4d1f-bda3-96bc0d77fb36.png,507,613,610,717,103,104,red blood cell,10712,1.0097087378640777,0.9903846153846154
65976,/images/25c6cfb1-01d0-4864-87f9-02b7593683c7.png,116,161,206,270,90,109,red blood cell,9810,1.211111111111111,0.8256880733944955
72791,/images/caeb2d62-1166-43f0-8eac-5b8fc48f02eb.png,328,1277,409,1362,81,85,red blood cell,6885,1.0493827160493827,0.9529411764705882
33987,/images/701206c5-aaac-4b99-9cc0-4a6854359457.png,1033,983,1165,1097,132,114,red blood cell,15048,0.8636363636363636,1.1578947368421053
45784,/images/584d62ed-4329-45dd-94ce-e929d8b2bb74.png,476,878,597,980,121,102,red blood cell,12342,0.8429752066115702,1.1862745098039216
68472,/images/74261741-4d6e-4dba-8ad4-4fbdf919c30f.png,150,1216,265,1335,115,119,red blood cell,13685,1.0347826086956522,0.9663865546218487
38981,/images/5939f341-a886-4f63-ae87-2219d000a1d4.png,411,373,520,469,109,96,red blood cell,10464,0.8807339449541285,1.1354166666666667
34554,/images/3af90874-59f3-4f0c-a7e6-cc889e80c605.png,1066,1478,1195,1594,129,116,red blood cell,14964,0.8992248062015504,1.1120689655172413
71176,/images/4fac16e1-8e62-499b-a66b-c4c890372914.png,106,726,215,837,109,111,red blood cell,12099,1.018348623853211,0.9819819819819819
79846,/images/a054a8e2-55f2-4508-97df-207f76b89be2.png,354,996,482,1107,128,111,red blood cell,14208,0.8671875,1.1531531531531531
23690,/images/79d7a014-21ff-40f1-9ac4-a69839390654.png,233,851,323,942,90,91,red blood cell,8190,1.011111111111111,0.989010989010989
79342,/images/dcb21739-3c36-459d-b3cc-1be5871d6fe7.png,609,1407,711,1498,102,91,red blood cell,9282,0.8921568627450981,1.120879120879121
17218,/images/471f75c6-bd5d-4c20-bcc1-258e836f4d69.png,40,105,135,200,95,95,red blood cell,9025,1.0,1.0
70155,/images/c742ee2c-6814-46cd-af56-ae87bb9972f4.png,111,156,203,238,92,82,red blood cell,7544,0.8913043478260869,1.1219512195121952
75711,/images/d12c5f45-6b20-46d6-a66f-c5a4683c25b3.png,649,154,753,251,104,97,red blood cell,10088,0.9326923076923077,1.0721649484536082
14901,/images/3090a362-1f3d-49e9-a76e-ce76ff9c2276.png,84,750,211,880,127,130,red blood cell,16510,1.0236220472440944,0.9769230769230769
58754,/images/e4827c85-311a-4df1-89c2-99dad0c3558c.png,609,1334,713,1437,104,103,red blood cell,10712,0.9903846153846154,1.0097087378640777
36595,/images/21f001d6-f568-4ea4-82da-fab54c77c419.png,351,552,469,656,118,104,red blood cell,12272,0.8813559322033898,1.1346153846153846
69697,/images/f0713bee-2a71-4ced-b953-4041ea99496a.png,936,878,1051,997,115,119,red blood cell,13685,1.0347826086956522,0.9663865546218487
75280,/images/9ec1dcec-87c2-4aca-8e6b-0db3cd05509c.png,25,1077,123,1198,98,121,red blood cell,11858,1.2346938775510203,0.8099173553719008
49231,/images/a9daf82a-a46d-4296-bd72-2c374ed0a193.png,433,363,542,478,109,115,red blood cell,12535,1.055045871559633,0.9478260869565217
32974,/images/d1924af6-7512-4ccc-9c6b-adbbaa8db41f.png,670,84,800,199,130,115,red blood cell,14950,0.8846153846153846,1.1304347826086956
57155,/images/7c870293-2665-4a6b-a4fa-336959051dfc.png,523,737,635,845,112,108,red blood cell,12096,0.9642857142857143,1.037037037037037
12435,/images/cc94eabb-a3dc-4cfc-9fff-55c76b5b4a71.png,661,111,770,224,109,113,red blood cell,12317,1.036697247706422,0.9646017699115044
45707,/images/584d62ed-4329-45dd-94ce-e929d8b2bb74.png,339,182,482,308,143,126,red blood cell,18018,0.8811188811188811,1.1349206349206349
33694,/images/441d7843-b20b-4c10-84e3-e6d32621e880.png,681,592,785,690,104,98,red blood cell,10192,0.9423076923076923,1.0612244897959184
61547,/images/4a717a39-80f8-4b75-a25e-c46d65d7dcd5.png,930,1271,1024,1372,94,101,red blood cell,9494,1.074468085106383,0.9306930693069307
13585,/images/c0c3041f-78cd-46de-8e36-0a7dad0c04c4.png,584,689,698,797,114,108,red blood cell,12312,0.9473684210526315,1.0555555555555556
19497,/images/a85cd1ae-0c94-4387-8305-84ab8d96d137.png,1082,715,1188,827,106,112,red blood cell,11872,1.0566037735849056,0.9464285714285714
44820,/images/6795acae-e84d-4e97-b9a1-b4f4f0a72cfd.png,645,1021,749,1128,104,107,red blood cell,11128,1.0288461538461537,0.9719626168224299
19121,/images/2196389c-45ec-46b5-bc6c-1f4a33df7f7c.png,632,129,755,266,123,137,red blood cell,16851,1.113821138211382,0.8978102189781022
78409,/images/fe00fa09-d3c8-485b-9d0f-3cce556c9edd.png,90,1251,195,1363,105,112,red blood cell,11760,1.0666666666666667,0.9375
1989,/images/b95ceeeb-8870-4492-9037-2091ff268c5a.png,249,565,359,702,110,137,red blood cell,15070,1.2454545454545454,0.8029197080291971
49216,/images/a9daf82a-a46d-4296-bd72-2c374ed0a193.png,191,1432,303,1544,112,112,red blood cell,12544,1.0,1.0
66257,/images/e8058bed-c362-4e1c-85dc-62f80f32938f.png,51,814,151,903,100,89,red blood cell,8900,0.89,1.1235955056179776
60748,/images/645cd195-af50-409f-8da9-6e7c7f18ea09.png,520,580,624,691,104,111,red blood cell,11544,1.0673076923076923,0.9369369369369369
47545,/images/adff132d-3af0-4cef-942c-58fc09729bee.png,403,1434,525,1562,122,128,red blood cell,15616,1.0491803278688525,0.953125
3981,/images/f09acb0c-b270-4e91-99f8-410adfa7f34a.png,858,1195,950,1286,92,91,red blood cell,8372,0.9891304347826086,1.010989010989011
16236,/images/acdc6e12-73d9-44ba-be8c-2a56aaffef4f.png,836,830,955,951,119,121,red blood cell,14399,1.0168067226890756,0.9834710743801653
15171,/images/3a8f468f-f9de-46a8-a7c8-f2be239fa207.png,523,482,606,564,83,82,red blood cell,6806,0.9879518072289156,1.0121951219512195
14752,/images/1fdf99d1-a494-4174-bcd7-efbe457ab899.png,986,115,1107,235,121,120,red blood cell,14520,0.9917355371900827,1.0083333333333333
79698,/images/03b9d6ad-39ca-4097-a98b-77f02b3c00a7.png,406,404,518,517,112,113,red blood cell,12656,1.0089285714285714,0.9911504424778761
2392,/images/fe851c88-692d-4199-87e0-d19d9c4eb591.png,603,1124,697,1225,94,101,red blood cell,9494,1.074468085106383,0.9306930693069307
67852,/images/41ebf9a1-24dc-454e-8bf8-508218f5ee57.png,74,1387,188,1492,114,105,red blood cell,11970,0.9210526315789473,1.0857142857142856
51734,/images/592c941a-aa54-4971-b499-dc47356f80a3.png,786,791,894,902,108,111,red blood cell,11988,1.0277777777777777,0.972972972972973
11774,/images/082e1f81-4f49-44ad-b5bb-9dfc155b2ed8.png,276,34,396,133,120,99,red blood cell,11880,0.825,1.2121212121212122
63640,/images/d9c9479e-f1ea-4d6e-861f-843ff9a90d19.png,123,593,251,719,128,126,red blood cell,16128,0.984375,1.0158730158730158
56613,/images/a824b499-3736-4581-bbdc-be1b3b4cf756.png,667,761,764,878,97,117,red blood cell,11349,1.2061855670103092,0.8290598290598291
3289,/images/b901c906-91be-48c4-88ec-2c527544a258.png,97,631,217,753,120,122,red blood cell,14640,1.0166666666666666,0.9836065573770492
76962,/images/51e86aa9-caa0-4297-94e8-34a57d7f7e36.png,686,1408,790,1501,104,93,red blood cell,9672,0.8942307692307693,1.118279569892473
31060,/images/9c48fdf4-621d-4f40-bcd7-6a28cd530de7.png,32,516,138,625,106,109,red blood cell,11554,1.028301886792453,0.9724770642201835
46649,/images/da111ca5-520f-4ea8-97ad-ae5fce58ee91.png,533,38,629,144,96,106,red blood cell,10176,1.1041666666666667,0.9056603773584906
54683,/images/6473ddb6-ad56-48a2-81e8-c7cb45f06825.png,568,956,666,1040,98,84,red blood cell,8232,0.8571428571428571,1.1666666666666667
51905,/images/d67398c5-8b0e-463f-a04e-8583c820786c.png,17,161,121,279,104,118,red blood cell,12272,1.1346153846153846,0.8813559322033898
75193,/images/61dfc937-a428-44b4-94fb-d682bdb8dff0.png,303,1347,419,1446,116,99,red blood cell,11484,0.853448275862069,1.1717171717171717
9427,/images/e3a4b3e7-9500-4b6c-a402-b6d3f45e714b.png,433,715,550,835,117,120,red blood cell,14040,1.0256410256410255,0.975
21711,/images/81af1442-d835-46bf-b80b-a898dba3da1b.png,1058,188,1188,312,130,124,red blood cell,16120,0.9538461538461539,1.0483870967741935
60634,/images/724e0c34-32cd-41f1-ae37-586038bc67ab.png,723,1116,822,1209,99,93,red blood cell,9207,0.9393939393939394,1.064516129032258
70746,/images/8ab5c462-045e-4b59-b53a-9b2bc3ed2487.png,7,178,101,273,94,95,red blood cell,8930,1.0106382978723405,0.9894736842105263
48223,/images/71204a6d-814e-44b6-9cee-7b979f478021.png,568,906,661,999,93,93,red blood cell,8649,1.0,1.0
6847,/images/b21f6c6e-4b45-407a-b4c7-034a115f3ee4.png,408,571,538,697,130,126,red blood cell,16380,0.9692307692307692,1.0317460317460319
73104,/images/f39e2289-fedd-4d12-9e64-ffdafb89247e.png,821,1177,940,1283,119,106,red blood cell,12614,0.8907563025210085,1.1226415094339623
4417,/images/21ea4841-8998-4c04-b345-bc99cd8ecee6.png,238,570,354,687,116,117,red blood cell,13572,1.0086206896551724,0.9914529914529915
79707,/images/03b9d6ad-39ca-4097-a98b-77f02b3c00a7.png,547,792,640,885,93,93,red blood cell,8649,1.0,1.0
51320,/images/b4f3b2a4-f4b9-48de-ac5d-0e681b77be27.png,434,812,536,908,102,96,red blood cell,9792,0.9411764705882353,1.0625
35899,/images/33068c1a-48f7-470b-8e49-e2f0888042e9.png,1056,864,1180,994,124,130,red blood cell,16120,1.0483870967741935,0.9538461538461539
74274,/images/8939e14b-fcdf-48b1-acb9-6514a2fc2fc0.png,925,1212,1049,1314,124,102,red blood cell,12648,0.8225806451612904,1.2156862745098038
27478,/images/f5869ba8-6253-426b-93f3-82af59a86144.png,34,416,126,525,92,109,red blood cell,10028,1.184782608695652,0.8440366972477065
39189,/images/2aeb7b85-7df9-4a63-8d37-2eecaaa190e7.png,1069,821,1187,933,118,112,red blood cell,13216,0.9491525423728814,1.0535714285714286
13364,/images/a7f1bbb1-6058-4642-bd66-cfb90dce762e.png,796,1143,901,1263,105,120,red blood cell,12600,1.1428571428571428,0.875
55699,/images/c32b8bb8-c89d-4ae9-9c77-5b9356ca35a1.png,700,1167,798,1268,98,101,red blood cell,9898,1.030612244897959,0.9702970297029703
54021,/images/5e4f7425-11e6-4f9e-be2d-5a27deb9d1b4.png,629,207,730,316,101,109,red blood cell,11009,1.0792079207920793,0.926605504587156
66393,/images/e5fd5949-4cd0-4cb6-837a-02c26a5eb87a.png,1016,1362,1131,1482,115,120,red blood cell,13800,1.0434782608695652,0.9583333333333334
15485,/images/79f63258-24ce-4e69-a5cb-8529635a89a9.png,525,34,625,141,100,107,red blood cell,10700,1.07,0.9345794392523364
14308,/images/95bea542-6cd0-41c5-82c5-509af8c3b505.png,952,522,1061,648,109,126,red blood cell,13734,1.1559633027522935,0.8650793650793651
26798,/images/2518f6e4-29cc-4ae4-a914-b215a4c56099.png,329,1452,425,1557,96,105,red blood cell,10080,1.09375,0.9142857142857143
4658,/images/a2d07312-2f97-40d2-8b09-7f2aca7b16fb.png,102,68,227,197,125,129,red blood cell,16125,1.032,0.9689922480620154
51046,/images/7eb95580-693f-41b6-9338-174be1430c23.png,1024,259,1151,370,127,111,red blood cell,14097,0.8740157480314961,1.1441441441441442
680,/images/e61e6af2-7f8b-47b0-bbe7-acb2ed0299ab.png,539,877,627,971,88,94,red blood cell,8272,1.0681818181818181,0.9361702127659575
57178,/images/7c870293-2665-4a6b-a4fa-336959051dfc.png,1039,1456,1156,1574,117,118,red blood cell,13806,1.0085470085470085,0.9915254237288136
32090,/images/b8a4d467-c40c-4ebf-91dd-1c19d0f2a7ae.png,978,505,1074,618,96,113,red blood cell,10848,1.1770833333333333,0.8495575221238938
77074,/images/637957ef-df75-4a7b-86d5-9f6e9c042ca2.png,1038,1506,1145,1596,107,90,red blood cell,9630,0.8411214953271028,1.1888888888888889
51764,/images/f07174a5-f799-4286-ac43-5b0f5c5777ac.png,1034,260,1143,377,109,117,red blood cell,12753,1.073394495412844,0.9316239316239316
65372,/images/24418314-f7a4-49fc-a03e-ec597ca6796e.png,188,1210,265,1303,77,93,red blood cell,7161,1.2077922077922079,0.8279569892473119
31131,/images/1976cd04-d24f-457c-b423-7e4cdb05de9e.png,467,41,588,154,121,113,red blood cell,13673,0.9338842975206612,1.0707964601769913
71064,/images/2dbf6f69-e020-4948-9e49-4b33edb7cebd.png,106,932,215,1048,109,116,red blood cell,12644,1.0642201834862386,0.9396551724137931
71441,/images/bcb447c9-5d37-414f-a513-d7076b04a532.png,699,766,789,859,90,93,red blood cell,8370,1.0333333333333334,0.967741935483871
46261,/images/815bf40c-371a-4d34-aa41-c549c8221881.png,1008,784,1129,904,121,120,red blood cell,14520,0.9917355371900827,1.0083333333333333
50903,/images/0906111b-bac7-4541-a6dc-da435c0724a8.png,814,982,931,1079,117,97,red blood cell,11349,0.8290598290598291,1.2061855670103092
865,/images/c7a2d648-47cb-4b39-afa4-1b7fcfe51934.png,544,1306,652,1433,108,127,red blood cell,13716,1.1759259259259258,0.8503937007874016
4000,/images/a5e05ba8-0c19-41e3-92d5-10e42a03b85e.png,130,686,241,801,111,115,red blood cell,12765,1.0360360360360361,0.9652173913043478
43117,/images/c5db0fc0-b96c-496e-90b4-f9fb1b85b28e.png,748,678,855,788,107,110,red blood cell,11770,1.02803738317757,0.9727272727272728
25370,/images/fbb1b44c-d75a-4550-a6c0-0eb62b96bfce.png,130,1318,234,1435,104,117,red blood cell,12168,1.125,0.8888888888888888
24535,/images/109fbb82-bc3c-41ac-984d-e2da86202873.png,441,1268,547,1400,106,132,red blood cell,13992,1.2452830188679245,0.803030303030303
61953,/images/c66a3e52-0f3f-4c81-bab9-0303499549f7.png,369,1127,489,1223,120,96,red blood cell,11520,0.8,1.25
46998,/images/9ebd623d-5534-4dd9-bff8-cdedf322db35.png,971,626,1081,733,110,107,red blood cell,11770,0.9727272727272728,1.02803738317757
58054,/images/a7c91b63-b97c-4f4b-8d34-7ad2b08d7a17.png,558,215,662,326,104,111,red blood cell,11544,1.0673076923076923,0.9369369369369369
8679,/images/ea6b012a-3425-4bfc-a61d-88563aa2a264.png,1035,183,1147,290,112,107,red blood cell,11984,0.9553571428571429,1.0467289719626167
32529,/images/318de807-7232-4ab1-843e-a901547c0125.png,236,444,346,565,110,121,red blood cell,13310,1.1,0.9090909090909091
61555,/images/4a717a39-80f8-4b75-a25e-c46d65d7dcd5.png,428,735,534,843,106,108,red blood cell,11448,1.0188679245283019,0.9814814814814815
56910,/images/f28e6d66-af71-40c1-b30c-da71d7230a3f.png,936,1256,1061,1386,125,130,red blood cell,16250,1.04,0.9615384615384616
75574,/images/c35ee701-fde2-46b5-b178-1fe3f1ea7da2.png,1063,950,1167,1065,104,115,red blood cell,11960,1.1057692307692308,0.9043478260869565
2754,/images/a89cace5-c818-4f23-a432-052b3433b81e.png,741,625,827,696,86,71,red blood cell,6106,0.8255813953488372,1.2112676056338028
6818,/images/e36cb882-c6d0-4467-812e-d18c169a9a47.png,433,584,556,700,123,116,red blood cell,14268,0.943089430894309,1.0603448275862069
20104,/images/81a2748d-51c9-4439-995d-f747871d6544.png,818,1306,928,1416,110,110,red blood cell,12100,1.0,1.0
23912,/images/3d8fb5bf-3315-48fb-8ab1-802eafd550bc.png,170,234,282,352,112,118,red blood cell,13216,1.0535714285714286,0.9491525423728814
32285,/images/1c406ce1-023b-47fc-a2cd-5ea2e255de65.png,947,727,1075,857,128,130,red blood cell,16640,1.015625,0.9846153846153847
54516,/images/db871d17-28fd-4ceb-b421-e4e4afa0a7a0.png,382,51,503,158,121,107,red blood cell,12947,0.8842975206611571,1.1308411214953271
64118,/images/0d3c2521-da55-4df5-bf06-56b3bd4fb2fc.png,247,452,351,565,104,113,red blood cell,11752,1.0865384615384615,0.9203539823008849
74371,/images/06a3effb-996c-4767-afd2-6aa3b697cb4e.png,575,740,668,840,93,100,red blood cell,9300,1.075268817204301,0.93
43970,/images/d7c7eb2c-2acd-4f86-8a5a-09ab3dd02d16.png,909,475,1005,573,96,98,red blood cell,9408,1.0208333333333333,0.9795918367346939
15117,/images/3a8f468f-f9de-46a8-a7c8-f2be239fa207.png,1043,543,1155,659,112,116,red blood cell,12992,1.0357142857142858,0.9655172413793104
21003,/images/666601e7-608d-4d19-999f-8fc6ab373a55.png,73,151,187,270,114,119,red blood cell,13566,1.043859649122807,0.957983193277311
37030,/images/b2e34f5f-904e-4473-9dc7-c6bc1ce12640.png,402,754,503,848,101,94,red blood cell,9494,0.9306930693069307,1.074468085106383
60068,/images/e63e1607-f344-43d6-a0d8-e10cf2e5054a.png,951,462,1054,557,103,95,red blood cell,9785,0.9223300970873787,1.0842105263157895
1020,/images/63d36d2c-43a9-49ac-9504-028b4968c860.png,503,873,610,977,107,104,red blood cell,11128,0.9719626168224299,1.0288461538461537
6582,/images/640c4a52-3742-4f57-aee3-9e3dc0887622.png,71,629,156,729,85,100,red blood cell,8500,1.1764705882352942,0.85
39137,/images/7bde7de1-889b-4218-b0e1-e2c04f6a7986.png,1014,892,1130,1010,116,118,red blood cell,13688,1.0172413793103448,0.9830508474576272
75062,/images/073c10c9-5749-44b5-b08b-1be556a960f0.png,1075,1148,1182,1246,107,98,red blood cell,10486,0.9158878504672897,1.0918367346938775
20628,/images/0f2a6cda-afec-437b-8803-8d3176b072c1.png,1052,480,1163,586,111,106,red blood cell,11766,0.954954954954955,1.0471698113207548
16552,/images/69565501-6e77-4f40-bd80-caa3dda34d8b.png,94,885,204,1006,110,121,red blood cell,13310,1.1,0.9090909090909091
23641,/images/79d7a014-21ff-40f1-9ac4-a69839390654.png,905,984,1003,1076,98,92,red blood cell,9016,0.9387755102040817,1.065217391304348
45690,/images/584d62ed-4329-45dd-94ce-e929d8b2bb74.png,40,447,140,544,100,97,red blood cell,9700,0.97,1.0309278350515463
63450,/images/b9d65ef3-1adc-4479-abee-2e422f5a613a.png,234,785,321,877,87,92,red blood cell,8004,1.0574712643678161,0.9456521739130435
52609,/images/0546d843-d778-4aca-b8b5-bfe23d7c87da.png,586,848,679,947,93,99,red blood cell,9207,1.064516129032258,0.9393939393939394
5894,/images/a30da226-b452-408a-a556-bfae4d521464.png,921,313,1018,423,97,110,red blood cell,10670,1.134020618556701,0.8818181818181818
32123,/images/9258fe22-6406-4d00-b6f0-3f9492925405.png,837,21,936,115,99,94,red blood cell,9306,0.9494949494949495,1.053191489361702
16755,/images/4823c1fe-a7f9-4b92-959f-0d9be09cd14b.png,162,117,271,219,109,102,red blood cell,11118,0.9357798165137615,1.0686274509803921
66635,/images/b88fe674-fb9a-41d4-b100-cb1c86440d44.png,94,1356,207,1450,113,94,red blood cell,10622,0.831858407079646,1.202127659574468
1344,/images/6d91d1f0-636b-4f5a-a526-7c17fc857190.png,914,1413,1008,1492,94,79,red blood cell,7426,0.8404255319148937,1.1898734177215189
78787,/images/9174f910-3859-4839-8e30-2c3b25269322.png,893,16,1019,124,126,108,red blood cell,13608,0.8571428571428571,1.1666666666666667
14862,/images/3090a362-1f3d-49e9-a76e-ce76ff9c2276.png,620,184,721,292,101,108,red blood cell,10908,1.0693069306930694,0.9351851851851852
51869,/images/d67398c5-8b0e-463f-a04e-8583c820786c.png,493,1208,615,1318,122,110,red blood cell,13420,0.9016393442622951,1.1090909090909091
61426,/images/e16c0dab-780d-4035-872e-1bb91e49f9d2.png,781,633,859,710,78,77,red blood cell,6006,0.9871794871794872,1.0129870129870129
43406,/images/367663b2-5d09-4020-ab0a-c2200e7a1c8c.png,512,1102,604,1198,92,96,red blood cell,8832,1.0434782608695652,0.9583333333333334
19830,/images/b318889c-3c60-477c-b8f6-d18cb01a59df.png,229,1029,329,1131,100,102,red blood cell,10200,1.02,0.9803921568627451
5099,/images/a777e78c-ad1f-4380-9ab2-b4f9f32b2d78.png,498,564,582,649,84,85,red blood cell,7140,1.0119047619047619,0.9882352941176471
39882,/images/af2e63a3-9fde-46aa-a867-81c5c259d1dc.png,443,1384,543,1500,100,116,red blood cell,11600,1.16,0.8620689655172413
78522,/images/c94827ce-d619-4705-a68a-df63a2c95ffa.png,635,485,746,590,111,105,red blood cell,11655,0.9459459459459459,1.0571428571428572
55587,/images/a27b451d-44a6-4740-861a-9e7e99915563.png,237,1393,349,1496,112,103,red blood cell,11536,0.9196428571428571,1.087378640776699
63208,/images/f0804a5e-e7f5-4cf2-a5df-b65e66502bf1.png,765,270,852,369,87,99,red blood cell,8613,1.1379310344827587,0.8787878787878788
29298,/images/3850f2a5-ab62-49d3-8135-68d60baa676b.png,190,1294,310,1413,120,119,red blood cell,14280,0.9916666666666667,1.0084033613445378
53033,/images/42e87148-a015-4148-923a-fb83016f64e7.png,645,565,764,680,119,115,red blood cell,13685,0.9663865546218487,1.0347826086956522
40354,/images/eb86033f-4f1c-4e8c-ae84-e8e4c7e08626.png,1008,177,1114,269,106,92,red blood cell,9752,0.8679245283018868,1.1521739130434783
22642,/images/4ab47131-c2ac-461f-b95c-ac19ce24edbd.png,534,952,637,1071,103,119,red blood cell,12257,1.1553398058252426,0.865546218487395
69851,/images/9edba799-e169-46cd-b100-c9f8fc7a8c7d.png,80,194,196,296,116,102,red blood cell,11832,0.8793103448275862,1.1372549019607843
19969,/images/8e69098c-fae0-47a3-8833-c2bfdfb1a416.png,643,1272,751,1390,108,118,red blood cell,12744,1.0925925925925926,0.9152542372881356
2395,/images/fe851c88-692d-4199-87e0-d19d9c4eb591.png,568,1246,666,1346,98,100,red blood cell,9800,1.0204081632653061,0.98
65950,/images/25c6cfb1-01d0-4864-87f9-02b7593683c7.png,325,261,425,369,100,108,red blood cell,10800,1.08,0.9259259259259259
16841,/images/4823c1fe-a7f9-4b92-959f-0d9be09cd14b.png,907,1296,997,1390,90,94,red blood cell,8460,1.0444444444444445,0.9574468085106383
15330,/images/2d0f600d-f94e-4907-b712-52fb37d9ed52.png,924,779,1014,858,90,79,red blood cell,7110,0.8777777777777778,1.139240506329114
25378,/images/fbb1b44c-d75a-4550-a6c0-0eb62b96bfce.png,33,1464,151,1579,118,115,red blood cell,13570,0.9745762711864406,1.0260869565217392
18646,/images/c22f7031-9cf8-48ce-b03b-1b12d0db4951.png,149,1196,242,1291,93,95,red blood cell,8835,1.021505376344086,0.9789473684210527
3975,/images/f09acb0c-b270-4e91-99f8-410adfa7f34a.png,1094,836,1198,930,104,94,red blood cell,9776,0.9038461538461539,1.1063829787234043
49680,/images/9842445c-5899-4189-9f2e-3a3a179fdad3.png,1023,1425,1138,1542,115,117,red blood cell,13455,1.017391304347826,0.9829059829059829
59149,/images/4736f545-1f1f-4d77-9241-d69cbf4dae35.png,225,166,314,269,89,103,red blood cell,9167,1.1573033707865168,0.8640776699029126
40383,/images/db249e5a-4142-432c-8288-bacd10d7273d.png,616,1229,715,1339,99,110,red blood cell,10890,1.1111111111111112,0.9
28593,/images/dbdfad64-110c-421f-a1c7-f68fd9e82d67.png,4,678,127,822,123,144,red blood cell,17712,1.170731707317073,0.8541666666666666
74658,/images/5ccca8ee-abea-458a-a891-bedd31c3ddc3.png,1042,813,1148,914,106,101,red blood cell,10706,0.9528301886792453,1.0495049504950495
53715,/images/6f67a66b-56ec-4c36-ae7c-f250d3b86a23.png,266,473,351,561,85,88,red blood cell,7480,1.035294117647059,0.9659090909090909
31797,/images/63ed5931-d93e-4f9b-a6f3-152713cb560e.png,932,349,1048,459,116,110,red blood cell,12760,0.9482758620689655,1.0545454545454545
13244,/images/711f6b3f-cd63-46d1-834a-bc8e9aa9b43e.png,297,274,393,359,96,85,red blood cell,8160,0.8854166666666666,1.1294117647058823
58592,/images/a4d7a7e1-5ae1-486d-b6ee-c9af1476ccad.png,406,649,529,753,123,104,red blood cell,12792,0.8455284552845529,1.1826923076923077
19176,/images/bb795ddf-ce72-42d5-9006-124db4d5cf1c.png,1024,1115,1137,1208,113,93,red blood cell,10509,0.8230088495575221,1.2150537634408602
54446,/images/22a464ef-c3da-4d56-b37e-e22e95d945e7.png,856,1347,948,1435,92,88,red blood cell,8096,0.9565217391304348,1.0454545454545454
28891,/images/686ed568-d5f8-475e-81ad-edab9dd473a0.png,324,1218,405,1308,81,90,red blood cell,7290,1.1111111111111112,0.9
7765,/images/e726dac6-f962-449c-acff-4dd56847b685.png,775,977,868,1078,93,101,red blood cell,9393,1.086021505376344,0.9207920792079208
59125,/images/4736f545-1f1f-4d77-9241-d69cbf4dae35.png,15,1362,107,1461,92,99,red blood cell,9108,1.076086956521739,0.9292929292929293
8293,/images/65e3d6a6-012c-4b40-9a42-83078eb85e31.png,754,1491,864,1584,110,93,red blood cell,10230,0.8454545454545455,1.1827956989247312
60978,/images/5397d8e2-bb09-42e7-9861-65ffad0fe94e.png,481,32,601,151,120,119,red blood cell,14280,0.9916666666666667,1.0084033613445378
18773,/images/cc882eae-a341-4783-bd19-8bdedf798538.png,1010,1435,1122,1544,112,109,red blood cell,12208,0.9732142857142857,1.0275229357798166
29525,/images/8cc6fe77-5f2f-4670-b4ac-1b49550241a8.png,867,843,986,951,119,108,red blood cell,12852,0.907563025210084,1.1018518518518519
11873,/images/3cdcb09b-6a8c-43ca-b1d0-c1a289202f65.png,2,1029,98,1140,96,111,red blood cell,10656,1.15625,0.8648648648648649
26370,/images/ef1419e0-3a3a-458a-b3b2-7efddac50404.png,87,1149,231,1271,144,122,red blood cell,17568,0.8472222222222222,1.180327868852459
72640,/images/a63ce82f-f3d1-4818-9035-d3d230e5f686.png,475,693,572,796,97,103,red blood cell,9991,1.0618556701030928,0.941747572815534
4119,/images/d3b79739-aea2-4804-8c7a-183b7ed07de3.png,432,197,557,297,125,100,red blood cell,12500,0.8,1.25
41986,/images/46a03374-64c7-49ac-81c9-c3d62542bbf3.png,886,1331,1002,1439,116,108,red blood cell,12528,0.9310344827586207,1.0740740740740742
27154,/images/f232eec3-02c0-43f9-bf32-3e60245397e2.png,302,1260,431,1369,129,109,red blood cell,14061,0.8449612403100775,1.18348623853211
31956,/images/9eb66577-7857-43dc-a879-8f2c9d7f780f.png,407,903,498,990,91,87,red blood cell,7917,0.9560439560439561,1.0459770114942528
28670,/images/151f3af5-5e6e-4bcd-9389-4974fc68813e.png,764,1121,864,1226,100,105,red blood cell,10500,1.05,0.9523809523809523
17732,/images/b5143aae-6e98-4dc6-b546-980cb472de67.png,420,479,512,594,92,115,red blood cell,10580,1.25,0.8
20253,/images/c66cb6b2-1480-446a-a9d2-b8032a3de0d7.png,734,1111,844,1217,110,106,red blood cell,11660,0.9636363636363636,1.0377358490566038
46944,/images/9e0e1928-d19a-4100-b093-0b962ac09e05.png,397,770,505,870,108,100,red blood cell,10800,0.9259259259259259,1.08
33562,/images/255d5f0c-87fc-4337-bb51-07c440df4f1b.png,1050,1367,1158,1497,108,130,red blood cell,14040,1.2037037037037037,0.8307692307692308
7989,/images/694222bb-cddf-469a-9526-f873c6fba58e.png,886,715,995,813,109,98,red blood cell,10682,0.8990825688073395,1.1122448979591837
38022,/images/e3e9c2de-0a24-4c7e-8a69-3d3093d5bdab.png,388,876,484,970,96,94,red blood cell,9024,0.9791666666666666,1.0212765957446808
73145,/images/f39e2289-fedd-4d12-9e64-ffdafb89247e.png,870,420,952,521,82,101,red blood cell,8282,1.2317073170731707,0.8118811881188119
851,/images/c7a2d648-47cb-4b39-afa4-1b7fcfe51934.png,970,1012,1092,1114,122,102,red blood cell,12444,0.8360655737704918,1.196078431372549
26880,/images/2518f6e4-29cc-4ae4-a914-b215a4c56099.png,924,793,1045,900,121,107,red blood cell,12947,0.8842975206611571,1.1308411214953271
60401,/images/8d5d5c22-2f75-4fe1-9ea3-03a3c7b92ea9.png,372,87,498,211,126,124,red blood cell,15624,0.9841269841269841,1.0161290322580645
59881,/images/1519257c-e3e5-4474-908f-8665b3cf1258.png,787,233,890,341,103,108,red blood cell,11124,1.0485436893203883,0.9537037037037037
17436,/images/56077789-8580-41b4-89d6-deea227e5c60.png,565,3,674,114,109,111,red blood cell,12099,1.018348623853211,0.9819819819819819
37627,/images/205306da-0ed8-475a-ace6-f2f81d4be88a.png,921,800,1008,892,87,92,red blood cell,8004,1.0574712643678161,0.9456521739130435
42512,/images/29648565-fe28-4517-ba72-68df0c82c9c5.png,192,1007,284,1102,92,95,red blood cell,8740,1.0326086956521738,0.968421052631579
72439,/images/a15e0fa8-2620-4f66-896e-175115c9dc3d.png,1079,1436,1193,1546,114,110,red blood cell,12540,0.9649122807017544,1.0363636363636364
41935,/images/46a03374-64c7-49ac-81c9-c3d62542bbf3.png,616,1359,713,1456,97,97,red blood cell,9409,1.0,1.0
49377,/images/f2574be3-81c6-4fc3-8a40-0230d1264f52.png,863,652,995,781,132,129,red blood cell,17028,0.9772727272727273,1.0232558139534884
19459,/images/361a3578-4cbb-422b-9e3c-b5e61395b12e.png,777,316,895,431,118,115,red blood cell,13570,0.9745762711864406,1.0260869565217392
22689,/images/4ab47131-c2ac-461f-b95c-ac19ce24edbd.png,395,18,501,120,106,102,red blood cell,10812,0.9622641509433962,1.0392156862745099
5788,/images/143f5959-5b6d-4f95-bcee-9e110450fc22.png,108,181,219,284,111,103,red blood cell,11433,0.9279279279279279,1.0776699029126213
38385,/images/674b0fd3-f247-4b7f-97f7-3e6c57c9ba9e.png,215,1022,315,1122,100,100,red blood cell,10000,1.0,1.0
38221,/images/1d9d4dac-66f9-4c87-b714-d723d5b15fa9.png,719,1318,848,1442,129,124,red blood cell,15996,0.9612403100775194,1.0403225806451613
38621,/images/3b601a1b-26d8-4873-afcf-fdd1b1e0010c.png,795,47,906,158,111,111,red blood cell,12321,1.0,1.0
5220,/images/729733ff-a349-4a96-b636-ccabe7d7e167.png,277,153,397,284,120,131,red blood cell,15720,1.0916666666666666,0.916030534351145
3780,/images/c9499a06-fb31-4552-a9e2-fb4ebb440859.png,204,250,321,366,117,116,red blood cell,13572,0.9914529914529915,1.0086206896551724
38180,/images/33bdb7b5-ad5b-4a73-bbc2-3350f8c2ac0c.png,727,1385,841,1496,114,111,red blood cell,12654,0.9736842105263158,1.027027027027027
57824,/images/c9ad92d4-b408-4506-916e-def47b2e6ed0.png,116,661,206,755,90,94,red blood cell,8460,1.0444444444444445,0.9574468085106383
42640,/images/3abbc4d3-1d7e-40c9-9963-33732da7cc50.png,381,692,494,795,113,103,red blood cell,11639,0.911504424778761,1.0970873786407767
53568,/images/7c1cd7c7-7452-4428-a98e-dd7675c8ddea.png,807,600,911,701,104,101,red blood cell,10504,0.9711538461538461,1.0297029702970297
6980,/images/c776eb78-3323-4571-b39f-7ffc73ae63ce.png,232,1036,329,1134,97,98,red blood cell,9506,1.0103092783505154,0.9897959183673469
59912,/images/1519257c-e3e5-4474-908f-8665b3cf1258.png,936,1172,1028,1282,92,110,red blood cell,10120,1.1956521739130435,0.8363636363636363
8281,/images/65e3d6a6-012c-4b40-9a42-83078eb85e31.png,553,855,663,956,110,101,red blood cell,11110,0.9181818181818182,1.0891089108910892
28106,/images/cd2774a0-dab2-4d68-aae9-7568b9f3d2a6.png,549,1154,647,1263,98,109,red blood cell,10682,1.1122448979591837,0.8990825688073395
1709,/images/5f783f43-0090-4f8a-bd75-9562f4aa2dd5.png,946,1474,1056,1592,110,118,red blood cell,12980,1.0727272727272728,0.9322033898305084
1013,/images/63d36d2c-43a9-49ac-9504-028b4968c860.png,88,1293,211,1412,123,119,red blood cell,14637,0.967479674796748,1.0336134453781514
42948,/images/ff37dd9b-2e3c-444d-9d29-6db186cfa2fb.png,248,90,367,213,119,123,red blood cell,14637,1.0336134453781514,0.967479674796748
6672,/images/95fea6d8-413f-421e-b331-5d51c31df150.png,629,854,748,972,119,118,red blood cell,14042,0.9915966386554622,1.0084745762711864
57179,/images/7c870293-2665-4a6b-a4fa-336959051dfc.png,710,387,808,485,98,98,red blood cell,9604,1.0,1.0
17792,/images/1863da5f-c595-4541-a8f4-21fe78678168.png,7,956,111,1061,104,105,red blood cell,10920,1.0096153846153846,0.9904761904761905
39616,/images/04d21589-b777-43c2-86b5-038cbf8c3a4e.png,147,256,244,367,97,111,red blood cell,10767,1.1443298969072164,0.8738738738738738
34388,/images/1a48cbc1-5423-47e5-8ca5-2ab4f83a05a5.png,674,9,780,101,106,92,red blood cell,9752,0.8679245283018868,1.1521739130434783
54953,/images/f1872d08-f8a6-4b21-aa29-f56bbf607883.png,964,891,1086,1003,122,112,red blood cell,13664,0.9180327868852459,1.0892857142857142
58778,/images/e4827c85-311a-4df1-89c2-99dad0c3558c.png,1049,77,1147,159,98,82,red blood cell,8036,0.8367346938775511,1.1951219512195121
20105,/images/81a2748d-51c9-4439-995d-f747871d6544.png,272,1401,393,1539,121,138,red blood cell,16698,1.140495867768595,0.8768115942028986
78810,/images/19979a60-df80-4111-bf69-81a7e9c4dd0b.png,209,73,326,186,117,113,red blood cell,13221,0.9658119658119658,1.0353982300884956
57572,/images/8190ec37-9a5e-419f-89ed-fbfb079370db.png,676,410,769,509,93,99,red blood cell,9207,1.064516129032258,0.9393939393939394
61749,/images/985627c9-7b85-40de-a106-eb9cc47b47cb.png,502,1381,602,1491,100,110,red blood cell,11000,1.1,0.9090909090909091
33679,/images/84ee2ea3-9edd-4672-a1b3-f09c607d833a.png,613,701,731,820,118,119,red blood cell,14042,1.0084745762711864,0.9915966386554622
77156,/images/fe691faa-3bc7-475e-b558-aa8fe7b795bc.png,93,239,208,352,115,113,red blood cell,12995,0.9826086956521739,1.0176991150442478
21432,/images/b701b5c5-b922-4315-b12a-aac4ec65ee8b.png,139,1213,245,1328,106,115,red blood cell,12190,1.0849056603773586,0.9217391304347826
65268,/images/45ac9409-5537-44ed-90cd-5c8a1ae0e1e0.png,1071,742,1189,847,118,105,red blood cell,12390,0.8898305084745762,1.1238095238095238
21398,/images/b701b5c5-b922-4315-b12a-aac4ec65ee8b.png,887,943,984,1035,97,92,red blood cell,8924,0.9484536082474226,1.0543478260869565
50870,/images/0906111b-bac7-4541-a6dc-da435c0724a8.png,987,1000,1106,1115,119,115,red blood cell,13685,0.9663865546218487,1.0347826086956522
56908,/images/f28e6d66-af71-40c1-b30c-da71d7230a3f.png,590,12,696,143,106,131,red blood cell,13886,1.2358490566037736,0.8091603053435115
23046,/images/0d095f3a-9243-472b-90b4-0ce8309e778c.png,158,1480,267,1599,109,119,red blood cell,12971,1.091743119266055,0.9159663865546218
42960,/images/ff37dd9b-2e3c-444d-9d29-6db186cfa2fb.png,245,1097,357,1189,112,92,red blood cell,10304,0.8214285714285714,1.2173913043478262
3401,/images/fd1302e2-3cd2-4a1a-9c13-00f810a9c41b.png,792,1460,899,1581,107,121,red blood cell,12947,1.1308411214953271,0.8842975206611571
64445,/images/34a70114-d3e3-4351-b8db-f6caab17e743.png,526,557,633,660,107,103,red blood cell,11021,0.9626168224299065,1.0388349514563107
40033,/images/8a4aadac-cf5c-4a79-b875-271b3fbfd230.png,318,1184,402,1273,84,89,red blood cell,7476,1.0595238095238095,0.9438202247191011
13799,/images/1b369bcf-ced4-4ae2-9196-2664bd2b1738.png,1073,1369,1182,1478,109,109,red blood cell,11881,1.0,1.0
50966,/images/ef8fcfa4-8466-4186-8c69-f5f4904eb489.png,218,261,329,358,111,97,red blood cell,10767,0.8738738738738738,1.1443298969072164
69998,/images/3e36698f-8c09-4c8b-8948-737310bf97e5.png,932,694,1038,806,106,112,red blood cell,11872,1.0566037735849056,0.9464285714285714
50861,/images/0906111b-bac7-4541-a6dc-da435c0724a8.png,773,147,881,255,108,108,red blood cell,11664,1.0,1.0
40135,/images/b34e65f6-c32e-42f1-a437-4a037c75a231.png,423,1003,519,1100,96,97,red blood cell,9312,1.0104166666666667,0.9896907216494846
59510,/images/6bfe6a90-8a69-4171-8e7f-42dc9417c6d9.png,563,1045,667,1156,104,111,red blood cell,11544,1.0673076923076923,0.9369369369369369
78684,/images/76a8a5f5-1328-4539-a131-baf877f40cf3.png,440,258,549,365,109,107,red blood cell,11663,0.981651376146789,1.0186915887850467
4011,/images/a5e05ba8-0c19-41e3-92d5-10e42a03b85e.png,364,325,489,437,125,112,red blood cell,14000,0.896,1.1160714285714286
11528,/images/834a30bb-26bf-4e60-9ea1-3250b926892e.png,912,190,1042,304,130,114,red blood cell,14820,0.8769230769230769,1.1403508771929824
59885,/images/1519257c-e3e5-4474-908f-8665b3cf1258.png,1034,552,1137,635,103,83,red blood cell,8549,0.8058252427184466,1.2409638554216869
56857,/images/a588091c-5e4c-4e61-914d-e96f3ee3e505.png,771,1187,880,1286,109,99,red blood cell,10791,0.908256880733945,1.101010101010101
10053,/images/26799d2b-a289-4eff-9218-0aad77e05e41.png,477,1115,588,1206,111,91,red blood cell,10101,0.8198198198198198,1.2197802197802199
651,/images/e61e6af2-7f8b-47b0-bbe7-acb2ed0299ab.png,458,942,552,1036,94,94,red blood cell,8836,1.0,1.0
42024,/images/46a03374-64c7-49ac-81c9-c3d62542bbf3.png,300,34,398,132,98,98,red blood cell,9604,1.0,1.0
53631,/images/7bcd3735-3134-46d1-8ca2-d4379f2d51c0.png,367,1029,477,1144,110,115,red blood cell,12650,1.0454545454545454,0.9565217391304348
10036,/images/26799d2b-a289-4eff-9218-0aad77e05e41.png,891,961,991,1064,100,103,red blood cell,10300,1.03,0.970873786407767
72833,/images/31435107-c77d-42f8-a619-75cba6a5161b.png,1091,1484,1184,1571,93,87,red blood cell,8091,0.9354838709677419,1.0689655172413792
72579,/images/a63ce82f-f3d1-4818-9035-d3d230e5f686.png,67,1477,163,1572,96,95,red blood cell,9120,0.9895833333333334,1.0105263157894737
22137,/images/ca677c3c-083f-4d54-9dec-39f79f6a17d8.png,218,1266,312,1371,94,105,red blood cell,9870,1.1170212765957446,0.8952380952380953
9001,/images/ef815e3a-02a6-4cf8-9262-45bc74c50b00.png,190,481,300,590,110,109,red blood cell,11990,0.990909090909091,1.0091743119266054
76056,/images/4c7d2382-a962-4237-a053-955eea3decd8.png,368,1359,473,1450,105,91,red blood cell,9555,0.8666666666666667,1.1538461538461537
78082,/images/105af41b-13cc-4ad1-8a1f-8bc4d47cdd94.png,307,1002,408,1102,101,100,red blood cell,10100,0.9900990099009901,1.01
74232,/images/4e43fc22-dc08-4cde-b3ce-ce8a4f377c47.png,716,1133,802,1228,86,95,red blood cell,8170,1.1046511627906976,0.9052631578947369
13561,/images/370277f8-436b-4103-8210-b4feb5ab95ea.png,658,1239,763,1335,105,96,red blood cell,10080,0.9142857142857143,1.09375
48255,/images/71204a6d-814e-44b6-9cee-7b979f478021.png,809,1343,910,1445,101,102,red blood cell,10302,1.00990099009901,0.9901960784313726
52029,/images/6c3f81d7-5670-46bd-9eaa-9b426413abb7.png,393,915,524,1044,131,129,red blood cell,16899,0.9847328244274809,1.0155038759689923
57108,/images/7d041c38-11f2-4186-8a24-29d7d0f5c3cf.png,862,1379,953,1475,91,96,red blood cell,8736,1.054945054945055,0.9479166666666666
75079,/images/073c10c9-5749-44b5-b08b-1be556a960f0.png,38,1483,131,1572,93,89,red blood cell,8277,0.956989247311828,1.0449438202247192
31370,/images/04fb49a2-07b8-4cdf-b6f7-df5c3688e5f8.png,402,984,515,1093,113,109,red blood cell,12317,0.9646017699115044,1.036697247706422
48183,/images/913099c5-8085-4908-bf4b-1f098bbfcf66.png,120,1019,214,1111,94,92,red blood cell,8648,0.9787234042553191,1.0217391304347827
65754,/images/daea4860-a296-4f6d-acef-996ab0882676.png,358,273,473,378,115,105,red blood cell,12075,0.9130434782608695,1.0952380952380953
21892,/images/d57b3894-c912-47e8-b00a-e1a2a7aba644.png,18,1442,122,1558,104,116,red blood cell,12064,1.1153846153846154,0.896551724137931
32323,/images/1c406ce1-023b-47fc-a2cd-5ea2e255de65.png,410,788,537,916,127,128,red blood cell,16256,1.0078740157480315,0.9921875
74404,/images/06a3effb-996c-4767-afd2-6aa3b697cb4e.png,54,706,157,800,103,94,red blood cell,9682,0.912621359223301,1.0957446808510638
51695,/images/592c941a-aa54-4971-b499-dc47356f80a3.png,832,866,927,973,95,107,red blood cell,10165,1.1263157894736842,0.8878504672897196
33777,/images/cb08956d-dd6a-4e13-817b-40a0a93068f1.png,188,1023,316,1141,128,118,red blood cell,15104,0.921875,1.0847457627118644
34365,/images/1a48cbc1-5423-47e5-8ca5-2ab4f83a05a5.png,180,1312,285,1432,105,120,red blood cell,12600,1.1428571428571428,0.875
9841,/images/3859deaf-6ae1-49a3-9051-898d0f0d7de6.png,148,46,238,135,90,89,red blood cell,8010,0.9888888888888889,1.0112359550561798
14332,/images/f5eb7c5e-bd77-4638-ba9f-58d42f87476b.png,406,793,518,914,112,121,red blood cell,13552,1.0803571428571428,0.9256198347107438
26079,/images/71925778-a26e-483e-a07c-f3aaf740122a.png,1020,566,1145,680,125,114,red blood cell,14250,0.912,1.0964912280701755
75385,/images/468c261d-f5d8-423f-883e-48af2bbbc5d1.png,344,615,439,699,95,84,red blood cell,7980,0.8842105263157894,1.130952380952381
58960,/images/a0eeeb10-d0cb-48d9-8c22-2c3a3c908d00.png,318,284,440,403,122,119,red blood cell,14518,0.9754098360655737,1.0252100840336134
39430,/images/55f8c052-8e49-4423-a4c4-365fc6afb6e1.png,880,1430,997,1546,117,116,red blood cell,13572,0.9914529914529915,1.0086206896551724
15020,/images/3003252a-2d2e-4687-ad30-9c38d68f1394.png,206,1006,343,1119,137,113,red blood cell,15481,0.8248175182481752,1.2123893805309736
19988,/images/8e69098c-fae0-47a3-8833-c2bfdfb1a416.png,902,88,1001,184,99,96,red blood cell,9504,0.9696969696969697,1.03125
21190,/images/fb05b297-180a-4171-b633-09d5616d7534.png,252,1132,342,1226,90,94,red blood cell,8460,1.0444444444444445,0.9574468085106383
14503,/images/458cb2e9-5a7f-437c-ac5d-a56f98a3efdf.png,884,482,983,578,99,96,red blood cell,9504,0.9696969696969697,1.03125
73215,/images/85546330-4efd-43e2-87aa-d53a30220bfc.png,1028,1334,1128,1422,100,88,red blood cell,8800,0.88,1.1363636363636365
56149,/images/50d9fc90-8642-4bb6-91a7-0069a7e37392.png,360,395,476,503,116,108,red blood cell,12528,0.9310344827586207,1.0740740740740742
49720,/images/5e17f8e6-fd8d-426c-b444-1515d14f04b7.png,951,674,1055,777,104,103,red blood cell,10712,0.9903846153846154,1.0097087378640777
53171,/images/801296d9-3403-426f-859e-5c532858e025.png,424,952,552,1095,128,143,red blood cell,18304,1.1171875,0.8951048951048951
31273,/images/db7c5ec1-fefe-4e9d-83c1-da8fb982f1e2.png,796,1126,900,1238,104,112,red blood cell,11648,1.0769230769230769,0.9285714285714286
71699,/images/5c99cd97-39f6-4809-9528-9d380cc16b16.png,394,542,503,655,109,113,red blood cell,12317,1.036697247706422,0.9646017699115044
11845,/images/3cdcb09b-6a8c-43ca-b1d0-c1a289202f65.png,200,1130,303,1243,103,113,red blood cell,11639,1.0970873786407767,0.911504424778761
72233,/images/7d4d0646-26b5-46fa-ab25-452d986e887b.png,696,1120,780,1213,84,93,red blood cell,7812,1.1071428571428572,0.9032258064516129
31777,/images/ab59c9e4-3e50-48b9-874d-060d317410cc.png,606,1457,741,1596,135,139,red blood cell,18765,1.0296296296296297,0.9712230215827338
24263,/images/bb3ae957-0f6d-4615-bfe5-24fbca50b459.png,328,471,448,581,120,110,red blood cell,13200,0.9166666666666666,1.0909090909090908
5539,/images/eb6e8684-b84e-483d-b835-f59286d2516b.png,396,1045,498,1162,102,117,red blood cell,11934,1.1470588235294117,0.8717948717948718
23161,/images/c94a5851-b846-4fde-8c89-05bec3a8ac53.png,53,56,154,162,101,106,red blood cell,10706,1.0495049504950495,0.9528301886792453
35727,/images/4063945d-03fc-4ce3-a04c-17435dce8f91.png,446,395,540,502,94,107,red blood cell,10058,1.1382978723404256,0.8785046728971962
11747,/images/082e1f81-4f49-44ad-b5bb-9dfc155b2ed8.png,107,573,193,670,86,97,red blood cell,8342,1.127906976744186,0.8865979381443299
31029,/images/b59dc3a0-3d54-4e3b-a485-33b3e43966de.png,546,882,664,994,118,112,red blood cell,13216,0.9491525423728814,1.0535714285714286
14810,/images/f8b6a868-60e9-4569-ae69-638a0c39834d.png,964,327,1078,441,114,114,red blood cell,12996,1.0,1.0
55254,/images/8ad7ba46-5db8-4ba9-b3e0-3cac52f7efc3.png,992,424,1095,518,103,94,red blood cell,9682,0.912621359223301,1.0957446808510638
13098,/images/711f6b3f-cd63-46d1-834a-bc8e9aa9b43e.png,540,977,647,1080,107,103,red blood cell,11021,0.9626168224299065,1.0388349514563107
8160,/images/694222bb-cddf-469a-9526-f873c6fba58e.png,528,484,628,594,100,110,red blood cell,11000,1.1,0.9090909090909091
71908,/images/61575482-91e1-4db9-83c7-687b7ddbbfc4.png,283,1156,392,1256,109,100,red blood cell,10900,0.9174311926605505,1.09
3307,/images/b901c906-91be-48c4-88ec-2c527544a258.png,569,323,707,441,138,118,red blood cell,16284,0.855072463768116,1.1694915254237288
22247,/images/3d4d7ba7-6c7c-4ddd-b282-31fb5d80edb5.png,325,391,421,487,96,96,red blood cell,9216,1.0,1.0
63227,/images/d3283f5b-3b3a-40ea-800b-79960ca851cb.png,145,1012,272,1139,127,127,red blood cell,16129,1.0,1.0
50562,/images/e98ea067-82b5-4a0d-87bf-b4bbdc10ddab.png,1077,716,1189,840,112,124,red blood cell,13888,1.1071428571428572,0.9032258064516129
31174,/images/1976cd04-d24f-457c-b423-7e4cdb05de9e.png,662,647,790,765,128,118,red blood cell,15104,0.921875,1.0847457627118644
38907,/images/d79b4e90-c45d-4f5d-a498-49c3e323c291.png,143,1241,240,1354,97,113,red blood cell,10961,1.1649484536082475,0.8584070796460177
61242,/images/b3058064-d817-47dd-a8c4-cdb1f62374f8.png,759,446,882,560,123,114,red blood cell,14022,0.926829268292683,1.0789473684210527
40266,/images/f05ffdca-dc3a-47bd-a231-2a0d9bd1d50e.png,805,211,938,343,133,132,red blood cell,17556,0.9924812030075187,1.0075757575757576
52890,/images/abb2f9d6-26fa-4328-983c-959ef6717c05.png,628,1137,747,1256,119,119,red blood cell,14161,1.0,1.0
70774,/images/b62d47f9-2ff5-4902-abdc-b3610acfc7ba.png,267,1227,383,1353,116,126,red blood cell,14616,1.0862068965517242,0.9206349206349206
73440,/images/58594235-0d32-4a4e-91cd-4c800eaaaa73.png,930,990,1026,1081,96,91,red blood cell,8736,0.9479166666666666,1.054945054945055
3757,/images/dacf7e3f-1d8c-42a0-8539-3abe3971c956.png,580,293,711,422,131,129,red blood cell,16899,0.9847328244274809,1.0155038759689923
5694,/images/d3dcdf92-9328-4796-adf4-918646877ba1.png,974,735,1087,830,113,95,red blood cell,10735,0.8407079646017699,1.1894736842105262
27793,/images/e3c1442a-717f-41dd-bf97-81e1233ac9fa.png,471,905,569,1001,98,96,red blood cell,9408,0.9795918367346939,1.0208333333333333
37620,/images/205306da-0ed8-475a-ace6-f2f81d4be88a.png,1013,1440,1115,1540,102,100,red blood cell,10200,0.9803921568627451,1.02
59212,/images/4736f545-1f1f-4d77-9241-d69cbf4dae35.png,970,1355,1049,1430,79,75,red blood cell,5925,0.9493670886075949,1.0533333333333332
49183,/images/a9daf82a-a46d-4296-bd72-2c374ed0a193.png,810,816,929,936,119,120,red blood cell,14280,1.0084033613445378,0.9916666666666667
16712,/images/d6352a03-ef81-421d-915e-226499555d20.png,34,415,161,536,127,121,red blood cell,15367,0.952755905511811,1.0495867768595042
21175,/images/fb05b297-180a-4171-b633-09d5616d7534.png,398,413,520,528,122,115,red blood cell,14030,0.9426229508196722,1.0608695652173914
41708,/images/67abb826-9b70-4459-8764-da76ecf35bfe.png,326,591,455,712,129,121,red blood cell,15609,0.937984496124031,1.0661157024793388
56700,/images/89b3d781-2f81-4d23-bed4-84da064df7f3.png,1009,564,1112,667,103,103,red blood cell,10609,1.0,1.0
70378,/images/4876c9d0-b386-48fb-84e8-91bf87529161.png,65,221,176,315,111,94,red blood cell,10434,0.8468468468468469,1.1808510638297873
78611,/images/3612aa3b-2906-44a6-9c80-6144511a35ce.png,45,524,161,637,116,113,red blood cell,13108,0.9741379310344828,1.0265486725663717
20507,/images/cbde7f7e-2458-4dda-9db2-3d5ccf950ced.png,903,370,1020,494,117,124,red blood cell,14508,1.0598290598290598,0.9435483870967742
38721,/images/b5acf759-1115-42f0-a753-656736192528.png,820,971,935,1072,115,101,red blood cell,11615,0.8782608695652174,1.1386138613861385
24672,/images/30948737-0d0d-4b68-b9ab-50577e0fe026.png,641,871,750,991,109,120,red blood cell,13080,1.1009174311926606,0.9083333333333333
38243,/images/b834cbf7-ff97-49d9-9561-566c9343735c.png,42,1482,163,1598,121,116,red blood cell,14036,0.9586776859504132,1.043103448275862
65550,/images/01b38a56-13eb-447b-89ee-fc21cb40dcc1.png,995,134,1103,244,108,110,red blood cell,11880,1.0185185185185186,0.9818181818181818
69028,/images/b5246b58-6f40-4c9e-8024-f49b0ed6bdbd.png,113,727,228,853,115,126,red blood cell,14490,1.0956521739130434,0.9126984126984127
21164,/images/fb05b297-180a-4171-b633-09d5616d7534.png,265,195,370,312,105,117,red blood cell,12285,1.1142857142857143,0.8974358974358975
26453,/images/2c4d72f1-71a6-4bf1-b5d9-8023c7bbec74.png,549,1061,666,1189,117,128,red blood cell,14976,1.0940170940170941,0.9140625
58147,/images/d615b706-8f50-4d96-8de5-6858897528d0.png,198,249,328,377,130,128,red blood cell,16640,0.9846153846153847,1.015625
15762,/images/64113b22-03b1-4ab8-89ab-b2f32154fbbd.png,941,231,1036,320,95,89,red blood cell,8455,0.9368421052631579,1.0674157303370786
9876,/images/b4261fa5-876d-48ea-b6da-ec7ca5b48fe2.png,969,192,1094,310,125,118,red blood cell,14750,0.944,1.0593220338983051
17608,/images/70a95e58-ba60-4c1f-adcd-49c198dc2ba0.png,889,672,988,792,99,120,red blood cell,11880,1.2121212121212122,0.825
31753,/images/ab59c9e4-3e50-48b9-874d-060d317410cc.png,657,741,790,869,133,128,red blood cell,17024,0.9624060150375939,1.0390625
33510,/images/795d0331-da56-4d45-a58a-54803408ffd9.png,209,621,336,740,127,119,red blood cell,15113,0.937007874015748,1.0672268907563025
34288,/images/259da25f-40f3-4d37-bca9-a9c807af1547.png,916,6,1008,109,92,103,red blood cell,9476,1.1195652173913044,0.8932038834951457
66471,/images/5f66d20c-fbfe-44ec-a01b-8a09da24807e.png,1019,895,1106,981,87,86,red blood cell,7482,0.9885057471264368,1.0116279069767442
4185,/images/ac3358f1-ef9a-4ccc-b66c-da5e47e352e0.png,30,406,142,514,112,108,red blood cell,12096,0.9642857142857143,1.037037037037037
5042,/images/b7d0ae11-a393-4aec-8f68-6ba07147f78a.png,308,103,417,224,109,121,red blood cell,13189,1.110091743119266,0.9008264462809917
66732,/images/334bf865-e3fb-4200-bd53-d9ff5808ed9f.png,322,449,424,560,102,111,red blood cell,11322,1.088235294117647,0.918918918918919
38209,/images/1d9d4dac-66f9-4c87-b714-d723d5b15fa9.png,379,280,506,400,127,120,red blood cell,15240,0.9448818897637795,1.0583333333333333
27089,/images/ec301f62-1302-4407-96f9-fcfe45c150ae.png,588,194,693,311,105,117,red blood cell,12285,1.1142857142857143,0.8974358974358975
3861,/images/73dd09d3-2bff-4b5e-b996-9da0b8b54a8f.png,683,1313,801,1448,118,135,red blood cell,15930,1.1440677966101696,0.8740740740740741
50506,/images/79f2fbab-169d-4062-820d-3dfd12f062c8.png,967,889,1098,1001,131,112,red blood cell,14672,0.8549618320610687,1.1696428571428572
56114,/images/50d9fc90-8642-4bb6-91a7-0069a7e37392.png,112,597,202,683,90,86,red blood cell,7740,0.9555555555555556,1.0465116279069768
50392,/images/f01f6659-2114-4801-9d28-1f411432a589.png,930,1380,1036,1493,106,113,red blood cell,11978,1.0660377358490567,0.9380530973451328
72020,/images/6ad3efc9-4392-4cee-98a5-186564a96373.png,379,253,493,378,114,125,red blood cell,14250,1.0964912280701755,0.912
33234,/images/877d5e7f-19b6-40e7-81bd-c92f25e72503.png,485,66,602,192,117,126,red blood cell,14742,1.0769230769230769,0.9285714285714286
35121,/images/a6ba808f-ec60-42a5-ad91-7b32412ab708.png,635,1320,752,1448,117,128,red blood cell,14976,1.0940170940170941,0.9140625
2157,/images/e94a811d-3145-4313-ba42-2d5ed283179f.png,988,890,1086,989,98,99,red blood cell,9702,1.010204081632653,0.98989898989899
26026,/images/612bdd3c-da43-4321-a76b-c73c614928d1.png,423,230,557,355,134,125,red blood cell,16750,0.9328358208955224,1.072
38230,/images/1d9d4dac-66f9-4c87-b714-d723d5b15fa9.png,853,1330,980,1440,127,110,red blood cell,13970,0.8661417322834646,1.1545454545454545
31479,/images/6695a204-e39c-4418-b904-3f080fdbe7e8.png,885,263,980,366,95,103,red blood cell,9785,1.0842105263157895,0.9223300970873787
47190,/images/3d1b889e-bb4a-4ee6-b899-974ee7d956a7.png,268,0,358,101,90,101,red blood cell,9090,1.1222222222222222,0.8910891089108911
42373,/images/1a27ebe9-93a1-4898-af69-f276057d4012.png,444,1124,566,1255,122,131,red blood cell,15982,1.0737704918032787,0.9312977099236641
23718,/images/79d7a014-21ff-40f1-9ac4-a69839390654.png,215,887,304,978,89,91,red blood cell,8099,1.0224719101123596,0.978021978021978
9534,/images/a18f122f-3a3e-4478-8ac4-91b83e050e65.png,1063,1225,1176,1346,113,121,red blood cell,13673,1.0707964601769913,0.9338842975206612
57494,/images/00d04a90-80e5-4bce-9511-1b64eabb7a47.png,705,1142,791,1245,86,103,red blood cell,8858,1.197674418604651,0.8349514563106796
13699,/images/0b04ec46-5119-4cda-8c35-c4e5b6f0eed0.png,774,531,883,648,109,117,red blood cell,12753,1.073394495412844,0.9316239316239316
1618,/images/7094c11a-1e62-4f98-894e-d17d138a88e9.png,939,429,1040,519,101,90,red blood cell,9090,0.8910891089108911,1.1222222222222222
61203,/images/0da07970-3146-479c-8a07-f61ed32814a9.png,950,1180,1065,1282,115,102,red blood cell,11730,0.8869565217391304,1.1274509803921569
71755,/images/093a831a-bf71-4333-bc06-942ae70cb164.png,822,225,919,328,97,103,red blood cell,9991,1.0618556701030928,0.941747572815534
76135,/images/16244280-6c74-47d3-b544-9fd6831a6bf9.png,933,148,1031,254,98,106,red blood cell,10388,1.0816326530612246,0.9245283018867925
69680,/images/f0713bee-2a71-4ced-b953-4041ea99496a.png,643,1359,766,1488,123,129,red blood cell,15867,1.048780487804878,0.9534883720930233
34859,/images/4fc9a597-aaa8-43b0-ad1c-2eabbe442e84.png,956,1004,1054,1092,98,88,red blood cell,8624,0.8979591836734694,1.1136363636363635
68461,/images/74261741-4d6e-4dba-8ad4-4fbdf919c30f.png,962,754,1070,866,108,112,red blood cell,12096,1.037037037037037,0.9642857142857143
42032,/images/46a03374-64c7-49ac-81c9-c3d62542bbf3.png,635,1021,727,1108,92,87,red blood cell,8004,0.9456521739130435,1.0574712643678161
76788,/images/2165fe38-b474-467d-be11-d1d728085efd.png,410,517,510,616,100,99,red blood cell,9900,0.99,1.0101010101010102
75489,/images/6c20abb2-c4bb-4de0-8774-03f4d30ce93d.png,0,653,105,781,105,128,red blood cell,13440,1.2190476190476192,0.8203125
32408,/images/3911fcd2-4e26-4ad9-aaf0-d1c5bf41defc.png,1062,1256,1173,1362,111,106,red blood cell,11766,0.954954954954955,1.0471698113207548
5499,/images/eb6e8684-b84e-483d-b835-f59286d2516b.png,921,732,1042,849,121,117,red blood cell,14157,0.9669421487603306,1.0341880341880343
54546,/images/db871d17-28fd-4ceb-b421-e4e4afa0a7a0.png,920,1236,1020,1325,100,89,red blood cell,8900,0.89,1.1235955056179776
1302,/images/6d91d1f0-636b-4f5a-a526-7c17fc857190.png,640,487,729,573,89,86,red blood cell,7654,0.9662921348314607,1.0348837209302326
33269,/images/5721e41b-90ef-4851-8587-8dc71227ef90.png,952,535,1047,639,95,104,red blood cell,9880,1.0947368421052632,0.9134615384615384
4575,/images/0f26699f-a776-4424-b092-27da9a1d12e2.png,324,1490,432,1589,108,99,red blood cell,10692,0.9166666666666666,1.0909090909090908
34348,/images/1a48cbc1-5423-47e5-8ca5-2ab4f83a05a5.png,367,1030,464,1129,97,99,red blood cell,9603,1.0206185567010309,0.9797979797979798
78135,/images/bb137718-20ba-457d-8ffe-4f9420ecaab6.png,358,859,459,965,101,106,red blood cell,10706,1.0495049504950495,0.9528301886792453
25769,/images/1f8edb2a-40bc-4beb-aa6b-884d2473df0f.png,362,1343,485,1477,123,134,red blood cell,16482,1.089430894308943,0.917910447761194
36953,/images/b2e34f5f-904e-4473-9dc7-c6bc1ce12640.png,396,370,496,476,100,106,red blood cell,10600,1.06,0.9433962264150944
26485,/images/cdb086a8-2bf8-4436-b1ef-96cdd801f247.png,199,251,316,373,117,122,red blood cell,14274,1.0427350427350428,0.9590163934426229
13606,/images/d47cd049-d78b-4ba3-a7d4-399be4dd1dde.png,1058,837,1174,950,116,113,red blood cell,13108,0.9741379310344828,1.0265486725663717
11903,/images/2e8d6a43-0110-4bf4-8e70-20567e513b81.png,113,717,222,836,109,119,red blood cell,12971,1.091743119266055,0.9159663865546218
47379,/images/477e541c-0519-4542-9b13-8ee7922644d3.png,520,280,611,377,91,97,red blood cell,8827,1.065934065934066,0.9381443298969072
24230,/images/bb3ae957-0f6d-4615-bfe5-24fbca50b459.png,480,1177,593,1298,113,121,red blood cell,13673,1.0707964601769913,0.9338842975206612
24374,/images/4d8a4ce8-0f9c-4f21-8844-4cf0e5514bbf.png,598,1369,686,1477,88,108,red blood cell,9504,1.2272727272727273,0.8148148148148148
63189,/images/f0804a5e-e7f5-4cf2-a5df-b65e66502bf1.png,755,552,862,659,107,107,red blood cell,11449,1.0,1.0
56591,/images/a824b499-3736-4581-bbdc-be1b3b4cf756.png,43,363,158,497,115,134,red blood cell,15410,1.1652173913043478,0.8582089552238806
8029,/images/694222bb-cddf-469a-9526-f873c6fba58e.png,111,155,203,239,92,84,red blood cell,7728,0.9130434782608695,1.0952380952380953
70335,/images/90246988-0d6d-4bf8-8a76-94107de4121e.png,697,645,803,737,106,92,red blood cell,9752,0.8679245283018868,1.1521739130434783
10831,/images/2a02cec2-a09b-483a-ad38-14359a763fa4.png,338,854,439,958,101,104,red blood cell,10504,1.0297029702970297,0.9711538461538461
67334,/images/49c4dbd3-6269-4d4c-9648-a2146c57bab1.png,396,1505,475,1600,79,95,red blood cell,7505,1.2025316455696202,0.8315789473684211
47032,/images/997eabd9-55bf-4683-83c4-4cee4673a4ef.png,453,587,573,720,120,133,red blood cell,15960,1.1083333333333334,0.9022556390977443
8916,/images/04628a94-b674-469b-aff6-b476b70df87d.png,947,1097,1051,1206,104,109,red blood cell,11336,1.0480769230769231,0.9541284403669725
63767,/images/06401963-8b02-46c5-ab2a-3d70bd01623f.png,875,437,970,517,95,80,red blood cell,7600,0.8421052631578947,1.1875
15754,/images/64113b22-03b1-4ab8-89ab-b2f32154fbbd.png,61,652,164,765,103,113,red blood cell,11639,1.0970873786407767,0.911504424778761
59521,/images/6bfe6a90-8a69-4171-8e7f-42dc9417c6d9.png,693,746,794,859,101,113,red blood cell,11413,1.118811881188119,0.8938053097345132
55997,/images/4c460388-e0c1-4970-8527-c9e5b42bea49.png,568,206,671,318,103,112,red blood cell,11536,1.087378640776699,0.9196428571428571
22018,/images/c5acd0ad-b0f2-478d-b0ad-5aa733aa7b32.png,804,1377,906,1490,102,113,red blood cell,11526,1.107843137254902,0.9026548672566371
78860,/images/4d0a1598-e4dd-45c4-8a90-dd7c780fe1da.png,441,191,563,306,122,115,red blood cell,14030,0.9426229508196722,1.0608695652173914
9614,/images/239f17eb-a2e2-47e9-82e3-fa0d9a70fb9f.png,705,602,824,726,119,124,red blood cell,14756,1.0420168067226891,0.9596774193548387
68754,/images/eb5f4f2f-2275-4a80-84a5-78a1eaf4ce4d.png,610,280,735,399,125,119,red blood cell,14875,0.952,1.050420168067227
49468,/images/f2574be3-81c6-4fc3-8a40-0230d1264f52.png,792,565,883,672,91,107,red blood cell,9737,1.1758241758241759,0.8504672897196262
18714,/images/f6f8a69a-3fd2-4684-ac77-3e83ea0fb36d.png,893,123,1000,231,107,108,red blood cell,11556,1.0093457943925233,0.9907407407407407
3113,/images/14efbfc8-39f6-4599-9994-a8cc95605b9c.png,566,1170,692,1290,126,120,red blood cell,15120,0.9523809523809523,1.05
23749,/images/6b2ff7ca-c5b3-415c-9481-7b14efc6d7ef.png,192,1037,323,1160,131,123,red blood cell,16113,0.9389312977099237,1.065040650406504
33795,/images/cb08956d-dd6a-4e13-817b-40a0a93068f1.png,490,1112,584,1221,94,109,red blood cell,10246,1.1595744680851063,0.8623853211009175
25630,/images/770b8ca4-8377-479b-9ad5-5455ec3b44f8.png,746,196,856,306,110,110,red blood cell,12100,1.0,1.0
47313,/images/1dd3e6dd-343f-4cc9-b0ed-e4d27fb36f0a.png,73,562,202,673,129,111,red blood cell,14319,0.8604651162790697,1.162162162162162
50109,/images/e98baeb2-aa58-4cce-8c61-66685dd2b239.png,901,216,1035,327,134,111,red blood cell,14874,0.8283582089552238,1.2072072072072073
43368,/images/aabca37c-f9ef-4415-aab6-3246caa348e9.png,489,444,611,559,122,115,red blood cell,14030,0.9426229508196722,1.0608695652173914
34734,/images/6294153c-6db3-4f2b-a8ff-9c087225e737.png,698,1096,821,1227,123,131,red blood cell,16113,1.065040650406504,0.9389312977099237
78705,/images/76a8a5f5-1328-4539-a131-baf877f40cf3.png,812,1347,907,1446,95,99,red blood cell,9405,1.0421052631578946,0.9595959595959596
19483,/images/a85cd1ae-0c94-4387-8305-84ab8d96d137.png,102,155,219,284,117,129,red blood cell,15093,1.1025641025641026,0.9069767441860465
71901,/images/61575482-91e1-4db9-83c7-687b7ddbbfc4.png,365,152,473,277,108,125,red blood cell,13500,1.1574074074074074,0.864
4894,/images/61cd8c7d-394d-42d3-9ed4-e09559110bed.png,326,778,448,905,122,127,red blood cell,15494,1.040983606557377,0.9606299212598425
33508,/images/795d0331-da56-4d45-a58a-54803408ffd9.png,793,754,906,875,113,121,red blood cell,13673,1.0707964601769913,0.9338842975206612
34075,/images/de5d19b7-e670-4ac7-843b-7ce7bcebdf45.png,1023,1294,1150,1428,127,134,red blood cell,17018,1.0551181102362204,0.9477611940298507
15173,/images/3a8f468f-f9de-46a8-a7c8-f2be239fa207.png,160,1166,265,1257,105,91,red blood cell,9555,0.8666666666666667,1.1538461538461537
39502,/images/5a631871-2fc7-4a68-9c39-f3b9a0bf4a04.png,732,1217,817,1311,85,94,red blood cell,7990,1.1058823529411765,0.9042553191489362
65335,/images/24418314-f7a4-49fc-a03e-ec597ca6796e.png,195,374,270,462,75,88,red blood cell,6600,1.1733333333333333,0.8522727272727273
53984,/images/540a5fee-175b-4b92-bf62-1ea9b59c86c6.png,656,747,757,844,101,97,red blood cell,9797,0.9603960396039604,1.041237113402062
37609,/images/205306da-0ed8-475a-ace6-f2f81d4be88a.png,178,734,272,827,94,93,red blood cell,8742,0.9893617021276596,1.010752688172043
53329,/images/d8f7e159-b7e3-49e4-86e8-aed8c5fbcd97.png,732,448,834,540,102,92,red blood cell,9384,0.9019607843137255,1.108695652173913
24498,/images/109fbb82-bc3c-41ac-984d-e2da86202873.png,626,625,740,743,114,118,red blood cell,13452,1.0350877192982457,0.9661016949152542
48034,/images/1d4f06e1-9c9b-487e-84cd-e7e50cc754da.png,1001,22,1120,141,119,119,red blood cell,14161,1.0,1.0
18003,/images/eb77e4a9-acb0-4d83-8055-2c5fcaa54b45.png,167,1143,260,1243,93,100,red blood cell,9300,1.075268817204301,0.93
57475,/images/00d04a90-80e5-4bce-9511-1b64eabb7a47.png,802,1127,898,1225,96,98,red blood cell,9408,1.0208333333333333,0.9795918367346939
10721,/images/20d4f65e-6c63-433a-935c-d568d577967b.png,672,236,772,336,100,100,red blood cell,10000,1.0,1.0
39973,/images/8271d0d8-9985-43eb-94b3-c702adca139f.png,312,957,416,1057,104,100,red blood cell,10400,0.9615384615384616,1.04
10041,/images/26799d2b-a289-4eff-9218-0aad77e05e41.png,575,912,703,1049,128,137,red blood cell,17536,1.0703125,0.9343065693430657
13525,/images/370277f8-436b-4103-8210-b4feb5ab95ea.png,331,329,423,418,92,89,red blood cell,8188,0.967391304347826,1.0337078651685394
55645,/images/c32b8bb8-c89d-4ae9-9c77-5b9356ca35a1.png,694,1039,805,1153,111,114,red blood cell,12654,1.027027027027027,0.9736842105263158
6928,/images/a9feccda-18f2-405e-9aa1-409fa1f49fe4.png,555,467,649,571,94,104,red blood cell,9776,1.1063829787234043,0.9038461538461539
21669,/images/66183740-e1e5-43c9-8539-a87028bb3621.png,250,1016,355,1121,105,105,red blood cell,11025,1.0,1.0
17203,/images/471f75c6-bd5d-4c20-bcc1-258e836f4d69.png,934,136,1039,234,105,98,red blood cell,10290,0.9333333333333333,1.0714285714285714
34007,/images/701206c5-aaac-4b99-9cc0-4a6854359457.png,574,954,675,1043,101,89,red blood cell,8989,0.8811881188118812,1.1348314606741574
25556,/images/f6ab936d-924b-4038-aa47-71b07c26b4e2.png,194,371,322,494,128,123,red blood cell,15744,0.9609375,1.0406504065040652
8860,/images/29539cb0-1c52-46b2-9302-552f8349dc71.png,957,673,1076,786,119,113,red blood cell,13447,0.9495798319327731,1.0530973451327434
57122,/images/7d041c38-11f2-4186-8a24-29d7d0f5c3cf.png,838,1057,935,1170,97,113,red blood cell,10961,1.1649484536082475,0.8584070796460177
53227,/images/d8f7e159-b7e3-49e4-86e8-aed8c5fbcd97.png,433,274,532,357,99,83,red blood cell,8217,0.8383838383838383,1.1927710843373494
26498,/images/b2f05937-b965-4c4b-b86e-f50e95d9d691.png,23,1069,145,1197,122,128,red blood cell,15616,1.0491803278688525,0.953125
78516,/images/c94827ce-d619-4705-a68a-df63a2c95ffa.png,57,563,159,668,102,105,red blood cell,10710,1.0294117647058822,0.9714285714285714
21143,/images/fb05b297-180a-4171-b633-09d5616d7534.png,432,890,547,1016,115,126,red blood cell,14490,1.0956521739130434,0.9126984126984127
8730,/images/92e4fd7b-79ef-49c2-a52b-9ef13dd720ef.png,57,1,181,115,124,114,red blood cell,14136,0.9193548387096774,1.087719298245614
16227,/images/acdc6e12-73d9-44ba-be8c-2a56aaffef4f.png,163,1265,297,1382,134,117,red blood cell,15678,0.8731343283582089,1.1452991452991452
25284,/images/587e5464-d70b-4279-8562-010279f6efbd.png,640,1057,764,1175,124,118,red blood cell,14632,0.9516129032258065,1.0508474576271187
51083,/images/93f40356-5676-45d3-8e83-8028708c93ba.png,6,1452,119,1576,113,124,red blood cell,14012,1.0973451327433628,0.9112903225806451
12169,/images/87d6343b-70dd-4cdd-939f-d3ac0ca2e700.png,717,1394,827,1523,110,129,red blood cell,14190,1.1727272727272726,0.8527131782945736
61005,/images/3d1429ed-4619-41f7-8ff3-d698ad28034c.png,1005,1267,1111,1375,106,108,red blood cell,11448,1.0188679245283019,0.9814814814814815
58587,/images/7fd2d254-b062-4f3d-8970-687e73c5a00a.png,206,0,312,107,106,107,red blood cell,11342,1.009433962264151,0.9906542056074766
40434,/images/db249e5a-4142-432c-8288-bacd10d7273d.png,738,994,842,1094,104,100,red blood cell,10400,0.9615384615384616,1.04
44865,/images/83ec8923-6232-40d7-ba1f-a1b8bf7cb66c.png,875,1263,978,1375,103,112,red blood cell,11536,1.087378640776699,0.9196428571428571
51773,/images/f07174a5-f799-4286-ac43-5b0f5c5777ac.png,495,1422,575,1517,80,95,red blood cell,7600,1.1875,0.8421052631578947
3157,/images/729a38d6-66db-48e5-a00d-7d90d224290f.png,341,98,470,220,129,122,red blood cell,15738,0.9457364341085271,1.0573770491803278
25130,/images/9e74feb8-017d-4d53-8896-9ebda4327dd1.png,628,446,741,557,113,111,red blood cell,12543,0.9823008849557522,1.018018018018018
55292,/images/4fb83278-adc5-4424-9f45-b6d0db2955b6.png,150,431,258,539,108,108,red blood cell,11664,1.0,1.0
30549,/images/7d9c1422-6332-44e9-b134-3ac94f07b0f0.png,640,375,738,487,98,112,red blood cell,10976,1.1428571428571428,0.875
23983,/images/3d8fb5bf-3315-48fb-8ab1-802eafd550bc.png,933,603,1035,724,102,121,red blood cell,12342,1.1862745098039216,0.8429752066115702
44139,/images/8b494b40-cab5-49d3-893d-c805000fbe88.png,519,112,597,204,78,92,red blood cell,7176,1.1794871794871795,0.8478260869565217
73403,/images/c890ee00-daa5-4b20-9cd5-930748ecc4e0.png,376,1219,473,1316,97,97,red blood cell,9409,1.0,1.0
75330,/images/9ec1dcec-87c2-4aca-8e6b-0db3cd05509c.png,600,419,692,512,92,93,red blood cell,8556,1.0108695652173914,0.989247311827957
55361,/images/4fb83278-adc5-4424-9f45-b6d0db2955b6.png,217,945,311,1057,94,112,red blood cell,10528,1.1914893617021276,0.8392857142857143
51647,/images/592c941a-aa54-4971-b499-dc47356f80a3.png,551,1412,657,1526,106,114,red blood cell,12084,1.0754716981132075,0.9298245614035088
16383,/images/69569ecf-cfa1-4ddd-9342-b22c23387fdb.png,716,1435,828,1556,112,121,red blood cell,13552,1.0803571428571428,0.9256198347107438
29980,/images/deeaa5b3-3895-4aec-a2ce-ed6404862cdf.png,882,839,987,937,105,98,red blood cell,10290,0.9333333333333333,1.0714285714285714
75831,/images/c4c7ed75-dbdf-4bb6-b6ba-718903cf7264.png,844,584,931,686,87,102,red blood cell,8874,1.1724137931034482,0.8529411764705882
43900,/images/d7c7eb2c-2acd-4f86-8a5a-09ab3dd02d16.png,681,286,774,389,93,103,red blood cell,9579,1.10752688172043,0.9029126213592233
35477,/images/3722d213-f2a9-46d5-aa76-9183b443e455.png,529,247,631,360,102,113,red blood cell,11526,1.107843137254902,0.9026548672566371
21584,/images/49efc89d-9cba-44f7-8257-7f911b73f68a.png,858,370,961,466,103,96,red blood cell,9888,0.9320388349514563,1.0729166666666667
29323,/images/3850f2a5-ab62-49d3-8135-68d60baa676b.png,754,977,883,1094,129,117,red blood cell,15093,0.9069767441860465,1.1025641025641026
76285,/images/1574565f-f45b-4160-947e-25ce1a81aaca.png,23,575,131,686,108,111,red blood cell,11988,1.0277777777777777,0.972972972972973
68543,/images/32700bc7-7a86-49d3-aded-ccaaed4ddc5c.png,687,131,801,232,114,101,red blood cell,11514,0.8859649122807017,1.1287128712871286
61886,/images/f32b21ae-5ca7-490b-bc40-6db9396d933c.png,156,557,269,672,113,115,red blood cell,12995,1.0176991150442478,0.9826086956521739
17782,/images/1863da5f-c595-4541-a8f4-21fe78678168.png,1002,1327,1111,1441,109,114,red blood cell,12426,1.0458715596330275,0.956140350877193
72859,/images/31435107-c77d-42f8-a619-75cba6a5161b.png,463,1021,548,1122,85,101,red blood cell,8585,1.188235294117647,0.8415841584158416
54903,/images/8f84a2c9-ca38-4405-a488-12fcd101278b.png,674,1483,790,1599,116,116,red blood cell,13456,1.0,1.0
42719,/images/b8dd6125-5027-47e2-a283-14e199274c80.png,392,0,514,137,122,137,red blood cell,16714,1.1229508196721312,0.8905109489051095
29423,/images/b4e5e08d-6427-46f3-aca8-a4df165a151d.png,338,310,465,419,127,109,red blood cell,13843,0.8582677165354331,1.165137614678899
65087,/images/5e042380-6ef2-496f-8231-0ca550fbfa71.png,980,352,1108,470,128,118,red blood cell,15104,0.921875,1.0847457627118644
14434,/images/3b13e20f-ec0d-44ec-b2f4-eaebfa09150e.png,642,1224,745,1333,103,109,red blood cell,11227,1.058252427184466,0.944954128440367
17960,/images/eb77e4a9-acb0-4d83-8055-2c5fcaa54b45.png,68,1461,162,1568,94,107,red blood cell,10058,1.1382978723404256,0.8785046728971962
7677,/images/9f959520-e15e-45c2-bc29-ef3c19154d1c.png,169,167,280,258,111,91,red blood cell,10101,0.8198198198198198,1.2197802197802199
56879,/images/a588091c-5e4c-4e61-914d-e96f3ee3e505.png,449,871,546,978,97,107,red blood cell,10379,1.1030927835051547,0.9065420560747663
28704,/images/151f3af5-5e6e-4bcd-9389-4974fc68813e.png,543,355,646,453,103,98,red blood cell,10094,0.9514563106796117,1.0510204081632653
30607,/images/f939782b-f5a2-40a3-9c22-6c6d7e18edc3.png,883,171,991,277,108,106,red blood cell,11448,0.9814814814814815,1.0188679245283019
44928,/images/83ec8923-6232-40d7-ba1f-a1b8bf7cb66c.png,310,976,409,1072,99,96,red blood cell,9504,0.9696969696969697,1.03125
45057,/images/13bab3c3-3f79-44d9-a287-0ae6d71eff31.png,729,123,846,249,117,126,red blood cell,14742,1.0769230769230769,0.9285714285714286
27296,/images/9f38055f-4fe6-47fd-a6dd-c0743db4eccf.png,880,1206,992,1315,112,109,red blood cell,12208,0.9732142857142857,1.0275229357798166
25450,/images/5f742392-278d-461c-a848-08def2c28878.png,529,350,633,463,104,113,red blood cell,11752,1.0865384615384615,0.9203539823008849
47977,/images/eba73bff-fbe1-436d-9a5f-0a61331a0ea2.png,133,1093,212,1185,79,92,red blood cell,7268,1.1645569620253164,0.8586956521739131
17456,/images/56077789-8580-41b4-89d6-deea227e5c60.png,506,676,617,786,111,110,red blood cell,12210,0.990990990990991,1.009090909090909
43405,/images/aabca37c-f9ef-4415-aab6-3246caa348e9.png,1087,1396,1200,1497,113,101,red blood cell,11413,0.8938053097345132,1.118811881188119
17144,/images/dc3bdfe9-1565-4cda-9c4e-0979846dab60.png,658,190,781,321,123,131,red blood cell,16113,1.065040650406504,0.9389312977099237
2506,/images/a23f5539-bfe6-4885-9a0e-dba972475ea9.png,813,819,929,916,116,97,red blood cell,11252,0.8362068965517241,1.1958762886597938
16184,/images/1e978dfa-d339-4025-809d-09cee76728ed.png,871,377,991,497,120,120,red blood cell,14400,1.0,1.0
52565,/images/0546d843-d778-4aca-b8b5-bfe23d7c87da.png,1076,1157,1168,1269,92,112,red blood cell,10304,1.2173913043478262,0.8214285714285714
39784,/images/5c68070c-3391-4db6-8c01-94175105dbea.png,13,976,139,1110,126,134,red blood cell,16884,1.0634920634920635,0.9402985074626866
59749,/images/f77d7469-d083-4c2d-a4ea-5a9ff162e3e2.png,367,329,487,441,120,112,red blood cell,13440,0.9333333333333333,1.0714285714285714
13761,/images/1b369bcf-ced4-4ae2-9196-2664bd2b1738.png,219,943,318,1058,99,115,red blood cell,11385,1.1616161616161615,0.8608695652173913
77961,/images/c691c8ef-d3c7-47b6-a941-f6a1089f21a9.png,153,340,258,451,105,111,red blood cell,11655,1.0571428571428572,0.9459459459459459
45990,/images/72088c26-d2dd-4906-b791-b8947fc7fbe4.png,710,1482,804,1584,94,102,red blood cell,9588,1.0851063829787233,0.9215686274509803
6782,/images/672e4ecf-a56b-462e-b83b-76f4efaa6634.png,777,102,875,190,98,88,red blood cell,8624,0.8979591836734694,1.1136363636363635
8028,/images/694222bb-cddf-469a-9526-f873c6fba58e.png,37,715,130,822,93,107,red blood cell,9951,1.1505376344086022,0.8691588785046729
76348,/images/3dad6483-ac30-4d2b-b045-9f24fe6ff75e.png,985,541,1079,653,94,112,red blood cell,10528,1.1914893617021276,0.8392857142857143
65620,/images/01b38a56-13eb-447b-89ee-fc21cb40dcc1.png,211,396,290,481,79,85,red blood cell,6715,1.0759493670886076,0.9294117647058824
18778,/images/cc882eae-a341-4783-bd19-8bdedf798538.png,923,191,1029,308,106,117,red blood cell,12402,1.1037735849056605,0.905982905982906
72949,/images/a20d0b4b-6e2e-4507-bc22-f321dedc4ed9.png,258,232,361,318,103,86,red blood cell,8858,0.8349514563106796,1.197674418604651
13449,/images/370277f8-436b-4103-8210-b4feb5ab95ea.png,1078,986,1179,1090,101,104,red blood cell,10504,1.0297029702970297,0.9711538461538461
28971,/images/b12ae3b1-613c-4c0e-9163-3c5cc314abf5.png,446,597,560,708,114,111,red blood cell,12654,0.9736842105263158,1.027027027027027
2939,/images/00a02700-2ea2-4590-9e15-ffc9160fd3de.png,103,1069,208,1184,105,115,red blood cell,12075,1.0952380952380953,0.9130434782608695
35605,/images/45f18ac0-f097-4b20-a99d-8837cf488822.png,429,1132,541,1241,112,109,red blood cell,12208,0.9732142857142857,1.0275229357798166
48242,/images/71204a6d-814e-44b6-9cee-7b979f478021.png,59,1035,175,1136,116,101,red blood cell,11716,0.8706896551724138,1.1485148514851484
30253,/images/cecbf663-0751-4e7f-b298-770c88afc2c1.png,958,287,1059,384,101,97,red blood cell,9797,0.9603960396039604,1.041237113402062
48986,/images/df3d98b9-3dd7-4107-8d4a-ae1b7f247793.png,354,1353,437,1453,83,100,red blood cell,8300,1.2048192771084338,0.83
51728,/images/592c941a-aa54-4971-b499-dc47356f80a3.png,387,1371,491,1466,104,95,red blood cell,9880,0.9134615384615384,1.0947368421052632
44935,/images/83ec8923-6232-40d7-ba1f-a1b8bf7cb66c.png,28,409,130,505,102,96,red blood cell,9792,0.9411764705882353,1.0625
56705,/images/89b3d781-2f81-4d23-bed4-84da064df7f3.png,587,1319,673,1425,86,106,red blood cell,9116,1.2325581395348837,0.8113207547169812
55780,/images/68f34a9c-f73d-4238-8f55-4b05a8a2154c.png,954,1450,1044,1551,90,101,red blood cell,9090,1.1222222222222222,0.8910891089108911
2304,/images/fe851c88-692d-4199-87e0-d19d9c4eb591.png,661,868,754,962,93,94,red blood cell,8742,1.010752688172043,0.9893617021276596
38700,/images/b5acf759-1115-42f0-a753-656736192528.png,854,828,962,917,108,89,red blood cell,9612,0.8240740740740741,1.2134831460674158
57121,/images/7d041c38-11f2-4186-8a24-29d7d0f5c3cf.png,536,1374,634,1484,98,110,red blood cell,10780,1.1224489795918366,0.8909090909090909
62653,/images/f7a4334a-4332-4de8-b39b-22da907976f2.png,1008,1239,1102,1338,94,99,red blood cell,9306,1.053191489361702,0.9494949494949495
10318,/images/f91670db-be74-474c-bd72-68120aed4756.png,526,387,644,483,118,96,red blood cell,11328,0.8135593220338984,1.2291666666666667
36578,/images/21f001d6-f568-4ea4-82da-fab54c77c419.png,505,824,610,931,105,107,red blood cell,11235,1.019047619047619,0.9813084112149533
55627,/images/c32b8bb8-c89d-4ae9-9c77-5b9356ca35a1.png,412,919,523,1032,111,113,red blood cell,12543,1.018018018018018,0.9823008849557522
16217,/images/acdc6e12-73d9-44ba-be8c-2a56aaffef4f.png,239,1,360,102,121,101,red blood cell,12221,0.8347107438016529,1.198019801980198
72850,/images/31435107-c77d-42f8-a619-75cba6a5161b.png,114,794,209,902,95,108,red blood cell,10260,1.1368421052631579,0.8796296296296297
7947,/images/933e7e07-fc3d-42eb-be0c-6b1623ee60fa.png,598,1421,696,1530,98,109,red blood cell,10682,1.1122448979591837,0.8990825688073395
15018,/images/3003252a-2d2e-4687-ad30-9c38d68f1394.png,444,360,562,473,118,113,red blood cell,13334,0.9576271186440678,1.0442477876106195
66913,/images/9acf303a-fcba-4e52-be3e-8d061aa5e72a.png,297,1467,400,1565,103,98,red blood cell,10094,0.9514563106796117,1.0510204081632653
62328,/images/e0ff3476-226f-4125-b182-8e524d5503dd.png,140,384,240,486,100,102,red blood cell,10200,1.02,0.9803921568627451
53038,/images/42e87148-a015-4148-923a-fb83016f64e7.png,1050,1447,1166,1569,116,122,red blood cell,14152,1.0517241379310345,0.9508196721311475
28942,/images/b12ae3b1-613c-4c0e-9163-3c5cc314abf5.png,415,91,529,202,114,111,red blood cell,12654,0.9736842105263158,1.027027027027027
11475,/images/2f9f400d-2d67-4118-aaa1-9094bc4b0e47.png,885,882,1003,1013,118,131,red blood cell,15458,1.1101694915254237,0.9007633587786259
50128,/images/4cccfcf0-cac9-46f0-870c-0eabfdc781ba.png,979,1011,1103,1144,124,133,red blood cell,16492,1.0725806451612903,0.9323308270676691
12395,/images/3b55c42f-ad59-422f-ba99-4f4f4ca9cb2e.png,940,818,1047,910,107,92,red blood cell,9844,0.8598130841121495,1.1630434782608696
18099,/images/947348fe-4c70-468e-8009-3c14daeca69b.png,59,784,174,887,115,103,red blood cell,11845,0.8956521739130435,1.116504854368932
1696,/images/5f783f43-0090-4f8a-bd75-9562f4aa2dd5.png,107,348,232,458,125,110,red blood cell,13750,0.88,1.1363636363636365
39867,/images/af2e63a3-9fde-46aa-a867-81c5c259d1dc.png,80,430,182,543,102,113,red blood cell,11526,1.107843137254902,0.9026548672566371
17364,/images/04018590-4e66-4cb9-ad2d-83570f1b29ae.png,1072,659,1185,776,113,117,red blood cell,13221,1.0353982300884956,0.9658119658119658
55610,/images/c32b8bb8-c89d-4ae9-9c77-5b9356ca35a1.png,511,1272,621,1382,110,110,red blood cell,12100,1.0,1.0
25960,/images/e683144c-0465-43a2-86b1-3cf52599d5e0.png,962,1429,1069,1532,107,103,red blood cell,11021,0.9626168224299065,1.0388349514563107
35075,/images/67582df6-bf13-4c83-a531-1214692b70de.png,575,847,689,966,114,119,red blood cell,13566,1.043859649122807,0.957983193277311
65703,/images/c54fcef1-0c51-4426-9a93-15ec5f2bf58a.png,823,158,930,267,107,109,red blood cell,11663,1.0186915887850467,0.981651376146789
35430,/images/002f20ad-2ace-499c-9335-c9080bc3e6b5.png,226,648,344,770,118,122,red blood cell,14396,1.0338983050847457,0.9672131147540983
41492,/images/c4494d4f-732f-431a-8a9d-62403f0b74fe.png,641,884,721,963,80,79,red blood cell,6320,0.9875,1.0126582278481013
49499,/images/9f33e0ea-065b-4703-9df9-15829b891860.png,1092,409,1186,523,94,114,red blood cell,10716,1.2127659574468086,0.8245614035087719
57089,/images/7d041c38-11f2-4186-8a24-29d7d0f5c3cf.png,665,706,763,814,98,108,red blood cell,10584,1.1020408163265305,0.9074074074074074
21209,/images/0ceb4539-5c4c-487d-9826-452a88b5d537.png,808,401,938,517,130,116,red blood cell,15080,0.8923076923076924,1.1206896551724137
5278,/images/729733ff-a349-4a96-b636-ccabe7d7e167.png,488,1219,568,1314,80,95,red blood cell,7600,1.1875,0.8421052631578947
44895,/images/83ec8923-6232-40d7-ba1f-a1b8bf7cb66c.png,358,579,469,683,111,104,red blood cell,11544,0.9369369369369369,1.0673076923076923
21693,/images/81af1442-d835-46bf-b80b-a898dba3da1b.png,540,37,647,148,107,111,red blood cell,11877,1.0373831775700935,0.963963963963964
30704,/images/8e0dfc1f-e3eb-4a3f-a1c4-249bdfbfaa27.png,939,237,1048,340,109,103,red blood cell,11227,0.944954128440367,1.058252427184466
23532,/images/177f883a-f0f1-4b8e-b598-2ca4bab27381.png,681,1088,804,1212,123,124,red blood cell,15252,1.008130081300813,0.9919354838709677
46729,/images/da111ca5-520f-4ea8-97ad-ae5fce58ee91.png,551,473,642,564,91,91,red blood cell,8281,1.0,1.0
53602,/images/7bcd3735-3134-46d1-8ca2-d4379f2d51c0.png,434,245,528,332,94,87,red blood cell,8178,0.925531914893617,1.0804597701149425
23206,/images/3dcd4f1b-ce43-4a34-b1ed-076bb42963b1.png,55,89,168,207,113,118,red blood cell,13334,1.0442477876106195,0.9576271186440678
13683,/images/1e86933d-6a5a-4a3c-a0f2-ca22afd767b3.png,794,804,894,913,100,109,red blood cell,10900,1.09,0.9174311926605505
20294,/images/98976666-9125-47fe-9601-43c41e58dfb4.png,1015,761,1112,868,97,107,red blood cell,10379,1.1030927835051547,0.9065420560747663
52441,/images/a2a20600-f851-4db7-90f9-6f7be027c8b5.png,95,492,172,585,77,93,red blood cell,7161,1.2077922077922079,0.8279569892473119
64824,/images/a74b6d6a-7e04-40ac-9292-d62f13f7ded3.png,408,1069,505,1166,97,97,red blood cell,9409,1.0,1.0
24239,/images/bb3ae957-0f6d-4615-bfe5-24fbca50b459.png,501,130,620,244,119,114,red blood cell,13566,0.957983193277311,1.043859649122807
70840,/images/bf002a25-6535-4621-be19-56d468be5413.png,462,182,574,297,112,115,red blood cell,12880,1.0267857142857142,0.9739130434782609
51861,/images/d67398c5-8b0e-463f-a04e-8583c820786c.png,585,1371,698,1482,113,111,red blood cell,12543,0.9823008849557522,1.018018018018018
42677,/images/3abbc4d3-1d7e-40c9-9963-33732da7cc50.png,910,1491,992,1585,82,94,red blood cell,7708,1.146341463414634,0.8723404255319149
9050,/images/ef815e3a-02a6-4cf8-9262-45bc74c50b00.png,860,967,962,1069,102,102,red blood cell,10404,1.0,1.0
54405,/images/22a464ef-c3da-4d56-b37e-e22e95d945e7.png,338,498,434,607,96,109,red blood cell,10464,1.1354166666666667,0.8807339449541285
24149,/images/505355c9-23bf-4f90-8ebc-6a7ef50964d0.png,263,1280,358,1358,95,78,red blood cell,7410,0.8210526315789474,1.2179487179487178
37392,/images/08f5a524-0554-49c2-83a8-ae9a6d51e8fd.png,410,1038,517,1130,107,92,red blood cell,9844,0.8598130841121495,1.1630434782608696
73681,/images/f11d05e4-538a-4024-8711-b08a4ce3c540.png,914,863,1018,979,104,116,red blood cell,12064,1.1153846153846154,0.896551724137931
73206,/images/85546330-4efd-43e2-87aa-d53a30220bfc.png,933,1043,1030,1151,97,108,red blood cell,10476,1.1134020618556701,0.8981481481481481
14450,/images/3b13e20f-ec0d-44ec-b2f4-eaebfa09150e.png,364,1323,473,1439,109,116,red blood cell,12644,1.0642201834862386,0.9396551724137931
43334,/images/36569710-a574-40be-ad42-897a6e74a128.png,719,218,847,350,128,132,red blood cell,16896,1.03125,0.9696969696969697
4002,/images/a5e05ba8-0c19-41e3-92d5-10e42a03b85e.png,74,1327,195,1442,121,115,red blood cell,13915,0.9504132231404959,1.0521739130434782
72657,/images/6ab870ba-b24b-49a9-9570-8eafe63aa74e.png,488,70,585,179,97,109,red blood cell,10573,1.1237113402061856,0.8899082568807339
74032,/images/fe436c09-b680-4f4c-8faf-aa10a55a335b.png,963,155,1073,269,110,114,red blood cell,12540,1.0363636363636364,0.9649122807017544
36740,/images/aa2dfa24-2dc3-4279-a232-f84780ace190.png,359,1336,462,1450,103,114,red blood cell,11742,1.1067961165048543,0.9035087719298246
67399,/images/266180ed-77a3-4284-8292-50a49fc47fce.png,584,729,670,820,86,91,red blood cell,7826,1.058139534883721,0.945054945054945
30880,/images/fbc1f360-4382-48bb-a32e-3f5f2f9dbe57.png,107,700,202,795,95,95,red blood cell,9025,1.0,1.0
45124,/images/56fbae44-4677-47f8-9c3a-22dac043c115.png,394,204,510,319,116,115,red blood cell,13340,0.9913793103448276,1.008695652173913
12817,/images/b634137b-bc8b-4e88-b0e3-b536ad6e7e18.png,993,1208,1097,1301,104,93,red blood cell,9672,0.8942307692307693,1.118279569892473
51375,/images/b4f3b2a4-f4b9-48de-ac5d-0e681b77be27.png,973,541,1084,661,111,120,red blood cell,13320,1.0810810810810811,0.925
33134,/images/6231d81d-9e84-4a5a-8cb8-47c6a37a0176.png,450,1186,542,1269,92,83,red blood cell,7636,0.9021739130434783,1.108433734939759
8274,/images/65e3d6a6-012c-4b40-9a42-83078eb85e31.png,293,1227,382,1319,89,92,red blood cell,8188,1.0337078651685394,0.967391304347826
36588,/images/21f001d6-f568-4ea4-82da-fab54c77c419.png,831,784,944,895,113,111,red blood cell,12543,0.9823008849557522,1.018018018018018
32716,/images/0154dd8e-72f8-4d78-a4dd-93e139577bd1.png,704,813,812,942,108,129,red blood cell,13932,1.1944444444444444,0.8372093023255814
54090,/images/d9345456-b76d-46cc-b81e-46d4a0a7b652.png,563,180,641,269,78,89,red blood cell,6942,1.141025641025641,0.8764044943820225
70132,/images/c742ee2c-6814-46cd-af56-ae87bb9972f4.png,185,440,286,530,101,90,red blood cell,9090,0.8910891089108911,1.1222222222222222
32155,/images/25cfca07-2101-484f-b312-a927395f2651.png,797,405,925,522,128,117,red blood cell,14976,0.9140625,1.0940170940170941
68033,/images/89b276cc-cc8f-4378-a877-e01aff333373.png,401,1041,529,1152,128,111,red blood cell,14208,0.8671875,1.1531531531531531
58774,/images/e4827c85-311a-4df1-89c2-99dad0c3558c.png,215,475,310,581,95,106,red blood cell,10070,1.1157894736842104,0.8962264150943396
51543,/images/6afb3717-f197-4668-929a-4fab389ae6e8.png,855,1037,968,1160,113,123,red blood cell,13899,1.0884955752212389,0.9186991869918699
53778,/images/76b24246-8571-4e7b-8815-b185414a2c51.png,291,207,387,294,96,87,red blood cell,8352,0.90625,1.103448275862069
39691,/images/56adbb1e-96a8-40a5-a5a2-243c97ea889b.png,213,1018,318,1143,105,125,red blood cell,13125,1.1904761904761905,0.84
25810,/images/14b68d86-ac7f-419d-b4a5-6b0b1d9aaa18.png,152,1016,281,1148,129,132,red blood cell,17028,1.0232558139534884,0.9772727272727273
40780,/images/252071ac-e9f2-41d2-abbb-87ef01b8a997.png,667,972,763,1065,96,93,red blood cell,8928,0.96875,1.032258064516129
4815,/images/3fa1a4e3-c80d-49da-8f7b-a1abb0424f48.png,389,1038,500,1144,111,106,red blood cell,11766,0.954954954954955,1.0471698113207548
63908,/images/5e974892-0ebe-4037-8427-ea8616d6d3b8.png,860,1296,960,1414,100,118,red blood cell,11800,1.18,0.847457627118644
30869,/images/fbc1f360-4382-48bb-a32e-3f5f2f9dbe57.png,219,901,331,1018,112,117,red blood cell,13104,1.0446428571428572,0.9572649572649573
60077,/images/e63e1607-f344-43d6-a0d8-e10cf2e5054a.png,1073,1086,1189,1204,116,118,red blood cell,13688,1.0172413793103448,0.9830508474576272
56231,/images/b600b38d-225b-46a5-b6f8-b607430f6a10.png,723,7,824,127,101,120,red blood cell,12120,1.188118811881188,0.8416666666666667
35335,/images/452482bc-24a3-413e-ba03-fad4c9d61f3c.png,796,1167,906,1286,110,119,red blood cell,13090,1.0818181818181818,0.9243697478991597
29391,/images/b4e5e08d-6427-46f3-aca8-a4df165a151d.png,98,690,206,789,108,99,red blood cell,10692,0.9166666666666666,1.0909090909090908
79851,/images/a054a8e2-55f2-4508-97df-207f76b89be2.png,914,680,1010,796,96,116,red blood cell,11136,1.2083333333333333,0.8275862068965517
34411,/images/1a48cbc1-5423-47e5-8ca5-2ab4f83a05a5.png,592,943,722,1059,130,116,red blood cell,15080,0.8923076923076924,1.1206896551724137
3481,/images/ad36bd67-594b-4f63-93e3-886af0bc618e.png,1077,1365,1189,1463,112,98,red blood cell,10976,0.875,1.1428571428571428
15593,/images/169d541c-daed-468e-8b41-0f1abccdf319.png,478,1100,585,1207,107,107,red blood cell,11449,1.0,1.0
53505,/images/43158031-a335-4533-9c20-48bebba90123.png,663,1229,758,1313,95,84,red blood cell,7980,0.8842105263157894,1.130952380952381
71858,/images/61575482-91e1-4db9-83c7-687b7ddbbfc4.png,387,273,489,366,102,93,red blood cell,9486,0.9117647058823529,1.096774193548387
57992,/images/7942691b-6376-4c75-ae8a-ddf65454dcb2.png,642,3,753,112,111,109,red blood cell,12099,0.9819819819819819,1.018348623853211
13798,/images/1b369bcf-ced4-4ae2-9196-2664bd2b1738.png,509,24,644,144,135,120,red blood cell,16200,0.8888888888888888,1.125
16447,/images/e474a20b-2769-48f1-a520-4f6ef5a0dbf5.png,1101,1339,1194,1423,93,84,red blood cell,7812,0.9032258064516129,1.1071428571428572
60416,/images/8d5d5c22-2f75-4fe1-9ea3-03a3c7b92ea9.png,986,548,1106,672,120,124,red blood cell,14880,1.0333333333333334,0.967741935483871
9303,/images/261562a8-ffd8-4e0e-919b-22e267000b74.png,323,1058,443,1173,120,115,red blood cell,13800,0.9583333333333334,1.0434782608695652
55768,/images/68f34a9c-f73d-4238-8f55-4b05a8a2154c.png,407,305,497,396,90,91,red blood cell,8190,1.011111111111111,0.989010989010989
41729,/images/32a1ea24-b6b7-4253-ad3e-bdf99c2c9b9d.png,13,280,127,415,114,135,red blood cell,15390,1.1842105263157894,0.8444444444444444
47845,/images/5a105b89-c592-4d78-b208-7db6c6572752.png,148,1433,267,1529,119,96,red blood cell,11424,0.8067226890756303,1.2395833333333333
7176,/images/56551792-4aa1-4301-9f8f-8bfebcd20050.png,658,1029,782,1130,124,101,red blood cell,12524,0.8145161290322581,1.2277227722772277
9682,/images/53afd70c-08a7-4b9a-b137-7003b2ecbeab.png,247,1262,374,1383,127,121,red blood cell,15367,0.952755905511811,1.0495867768595042
12459,/images/cc94eabb-a3dc-4cfc-9fff-55c76b5b4a71.png,931,751,1031,862,100,111,red blood cell,11100,1.11,0.9009009009009009
62567,/images/9ecf2006-8d49-4ae8-a14b-ed8b3b14ee7c.png,1049,1192,1178,1304,129,112,red blood cell,14448,0.8682170542635659,1.1517857142857142
32841,/images/2a6370b0-08f1-4c11-a639-265d4419c9a3.png,38,1463,143,1570,105,107,red blood cell,11235,1.019047619047619,0.9813084112149533
53114,/images/04a567df-5463-4043-81f1-d726223c19a9.png,576,828,689,926,113,98,red blood cell,11074,0.8672566371681416,1.153061224489796
48562,/images/f3d84be2-8af0-4d62-9f72-23d3dc08cbbe.png,75,707,185,840,110,133,red blood cell,14630,1.209090909090909,0.8270676691729323
60230,/images/214f1d15-a081-476e-992d-6c3a77f03d59.png,1075,396,1164,488,89,92,red blood cell,8188,1.0337078651685394,0.967391304347826
50711,/images/6b4c79f5-b194-4586-be9f-e339c5af4188.png,763,1397,880,1527,117,130,red blood cell,15210,1.1111111111111112,0.9
49905,/images/5e17f8e6-fd8d-426c-b444-1515d14f04b7.png,802,139,891,233,89,94,red blood cell,8366,1.0561797752808988,0.9468085106382979
31008,/images/b59dc3a0-3d54-4e3b-a485-33b3e43966de.png,146,1242,278,1350,132,108,red blood cell,14256,0.8181818181818182,1.2222222222222223
75564,/images/c35ee701-fde2-46b5-b178-1fe3f1ea7da2.png,875,284,973,390,98,106,red blood cell,10388,1.0816326530612246,0.9245283018867925
76023,/images/4c7d2382-a962-4237-a053-955eea3decd8.png,707,68,803,159,96,91,red blood cell,8736,0.9479166666666666,1.054945054945055
12420,/images/cc94eabb-a3dc-4cfc-9fff-55c76b5b4a71.png,625,263,734,379,109,116,red blood cell,12644,1.0642201834862386,0.9396551724137931
13475,/images/370277f8-436b-4103-8210-b4feb5ab95ea.png,457,148,539,240,82,92,red blood cell,7544,1.1219512195121952,0.8913043478260869
78088,/images/105af41b-13cc-4ad1-8a1f-8bc4d47cdd94.png,1084,513,1185,618,101,105,red blood cell,10605,1.0396039603960396,0.9619047619047619
58332,/images/319c9c52-f316-49f3-baad-4444ab19f85b.png,852,1010,946,1111,94,101,red blood cell,9494,1.074468085106383,0.9306930693069307
58074,/images/a7c91b63-b97c-4f4b-8d34-7ad2b08d7a17.png,992,108,1067,195,75,87,red blood cell,6525,1.16,0.8620689655172413
4075,/images/e02edd82-c424-4dee-98a7-575640655d9b.png,971,1269,1060,1378,89,109,red blood cell,9701,1.2247191011235956,0.8165137614678899
56964,/images/a93c35ba-1690-4358-8837-669bcd850bb7.png,451,608,566,714,115,106,red blood cell,12190,0.9217391304347826,1.0849056603773586
77221,/images/fe691faa-3bc7-475e-b558-aa8fe7b795bc.png,508,914,607,1030,99,116,red blood cell,11484,1.1717171717171717,0.853448275862069
16293,/images/d5009906-bce1-4353-90b4-f4c79362f4cf.png,688,633,806,734,118,101,red blood cell,11918,0.8559322033898306,1.1683168316831682
34759,/images/6294153c-6db3-4f2b-a8ff-9c087225e737.png,343,17,478,126,135,109,red blood cell,14715,0.8074074074074075,1.238532110091743
2334,/images/fe851c88-692d-4199-87e0-d19d9c4eb591.png,1097,292,1193,380,96,88,red blood cell,8448,0.9166666666666666,1.0909090909090908
71325,/images/bcb447c9-5d37-414f-a513-d7076b04a532.png,91,1144,206,1249,115,105,red blood cell,12075,0.9130434782608695,1.0952380952380953
2189,/images/e94a811d-3145-4313-ba42-2d5ed283179f.png,890,36,1006,138,116,102,red blood cell,11832,0.8793103448275862,1.1372549019607843
39848,/images/af2e63a3-9fde-46aa-a867-81c5c259d1dc.png,396,1037,505,1146,109,109,red blood cell,11881,1.0,1.0
14225,/images/c186dcd1-af61-455f-9619-1fdd8c881b06.png,233,122,327,226,94,104,red blood cell,9776,1.1063829787234043,0.9038461538461539
23550,/images/177f883a-f0f1-4b8e-b598-2ca4bab27381.png,798,313,917,433,119,120,red blood cell,14280,1.0084033613445378,0.9916666666666667
75691,/images/50d7c6c9-3230-48fe-947c-7dcfd0aad710.png,67,89,178,192,111,103,red blood cell,11433,0.9279279279279279,1.0776699029126213
33469,/images/9bd40bc6-4949-42d3-b38f-d60422932f65.png,890,289,1015,412,125,123,red blood cell,15375,0.984,1.016260162601626
15661,/images/84d7545e-c3a8-4b1f-9a39-36aab78c8699.png,320,1300,435,1417,115,117,red blood cell,13455,1.017391304347826,0.9829059829059829
19050,/images/6e39fb0a-aa41-4b16-b783-7589e97bf289.png,435,276,575,388,140,112,red blood cell,15680,0.8,1.25
25644,/images/770b8ca4-8377-479b-9ad5-5455ec3b44f8.png,116,991,229,1101,113,110,red blood cell,12430,0.9734513274336283,1.0272727272727273
52666,/images/3f390b82-8859-4c27-bbfe-d1b242477f63.png,492,565,603,667,111,102,red blood cell,11322,0.918918918918919,1.088235294117647
36929,/images/b2e34f5f-904e-4473-9dc7-c6bc1ce12640.png,834,907,924,1013,90,106,red blood cell,9540,1.1777777777777778,0.8490566037735849
35209,/images/a9159b11-ba49-4885-902e-00c8d5095b98.png,868,982,982,1084,114,102,red blood cell,11628,0.8947368421052632,1.1176470588235294
71118,/images/b666fcc2-d0b2-441e-bc5a-c660345eeb5d.png,553,346,669,461,116,115,red blood cell,13340,0.9913793103448276,1.008695652173913
14067,/images/eaf4b781-b3aa-41ce-8c5e-287979b4e15a.png,89,55,185,142,96,87,red blood cell,8352,0.90625,1.103448275862069
19034,/images/e9e78ff8-831b-46e9-9785-3eee9acbfcd8.png,693,1520,787,1600,94,80,red blood cell,7520,0.851063829787234,1.175
22222,/images/3d4d7ba7-6c7c-4ddd-b282-31fb5d80edb5.png,754,1375,857,1480,103,105,red blood cell,10815,1.0194174757281553,0.9809523809523809
18190,/images/947348fe-4c70-468e-8009-3c14daeca69b.png,57,505,151,613,94,108,red blood cell,10152,1.148936170212766,0.8703703703703703
59216,/images/4736f545-1f1f-4d77-9241-d69cbf4dae35.png,456,795,553,888,97,93,red blood cell,9021,0.9587628865979382,1.043010752688172
73829,/images/3eba916c-998b-40a7-993c-7ed916c2a04c.png,600,408,692,515,92,107,red blood cell,9844,1.1630434782608696,0.8598130841121495
22476,/images/99d6a7e5-128e-4455-841d-8fbd1663905e.png,373,1171,487,1303,114,132,red blood cell,15048,1.1578947368421053,0.8636363636363636
16126,/images/66557580-fd38-4d4b-80d8-88611ecc78c6.png,767,374,881,507,114,133,red blood cell,15162,1.1666666666666667,0.8571428571428571
12163,/images/87d6343b-70dd-4cdd-939f-d3ac0ca2e700.png,811,563,930,683,119,120,red blood cell,14280,1.0084033613445378,0.9916666666666667
1791,/images/5f783f43-0090-4f8a-bd75-9562f4aa2dd5.png,130,1164,215,1250,85,86,red blood cell,7310,1.011764705882353,0.9883720930232558
68455,/images/040112be-3c8d-49aa-93f1-522f94a592ff.png,873,933,957,1007,84,74,red blood cell,6216,0.8809523809523809,1.135135135135135
55728,/images/c32b8bb8-c89d-4ae9-9c77-5b9356ca35a1.png,23,978,132,1090,109,112,red blood cell,12208,1.0275229357798166,0.9732142857142857
76926,/images/25ddc1ca-d368-4fff-b1ad-1dbf1e7c97aa.png,263,1139,356,1231,93,92,red blood cell,8556,0.989247311827957,1.0108695652173914
43869,/images/679ae89f-4a02-4301-862e-1d844cc66cbf.png,102,990,234,1122,132,132,red blood cell,17424,1.0,1.0
37455,/images/c6530038-6d4e-49e1-8427-d1d3acc9fa21.png,893,1318,1015,1443,122,125,red blood cell,15250,1.0245901639344261,0.976
49731,/images/5e17f8e6-fd8d-426c-b444-1515d14f04b7.png,578,117,672,220,94,103,red blood cell,9682,1.0957446808510638,0.912621359223301
38111,/images/907650b5-edae-471d-bc54-a825be3d3fac.png,664,1320,792,1464,128,144,red blood cell,18432,1.125,0.8888888888888888
59061,/images/5e2cea49-0823-49d1-83cf-8fd1559cdd93.png,290,116,402,237,112,121,red blood cell,13552,1.0803571428571428,0.9256198347107438
2112,/images/e94a811d-3145-4313-ba42-2d5ed283179f.png,436,1061,539,1164,103,103,red blood cell,10609,1.0,1.0
70910,/images/bf002a25-6535-4621-be19-56d468be5413.png,688,640,806,752,118,112,red blood cell,13216,0.9491525423728814,1.0535714285714286
69349,/images/2ac343e4-c889-47c1-8fe2-461b626def76.png,504,495,631,619,127,124,red blood cell,15748,0.9763779527559056,1.0241935483870968
58687,/images/a4d7a7e1-5ae1-486d-b6ee-c9af1476ccad.png,195,1015,270,1095,75,80,red blood cell,6000,1.0666666666666667,0.9375
12625,/images/0901f9d1-be4f-4c19-8e83-dd724dded9f5.png,843,205,962,323,119,118,red blood cell,14042,0.9915966386554622,1.0084745762711864
21616,/images/66183740-e1e5-43c9-8539-a87028bb3621.png,190,11,293,117,103,106,red blood cell,10918,1.029126213592233,0.9716981132075472
21344,/images/8dace03a-10c4-4d59-bcd9-a2c314c5df33.png,53,766,174,888,121,122,red blood cell,14762,1.0082644628099173,0.9918032786885246
46023,/images/72088c26-d2dd-4906-b791-b8947fc7fbe4.png,1059,1321,1175,1420,116,99,red blood cell,11484,0.853448275862069,1.1717171717171717
64003,/images/5e974892-0ebe-4037-8427-ea8616d6d3b8.png,724,1150,825,1250,101,100,red blood cell,10100,0.9900990099009901,1.01
76289,/images/1574565f-f45b-4160-947e-25ce1a81aaca.png,742,967,856,1081,114,114,red blood cell,12996,1.0,1.0
19417,/images/5487faad-24a7-46b6-92d8-479d3a8d229f.png,549,1432,651,1541,102,109,red blood cell,11118,1.0686274509803921,0.9357798165137615
48120,/images/05717db9-f1ef-4101-a9f7-7a007e83b1c9.png,935,536,1052,648,117,112,red blood cell,13104,0.9572649572649573,1.0446428571428572
17745,/images/b5143aae-6e98-4dc6-b546-980cb472de67.png,710,359,832,468,122,109,red blood cell,13298,0.8934426229508197,1.1192660550458715
64264,/images/83d4e1fe-da84-4175-a9e2-8efc18782dcf.png,281,9,408,118,127,109,red blood cell,13843,0.8582677165354331,1.165137614678899
53385,/images/766d5547-8dd2-4c8d-b78e-3007f83932e8.png,371,862,482,970,111,108,red blood cell,11988,0.972972972972973,1.0277777777777777
50187,/images/4cccfcf0-cac9-46f0-870c-0eabfdc781ba.png,68,408,156,500,88,92,red blood cell,8096,1.0454545454545454,0.9565217391304348
46929,/images/9e0e1928-d19a-4100-b093-0b962ac09e05.png,161,374,267,492,106,118,red blood cell,12508,1.1132075471698113,0.8983050847457628
62721,/images/9e1b0217-0926-4fd1-bb9e-a815c05deb59.png,622,893,743,1014,121,121,red blood cell,14641,1.0,1.0
67050,/images/1fe1e118-adb8-4b10-a41e-1e5814e8f067.png,169,1109,298,1225,129,116,red blood cell,14964,0.8992248062015504,1.1120689655172413
67702,/images/2b128a1a-95ed-408b-b9f8-8795cc814d80.png,36,11,140,95,104,84,red blood cell,8736,0.8076923076923077,1.2380952380952381
19027,/images/e9e78ff8-831b-46e9-9785-3eee9acbfcd8.png,923,556,1024,654,101,98,red blood cell,9898,0.9702970297029703,1.030612244897959
26556,/images/4935818a-7e7a-4f44-a3b6-b361d1abfe16.png,185,1370,296,1497,111,127,red blood cell,14097,1.1441441441441442,0.8740157480314961
38872,/images/d79b4e90-c45d-4f5d-a498-49c3e323c291.png,324,1264,415,1372,91,108,red blood cell,9828,1.1868131868131868,0.8425925925925926
58946,/images/7aae78ce-ac97-478d-983c-c0ec290171df.png,729,901,861,1012,132,111,red blood cell,14652,0.8409090909090909,1.1891891891891893
46434,/images/bbecf1a8-a728-4c83-87f8-4dfbac0a1e03.png,825,189,922,297,97,108,red blood cell,10476,1.1134020618556701,0.8981481481481481
48706,/images/bc832bde-d3ea-4a8e-be90-7a3329dcc314.png,474,1363,589,1480,115,117,red blood cell,13455,1.017391304347826,0.9829059829059829
59516,/images/6bfe6a90-8a69-4171-8e7f-42dc9417c6d9.png,872,357,974,459,102,102,red blood cell,10404,1.0,1.0
35850,/images/027ab174-e47a-44f8-b85b-372449eeb7d8.png,921,945,1047,1055,126,110,red blood cell,13860,0.873015873015873,1.1454545454545455
51690,/images/592c941a-aa54-4971-b499-dc47356f80a3.png,1052,529,1143,620,91,91,red blood cell,8281,1.0,1.0
73329,/images/c890ee00-daa5-4b20-9cd5-930748ecc4e0.png,540,803,633,905,93,102,red blood cell,9486,1.096774193548387,0.9117647058823529
214,/images/2559636b-f01a-4414-93da-210c3b12d153.png,59,653,175,766,116,113,red blood cell,13108,0.9741379310344828,1.0265486725663717
56548,/images/ac8df764-c8d8-4312-916d-70bfb37574b4.png,535,636,631,739,96,103,red blood cell,9888,1.0729166666666667,0.9320388349514563
22815,/images/72105bb0-8e39-48be-b7f7-5b32f047b99e.png,303,1250,425,1361,122,111,red blood cell,13542,0.9098360655737705,1.0990990990990992
52798,/images/0a747cb3-c720-4572-a661-ab5670a5c42e.png,629,1185,744,1301,115,116,red blood cell,13340,1.008695652173913,0.9913793103448276
58051,/images/a7c91b63-b97c-4f4b-8d34-7ad2b08d7a17.png,1072,889,1165,990,93,101,red blood cell,9393,1.086021505376344,0.9207920792079208
35829,/images/bb2042c5-35e1-43cc-8171-7de81b764361.png,823,460,923,546,100,86,red blood cell,8600,0.86,1.1627906976744187
42427,/images/1a27ebe9-93a1-4898-af69-f276057d4012.png,283,769,389,893,106,124,red blood cell,13144,1.169811320754717,0.8548387096774194
355,/images/7c66d2fd-68ee-4628-b860-9d7ad25b2a80.png,173,842,274,942,101,100,red blood cell,10100,0.9900990099009901,1.01
37734,/images/fe0c5e48-f65e-488c-9c3c-1ea7c7835c0c.png,38,517,145,611,107,94,red blood cell,10058,0.8785046728971962,1.1382978723404256
79402,/images/dcb21739-3c36-459d-b3cc-1be5871d6fe7.png,910,729,1031,831,121,102,red blood cell,12342,0.8429752066115702,1.1862745098039216
27622,/images/a0785022-e82b-4878-b9d4-19cb7b75213f.png,913,1327,1015,1429,102,102,red blood cell,10404,1.0,1.0
7366,/images/89f10192-d3dd-4996-a571-4c851dbdc983.png,558,89,651,188,93,99,red blood cell,9207,1.064516129032258,0.9393939393939394
73496,/images/5f2b32bd-fdca-4d6f-b13a-ee9f83626c8d.png,164,1164,257,1256,93,92,red blood cell,8556,0.989247311827957,1.0108695652173914
24642,/images/30948737-0d0d-4b68-b9ab-50577e0fe026.png,1046,248,1166,371,120,123,red blood cell,14760,1.025,0.975609756097561
72244,/images/7d4d0646-26b5-46fa-ab25-452d986e887b.png,1108,371,1189,462,81,91,red blood cell,7371,1.123456790123457,0.8901098901098901
20913,/images/c2ec116f-f091-422c-926c-70b548a8f6ef.png,444,567,523,660,79,93,red blood cell,7347,1.1772151898734178,0.8494623655913979
72062,/images/64b0e49a-0e48-447d-8872-c1dd255e7a21.png,480,1179,613,1299,133,120,red blood cell,15960,0.9022556390977443,1.1083333333333334
41208,/images/eed298b3-35f2-4127-88ad-0c4a9062207b.png,1027,516,1134,616,107,100,red blood cell,10700,0.9345794392523364,1.07
76437,/images/34df8890-272d-423a-ae78-ff8d068d3306.png,845,1105,931,1191,86,86,red blood cell,7396,1.0,1.0
51667,/images/592c941a-aa54-4971-b499-dc47356f80a3.png,867,1043,975,1157,108,114,red blood cell,12312,1.0555555555555556,0.9473684210526315
78769,/images/9174f910-3859-4839-8e30-2c3b25269322.png,958,839,1065,951,107,112,red blood cell,11984,1.0467289719626167,0.9553571428571429
20101,/images/81a2748d-51c9-4439-995d-f747871d6544.png,61,1170,180,1282,119,112,red blood cell,13328,0.9411764705882353,1.0625
60747,/images/645cd195-af50-409f-8da9-6e7c7f18ea09.png,552,861,656,973,104,112,red blood cell,11648,1.0769230769230769,0.9285714285714286
36610,/images/21f001d6-f568-4ea4-82da-fab54c77c419.png,167,247,298,376,131,129,red blood cell,16899,0.9847328244274809,1.0155038759689923
57109,/images/7d041c38-11f2-4186-8a24-29d7d0f5c3cf.png,993,134,1082,226,89,92,red blood cell,8188,1.0337078651685394,0.967391304347826
58654,/images/a4d7a7e1-5ae1-486d-b6ee-c9af1476ccad.png,909,274,1015,374,106,100,red blood cell,10600,0.9433962264150944,1.06
22032,/images/c5acd0ad-b0f2-478d-b0ad-5aa733aa7b32.png,376,552,494,680,118,128,red blood cell,15104,1.0847457627118644,0.921875
28919,/images/b12ae3b1-613c-4c0e-9163-3c5cc314abf5.png,326,1329,430,1441,104,112,red blood cell,11648,1.0769230769230769,0.9285714285714286
77128,/images/dd6f047e-af73-43df-9c46-354534fc20e0.png,330,855,441,967,111,112,red blood cell,12432,1.009009009009009,0.9910714285714286
42686,/images/3abbc4d3-1d7e-40c9-9963-33732da7cc50.png,741,32,847,142,106,110,red blood cell,11660,1.0377358490566038,0.9636363636363636
39541,/images/5a631871-2fc7-4a68-9c39-f3b9a0bf4a04.png,161,372,263,481,102,109,red blood cell,11118,1.0686274509803921,0.9357798165137615
69615,/images/4a49841f-216c-4815-8140-b8762c4f6603.png,5,1299,91,1390,86,91,red blood cell,7826,1.058139534883721,0.945054945054945
74779,/images/91e93160-eb8d-4de0-b6bc-b98ec33d1663.png,887,560,1007,679,120,119,red blood cell,14280,0.9916666666666667,1.0084033613445378
66097,/images/191f87a4-6f2d-49e7-bba0-08e3aa78ddaf.png,1018,1296,1117,1396,99,100,red blood cell,9900,1.0101010101010102,0.99
66364,/images/e5fd5949-4cd0-4cb6-837a-02c26a5eb87a.png,818,1075,944,1198,126,123,red blood cell,15498,0.9761904761904762,1.024390243902439
25144,/images/9e74feb8-017d-4d53-8896-9ebda4327dd1.png,1071,483,1174,571,103,88,red blood cell,9064,0.8543689320388349,1.1704545454545454
11186,/images/6303f964-98ef-47c6-bb2d-283aa393f918.png,985,551,1076,645,91,94,red blood cell,8554,1.032967032967033,0.9680851063829787
32191,/images/07346d2e-a6e6-4dc0-95f1-9f7d8d7e3f66.png,1058,1075,1163,1178,105,103,red blood cell,10815,0.9809523809523809,1.0194174757281553
6059,/images/72732579-a812-4496-b2dd-ea1556924337.png,975,1045,1086,1147,111,102,red blood cell,11322,0.918918918918919,1.088235294117647
14121,/images/eaf4b781-b3aa-41ce-8c5e-287979b4e15a.png,229,812,320,898,91,86,red blood cell,7826,0.945054945054945,1.058139534883721
58134,/images/e9916e11-9be6-4dec-9df6-2e7d1a8e1735.png,90,962,199,1081,109,119,red blood cell,12971,1.091743119266055,0.9159663865546218
44852,/images/83ec8923-6232-40d7-ba1f-a1b8bf7cb66c.png,167,264,276,369,109,105,red blood cell,11445,0.963302752293578,1.0380952380952382
3899,/images/65e865f3-acfb-4d01-a75f-ff5a535ffa6a.png,525,1416,645,1533,120,117,red blood cell,14040,0.975,1.0256410256410255
73210,/images/85546330-4efd-43e2-87aa-d53a30220bfc.png,6,652,99,747,93,95,red blood cell,8835,1.021505376344086,0.9789473684210527
24563,/images/c03d9b87-e19b-402b-ad86-b30d6e8aeb59.png,427,554,524,653,97,99,red blood cell,9603,1.0206185567010309,0.9797979797979798
34583,/images/a0eedcb9-b85c-4612-b945-7e8227f53c35.png,956,329,1069,451,113,122,red blood cell,13786,1.079646017699115,0.9262295081967213
56959,/images/a93c35ba-1690-4358-8837-669bcd850bb7.png,121,1376,208,1474,87,98,red blood cell,8526,1.1264367816091954,0.8877551020408163
13260,/images/711f6b3f-cd63-46d1-834a-bc8e9aa9b43e.png,455,62,533,146,78,84,red blood cell,6552,1.0769230769230769,0.9285714285714286
53345,/images/d8f7e159-b7e3-49e4-86e8-aed8c5fbcd97.png,329,1092,425,1184,96,92,red blood cell,8832,0.9583333333333334,1.0434782608695652
57822,/images/c9ad92d4-b408-4506-916e-def47b2e6ed0.png,496,956,598,1072,102,116,red blood cell,11832,1.1372549019607843,0.8793103448275862
52621,/images/a6fe423a-5204-4378-bcfa-d6d298a3e9aa.png,686,1085,801,1210,115,125,red blood cell,14375,1.0869565217391304,0.92
49770,/images/5e17f8e6-fd8d-426c-b444-1515d14f04b7.png,783,438,875,530,92,92,red blood cell,8464,1.0,1.0
39596,/images/04d21589-b777-43c2-86b5-038cbf8c3a4e.png,189,831,304,956,115,125,red blood cell,14375,1.0869565217391304,0.92
50016,/images/b1145408-feae-4637-b4cf-3e70b99cc62d.png,952,1254,1062,1378,110,124,red blood cell,13640,1.1272727272727272,0.8870967741935484
72406,/images/a15e0fa8-2620-4f66-896e-175115c9dc3d.png,656,654,753,763,97,109,red blood cell,10573,1.1237113402061856,0.8899082568807339
47504,/images/adff132d-3af0-4cef-942c-58fc09729bee.png,41,1356,143,1456,102,100,red blood cell,10200,0.9803921568627451,1.02
5299,/images/06df7bbe-60d4-4f7c-ba4a-5a42ac4be91b.png,134,1036,249,1172,115,136,red blood cell,15640,1.182608695652174,0.8455882352941176
13512,/images/370277f8-436b-4103-8210-b4feb5ab95ea.png,452,1449,528,1540,76,91,red blood cell,6916,1.1973684210526316,0.8351648351648352
73689,/images/f11d05e4-538a-4024-8711-b08a4ce3c540.png,466,1100,575,1216,109,116,red blood cell,12644,1.0642201834862386,0.9396551724137931
1674,/images/5f783f43-0090-4f8a-bd75-9562f4aa2dd5.png,887,1004,985,1108,98,104,red blood cell,10192,1.0612244897959184,0.9423076923076923
72965,/images/a20d0b4b-6e2e-4507-bc22-f321dedc4ed9.png,807,970,897,1075,90,105,red blood cell,9450,1.1666666666666667,0.8571428571428571
67043,/images/1fe1e118-adb8-4b10-a41e-1e5814e8f067.png,511,1347,616,1457,105,110,red blood cell,11550,1.0476190476190477,0.9545454545454546
38790,/images/b426ef1d-4a59-4f90-b593-50226af60a60.png,546,289,657,413,111,124,red blood cell,13764,1.117117117117117,0.8951612903225806
28222,/images/036404d1-b9fc-497b-bbe1-f4d9c5ac3ce0.png,688,901,780,994,92,93,red blood cell,8556,1.0108695652173914,0.989247311827957
50930,/images/ef8fcfa4-8466-4186-8c69-f5f4904eb489.png,396,110,528,228,132,118,red blood cell,15576,0.8939393939393939,1.11864406779661
67636,/images/59542a24-b409-4c95-8608-d9691a741526.png,43,191,116,275,73,84,red blood cell,6132,1.1506849315068493,0.8690476190476191
74115,/images/9fe8bdc8-847d-434e-93e5-ae14ff3b45e1.png,766,822,878,933,112,111,red blood cell,12432,0.9910714285714286,1.009009009009009
10516,/images/46a2d369-4bea-4405-ac78-91bbe130b9a7.png,983,652,1084,750,101,98,red blood cell,9898,0.9702970297029703,1.030612244897959
37868,/images/56a57a8d-c9b9-432a-a3b0-32a09355806c.png,403,1035,512,1151,109,116,red blood cell,12644,1.0642201834862386,0.9396551724137931
44024,/images/de81bf7a-7a56-437f-a068-4d9c3e01134c.png,756,1358,873,1471,117,113,red blood cell,13221,0.9658119658119658,1.0353982300884956
25049,/images/ed0bee2f-05e0-4392-8357-19750cec577c.png,1074,1456,1177,1541,103,85,red blood cell,8755,0.8252427184466019,1.2117647058823529
56449,/images/d75933ed-d26e-4d1f-bda3-96bc0d77fb36.png,1027,439,1123,545,96,106,red blood cell,10176,1.1041666666666667,0.9056603773584906
34244,/images/259da25f-40f3-4d37-bca9-a9c807af1547.png,778,652,899,780,121,128,red blood cell,15488,1.0578512396694215,0.9453125
29274,/images/6274fe0d-0d71-40be-b61b-f0bd5b5df1e2.png,912,1296,997,1401,85,105,red blood cell,8925,1.2352941176470589,0.8095238095238095
71205,/images/86495bbf-687b-429c-b9d3-6c2681ade7e2.png,27,1170,133,1279,106,109,red blood cell,11554,1.028301886792453,0.9724770642201835
56148,/images/50d9fc90-8642-4bb6-91a7-0069a7e37392.png,287,1462,385,1564,98,102,red blood cell,9996,1.0408163265306123,0.9607843137254902
48167,/images/913099c5-8085-4908-bf4b-1f098bbfcf66.png,1042,1236,1141,1334,99,98,red blood cell,9702,0.98989898989899,1.010204081632653
57474,/images/00d04a90-80e5-4bce-9511-1b64eabb7a47.png,839,1348,914,1434,75,86,red blood cell,6450,1.1466666666666667,0.872093023255814
8695,/images/92e4fd7b-79ef-49c2-a52b-9ef13dd720ef.png,796,1104,920,1217,124,113,red blood cell,14012,0.9112903225806451,1.0973451327433628
17468,/images/56077789-8580-41b4-89d6-deea227e5c60.png,542,1025,647,1144,105,119,red blood cell,12495,1.1333333333333333,0.8823529411764706
72754,/images/caeb2d62-1166-43f0-8eac-5b8fc48f02eb.png,148,776,270,888,122,112,red blood cell,13664,0.9180327868852459,1.0892857142857142
46629,/images/da111ca5-520f-4ea8-97ad-ae5fce58ee91.png,315,1124,423,1240,108,116,red blood cell,12528,1.0740740740740742,0.9310344827586207
55560,/images/a27b451d-44a6-4740-861a-9e7e99915563.png,880,645,977,733,97,88,red blood cell,8536,0.9072164948453608,1.1022727272727273
33195,/images/877d5e7f-19b6-40e7-81bd-c92f25e72503.png,935,1183,1059,1310,124,127,red blood cell,15748,1.0241935483870968,0.9763779527559056
59113,/images/5e2cea49-0823-49d1-83cf-8fd1559cdd93.png,741,157,836,253,95,96,red blood cell,9120,1.0105263157894737,0.9895833333333334
31490,/images/83ec1cb9-1714-4bf1-81f6-115fde84564d.png,11,735,128,864,117,129,red blood cell,15093,1.1025641025641026,0.9069767441860465
22533,/images/bfe65b11-8aff-46aa-908b-1e989d25fdc4.png,988,41,1107,143,119,102,red blood cell,12138,0.8571428571428571,1.1666666666666667
54742,/images/10891eed-b0f2-4dd0-90cb-da185f6761b2.png,455,1228,562,1324,107,96,red blood cell,10272,0.897196261682243,1.1145833333333333
13895,/images/7d65d296-0f7b-41cc-9073-a547e24326c8.png,711,500,840,636,129,136,red blood cell,17544,1.054263565891473,0.9485294117647058
35216,/images/a9159b11-ba49-4885-902e-00c8d5095b98.png,708,535,800,644,92,109,red blood cell,10028,1.184782608695652,0.8440366972477065
5082,/images/b7f1a1eb-c150-4456-9c47-e7db8a5cb77a.png,438,181,569,307,131,126,red blood cell,16506,0.9618320610687023,1.0396825396825398
8304,/images/65e3d6a6-012c-4b40-9a42-83078eb85e31.png,498,418,596,516,98,98,red blood cell,9604,1.0,1.0
23153,/images/c94a5851-b846-4fde-8c89-05bec3a8ac53.png,180,1443,313,1573,133,130,red blood cell,17290,0.9774436090225563,1.023076923076923
66015,/images/25c6cfb1-01d0-4864-87f9-02b7593683c7.png,923,262,998,344,75,82,red blood cell,6150,1.0933333333333333,0.9146341463414634
1094,/images/edcb4d77-a4d3-465d-9b59-eb3087766b1c.png,66,640,179,755,113,115,red blood cell,12995,1.0176991150442478,0.9826086956521739
15378,/images/035f6c4b-0897-46ab-9c3b-5f3b0feff043.png,656,1479,763,1585,107,106,red blood cell,11342,0.9906542056074766,1.009433962264151
46196,/images/d8632217-ec33-4d0a-98e6-427824c58869.png,986,360,1106,473,120,113,red blood cell,13560,0.9416666666666667,1.0619469026548674
40807,/images/252071ac-e9f2-41d2-abbb-87ef01b8a997.png,1113,444,1191,524,78,80,red blood cell,6240,1.0256410256410255,0.975
43482,/images/5a539312-6cfa-43e6-8d5d-db883f343ad9.png,810,213,928,346,118,133,red blood cell,15694,1.1271186440677967,0.8872180451127819
68713,/images/dcf7a19a-ec3d-44ef-8d7c-33b1e91fb9af.png,327,705,446,823,119,118,red blood cell,14042,0.9915966386554622,1.0084745762711864
10607,/images/20d4f65e-6c63-433a-935c-d568d577967b.png,270,1056,396,1182,126,126,red blood cell,15876,1.0,1.0
28703,/images/151f3af5-5e6e-4bcd-9389-4974fc68813e.png,717,323,830,424,113,101,red blood cell,11413,0.8938053097345132,1.118811881188119
21434,/images/b701b5c5-b922-4315-b12a-aac4ec65ee8b.png,657,993,764,1097,107,104,red blood cell,11128,0.9719626168224299,1.0288461538461537
37026,/images/b2e34f5f-904e-4473-9dc7-c6bc1ce12640.png,251,380,364,500,113,120,red blood cell,13560,1.0619469026548674,0.9416666666666667
3635,/images/8bd71314-e38a-4670-bb25-5cd6c9acb595.png,364,1166,476,1278,112,112,red blood cell,12544,1.0,1.0
2070,/images/f3bd0fcc-647d-4ca0-8c43-a16bd6ea3878.png,16,1126,151,1240,135,114,red blood cell,15390,0.8444444444444444,1.1842105263157894
60723,/images/45651e76-4bd0-45e5-895b-edec65f51987.png,562,1437,665,1523,103,86,red blood cell,8858,0.8349514563106796,1.197674418604651
46131,/images/72088c26-d2dd-4906-b791-b8947fc7fbe4.png,423,827,516,903,93,76,red blood cell,7068,0.8172043010752689,1.2236842105263157
65304,/images/24418314-f7a4-49fc-a03e-ec597ca6796e.png,399,236,485,338,86,102,red blood cell,8772,1.186046511627907,0.8431372549019608
45398,/images/e4eea7ea-8989-46a9-9c98-25a178146b28.png,1100,695,1184,786,84,91,red blood cell,7644,1.0833333333333333,0.9230769230769231
65070,/images/ff3b9d4d-373c-48ef-a75a-d23e2c2ade87.png,458,650,540,748,82,98,red blood cell,8036,1.1951219512195121,0.8367346938775511
55461,/images/d67655e6-0a80-4a86-b552-1f5e85788377.png,620,140,718,221,98,81,red blood cell,7938,0.826530612244898,1.2098765432098766
27888,/images/948c94ad-395c-41f4-9a68-8a1dcb76888c.png,662,760,769,852,107,92,red blood cell,9844,0.8598130841121495,1.1630434782608696
12648,/images/0901f9d1-be4f-4c19-8e83-dd724dded9f5.png,443,1,586,118,143,117,red blood cell,16731,0.8181818181818182,1.2222222222222223
64900,/images/dec61ae1-5037-4c3a-8952-15371becca7d.png,370,530,468,637,98,107,red blood cell,10486,1.0918367346938775,0.9158878504672897
19735,/images/627d6331-7bb9-4d1a-b20d-e6541af4d0f9.png,147,614,249,718,102,104,red blood cell,10608,1.0196078431372548,0.9807692307692307
47886,/images/ab27173b-6e30-4957-bd68-29194328fd39.png,998,334,1118,460,120,126,red blood cell,15120,1.05,0.9523809523809523
75575,/images/c35ee701-fde2-46b5-b178-1fe3f1ea7da2.png,316,1174,414,1268,98,94,red blood cell,9212,0.9591836734693877,1.0425531914893618
12467,/images/cc94eabb-a3dc-4cfc-9fff-55c76b5b4a71.png,171,892,285,1000,114,108,red blood cell,12312,0.9473684210526315,1.0555555555555556
33177,/images/6231d81d-9e84-4a5a-8cb8-47c6a37a0176.png,782,308,891,423,109,115,red blood cell,12535,1.055045871559633,0.9478260869565217
31349,/images/04fb49a2-07b8-4cdf-b6f7-df5c3688e5f8.png,822,1075,921,1180,99,105,red blood cell,10395,1.0606060606060606,0.9428571428571428
72226,/images/7d4d0646-26b5-46fa-ab25-452d986e887b.png,302,1211,410,1320,108,109,red blood cell,11772,1.0092592592592593,0.9908256880733946
75814,/images/c4c7ed75-dbdf-4bb6-b6ba-718903cf7264.png,209,1277,334,1402,125,125,red blood cell,15625,1.0,1.0
42926,/images/7d4c2160-317f-48d1-a60a-788ec300b3e8.png,656,1186,794,1312,138,126,red blood cell,17388,0.9130434782608695,1.0952380952380953
54571,/images/59dc7da9-35d1-421e-a61b-1e9637bfbfa1.png,97,928,213,1047,116,119,red blood cell,13804,1.0258620689655173,0.9747899159663865
59943,/images/f0fe292d-85ae-4c3a-a676-037dde2594e6.png,973,693,1076,792,103,99,red blood cell,10197,0.9611650485436893,1.0404040404040404
77528,/images/2d2e81f3-e329-4765-9ba1-2c95f12dc9f3.png,545,338,638,433,93,95,red blood cell,8835,1.021505376344086,0.9789473684210527
68464,/images/74261741-4d6e-4dba-8ad4-4fbdf919c30f.png,908,1056,1020,1172,112,116,red blood cell,12992,1.0357142857142858,0.9655172413793104
33950,/images/1a332b2c-9d49-4ff2-810c-5633d2314527.png,361,1270,485,1404,124,134,red blood cell,16616,1.0806451612903225,0.9253731343283582
15912,/images/c7c1b873-0548-4a73-9618-f60912e164df.png,453,730,546,835,93,105,red blood cell,9765,1.1290322580645162,0.8857142857142857
79639,/images/a4409217-be11-4478-90a5-b406057d154d.png,87,980,195,1076,108,96,red blood cell,10368,0.8888888888888888,1.125
40936,/images/550cf4ce-b641-44a3-8487-3e16d4049187.png,717,1065,796,1162,79,97,red blood cell,7663,1.2278481012658229,0.8144329896907216
46460,/images/bbecf1a8-a728-4c83-87f8-4dfbac0a1e03.png,410,30,487,117,77,87,red blood cell,6699,1.12987012987013,0.8850574712643678
40649,/images/252071ac-e9f2-41d2-abbb-87ef01b8a997.png,693,1220,784,1311,91,91,red blood cell,8281,1.0,1.0
3453,/images/ad36bd67-594b-4f63-93e3-886af0bc618e.png,78,738,176,850,98,112,red blood cell,10976,1.1428571428571428,0.875
57290,/images/aaade430-4c49-4038-97b7-f8cdd937db57.png,623,1395,725,1492,102,97,red blood cell,9894,0.9509803921568627,1.0515463917525774
33500,/images/795d0331-da56-4d45-a58a-54803408ffd9.png,904,689,1021,805,117,116,red blood cell,13572,0.9914529914529915,1.0086206896551724
20221,/images/c66cb6b2-1480-446a-a9d2-b8032a3de0d7.png,1019,786,1124,895,105,109,red blood cell,11445,1.0380952380952382,0.963302752293578
65149,/images/5e042380-6ef2-496f-8231-0ca550fbfa71.png,259,1073,345,1167,86,94,red blood cell,8084,1.0930232558139534,0.9148936170212766
48304,/images/6fa2b30f-9b89-46ac-9b79-c0bc105d4271.png,309,1296,412,1404,103,108,red blood cell,11124,1.0485436893203883,0.9537037037037037
60566,/images/58065a0c-d4c5-40fd-bcdc-037f61788482.png,887,760,1015,889,128,129,red blood cell,16512,1.0078125,0.9922480620155039
11542,/images/834a30bb-26bf-4e60-9ea1-3250b926892e.png,406,762,535,875,129,113,red blood cell,14577,0.875968992248062,1.1415929203539823
50609,/images/c956e531-6805-4fe1-b61c-8b96a9815a77.png,774,1064,888,1175,114,111,red blood cell,12654,0.9736842105263158,1.027027027027027
60762,/images/645cd195-af50-409f-8da9-6e7c7f18ea09.png,892,764,1020,884,128,120,red blood cell,15360,0.9375,1.0666666666666667
61792,/images/985627c9-7b85-40de-a106-eb9cc47b47cb.png,1108,694,1199,782,91,88,red blood cell,8008,0.967032967032967,1.0340909090909092
9924,/images/b4261fa5-876d-48ea-b6da-ec7ca5b48fe2.png,1089,1155,1196,1245,107,90,red blood cell,9630,0.8411214953271028,1.1888888888888889
25748,/images/1f8edb2a-40bc-4beb-aa6b-884d2473df0f.png,327,1048,455,1186,128,138,red blood cell,17664,1.078125,0.927536231884058
67018,/images/1fe1e118-adb8-4b10-a41e-1e5814e8f067.png,64,513,168,619,104,106,red blood cell,11024,1.0192307692307692,0.9811320754716981
26237,/images/7ba9db7e-9d3f-413c-b672-2bba5fb5b415.png,910,1109,1035,1221,125,112,red blood cell,14000,0.896,1.1160714285714286
63779,/images/6013bff0-dc4b-4bde-9409-0f6139c3495c.png,1011,696,1112,806,101,110,red blood cell,11110,1.0891089108910892,0.9181818181818182
49305,/images/99b13257-b9d9-422f-8262-802da0bdc510.png,535,88,658,219,123,131,red blood cell,16113,1.065040650406504,0.9389312977099237
23234,/images/3dcd4f1b-ce43-4a34-b1ed-076bb42963b1.png,669,692,771,808,102,116,red blood cell,11832,1.1372549019607843,0.8793103448275862
61531,/images/7e837856-3519-4dc0-b357-4cdcfd30b4eb.png,551,891,639,984,88,93,red blood cell,8184,1.0568181818181819,0.946236559139785
26596,/images/5893e081-04f2-4e33-9851-bed5f0e4d333.png,695,331,808,447,113,116,red blood cell,13108,1.0265486725663717,0.9741379310344828
18090,/images/947348fe-4c70-468e-8009-3c14daeca69b.png,447,1036,570,1148,123,112,red blood cell,13776,0.9105691056910569,1.0982142857142858
16662,/images/bc377041-e098-45c4-9651-2b1ea90d1d7e.png,661,790,778,908,117,118,red blood cell,13806,1.0085470085470085,0.9915254237288136
21640,/images/66183740-e1e5-43c9-8539-a87028bb3621.png,700,1064,805,1180,105,116,red blood cell,12180,1.1047619047619048,0.9051724137931034
20882,/images/c2ec116f-f091-422c-926c-70b548a8f6ef.png,26,999,152,1110,126,111,red blood cell,13986,0.8809523809523809,1.135135135135135
29075,/images/4c13e22e-dfd1-4fa1-b373-be9d0c272c0f.png,678,1438,763,1535,85,97,red blood cell,8245,1.1411764705882352,0.8762886597938144
10138,/images/09ecf7be-28e2-4531-b9e2-07e01c44097d.png,38,402,146,497,108,95,red blood cell,10260,0.8796296296296297,1.1368421052631579
11258,/images/6303f964-98ef-47c6-bb2d-283aa393f918.png,517,421,597,501,80,80,red blood cell,6400,1.0,1.0
23744,/images/6b2ff7ca-c5b3-415c-9481-7b14efc6d7ef.png,527,922,651,1069,124,147,red blood cell,18228,1.185483870967742,0.8435374149659864
47662,/images/4b3a49bc-8536-4760-9553-440a6f64db37.png,703,1354,820,1481,117,127,red blood cell,14859,1.0854700854700854,0.9212598425196851
69074,/images/de2b8835-552c-4f01-98b7-67bc4910062e.png,540,1410,644,1521,104,111,red blood cell,11544,1.0673076923076923,0.9369369369369369
45430,/images/e4eea7ea-8989-46a9-9c98-25a178146b28.png,1109,1182,1196,1268,87,86,red blood cell,7482,0.9885057471264368,1.0116279069767442
57636,/images/d32022fa-e492-4b31-a776-9435cfdef6d6.png,239,1213,354,1311,115,98,red blood cell,11270,0.8521739130434782,1.1734693877551021
10226,/images/e3ea07d7-884a-412e-874a-40fd6b856736.png,684,1093,817,1206,133,113,red blood cell,15029,0.849624060150376,1.176991150442478
15427,/images/1b7f47fc-26cd-4273-b848-88a7cbfd9f85.png,1023,432,1127,541,104,109,red blood cell,11336,1.0480769230769231,0.9541284403669725
12904,/images/b10ea12f-cd36-4f2c-994a-67d1665269ab.png,453,427,551,527,98,100,red blood cell,9800,1.0204081632653061,0.98
22849,/images/95d5e689-c1d1-4ae8-a659-cc20c62a99f0.png,232,1166,340,1270,108,104,red blood cell,11232,0.9629629629629629,1.0384615384615385
1080,/images/edcb4d77-a4d3-465d-9b59-eb3087766b1c.png,336,614,449,725,113,111,red blood cell,12543,0.9823008849557522,1.018018018018018
78295,/images/24115f58-a7d6-4022-a95a-86b515a78d3e.png,428,124,546,232,118,108,red blood cell,12744,0.9152542372881356,1.0925925925925926
45190,/images/24879caf-a327-464c-9cd9-e0f3d9161079.png,681,416,790,536,109,120,red blood cell,13080,1.1009174311926606,0.9083333333333333
47676,/images/4b3a49bc-8536-4760-9553-440a6f64db37.png,712,761,840,874,128,113,red blood cell,14464,0.8828125,1.1327433628318584
49640,/images/bd7937db-fca2-44d0-8538-460110210927.png,100,789,211,907,111,118,red blood cell,13098,1.063063063063063,0.940677966101695
74784,/images/91e93160-eb8d-4de0-b6bc-b98ec33d1663.png,753,1271,863,1393,110,122,red blood cell,13420,1.1090909090909091,0.9016393442622951
1574,/images/0ac747cd-ff32-49bf-bc1a-3e9b7702ce9c.png,80,1433,197,1559,117,126,red blood cell,14742,1.0769230769230769,0.9285714285714286
27177,/images/f232eec3-02c0-43f9-bf32-3e60245397e2.png,992,994,1113,1119,121,125,red blood cell,15125,1.0330578512396693,0.968
54779,/images/10891eed-b0f2-4dd0-90cb-da185f6761b2.png,351,265,437,372,86,107,red blood cell,9202,1.244186046511628,0.8037383177570093
72986,/images/2bd26501-2fbc-4c1a-bef0-4ad57e02b4d0.png,327,438,430,544,103,106,red blood cell,10918,1.029126213592233,0.9716981132075472
70275,/images/90246988-0d6d-4bf8-8a76-94107de4121e.png,510,359,613,469,103,110,red blood cell,11330,1.0679611650485437,0.9363636363636364
38225,/images/1d9d4dac-66f9-4c87-b714-d723d5b15fa9.png,682,612,786,725,104,113,red blood cell,11752,1.0865384615384615,0.9203539823008849
38712,/images/b5acf759-1115-42f0-a753-656736192528.png,500,675,586,767,86,92,red blood cell,7912,1.069767441860465,0.9347826086956522
34283,/images/259da25f-40f3-4d37-bca9-a9c807af1547.png,834,295,946,392,112,97,red blood cell,10864,0.8660714285714286,1.1546391752577319
64502,/images/6ba5d0b8-cdc7-4266-9d78-db76faa312e9.png,473,765,568,862,95,97,red blood cell,9215,1.0210526315789474,0.979381443298969
37953,/images/56a57a8d-c9b9-432a-a3b0-32a09355806c.png,1061,1227,1154,1321,93,94,red blood cell,8742,1.010752688172043,0.9893617021276596
8413,/images/ae779806-6d01-4dc6-89df-294c368db6bc.png,540,269,642,381,102,112,red blood cell,11424,1.0980392156862746,0.9107142857142857
46077,/images/72088c26-d2dd-4906-b791-b8947fc7fbe4.png,213,1074,304,1170,91,96,red blood cell,8736,1.054945054945055,0.9479166666666666
24609,/images/c03d9b87-e19b-402b-ad86-b30d6e8aeb59.png,342,124,436,225,94,101,red blood cell,9494,1.074468085106383,0.9306930693069307
58870,/images/434523fd-d4d9-4961-a7c2-d71d6ae68e13.png,77,107,172,219,95,112,red blood cell,10640,1.1789473684210525,0.8482142857142857
73077,/images/f39e2289-fedd-4d12-9e64-ffdafb89247e.png,71,1085,177,1187,106,102,red blood cell,10812,0.9622641509433962,1.0392156862745099
26997,/images/1f337b61-1b0d-4539-91f9-73d4a0798a4a.png,828,1489,933,1599,105,110,red blood cell,11550,1.0476190476190477,0.9545454545454546
21475,/images/b701b5c5-b922-4315-b12a-aac4ec65ee8b.png,148,210,240,310,92,100,red blood cell,9200,1.0869565217391304,0.92
4874,/images/61cd8c7d-394d-42d3-9ed4-e09559110bed.png,241,168,361,283,120,115,red blood cell,13800,0.9583333333333334,1.0434782608695652
10521,/images/46a2d369-4bea-4405-ac78-91bbe130b9a7.png,112,1234,212,1339,100,105,red blood cell,10500,1.05,0.9523809523809523
62287,/images/e0ff3476-226f-4125-b182-8e524d5503dd.png,684,742,783,846,99,104,red blood cell,10296,1.0505050505050506,0.9519230769230769
48874,/images/fed6ba05-36a5-45dc-a4e1-9baa7de2c622.png,944,4,1054,112,110,108,red blood cell,11880,0.9818181818181818,1.0185185185185186
14468,/images/3b13e20f-ec0d-44ec-b2f4-eaebfa09150e.png,892,898,1038,1020,146,122,red blood cell,17812,0.8356164383561644,1.1967213114754098
27831,/images/db3f4098-02e4-45a3-a7af-5dda37ac1526.png,1023,1379,1137,1488,114,109,red blood cell,12426,0.956140350877193,1.0458715596330275
40980,/images/bbe65c18-8a56-4dfe-875c-94e124a84125.png,735,587,857,711,122,124,red blood cell,15128,1.0163934426229508,0.9838709677419355
31665,/images/0d7bf56f-3b5a-40bd-971c-2ca33dd89b2c.png,124,524,210,625,86,101,red blood cell,8686,1.1744186046511629,0.8514851485148515
26311,/images/d33bc9fc-3444-4f26-8082-307f9fccc52b.png,104,137,218,269,114,132,red blood cell,15048,1.1578947368421053,0.8636363636363636
66840,/images/9106a6bb-1352-411f-ac26-0d6fe48c16a8.png,790,994,902,1085,112,91,red blood cell,10192,0.8125,1.2307692307692308
46262,/images/815bf40c-371a-4d34-aa41-c549c8221881.png,156,597,268,711,112,114,red blood cell,12768,1.0178571428571428,0.9824561403508771
79641,/images/a4409217-be11-4478-90a5-b406057d154d.png,194,796,306,903,112,107,red blood cell,11984,0.9553571428571429,1.0467289719626167
68877,/images/6347dd6a-cfdf-4cb5-bc50-cff5403cfecb.png,31,815,125,932,94,117,red blood cell,10998,1.2446808510638299,0.8034188034188035
45926,/images/0d098413-6911-4535-b70a-3c3effd8cf49.png,616,902,726,1009,110,107,red blood cell,11770,0.9727272727272728,1.02803738317757
61783,/images/985627c9-7b85-40de-a106-eb9cc47b47cb.png,279,265,372,364,93,99,red blood cell,9207,1.064516129032258,0.9393939393939394
48387,/images/0fa5b35d-6c44-4207-b6f8-d5b355086b5f.png,897,629,1010,745,113,116,red blood cell,13108,1.0265486725663717,0.9741379310344828
42550,/images/9a25f103-1683-47d1-8b07-ac20fe0b3ee9.png,442,889,558,1004,116,115,red blood cell,13340,0.9913793103448276,1.008695652173913
41075,/images/e871f52c-77a6-4813-80d4-95bd97985f1a.png,373,1151,491,1257,118,106,red blood cell,12508,0.8983050847457628,1.1132075471698113
62775,/images/631340cc-cedf-4bca-a3d8-a0731a5482b4.png,490,1166,607,1276,117,110,red blood cell,12870,0.9401709401709402,1.0636363636363637
56939,/images/a93c35ba-1690-4358-8837-669bcd850bb7.png,308,980,413,1085,105,105,red blood cell,11025,1.0,1.0
19270,/images/b4d22412-a495-43a9-bec0-73a2322f8dad.png,909,595,1007,687,98,92,red blood cell,9016,0.9387755102040817,1.065217391304348
34620,/images/a0eedcb9-b85c-4612-b945-7e8227f53c35.png,567,661,665,764,98,103,red blood cell,10094,1.0510204081632653,0.9514563106796117
69393,/images/fde0fd54-49cc-42e1-90c6-6b612cd062d8.png,653,1478,752,1577,99,99,red blood cell,9801,1.0,1.0
7540,/images/071901eb-4c3f-404b-a747-3d0b9d0a5158.png,255,715,363,825,108,110,red blood cell,11880,1.0185185185185186,0.9818181818181818
31044,/images/9c48fdf4-621d-4f40-bcd7-6a28cd530de7.png,387,492,491,602,104,110,red blood cell,11440,1.0576923076923077,0.9454545454545454
54898,/images/8f84a2c9-ca38-4405-a488-12fcd101278b.png,115,938,239,1047,124,109,red blood cell,13516,0.8790322580645161,1.1376146788990826
18669,/images/c22f7031-9cf8-48ce-b03b-1b12d0db4951.png,212,418,300,519,88,101,red blood cell,8888,1.1477272727272727,0.8712871287128713
33650,/images/84ee2ea3-9edd-4672-a1b3-f09c607d833a.png,211,1362,309,1456,98,94,red blood cell,9212,0.9591836734693877,1.0425531914893618
15124,/images/3a8f468f-f9de-46a8-a7c8-f2be239fa207.png,801,32,912,137,111,105,red blood cell,11655,0.9459459459459459,1.0571428571428572
79108,/images/1c90231b-2830-42d9-884e-7301edb16933.png,855,386,961,496,106,110,red blood cell,11660,1.0377358490566038,0.9636363636363636
45949,/images/0d098413-6911-4535-b70a-3c3effd8cf49.png,430,1272,559,1382,129,110,red blood cell,14190,0.8527131782945736,1.1727272727272726
30596,/images/f939782b-f5a2-40a3-9c22-6c6d7e18edc3.png,628,1327,738,1437,110,110,red blood cell,12100,1.0,1.0
19954,/images/0ca25c88-457f-4f03-bbc1-98fb6663f1d1.png,673,716,802,834,129,118,red blood cell,15222,0.9147286821705426,1.0932203389830508
58392,/images/7eae1169-e294-4594-8e03-1366d23ff2d1.png,578,838,678,938,100,100,red blood cell,10000,1.0,1.0
3150,/images/729a38d6-66db-48e5-a00d-7d90d224290f.png,145,795,271,931,126,136,red blood cell,17136,1.0793650793650793,0.9264705882352942
41791,/images/28bd16ba-2bcf-46af-b889-41b78d2a50c0.png,545,252,652,376,107,124,red blood cell,13268,1.158878504672897,0.8629032258064516
46722,/images/da111ca5-520f-4ea8-97ad-ae5fce58ee91.png,836,1020,932,1131,96,111,red blood cell,10656,1.15625,0.8648648648648649
58464,/images/5cac6ddf-c8c6-45de-bce0-a1db64b14fb5.png,573,319,683,431,110,112,red blood cell,12320,1.018181818181818,0.9821428571428571
5265,/images/729733ff-a349-4a96-b636-ccabe7d7e167.png,283,856,390,964,107,108,red blood cell,11556,1.0093457943925233,0.9907407407407407
41181,/images/2240b991-48f6-4c59-9b62-5a8b5e541fae.png,1037,152,1142,242,105,90,red blood cell,9450,0.8571428571428571,1.1666666666666667
64597,/images/6dfafdf1-f588-4e80-8cf8-0126e1bf7af9.png,1002,414,1102,523,100,109,red blood cell,10900,1.09,0.9174311926605505
10730,/images/20d4f65e-6c63-433a-935c-d568d577967b.png,480,636,576,722,96,86,red blood cell,8256,0.8958333333333334,1.1162790697674418
17461,/images/56077789-8580-41b4-89d6-deea227e5c60.png,877,241,986,369,109,128,red blood cell,13952,1.1743119266055047,0.8515625
14155,/images/eaf4b781-b3aa-41ce-8c5e-287979b4e15a.png,107,818,212,916,105,98,red blood cell,10290,0.9333333333333333,1.0714285714285714
56450,/images/d75933ed-d26e-4d1f-bda3-96bc0d77fb36.png,143,1279,261,1383,118,104,red blood cell,12272,0.8813559322033898,1.1346153846153846
8865,/images/29539cb0-1c52-46b2-9302-552f8349dc71.png,798,953,929,1079,131,126,red blood cell,16506,0.9618320610687023,1.0396825396825398
39450,/images/5a631871-2fc7-4a68-9c39-f3b9a0bf4a04.png,851,1073,949,1171,98,98,red blood cell,9604,1.0,1.0
713,/images/dcc1a193-7b74-44f8-ad8d-813751d8fa6b.png,995,393,1119,505,124,112,red blood cell,13888,0.9032258064516129,1.1071428571428572
65071,/images/ff3b9d4d-373c-48ef-a75a-d23e2c2ade87.png,740,931,824,1021,84,90,red blood cell,7560,1.0714285714285714,0.9333333333333333
28614,/images/861c3e06-aada-47a0-99ae-94fbc2772cc0.png,315,512,435,634,120,122,red blood cell,14640,1.0166666666666666,0.9836065573770492
32148,/images/25cfca07-2101-484f-b312-a927395f2651.png,305,1394,424,1533,119,139,red blood cell,16541,1.1680672268907564,0.8561151079136691
331,/images/0dcca702-a4ef-4fb3-a940-9c0c140b21c7.png,408,700,505,804,97,104,red blood cell,10088,1.0721649484536082,0.9326923076923077
61731,/images/985627c9-7b85-40de-a106-eb9cc47b47cb.png,689,480,800,592,111,112,red blood cell,12432,1.009009009009009,0.9910714285714286
159,/images/13099edb-35d9-438f-b093-2cf2ebf9d255.png,398,1375,515,1485,117,110,red blood cell,12870,0.9401709401709402,1.0636363636363637
75655,/images/50d7c6c9-3230-48fe-947c-7dcfd0aad710.png,275,1450,388,1570,113,120,red blood cell,13560,1.0619469026548674,0.9416666666666667
62874,/images/4b346035-b8c0-46ca-8fdb-a01b1421ee4a.png,111,1020,220,1113,109,93,red blood cell,10137,0.8532110091743119,1.1720430107526882
16933,/images/8eeb378e-90f0-47ea-ac1c-2a201eb8d090.png,866,294,980,418,114,124,red blood cell,14136,1.087719298245614,0.9193548387096774
76593,/images/4184a235-d209-4151-86e9-6c77e7938dab.png,1045,641,1143,739,98,98,red blood cell,9604,1.0,1.0
62271,/images/59f5699f-885f-4004-b783-a60060144e43.png,885,1402,1009,1539,124,137,red blood cell,16988,1.1048387096774193,0.9051094890510949
16386,/images/e474a20b-2769-48f1-a520-4f6ef5a0dbf5.png,256,1015,371,1110,115,95,red blood cell,10925,0.8260869565217391,1.2105263157894737
918,/images/dce55b59-c6c3-4693-aa75-6b348c8f52cd.png,245,1300,343,1409,98,109,red blood cell,10682,1.1122448979591837,0.8990825688073395
2044,/images/f3bd0fcc-647d-4ca0-8c43-a16bd6ea3878.png,1085,327,1200,460,115,133,red blood cell,15295,1.1565217391304348,0.8646616541353384
21486,/images/7625dfc4-858a-4c8e-907c-8943d665e9a7.png,824,385,933,486,109,101,red blood cell,11009,0.926605504587156,1.0792079207920793
11367,/images/2f6224be-50d0-4e85-94ef-88315df561b6.png,612,1004,713,1112,101,108,red blood cell,10908,1.0693069306930694,0.9351851851851852
21227,/images/0ceb4539-5c4c-487d-9826-452a88b5d537.png,160,72,273,196,113,124,red blood cell,14012,1.0973451327433628,0.9112903225806451
6701,/images/95fea6d8-413f-421e-b331-5d51c31df150.png,331,1091,456,1199,125,108,red blood cell,13500,0.864,1.1574074074074074
67659,/images/2b128a1a-95ed-408b-b9f8-8795cc814d80.png,1046,835,1132,934,86,99,red blood cell,8514,1.1511627906976745,0.8686868686868687
52703,/images/9dc6ed5d-6698-48cf-aab3-fd156673729c.png,677,1068,781,1173,104,105,red blood cell,10920,1.0096153846153846,0.9904761904761905
3747,/images/dacf7e3f-1d8c-42a0-8539-3abe3971c956.png,606,1036,706,1157,100,121,red blood cell,12100,1.21,0.8264462809917356
50233,/images/3d32a988-449d-4d58-b71f-abbfdc3f2fbc.png,655,989,753,1080,98,91,red blood cell,8918,0.9285714285714286,1.0769230769230769
70375,/images/4876c9d0-b386-48fb-84e8-91bf87529161.png,288,1495,388,1581,100,86,red blood cell,8600,0.86,1.1627906976744187
65472,/images/da49db57-0c2f-4213-b322-c88c19fb9296.png,170,893,284,999,114,106,red blood cell,12084,0.9298245614035088,1.0754716981132075
50979,/images/ef8fcfa4-8466-4186-8c69-f5f4904eb489.png,790,1268,899,1386,109,118,red blood cell,12862,1.0825688073394495,0.923728813559322
32351,/images/a6526894-e290-482d-ac43-f1df34864817.png,952,947,1074,1062,122,115,red blood cell,14030,0.9426229508196722,1.0608695652173914
63850,/images/5e974892-0ebe-4037-8427-ea8616d6d3b8.png,250,1151,369,1275,119,124,red blood cell,14756,1.0420168067226891,0.9596774193548387
41555,/images/0fcd1ebe-ee4a-40a0-b787-29cee18bfa1b.png,85,505,180,600,95,95,red blood cell,9025,1.0,1.0
11505,/images/834a30bb-26bf-4e60-9ea1-3250b926892e.png,83,713,212,844,129,131,red blood cell,16899,1.0155038759689923,0.9847328244274809
35507,/images/3722d213-f2a9-46d5-aa76-9183b443e455.png,565,108,666,230,101,122,red blood cell,12322,1.2079207920792079,0.8278688524590164
35176,/images/bfc61c48-685d-470b-86b1-e4c7eb85c4fd.png,640,1448,768,1567,128,119,red blood cell,15232,0.9296875,1.0756302521008403
75803,/images/c4c7ed75-dbdf-4bb6-b6ba-718903cf7264.png,374,1296,485,1405,111,109,red blood cell,12099,0.9819819819819819,1.018348623853211
66642,/images/b88fe674-fb9a-41d4-b100-cb1c86440d44.png,860,1381,971,1473,111,92,red blood cell,10212,0.8288288288288288,1.2065217391304348
73136,/images/f39e2289-fedd-4d12-9e64-ffdafb89247e.png,83,780,181,881,98,101,red blood cell,9898,1.030612244897959,0.9702970297029703
72761,/images/caeb2d62-1166-43f0-8eac-5b8fc48f02eb.png,1091,1461,1193,1559,102,98,red blood cell,9996,0.9607843137254902,1.0408163265306123
14481,/images/3b13e20f-ec0d-44ec-b2f4-eaebfa09150e.png,771,440,877,546,106,106,red blood cell,11236,1.0,1.0
8716,/images/92e4fd7b-79ef-49c2-a52b-9ef13dd720ef.png,998,1141,1121,1255,123,114,red blood cell,14022,0.926829268292683,1.0789473684210527
16076,/images/7e25ced3-5caf-47f8-ad0c-42946bd4468b.png,1054,402,1173,519,119,117,red blood cell,13923,0.9831932773109243,1.017094017094017
8763,/images/29dc8176-dfe1-40e0-8247-2dc3c530057e.png,604,1263,717,1373,113,110,red blood cell,12430,0.9734513274336283,1.0272727272727273
23359,/images/a7688988-2bcc-4458-83d3-5e482da5f87b.png,410,880,514,985,104,105,red blood cell,10920,1.0096153846153846,0.9904761904761905
52785,/images/0a747cb3-c720-4572-a661-ab5670a5c42e.png,727,916,850,1037,123,121,red blood cell,14883,0.983739837398374,1.0165289256198347
49550,/images/9f33e0ea-065b-4703-9df9-15829b891860.png,1074,1191,1179,1319,105,128,red blood cell,13440,1.2190476190476192,0.8203125
67990,/images/bcaefb02-682a-41b9-acc7-e6cc010f5b30.png,313,409,409,514,96,105,red blood cell,10080,1.09375,0.9142857142857143
78159,/images/2bed2796-75a9-4d93-bb2d-e3ccbe1a5cbe.png,322,812,419,912,97,100,red blood cell,9700,1.0309278350515463,0.97
50802,/images/db0a1123-0b35-48d7-8337-3b1ebd6af0cc.png,349,435,486,555,137,120,red blood cell,16440,0.8759124087591241,1.1416666666666666
11167,/images/6303f964-98ef-47c6-bb2d-283aa393f918.png,202,1016,300,1127,98,111,red blood cell,10878,1.1326530612244898,0.8828828828828829
5237,/images/729733ff-a349-4a96-b636-ccabe7d7e167.png,436,175,530,291,94,116,red blood cell,10904,1.2340425531914894,0.8103448275862069
77402,/images/c7ec51d5-9f45-4209-8357-39e9a984a733.png,1069,381,1176,481,107,100,red blood cell,10700,0.9345794392523364,1.07
36227,/images/c3209548-7f7c-4afd-b47c-b42a72b1ebf7.png,615,235,754,365,139,130,red blood cell,18070,0.935251798561151,1.0692307692307692
8353,/images/65e3d6a6-012c-4b40-9a42-83078eb85e31.png,535,965,631,1063,96,98,red blood cell,9408,1.0208333333333333,0.9795918367346939
60076,/images/e63e1607-f344-43d6-a0d8-e10cf2e5054a.png,689,48,784,144,95,96,red blood cell,9120,1.0105263157894737,0.9895833333333334
35687,/images/4063945d-03fc-4ce3-a04c-17435dce8f91.png,995,691,1102,797,107,106,red blood cell,11342,0.9906542056074766,1.009433962264151
4589,/images/f1de7c7e-e7d3-45ae-a66c-58538bf6cac1.png,350,1378,448,1493,98,115,red blood cell,11270,1.1734693877551021,0.8521739130434782
23238,/images/3dcd4f1b-ce43-4a34-b1ed-076bb42963b1.png,1022,224,1117,327,95,103,red blood cell,9785,1.0842105263157895,0.9223300970873787
45305,/images/9e793460-d94c-47ac-b3a7-0d6ad86357da.png,863,701,968,804,105,103,red blood cell,10815,0.9809523809523809,1.0194174757281553
54810,/images/b6364a57-72a9-43f3-8d02-9f53a992dc95.png,906,184,1015,297,109,113,red blood cell,12317,1.036697247706422,0.9646017699115044
2450,/images/fe851c88-692d-4199-87e0-d19d9c4eb591.png,585,505,681,585,96,80,red blood cell,7680,0.8333333333333334,1.2
43544,/images/2d857091-efcd-41c0-ba3f-226de90445c4.png,110,45,232,180,122,135,red blood cell,16470,1.1065573770491803,0.9037037037037037
44255,/images/4257342d-6d77-4671-a84b-1f0c36ccb367.png,721,1431,828,1535,107,104,red blood cell,11128,0.9719626168224299,1.0288461538461537
32188,/images/25cfca07-2101-484f-b312-a927395f2651.png,700,253,825,378,125,125,red blood cell,15625,1.0,1.0
53206,/images/d8f7e159-b7e3-49e4-86e8-aed8c5fbcd97.png,500,1221,594,1332,94,111,red blood cell,10434,1.1808510638297873,0.8468468468468469
40511,/images/e3ade58d-086c-47fa-9120-76beacb45395.png,31,823,153,951,122,128,red blood cell,15616,1.0491803278688525,0.953125
51994,/images/4f62b14e-c6f4-4155-8f50-881558f83fae.png,927,247,1000,335,73,88,red blood cell,6424,1.2054794520547945,0.8295454545454546
32591,/images/3f26fbbc-deb1-494f-b71c-c7cb3d4819fb.png,64,1231,201,1343,137,112,red blood cell,15344,0.8175182481751825,1.2232142857142858
71230,/images/86495bbf-687b-429c-b9d3-6c2681ade7e2.png,655,388,783,508,128,120,red blood cell,15360,0.9375,1.0666666666666667
36694,/images/21f001d6-f568-4ea4-82da-fab54c77c419.png,894,476,992,569,98,93,red blood cell,9114,0.9489795918367347,1.053763440860215
26396,/images/ef1419e0-3a3a-458a-b3b2-7efddac50404.png,553,732,689,863,136,131,red blood cell,17816,0.9632352941176471,1.0381679389312977
47270,/images/1dd3e6dd-343f-4cc9-b0ed-e4d27fb36f0a.png,362,694,477,810,115,116,red blood cell,13340,1.008695652173913,0.9913793103448276
41015,/images/8e078333-8fa0-45be-a46e-fa05708cb365.png,472,36,582,165,110,129,red blood cell,14190,1.1727272727272726,0.8527131782945736
74170,/images/4e43fc22-dc08-4cde-b3ce-ce8a4f377c47.png,1,208,86,292,85,84,red blood cell,7140,0.9882352941176471,1.0119047619047619
72385,/images/a15e0fa8-2620-4f66-896e-175115c9dc3d.png,267,131,380,244,113,113,red blood cell,12769,1.0,1.0
8622,/images/a6aa3b72-2970-4c78-b655-ea8dfe6e018c.png,929,1071,1071,1191,142,120,red blood cell,17040,0.8450704225352113,1.1833333333333333
20385,/images/11e517bf-943b-4928-929a-e9f72c097880.png,940,660,1040,756,100,96,red blood cell,9600,0.96,1.0416666666666667
62778,/images/631340cc-cedf-4bca-a3d8-a0731a5482b4.png,740,1271,838,1377,98,106,red blood cell,10388,1.0816326530612246,0.9245283018867925
34570,/images/3af90874-59f3-4f0c-a7e6-cc889e80c605.png,767,923,908,1051,141,128,red blood cell,18048,0.9078014184397163,1.1015625
78403,/images/24115f58-a7d6-4022-a95a-86b515a78d3e.png,373,1436,484,1534,111,98,red blood cell,10878,0.8828828828828829,1.1326530612244898
41063,/images/e871f52c-77a6-4813-80d4-95bd97985f1a.png,322,940,431,1054,109,114,red blood cell,12426,1.0458715596330275,0.956140350877193
51120,/images/d64cd75a-df26-44d5-ac25-69061a4e4d57.png,134,960,237,1056,103,96,red blood cell,9888,0.9320388349514563,1.0729166666666667
37758,/images/fe0c5e48-f65e-488c-9c3c-1ea7c7835c0c.png,460,681,555,775,95,94,red blood cell,8930,0.9894736842105263,1.0106382978723405
16004,/images/c7c1b873-0548-4a73-9618-f60912e164df.png,786,53,889,151,103,98,red blood cell,10094,0.9514563106796117,1.0510204081632653
7828,/images/e726dac6-f962-449c-acff-4dd56847b685.png,826,1452,928,1572,102,120,red blood cell,12240,1.1764705882352942,0.85
6403,/images/1ecb0405-a6e9-4485-819e-2fbbf2b718aa.png,690,1436,817,1554,127,118,red blood cell,14986,0.9291338582677166,1.076271186440678
38287,/images/b834cbf7-ff97-49d9-9561-566c9343735c.png,1054,225,1163,339,109,114,red blood cell,12426,1.0458715596330275,0.956140350877193
57743,/images/5c037ffc-f515-48b3-b231-c110fbd2b8ca.png,988,654,1102,749,114,95,red blood cell,10830,0.8333333333333334,1.2
39303,/images/6315a55b-fed1-4355-88fa-8594538acf18.png,285,879,392,997,107,118,red blood cell,12626,1.102803738317757,0.9067796610169492
9753,/images/3859deaf-6ae1-49a3-9051-898d0f0d7de6.png,795,381,891,474,96,93,red blood cell,8928,0.96875,1.032258064516129
3745,/images/dacf7e3f-1d8c-42a0-8539-3abe3971c956.png,939,607,1046,721,107,114,red blood cell,12198,1.0654205607476634,0.9385964912280702
69949,/images/089c9744-f906-41d8-908d-1e37919a8658.png,501,925,615,1029,114,104,red blood cell,11856,0.9122807017543859,1.0961538461538463
58435,/images/7eae1169-e294-4594-8e03-1366d23ff2d1.png,896,1037,1012,1137,116,100,red blood cell,11600,0.8620689655172413,1.16
53620,/images/7bcd3735-3134-46d1-8ca2-d4379f2d51c0.png,431,625,522,717,91,92,red blood cell,8372,1.010989010989011,0.9891304347826086
68475,/images/74261741-4d6e-4dba-8ad4-4fbdf919c30f.png,771,1464,875,1563,104,99,red blood cell,10296,0.9519230769230769,1.0505050505050506
38963,/images/5939f341-a886-4f63-ae87-2219d000a1d4.png,799,1464,912,1580,113,116,red blood cell,13108,1.0265486725663717,0.9741379310344828
52529,/images/d1144956-5a0c-4bd2-b67d-8498c82d6a12.png,1075,1373,1170,1471,95,98,red blood cell,9310,1.0315789473684212,0.9693877551020408
73501,/images/5f2b32bd-fdca-4d6f-b13a-ee9f83626c8d.png,909,1211,1017,1317,108,106,red blood cell,11448,0.9814814814814815,1.0188679245283019
43122,/images/c5db0fc0-b96c-496e-90b4-f9fb1b85b28e.png,913,990,1006,1096,93,106,red blood cell,9858,1.1397849462365592,0.8773584905660378
44732,/images/ccb4b13d-ab20-4222-892f-5adf70249aaa.png,999,1291,1114,1416,115,125,red blood cell,14375,1.0869565217391304,0.92
57954,/images/7942691b-6376-4c75-ae8a-ddf65454dcb2.png,277,1421,405,1550,128,129,red blood cell,16512,1.0078125,0.9922480620155039
6813,/images/e36cb882-c6d0-4467-812e-d18c169a9a47.png,21,1068,150,1190,129,122,red blood cell,15738,0.9457364341085271,1.0573770491803278
67272,/images/5f491efd-a21c-4a80-aaba-70b8876238ac.png,1095,554,1183,640,88,86,red blood cell,7568,0.9772727272727273,1.0232558139534884
38070,/images/e3e9c2de-0a24-4c7e-8a69-3d3093d5bdab.png,491,1505,600,1599,109,94,red blood cell,10246,0.8623853211009175,1.1595744680851063
22764,/images/8490c623-3d88-4532-baf5-0d266a45b16f.png,14,525,120,626,106,101,red blood cell,10706,0.9528301886792453,1.0495049504950495
24399,/images/4d8a4ce8-0f9c-4f21-8844-4cf0e5514bbf.png,569,635,684,732,115,97,red blood cell,11155,0.8434782608695652,1.1855670103092784
56151,/images/50d9fc90-8642-4bb6-91a7-0069a7e37392.png,1110,779,1200,877,90,98,red blood cell,8820,1.0888888888888888,0.9183673469387755
21376,/images/5077f87d-a19f-494c-b911-14ccb03bd230.png,432,1091,558,1209,126,118,red blood cell,14868,0.9365079365079365,1.0677966101694916
27745,/images/e3c1442a-717f-41dd-bf97-81e1233ac9fa.png,686,349,769,443,83,94,red blood cell,7802,1.1325301204819278,0.8829787234042553
64823,/images/a74b6d6a-7e04-40ac-9292-d62f13f7ded3.png,91,976,186,1067,95,91,red blood cell,8645,0.9578947368421052,1.043956043956044
48838,/images/fed6ba05-36a5-45dc-a4e1-9baa7de2c622.png,948,331,1026,427,78,96,red blood cell,7488,1.2307692307692308,0.8125
39685,/images/56adbb1e-96a8-40a5-a5a2-243c97ea889b.png,531,543,656,675,125,132,red blood cell,16500,1.056,0.946969696969697
46636,/images/da111ca5-520f-4ea8-97ad-ae5fce58ee91.png,333,510,434,635,101,125,red blood cell,12625,1.2376237623762376,0.808
10485,/images/46a2d369-4bea-4405-ac78-91bbe130b9a7.png,869,1099,953,1180,84,81,red blood cell,6804,0.9642857142857143,1.037037037037037
22369,/images/78c35732-7e31-4153-842e-55ab1cd656f6.png,422,754,529,867,107,113,red blood cell,12091,1.0560747663551402,0.9469026548672567
47627,/images/78ac1e98-7062-4e27-8d58-25c392cae889.png,421,1136,531,1260,110,124,red blood cell,13640,1.1272727272727272,0.8870967741935484
3095,/images/14efbfc8-39f6-4599-9994-a8cc95605b9c.png,246,845,372,956,126,111,red blood cell,13986,0.8809523809523809,1.135135135135135
5030,/images/b7d0ae11-a393-4aec-8f68-6ba07147f78a.png,185,332,305,452,120,120,red blood cell,14400,1.0,1.0
19462,/images/361a3578-4cbb-422b-9e3c-b5e61395b12e.png,893,326,1024,443,131,117,red blood cell,15327,0.8931297709923665,1.1196581196581197
49921,/images/05804cf0-f854-4099-97c2-df287f7c8a8c.png,267,520,377,641,110,121,red blood cell,13310,1.1,0.9090909090909091
77955,/images/c691c8ef-d3c7-47b6-a941-f6a1089f21a9.png,489,109,604,209,115,100,red blood cell,11500,0.8695652173913043,1.15
49293,/images/99b13257-b9d9-422f-8262-802da0bdc510.png,48,271,153,387,105,116,red blood cell,12180,1.1047619047619048,0.9051724137931034
49289,/images/99b13257-b9d9-422f-8262-802da0bdc510.png,926,1113,1060,1256,134,143,red blood cell,19162,1.0671641791044777,0.9370629370629371
20736,/images/79b3a64f-2fb9-46e0-85d4-2bdd59c2075e.png,12,1259,122,1361,110,102,red blood cell,11220,0.9272727272727272,1.0784313725490196
57200,/images/ca5e6a15-ba65-48ea-8913-2d986e71bf3a.png,1022,1340,1134,1443,112,103,red blood cell,11536,0.9196428571428571,1.087378640776699
3959,/images/f09acb0c-b270-4e91-99f8-410adfa7f34a.png,178,875,276,995,98,120,red blood cell,11760,1.2244897959183674,0.8166666666666667
75975,/images/034c8d57-04d5-4786-93a4-6ae8fde2c258.png,985,688,1077,775,92,87,red blood cell,8004,0.9456521739130435,1.0574712643678161
23824,/images/eeb06e39-482b-443d-8cf6-b9b5c763df78.png,952,322,1084,439,132,117,red blood cell,15444,0.8863636363636364,1.1282051282051282
45274,/images/9e793460-d94c-47ac-b3a7-0d6ad86357da.png,911,857,1043,980,132,123,red blood cell,16236,0.9318181818181818,1.0731707317073171
18280,/images/947348fe-4c70-468e-8009-3c14daeca69b.png,711,896,818,985,107,89,red blood cell,9523,0.8317757009345794,1.202247191011236
45345,/images/e4eea7ea-8989-46a9-9c98-25a178146b28.png,648,27,771,151,123,124,red blood cell,15252,1.008130081300813,0.9919354838709677
75752,/images/d12c5f45-6b20-46d6-a66f-c5a4683c25b3.png,5,412,113,526,108,114,red blood cell,12312,1.0555555555555556,0.9473684210526315
47119,/images/3d1b889e-bb4a-4ee6-b899-974ee7d956a7.png,61,1084,170,1185,109,101,red blood cell,11009,0.926605504587156,1.0792079207920793
18703,/images/f6f8a69a-3fd2-4684-ac77-3e83ea0fb36d.png,1053,915,1175,1028,122,113,red blood cell,13786,0.9262295081967213,1.079646017699115
37782,/images/fe0c5e48-f65e-488c-9c3c-1ea7c7835c0c.png,40,406,150,515,110,109,red blood cell,11990,0.990909090909091,1.0091743119266054
41829,/images/c3b07675-9d02-477c-91fe-f0737867049b.png,79,773,211,888,132,115,red blood cell,15180,0.8712121212121212,1.1478260869565218
7095,/images/64a678d4-9048-4491-90c7-1924f38be19a.png,173,34,290,144,117,110,red blood cell,12870,0.9401709401709402,1.0636363636363637
61902,/images/f32b21ae-5ca7-490b-bc40-6db9396d933c.png,1044,610,1147,697,103,87,red blood cell,8961,0.8446601941747572,1.1839080459770115
29988,/images/deeaa5b3-3895-4aec-a2ce-ed6404862cdf.png,1056,199,1168,303,112,104,red blood cell,11648,0.9285714285714286,1.0769230769230769
14780,/images/1fdf99d1-a494-4174-bcd7-efbe457ab899.png,0,1033,90,1115,90,82,red blood cell,7380,0.9111111111111111,1.0975609756097562
5251,/images/729733ff-a349-4a96-b636-ccabe7d7e167.png,316,1245,407,1349,91,104,red blood cell,9464,1.1428571428571428,0.875
10924,/images/1380f9b4-bf54-4492-90c3-743c7aa8898b.png,1026,146,1130,253,104,107,red blood cell,11128,1.0288461538461537,0.9719626168224299
16151,/images/1e978dfa-d339-4025-809d-09cee76728ed.png,159,1171,260,1279,101,108,red blood cell,10908,1.0693069306930694,0.9351851851851852
13379,/images/a7f1bbb1-6058-4642-bd66-cfb90dce762e.png,140,303,248,423,108,120,red blood cell,12960,1.1111111111111112,0.9
2507,/images/a23f5539-bfe6-4885-9a0e-dba972475ea9.png,1047,245,1161,357,114,112,red blood cell,12768,0.9824561403508771,1.0178571428571428
42567,/images/184b376b-03cb-4c2d-af51-fc1a62196293.png,234,1454,334,1552,100,98,red blood cell,9800,0.98,1.0204081632653061
37943,/images/56a57a8d-c9b9-432a-a3b0-32a09355806c.png,249,1195,343,1296,94,101,red blood cell,9494,1.074468085106383,0.9306930693069307
10434,/images/46a2d369-4bea-4405-ac78-91bbe130b9a7.png,834,1061,937,1159,103,98,red blood cell,10094,0.9514563106796117,1.0510204081632653
34584,/images/a0eedcb9-b85c-4612-b945-7e8227f53c35.png,605,1109,698,1198,93,89,red blood cell,8277,0.956989247311828,1.0449438202247192
8320,/images/65e3d6a6-012c-4b40-9a42-83078eb85e31.png,236,661,325,763,89,102,red blood cell,9078,1.146067415730337,0.8725490196078431
54050,/images/d9345456-b76d-46cc-b81e-46d4a0a7b652.png,260,1314,367,1419,107,105,red blood cell,11235,0.9813084112149533,1.019047619047619
57005,/images/9e82c996-2cfa-418d-9482-8ee23e9d0a5d.png,422,354,525,459,103,105,red blood cell,10815,1.0194174757281553,0.9809523809523809
13528,/images/370277f8-436b-4103-8210-b4feb5ab95ea.png,716,107,827,201,111,94,red blood cell,10434,0.8468468468468469,1.1808510638297873
50193,/images/4cccfcf0-cac9-46f0-870c-0eabfdc781ba.png,396,1296,485,1393,89,97,red blood cell,8633,1.0898876404494382,0.9175257731958762
28725,/images/151f3af5-5e6e-4bcd-9389-4974fc68813e.png,261,464,376,563,115,99,red blood cell,11385,0.8608695652173913,1.1616161616161615
9938,/images/b4261fa5-876d-48ea-b6da-ec7ca5b48fe2.png,411,757,515,858,104,101,red blood cell,10504,0.9711538461538461,1.0297029702970297
1714,/images/5f783f43-0090-4f8a-bd75-9562f4aa2dd5.png,649,588,763,715,114,127,red blood cell,14478,1.1140350877192982,0.8976377952755905
52623,/images/a6fe423a-5204-4378-bcfa-d6d298a3e9aa.png,978,314,1076,419,98,105,red blood cell,10290,1.0714285714285714,0.9333333333333333
36708,/images/21f001d6-f568-4ea4-82da-fab54c77c419.png,359,340,462,443,103,103,red blood cell,10609,1.0,1.0
77224,/images/fe691faa-3bc7-475e-b558-aa8fe7b795bc.png,233,1405,329,1511,96,106,red blood cell,10176,1.1041666666666667,0.9056603773584906
30340,/images/4aad9589-6b32-4522-bcd7-ca04687a02ca.png,348,590,456,700,108,110,red blood cell,11880,1.0185185185185186,0.9818181818181818
64268,/images/83d4e1fe-da84-4175-a9e2-8efc18782dcf.png,989,574,1077,667,88,93,red blood cell,8184,1.0568181818181819,0.946236559139785
79914,/images/0b923ab7-ebff-4079-a4bb-af7da89f374e.png,186,224,295,335,109,111,red blood cell,12099,1.018348623853211,0.9819819819819819
12574,/images/8e4bdd0d-1c72-4836-ae3e-05e2e50e4983.png,146,296,249,394,103,98,red blood cell,10094,0.9514563106796117,1.0510204081632653
8422,/images/ae779806-6d01-4dc6-89df-294c368db6bc.png,94,663,215,787,121,124,red blood cell,15004,1.024793388429752,0.9758064516129032
50452,/images/a2de1248-7bc0-44dc-b508-70a357eedd68.png,740,1047,878,1160,138,113,red blood cell,15594,0.8188405797101449,1.2212389380530972
48024,/images/eba73bff-fbe1-436d-9a5f-0a61331a0ea2.png,729,699,834,796,105,97,red blood cell,10185,0.9238095238095239,1.0824742268041236
63557,/images/de0321fa-6f7d-4dd1-b96b-186701c3b1d9.png,102,774,207,877,105,103,red blood cell,10815,0.9809523809523809,1.0194174757281553
39528,/images/5a631871-2fc7-4a68-9c39-f3b9a0bf4a04.png,885,909,981,1008,96,99,red blood cell,9504,1.03125,0.9696969696969697
30337,/images/cecbf663-0751-4e7f-b298-770c88afc2c1.png,1097,608,1198,714,101,106,red blood cell,10706,1.0495049504950495,0.9528301886792453
27324,/images/9f38055f-4fe6-47fd-a6dd-c0743db4eccf.png,43,452,155,565,112,113,red blood cell,12656,1.0089285714285714,0.9911504424778761
45307,/images/9e793460-d94c-47ac-b3a7-0d6ad86357da.png,214,670,340,791,126,121,red blood cell,15246,0.9603174603174603,1.0413223140495869
60234,/images/abf4cf2a-4532-4772-9f0f-9e123cc1713d.png,357,1178,486,1303,129,125,red blood cell,16125,0.9689922480620154,1.032
3249,/images/96596a68-8c95-43f3-b74e-e9506c235144.png,856,1230,962,1320,106,90,red blood cell,9540,0.8490566037735849,1.1777777777777778
8523,/images/dfc026a9-079f-4f45-8666-e0ccba5bb437.png,253,389,377,511,124,122,red blood cell,15128,0.9838709677419355,1.0163934426229508
17741,/images/b5143aae-6e98-4dc6-b546-980cb472de67.png,552,339,672,461,120,122,red blood cell,14640,1.0166666666666666,0.9836065573770492
51393,/images/b4f3b2a4-f4b9-48de-ac5d-0e681b77be27.png,20,805,130,916,110,111,red blood cell,12210,1.009090909090909,0.990990990990991
13283,/images/030f3421-ed3f-4bf1-8f27-4d02590bffbc.png,308,394,401,491,93,97,red blood cell,9021,1.043010752688172,0.9587628865979382
9379,/images/e3a4b3e7-9500-4b6c-a402-b6d3f45e714b.png,610,0,721,104,111,104,red blood cell,11544,0.9369369369369369,1.0673076923076923
51497,/images/baa87bf8-786c-444c-81e8-9fa0a41d8149.png,83,323,176,407,93,84,red blood cell,7812,0.9032258064516129,1.1071428571428572
23934,/images/3d8fb5bf-3315-48fb-8ab1-802eafd550bc.png,681,877,783,979,102,102,red blood cell,10404,1.0,1.0
18257,/images/947348fe-4c70-468e-8009-3c14daeca69b.png,245,1134,350,1237,105,103,red blood cell,10815,0.9809523809523809,1.0194174757281553
72263,/images/ee57e743-a876-4f69-9fe5-bf5d01b44689.png,1038,913,1138,1013,100,100,red blood cell,10000,1.0,1.0
7271,/images/89f10192-d3dd-4996-a571-4c851dbdc983.png,697,361,793,469,96,108,red blood cell,10368,1.125,0.8888888888888888
22730,/images/8490c623-3d88-4532-baf5-0d266a45b16f.png,768,1045,884,1167,116,122,red blood cell,14152,1.0517241379310345,0.9508196721311475
37340,/images/4d88e2d2-5aad-410c-9bbc-702ee9496995.png,576,1141,697,1259,121,118,red blood cell,14278,0.9752066115702479,1.0254237288135593
23106,/images/be5bb7d0-7c3f-4bb9-8bb4-f8bc8d875943.png,895,1358,995,1459,100,101,red blood cell,10100,1.01,0.9900990099009901
60954,/images/5397d8e2-bb09-42e7-9861-65ffad0fe94e.png,877,650,995,764,118,114,red blood cell,13452,0.9661016949152542,1.0350877192982457
13822,/images/345cb914-7583-49df-96e3-3cf19c2ba8f1.png,997,502,1112,612,115,110,red blood cell,12650,0.9565217391304348,1.0454545454545454
12869,/images/b10ea12f-cd36-4f2c-994a-67d1665269ab.png,714,966,796,1061,82,95,red blood cell,7790,1.1585365853658536,0.8631578947368421
63750,/images/06401963-8b02-46c5-ab2a-3d70bd01623f.png,347,607,431,687,84,80,red blood cell,6720,0.9523809523809523,1.05
63610,/images/d9c9479e-f1ea-4d6e-861f-843ff9a90d19.png,830,338,946,471,116,133,red blood cell,15428,1.146551724137931,0.8721804511278195
45697,/images/584d62ed-4329-45dd-94ce-e929d8b2bb74.png,500,558,588,664,88,106,red blood cell,9328,1.2045454545454546,0.8301886792452831
46161,/images/d8632217-ec33-4d0a-98e6-427824c58869.png,467,1449,594,1578,127,129,red blood cell,16383,1.015748031496063,0.9844961240310077
76496,/images/34df8890-272d-423a-ae78-ff8d068d3306.png,550,750,647,866,97,116,red blood cell,11252,1.1958762886597938,0.8362068965517241
13335,/images/a7f1bbb1-6058-4642-bd66-cfb90dce762e.png,780,353,900,477,120,124,red blood cell,14880,1.0333333333333334,0.967741935483871
41150,/images/2240b991-48f6-4c59-9b62-5a8b5e541fae.png,667,240,772,349,105,109,red blood cell,11445,1.0380952380952382,0.963302752293578
69043,/images/b5246b58-6f40-4c9e-8024-f49b0ed6bdbd.png,770,164,868,252,98,88,red blood cell,8624,0.8979591836734694,1.1136363636363635
15479,/images/79f63258-24ce-4e69-a5cb-8529635a89a9.png,39,1171,146,1297,107,126,red blood cell,13482,1.1775700934579438,0.8492063492063492
45365,/images/e4eea7ea-8989-46a9-9c98-25a178146b28.png,814,800,917,903,103,103,red blood cell,10609,1.0,1.0
13781,/images/1b369bcf-ced4-4ae2-9196-2664bd2b1738.png,68,648,188,766,120,118,red blood cell,14160,0.9833333333333333,1.0169491525423728
33244,/images/877d5e7f-19b6-40e7-81bd-c92f25e72503.png,392,729,504,852,112,123,red blood cell,13776,1.0982142857142858,0.9105691056910569
35461,/images/3722d213-f2a9-46d5-aa76-9183b443e455.png,986,614,1091,730,105,116,red blood cell,12180,1.1047619047619048,0.9051724137931034
52797,/images/0a747cb3-c720-4572-a661-ab5670a5c42e.png,582,215,711,338,129,123,red blood cell,15867,0.9534883720930233,1.048780487804878
11920,/images/2e8d6a43-0110-4bf4-8e70-20567e513b81.png,633,983,748,1084,115,101,red blood cell,11615,0.8782608695652174,1.1386138613861385
61674,/images/a3c0a876-be12-4ede-8aed-18b32a64401b.png,854,911,967,1021,113,110,red blood cell,12430,0.9734513274336283,1.0272727272727273
76717,/images/3317d733-ec0d-45e6-b631-40457392f343.png,825,606,935,719,110,113,red blood cell,12430,1.0272727272727273,0.9734513274336283
57473,/images/00d04a90-80e5-4bce-9511-1b64eabb7a47.png,720,342,812,454,92,112,red blood cell,10304,1.2173913043478262,0.8214285714285714
63007,/images/f234a2de-f3c8-4521-a306-8cfdf52dd597.png,652,79,742,155,90,76,red blood cell,6840,0.8444444444444444,1.1842105263157894
61049,/images/6e86206f-dafe-4c28-bacc-7b83b2d40f0c.png,652,201,769,310,117,109,red blood cell,12753,0.9316239316239316,1.073394495412844
23908,/images/3d8fb5bf-3315-48fb-8ab1-802eafd550bc.png,468,827,576,939,108,112,red blood cell,12096,1.037037037037037,0.9642857142857143
69900,/images/9edba799-e169-46cd-b100-c9f8fc7a8c7d.png,48,65,150,175,102,110,red blood cell,11220,1.0784313725490196,0.9272727272727272
30126,/images/81c3c8f0-d5a9-4dda-afd5-e86f6afd9424.png,680,413,794,522,114,109,red blood cell,12426,0.956140350877193,1.0458715596330275
7781,/images/e726dac6-f962-449c-acff-4dd56847b685.png,541,1149,652,1266,111,117,red blood cell,12987,1.054054054054054,0.9487179487179487
39868,/images/af2e63a3-9fde-46aa-a867-81c5c259d1dc.png,95,1465,196,1573,101,108,red blood cell,10908,1.0693069306930694,0.9351851851851852
47028,/images/997eabd9-55bf-4683-83c4-4cee4673a4ef.png,794,547,928,671,134,124,red blood cell,16616,0.9253731343283582,1.0806451612903225
26570,/images/4935818a-7e7a-4f44-a3b6-b361d1abfe16.png,449,470,563,573,114,103,red blood cell,11742,0.9035087719298246,1.1067961165048543
18163,/images/947348fe-4c70-468e-8009-3c14daeca69b.png,992,1009,1102,1135,110,126,red blood cell,13860,1.1454545454545455,0.873015873015873
37070,/images/b2e34f5f-904e-4473-9dc7-c6bc1ce12640.png,853,217,949,322,96,105,red blood cell,10080,1.09375,0.9142857142857143
39433,/images/55f8c052-8e49-4423-a4c4-365fc6afb6e1.png,135,1046,249,1150,114,104,red blood cell,11856,0.9122807017543859,1.0961538461538463
27949,/images/46f5bd4f-8bea-48d1-a1da-4dea28e3b814.png,976,99,1104,211,128,112,red blood cell,14336,0.875,1.1428571428571428
78152,/images/bb137718-20ba-457d-8ffe-4f9420ecaab6.png,99,45,196,153,97,108,red blood cell,10476,1.1134020618556701,0.8981481481481481
47794,/images/5a105b89-c592-4d78-b208-7db6c6572752.png,277,612,392,736,115,124,red blood cell,14260,1.0782608695652174,0.9274193548387096
40189,/images/ef1a9020-5e45-450d-a237-165114308592.png,200,852,310,961,110,109,red blood cell,11990,0.990909090909091,1.0091743119266054
32634,/images/ed0d8763-e734-4506-b61b-53fc32a8d8c9.png,511,410,620,525,109,115,red blood cell,12535,1.055045871559633,0.9478260869565217
13367,/images/a7f1bbb1-6058-4642-bd66-cfb90dce762e.png,742,467,855,591,113,124,red blood cell,14012,1.0973451327433628,0.9112903225806451
23760,/images/6b2ff7ca-c5b3-415c-9481-7b14efc6d7ef.png,680,61,791,180,111,119,red blood cell,13209,1.072072072072072,0.9327731092436975
41939,/images/46a03374-64c7-49ac-81c9-c3d62542bbf3.png,638,903,730,1005,92,102,red blood cell,9384,1.108695652173913,0.9019607843137255
71881,/images/61575482-91e1-4db9-83c7-687b7ddbbfc4.png,757,777,854,873,97,96,red blood cell,9312,0.9896907216494846,1.0104166666666667
43670,/images/a4851ed0-1499-4eae-9157-dcd34773254f.png,1069,1366,1173,1477,104,111,red blood cell,11544,1.0673076923076923,0.9369369369369369
17563,/images/e80bad38-66d0-473e-85dd-92142dba37e6.png,160,243,290,361,130,118,red blood cell,15340,0.9076923076923077,1.1016949152542372
33897,/images/1a332b2c-9d49-4ff2-810c-5633d2314527.png,281,1146,415,1283,134,137,red blood cell,18358,1.0223880597014925,0.9781021897810219
17404,/images/6f4ffe7b-395f-41ea-ad61-df5e0cbd531c.png,920,1001,1038,1122,118,121,red blood cell,14278,1.0254237288135593,0.9752066115702479
10437,/images/46a2d369-4bea-4405-ac78-91bbe130b9a7.png,657,1196,771,1311,114,115,red blood cell,13110,1.0087719298245614,0.991304347826087
2800,/images/e79bd81b-f878-4bee-9be2-d91a722c031e.png,680,523,795,638,115,115,red blood cell,13225,1.0,1.0
39299,/images/697bdbc0-6e31-4e48-ac74-ba4ab5760d32.png,290,1307,420,1426,130,119,red blood cell,15470,0.9153846153846154,1.0924369747899159
25216,/images/90171428-f208-428a-b40e-f57ee3bea457.png,11,805,121,917,110,112,red blood cell,12320,1.018181818181818,0.9821428571428571
73705,/images/f11d05e4-538a-4024-8711-b08a4ce3c540.png,1098,1275,1194,1381,96,106,red blood cell,10176,1.1041666666666667,0.9056603773584906
12144,/images/87d6343b-70dd-4cdd-939f-d3ac0ca2e700.png,694,958,800,1080,106,122,red blood cell,12932,1.150943396226415,0.8688524590163934
59163,/images/4736f545-1f1f-4d77-9241-d69cbf4dae35.png,378,62,472,161,94,99,red blood cell,9306,1.053191489361702,0.9494949494949495
79286,/images/05ac7b2a-6a77-4464-926b-8570f7c01693.png,815,1207,903,1295,88,88,red blood cell,7744,1.0,1.0
52728,/images/9dc6ed5d-6698-48cf-aab3-fd156673729c.png,158,1140,263,1245,105,105,red blood cell,11025,1.0,1.0
8543,/images/dfc026a9-079f-4f45-8666-e0ccba5bb437.png,116,265,229,372,113,107,red blood cell,12091,0.9469026548672567,1.0560747663551402
16102,/images/66557580-fd38-4d4b-80d8-88611ecc78c6.png,1050,1074,1153,1182,103,108,red blood cell,11124,1.0485436893203883,0.9537037037037037
54843,/images/b6364a57-72a9-43f3-8d02-9f53a992dc95.png,668,127,759,233,91,106,red blood cell,9646,1.164835164835165,0.8584905660377359
44845,/images/83ec8923-6232-40d7-ba1f-a1b8bf7cb66c.png,109,1074,212,1172,103,98,red blood cell,10094,0.9514563106796117,1.0510204081632653
57319,/images/aaade430-4c49-4038-97b7-f8cdd937db57.png,490,48,583,135,93,87,red blood cell,8091,0.9354838709677419,1.0689655172413792
25880,/images/461a3ed6-039f-4a70-97cf-c474ecf51ccd.png,811,251,920,374,109,123,red blood cell,13407,1.128440366972477,0.8861788617886179
59681,/images/a2754679-68b0-40f4-be01-bafad5ac1261.png,213,107,328,203,115,96,red blood cell,11040,0.8347826086956521,1.1979166666666667
45367,/images/e4eea7ea-8989-46a9-9c98-25a178146b28.png,784,32,878,121,94,89,red blood cell,8366,0.9468085106382979,1.0561797752808988
71211,/images/86495bbf-687b-429c-b9d3-6c2681ade7e2.png,1055,509,1151,616,96,107,red blood cell,10272,1.1145833333333333,0.897196261682243
16212,/images/acdc6e12-73d9-44ba-be8c-2a56aaffef4f.png,448,92,557,217,109,125,red blood cell,13625,1.146788990825688,0.872
65504,/images/da49db57-0c2f-4213-b322-c88c19fb9296.png,685,167,773,271,88,104,red blood cell,9152,1.1818181818181819,0.8461538461538461
66230,/images/e8058bed-c362-4e1c-85dc-62f80f32938f.png,854,890,978,1003,124,113,red blood cell,14012,0.9112903225806451,1.0973451327433628
26398,/images/d532e31c-10ce-4313-9a36-bd5e01230254.png,149,191,253,292,104,101,red blood cell,10504,0.9711538461538461,1.0297029702970297
74977,/images/b4c52960-bbee-439e-83dc-f89ddaade71b.png,213,369,316,472,103,103,red blood cell,10609,1.0,1.0
44889,/images/83ec8923-6232-40d7-ba1f-a1b8bf7cb66c.png,747,213,861,318,114,105,red blood cell,11970,0.9210526315789473,1.0857142857142856
23393,/images/8757be1e-b832-407a-8e95-62abae485b24.png,215,1451,331,1570,116,119,red blood cell,13804,1.0258620689655173,0.9747899159663865
20585,/images/0f2a6cda-afec-437b-8803-8d3176b072c1.png,1018,815,1147,936,129,121,red blood cell,15609,0.937984496124031,1.0661157024793388
78919,/images/4d0a1598-e4dd-45c4-8a90-dd7c780fe1da.png,879,230,974,333,95,103,red blood cell,9785,1.0842105263157895,0.9223300970873787
38378,/images/674b0fd3-f247-4b7f-97f7-3e6c57c9ba9e.png,975,935,1058,1020,83,85,red blood cell,7055,1.0240963855421688,0.9764705882352941
48066,/images/1d4f06e1-9c9b-487e-84cd-e7e50cc754da.png,238,1119,357,1231,119,112,red blood cell,13328,0.9411764705882353,1.0625
55564,/images/a27b451d-44a6-4740-861a-9e7e99915563.png,735,1049,837,1155,102,106,red blood cell,10812,1.0392156862745099,0.9622641509433962
43996,/images/de81bf7a-7a56-437f-a068-4d9c3e01134c.png,1067,460,1164,564,97,104,red blood cell,10088,1.0721649484536082,0.9326923076923077
63522,/images/44b4a765-104e-4182-8871-e933c83c91ef.png,867,361,987,469,120,108,red blood cell,12960,0.9,1.1111111111111112
28555,/images/dbdfad64-110c-421f-a1c7-f68fd9e82d67.png,560,373,664,486,104,113,red blood cell,11752,1.0865384615384615,0.9203539823008849
4732,/images/3fa1a4e3-c80d-49da-8f7b-a1abb0424f48.png,527,176,649,297,122,121,red blood cell,14762,0.9918032786885246,1.0082644628099173
63784,/images/6013bff0-dc4b-4bde-9409-0f6139c3495c.png,351,190,470,291,119,101,red blood cell,12019,0.8487394957983193,1.1782178217821782
77258,/images/07a80340-f65e-4f58-9317-94bb6ebd5a28.png,761,1333,850,1423,89,90,red blood cell,8010,1.0112359550561798,0.9888888888888889
11052,/images/85a4d82e-cfb7-4983-b272-626c9e8c7583.png,619,1196,728,1320,109,124,red blood cell,13516,1.1376146788990826,0.8790322580645161
68212,/images/ff1b23d0-3cef-459b-b81f-39bfcdb6526f.png,625,1135,733,1250,108,115,red blood cell,12420,1.0648148148148149,0.9391304347826087
25691,/images/c118ff18-f9f2-4617-bddb-dc4091fb8f5f.png,516,954,625,1045,109,91,red blood cell,9919,0.8348623853211009,1.1978021978021978
51100,/images/4748ba2b-6771-41d9-93a5-af9ccd559261.png,392,1240,513,1360,121,120,red blood cell,14520,0.9917355371900827,1.0083333333333333
18103,/images/947348fe-4c70-468e-8009-3c14daeca69b.png,226,436,318,533,92,97,red blood cell,8924,1.0543478260869565,0.9484536082474226
48319,/images/6fa2b30f-9b89-46ac-9b79-c0bc105d4271.png,973,1075,1088,1179,115,104,red blood cell,11960,0.9043478260869565,1.1057692307692308
41443,/images/c4494d4f-732f-431a-8a9d-62403f0b74fe.png,446,358,558,467,112,109,red blood cell,12208,0.9732142857142857,1.0275229357798166
70159,/images/c742ee2c-6814-46cd-af56-ae87bb9972f4.png,646,1091,733,1183,87,92,red blood cell,8004,1.0574712643678161,0.9456521739130435
12486,/images/cc94eabb-a3dc-4cfc-9fff-55c76b5b4a71.png,875,770,971,862,96,92,red blood cell,8832,0.9583333333333334,1.0434782608695652
19572,/images/883d9731-a04d-4f84-83c9-d3bef954759d.png,863,676,980,798,117,122,red blood cell,14274,1.0427350427350428,0.9590163934426229
59897,/images/1519257c-e3e5-4474-908f-8665b3cf1258.png,440,601,533,694,93,93,red blood cell,8649,1.0,1.0
76031,/images/4c7d2382-a962-4237-a053-955eea3decd8.png,410,25,504,120,94,95,red blood cell,8930,1.0106382978723405,0.9894736842105263
58881,/images/8a7deb24-d2b4-4acf-86c4-3aadd39157fa.png,731,736,832,836,101,100,red blood cell,10100,0.9900990099009901,1.01
21596,/images/49efc89d-9cba-44f7-8257-7f911b73f68a.png,403,200,495,299,92,99,red blood cell,9108,1.076086956521739,0.9292929292929293
34644,/images/a0eedcb9-b85c-4612-b945-7e8227f53c35.png,804,486,904,597,100,111,red blood cell,11100,1.11,0.9009009009009009
1279,/images/6d91d1f0-636b-4f5a-a526-7c17fc857190.png,577,130,676,220,99,90,red blood cell,8910,0.9090909090909091,1.1
70367,/images/4876c9d0-b386-48fb-84e8-91bf87529161.png,101,786,209,879,108,93,red blood cell,10044,0.8611111111111112,1.1612903225806452
46887,/images/9e0e1928-d19a-4100-b093-0b962ac09e05.png,424,1097,535,1206,111,109,red blood cell,12099,0.9819819819819819,1.018348623853211
49934,/images/05804cf0-f854-4099-97c2-df287f7c8a8c.png,965,661,1082,771,117,110,red blood cell,12870,0.9401709401709402,1.0636363636363637
74086,/images/fe436c09-b680-4f4c-8faf-aa10a55a335b.png,761,394,862,490,101,96,red blood cell,9696,0.9504950495049505,1.0520833333333333
50024,/images/b1145408-feae-4637-b4cf-3e70b99cc62d.png,210,713,328,824,118,111,red blood cell,13098,0.940677966101695,1.063063063063063
36913,/images/b2e34f5f-904e-4473-9dc7-c6bc1ce12640.png,1060,594,1161,693,101,99,red blood cell,9999,0.9801980198019802,1.02020202020202
47169,/images/3d1b889e-bb4a-4ee6-b899-974ee7d956a7.png,673,58,791,173,118,115,red blood cell,13570,0.9745762711864406,1.0260869565217392
37258,/images/2fdbd9bc-bbaf-44c2-b40c-d193709639fa.png,348,1265,460,1382,112,117,red blood cell,13104,1.0446428571428572,0.9572649572649573
13726,/images/1b369bcf-ced4-4ae2-9196-2664bd2b1738.png,790,254,885,361,95,107,red blood cell,10165,1.1263157894736842,0.8878504672897196
14214,/images/c186dcd1-af61-455f-9619-1fdd8c881b06.png,618,1459,745,1584,127,125,red blood cell,15875,0.984251968503937,1.016
64143,/images/0d3c2521-da55-4df5-bf06-56b3bd4fb2fc.png,903,763,1000,856,97,93,red blood cell,9021,0.9587628865979382,1.043010752688172
1510,/images/0ac747cd-ff32-49bf-bc1a-3e9b7702ce9c.png,130,604,234,705,104,101,red blood cell,10504,0.9711538461538461,1.0297029702970297
23444,/images/8757be1e-b832-407a-8e95-62abae485b24.png,345,461,453,567,108,106,red blood cell,11448,0.9814814814814815,1.0188679245283019
79715,/images/03b9d6ad-39ca-4097-a98b-77f02b3c00a7.png,153,1100,260,1215,107,115,red blood cell,12305,1.074766355140187,0.9304347826086956
70454,/images/8cca114a-ed05-4b87-95b7-fae02487f08c.png,71,151,164,263,93,112,red blood cell,10416,1.2043010752688172,0.8303571428571429
66982,/images/3b4440f7-a69b-4042-a9d0-d6958abcdf4e.png,707,531,807,638,100,107,red blood cell,10700,1.07,0.9345794392523364
59327,/images/03c8da48-04b9-4520-b674-44a0ecd35688.png,610,462,700,551,90,89,red blood cell,8010,0.9888888888888889,1.0112359550561798
10840,/images/2a02cec2-a09b-483a-ad38-14359a763fa4.png,774,1465,883,1576,109,111,red blood cell,12099,1.018348623853211,0.9819819819819819
39429,/images/55f8c052-8e49-4423-a4c4-365fc6afb6e1.png,79,964,197,1072,118,108,red blood cell,12744,0.9152542372881356,1.0925925925925926
23187,/images/3dcd4f1b-ce43-4a34-b1ed-076bb42963b1.png,488,721,602,844,114,123,red blood cell,14022,1.0789473684210527,0.926829268292683
70950,/images/deaa1931-5f97-45bf-8c00-be6ddeb37b9a.png,463,1248,568,1346,105,98,red blood cell,10290,0.9333333333333333,1.0714285714285714
61727,/images/985627c9-7b85-40de-a106-eb9cc47b47cb.png,893,120,1013,247,120,127,red blood cell,15240,1.0583333333333333,0.9448818897637795
13730,/images/1b369bcf-ced4-4ae2-9196-2664bd2b1738.png,325,1425,440,1542,115,117,red blood cell,13455,1.017391304347826,0.9829059829059829
64595,/images/6dfafdf1-f588-4e80-8cf8-0126e1bf7af9.png,789,78,875,180,86,102,red blood cell,8772,1.186046511627907,0.8431372549019608
42535,/images/29648565-fe28-4517-ba72-68df0c82c9c5.png,567,693,659,781,92,88,red blood cell,8096,0.9565217391304348,1.0454545454545454
55393,/images/d67655e6-0a80-4a86-b552-1f5e85788377.png,974,112,1091,219,117,107,red blood cell,12519,0.9145299145299145,1.0934579439252337
15734,/images/64113b22-03b1-4ab8-89ab-b2f32154fbbd.png,732,1035,831,1144,99,109,red blood cell,10791,1.101010101010101,0.908256880733945
50592,/images/e98ea067-82b5-4a0d-87bf-b4bbdc10ddab.png,828,710,941,813,113,103,red blood cell,11639,0.911504424778761,1.0970873786407767
42219,/images/ca734448-0d52-42fa-b41c-17b2939e58ae.png,541,438,640,560,99,122,red blood cell,12078,1.2323232323232323,0.8114754098360656
13316,/images/030f3421-ed3f-4bf1-8f27-4d02590bffbc.png,1042,400,1143,505,101,105,red blood cell,10605,1.0396039603960396,0.9619047619047619
20384,/images/11e517bf-943b-4928-929a-e9f72c097880.png,1017,1288,1148,1397,131,109,red blood cell,14279,0.8320610687022901,1.201834862385321
51168,/images/d64cd75a-df26-44d5-ac25-69061a4e4d57.png,687,916,805,1011,118,95,red blood cell,11210,0.8050847457627118,1.2421052631578948
22555,/images/bfe65b11-8aff-46aa-908b-1e989d25fdc4.png,212,784,340,900,128,116,red blood cell,14848,0.90625,1.103448275862069
76236,/images/90a82250-1f68-48c9-9af9-15f18bf8c974.png,540,1432,645,1529,105,97,red blood cell,10185,0.9238095238095239,1.0824742268041236
78396,/images/24115f58-a7d6-4022-a95a-86b515a78d3e.png,805,793,887,887,82,94,red blood cell,7708,1.146341463414634,0.8723404255319149
23201,/images/3dcd4f1b-ce43-4a34-b1ed-076bb42963b1.png,740,175,819,256,79,81,red blood cell,6399,1.0253164556962024,0.9753086419753086
37188,/images/befe6182-266b-4f8a-ac82-3a4154f05f60.png,678,885,800,996,122,111,red blood cell,13542,0.9098360655737705,1.0990990990990992
66848,/images/9106a6bb-1352-411f-ac26-0d6fe48c16a8.png,844,1471,947,1569,103,98,red blood cell,10094,0.9514563106796117,1.0510204081632653
69088,/images/de2b8835-552c-4f01-98b7-67bc4910062e.png,467,393,562,477,95,84,red blood cell,7980,0.8842105263157894,1.130952380952381
20005,/images/8e69098c-fae0-47a3-8833-c2bfdfb1a416.png,876,454,991,578,115,124,red blood cell,14260,1.0782608695652174,0.9274193548387096
78194,/images/2bed2796-75a9-4d93-bb2d-e3ccbe1a5cbe.png,888,1138,964,1231,76,93,red blood cell,7068,1.2236842105263157,0.8172043010752689
72089,/images/64b0e49a-0e48-447d-8872-c1dd255e7a21.png,564,22,669,121,105,99,red blood cell,10395,0.9428571428571428,1.0606060606060606
61235,/images/b3058064-d817-47dd-a8c4-cdb1f62374f8.png,373,130,477,221,104,91,red blood cell,9464,0.875,1.1428571428571428
69587,/images/4a49841f-216c-4815-8140-b8762c4f6603.png,433,620,551,732,118,112,red blood cell,13216,0.9491525423728814,1.0535714285714286
15562,/images/169d541c-daed-468e-8b41-0f1abccdf319.png,405,330,502,436,97,106,red blood cell,10282,1.092783505154639,0.9150943396226415
25334,/images/c52f8cc8-afd7-441c-9f1f-18b6e16d79cf.png,636,819,763,946,127,127,red blood cell,16129,1.0,1.0
68404,/images/040112be-3c8d-49aa-93f1-522f94a592ff.png,624,1302,716,1398,92,96,red blood cell,8832,1.0434782608695652,0.9583333333333334
6680,/images/95fea6d8-413f-421e-b331-5d51c31df150.png,705,152,803,251,98,99,red blood cell,9702,1.010204081632653,0.98989898989899
10742,/images/20d4f65e-6c63-433a-935c-d568d577967b.png,60,814,146,910,86,96,red blood cell,8256,1.1162790697674418,0.8958333333333334
16334,/images/69569ecf-cfa1-4ddd-9342-b22c23387fdb.png,471,1042,600,1166,129,124,red blood cell,15996,0.9612403100775194,1.0403225806451613
53866,/images/540a5fee-175b-4b92-bf62-1ea9b59c86c6.png,836,1187,949,1292,113,105,red blood cell,11865,0.9292035398230089,1.0761904761904761
73573,/images/7624ac36-1cf9-42fb-844d-376078309553.png,158,37,244,140,86,103,red blood cell,8858,1.197674418604651,0.8349514563106796
2982,/images/5a386082-397f-4524-a6f9-c2b8efe5014d.png,526,1315,624,1431,98,116,red blood cell,11368,1.183673469387755,0.8448275862068966
33890,/images/1a332b2c-9d49-4ff2-810c-5633d2314527.png,644,948,767,1057,123,109,red blood cell,13407,0.8861788617886179,1.128440366972477
71445,/images/bcb447c9-5d37-414f-a513-d7076b04a532.png,988,692,1090,807,102,115,red blood cell,11730,1.1274509803921569,0.8869565217391304
42588,/images/184b376b-03cb-4c2d-af51-fc1a62196293.png,53,549,151,658,98,109,red blood cell,10682,1.1122448979591837,0.8990825688073395
45837,/images/7db1373d-5bbf-47e6-ab40-30cba7678745.png,475,511,579,617,104,106,red blood cell,11024,1.0192307692307692,0.9811320754716981
71499,/images/191071ab-6515-428c-9f05-8e4309542b75.png,916,1376,1011,1489,95,113,red blood cell,10735,1.1894736842105262,0.8407079646017699
18513,/images/c22f7031-9cf8-48ce-b03b-1b12d0db4951.png,954,395,1057,494,103,99,red blood cell,10197,0.9611650485436893,1.0404040404040404
35671,/images/4063945d-03fc-4ce3-a04c-17435dce8f91.png,401,816,507,924,106,108,red blood cell,11448,1.0188679245283019,0.9814814814814815
56689,/images/89b3d781-2f81-4d23-bed4-84da064df7f3.png,516,952,616,1058,100,106,red blood cell,10600,1.06,0.9433962264150944
58116,/images/e9916e11-9be6-4dec-9df6-2e7d1a8e1735.png,135,439,267,556,132,117,red blood cell,15444,0.8863636363636364,1.1282051282051282
41573,/images/0fcd1ebe-ee4a-40a0-b787-29cee18bfa1b.png,791,821,889,920,98,99,red blood cell,9702,1.010204081632653,0.98989898989899
17117,/images/dc3bdfe9-1565-4cda-9c4e-0979846dab60.png,617,438,728,556,111,118,red blood cell,13098,1.063063063063063,0.940677966101695
20685,/images/e6d7c5e1-43fc-4712-86d5-aa70252b978f.png,847,1316,969,1450,122,134,red blood cell,16348,1.098360655737705,0.9104477611940298
21246,/images/0ceb4539-5c4c-487d-9826-452a88b5d537.png,464,343,573,465,109,122,red blood cell,13298,1.1192660550458715,0.8934426229508197
68808,/images/aa3ad405-828e-4986-8251-20fd981f34d3.png,551,1037,654,1150,103,113,red blood cell,11639,1.0970873786407767,0.911504424778761
79437,/images/dcb21739-3c36-459d-b3cc-1be5871d6fe7.png,843,1237,935,1321,92,84,red blood cell,7728,0.9130434782608695,1.0952380952380953
42515,/images/29648565-fe28-4517-ba72-68df0c82c9c5.png,276,997,392,1110,116,113,red blood cell,13108,0.9741379310344828,1.0265486725663717
22431,/images/f97c7c87-5e27-45ea-9f93-3285d74091de.png,305,167,417,278,112,111,red blood cell,12432,0.9910714285714286,1.009009009009009
30572,/images/7d9c1422-6332-44e9-b134-3ac94f07b0f0.png,197,1419,294,1525,97,106,red blood cell,10282,1.092783505154639,0.9150943396226415
1471,/images/0ac747cd-ff32-49bf-bc1a-3e9b7702ce9c.png,1051,329,1187,446,136,117,red blood cell,15912,0.8602941176470589,1.1623931623931625
2747,/images/a89cace5-c818-4f23-a432-052b3433b81e.png,465,184,561,270,96,86,red blood cell,8256,0.8958333333333334,1.1162790697674418
54883,/images/8f84a2c9-ca38-4405-a488-12fcd101278b.png,1060,1036,1178,1152,118,116,red blood cell,13688,0.9830508474576272,1.0172413793103448
49161,/images/df3d98b9-3dd7-4107-8d4a-ae1b7f247793.png,133,640,229,757,96,117,red blood cell,11232,1.21875,0.8205128205128205
58973,/images/a0eeeb10-d0cb-48d9-8c22-2c3a3c908d00.png,1006,1375,1109,1490,103,115,red blood cell,11845,1.116504854368932,0.8956521739130435
921,/images/dce55b59-c6c3-4693-aa75-6b348c8f52cd.png,649,523,746,619,97,96,red blood cell,9312,0.9896907216494846,1.0104166666666667
43758,/images/ef83ed4c-2724-4d5f-8abe-1a18d25cea35.png,923,1166,1023,1277,100,111,red blood cell,11100,1.11,0.9009009009009009
9269,/images/261562a8-ffd8-4e0e-919b-22e267000b74.png,140,768,252,868,112,100,red blood cell,11200,0.8928571428571429,1.12
32266,/images/f4722a74-35e7-42bd-8ef6-dfff04b9cd22.png,282,53,396,165,114,112,red blood cell,12768,0.9824561403508771,1.0178571428571428
2301,/images/fe851c88-692d-4199-87e0-d19d9c4eb591.png,617,501,714,591,97,90,red blood cell,8730,0.9278350515463918,1.0777777777777777
14258,/images/6382976c-ee87-4916-b798-4ef1373b2df0.png,876,461,998,582,122,121,red blood cell,14762,0.9918032786885246,1.0082644628099173
77420,/images/c7ec51d5-9f45-4209-8357-39e9a984a733.png,201,470,299,578,98,108,red blood cell,10584,1.1020408163265305,0.9074074074074074
58073,/images/a7c91b63-b97c-4f4b-8d34-7ad2b08d7a17.png,636,578,717,659,81,81,red blood cell,6561,1.0,1.0
11830,/images/3cdcb09b-6a8c-43ca-b1d0-c1a289202f65.png,847,20,959,128,112,108,red blood cell,12096,0.9642857142857143,1.037037037037037
58731,/images/e4827c85-311a-4df1-89c2-99dad0c3558c.png,644,331,750,426,106,95,red blood cell,10070,0.8962264150943396,1.1157894736842104
33943,/images/1a332b2c-9d49-4ff2-810c-5633d2314527.png,828,925,938,1038,110,113,red blood cell,12430,1.0272727272727273,0.9734513274336283
39127,/images/7bde7de1-889b-4218-b0e1-e2c04f6a7986.png,102,1186,206,1271,104,85,red blood cell,8840,0.8173076923076923,1.223529411764706
8464,/images/e234ce8b-4ec4-4d93-9068-d7854d77ddf4.png,207,975,312,1089,105,114,red blood cell,11970,1.0857142857142856,0.9210526315789473
49194,/images/a9daf82a-a46d-4296-bd72-2c374ed0a193.png,606,382,711,490,105,108,red blood cell,11340,1.0285714285714285,0.9722222222222222
17901,/images/eb77e4a9-acb0-4d83-8055-2c5fcaa54b45.png,974,220,1072,325,98,105,red blood cell,10290,1.0714285714285714,0.9333333333333333
38295,/images/674b0fd3-f247-4b7f-97f7-3e6c57c9ba9e.png,536,185,651,281,115,96,red blood cell,11040,0.8347826086956521,1.1979166666666667
40464,/images/db249e5a-4142-432c-8288-bacd10d7273d.png,257,1196,346,1307,89,111,red blood cell,9879,1.247191011235955,0.8018018018018018
16425,/images/e474a20b-2769-48f1-a520-4f6ef5a0dbf5.png,353,796,464,895,111,99,red blood cell,10989,0.8918918918918919,1.121212121212121
29740,/images/f25a2ac8-cb6e-4e05-a0cd-cc00ac47718a.png,748,6,870,119,122,113,red blood cell,13786,0.9262295081967213,1.079646017699115
1297,/images/6d91d1f0-636b-4f5a-a526-7c17fc857190.png,232,1013,320,1113,88,100,red blood cell,8800,1.1363636363636365,0.88
51465,/images/baa87bf8-786c-444c-81e8-9fa0a41d8149.png,1077,821,1194,931,117,110,red blood cell,12870,0.9401709401709402,1.0636363636363637
61636,/images/a3c0a876-be12-4ede-8aed-18b32a64401b.png,511,751,619,856,108,105,red blood cell,11340,0.9722222222222222,1.0285714285714285
16678,/images/bc377041-e098-45c4-9651-2b1ea90d1d7e.png,852,1126,1002,1258,150,132,red blood cell,19800,0.88,1.1363636363636365
28685,/images/151f3af5-5e6e-4bcd-9389-4974fc68813e.png,1021,1191,1115,1283,94,92,red blood cell,8648,0.9787234042553191,1.0217391304347827
29834,/images/9cdee92c-6267-4188-a41e-125bc0abb9ae.png,577,647,686,748,109,101,red blood cell,11009,0.926605504587156,1.0792079207920793
58648,/images/a4d7a7e1-5ae1-486d-b6ee-c9af1476ccad.png,492,1171,582,1260,90,89,red blood cell,8010,0.9888888888888889,1.0112359550561798
18049,/images/0f0c949e-018a-4f3f-ab02-3704f49c7754.png,29,891,149,1015,120,124,red blood cell,14880,1.0333333333333334,0.967741935483871
41200,/images/eed298b3-35f2-4127-88ad-0c4a9062207b.png,375,824,474,919,99,95,red blood cell,9405,0.9595959595959596,1.0421052631578946
9371,/images/261562a8-ffd8-4e0e-919b-22e267000b74.png,1104,14,1198,126,94,112,red blood cell,10528,1.1914893617021276,0.8392857142857143
4854,/images/c6ab535c-30e5-4b6b-8273-1ec8d78cdd13.png,214,1376,351,1492,137,116,red blood cell,15892,0.8467153284671532,1.1810344827586208
73931,/images/2ae3e6e6-7482-4ab8-ad73-b530b5c2ee3b.png,393,273,476,360,83,87,red blood cell,7221,1.0481927710843373,0.9540229885057471
66432,/images/5f66d20c-fbfe-44ec-a01b-8a09da24807e.png,100,1034,194,1137,94,103,red blood cell,9682,1.0957446808510638,0.912621359223301
69880,/images/9edba799-e169-46cd-b100-c9f8fc7a8c7d.png,624,1411,734,1513,110,102,red blood cell,11220,0.9272727272727272,1.0784313725490196
7995,/images/694222bb-cddf-469a-9526-f873c6fba58e.png,750,12,857,121,107,109,red blood cell,11663,1.0186915887850467,0.981651376146789
56001,/images/4c460388-e0c1-4970-8527-c9e5b42bea49.png,231,1017,324,1111,93,94,red blood cell,8742,1.010752688172043,0.9893617021276596
48873,/images/fed6ba05-36a5-45dc-a4e1-9baa7de2c622.png,903,258,1001,361,98,103,red blood cell,10094,1.0510204081632653,0.9514563106796117
32027,/images/b8a4d467-c40c-4ebf-91dd-1c19d0f2a7ae.png,859,1145,961,1247,102,102,red blood cell,10404,1.0,1.0
57418,/images/00d04a90-80e5-4bce-9511-1b64eabb7a47.png,689,27,786,131,97,104,red blood cell,10088,1.0721649484536082,0.9326923076923077
30547,/images/7d9c1422-6332-44e9-b134-3ac94f07b0f0.png,38,108,154,210,116,102,red blood cell,11832,0.8793103448275862,1.1372549019607843
55246,/images/8ad7ba46-5db8-4ba9-b3e0-3cac52f7efc3.png,389,989,514,1102,125,113,red blood cell,14125,0.904,1.1061946902654867
3851,/images/73dd09d3-2bff-4b5e-b996-9da0b8b54a8f.png,712,165,836,288,124,123,red blood cell,15252,0.9919354838709677,1.008130081300813
48628,/images/55836297-fc8e-4e00-9767-0d12b86e4604.png,103,265,214,365,111,100,red blood cell,11100,0.9009009009009009,1.11
68913,/images/bbaa004f-05dc-4cb8-8768-e148085bb0f9.png,1057,1393,1156,1493,99,100,red blood cell,9900,1.0101010101010102,0.99
69458,/images/664c570b-4822-413c-9724-11b1d91fac44.png,595,916,689,1014,94,98,red blood cell,9212,1.0425531914893618,0.9591836734693877
869,/images/dce55b59-c6c3-4693-aa75-6b348c8f52cd.png,94,410,186,511,92,101,red blood cell,9292,1.0978260869565217,0.9108910891089109
52550,/images/0546d843-d778-4aca-b8b5-bfe23d7c87da.png,295,518,402,638,107,120,red blood cell,12840,1.1214953271028036,0.8916666666666667
56798,/images/0dcbf2c9-f959-4703-a72b-f6a81e66c2ea.png,592,73,693,183,101,110,red blood cell,11110,1.0891089108910892,0.9181818181818182
72386,/images/a15e0fa8-2620-4f66-896e-175115c9dc3d.png,242,660,345,761,103,101,red blood cell,10403,0.9805825242718447,1.0198019801980198
20731,/images/79b3a64f-2fb9-46e0-85d4-2bdd59c2075e.png,397,607,510,714,113,107,red blood cell,12091,0.9469026548672567,1.0560747663551402
24367,/images/4d8a4ce8-0f9c-4f21-8844-4cf0e5514bbf.png,996,1437,1076,1508,80,71,red blood cell,5680,0.8875,1.1267605633802817
21083,/images/c680004e-6ee2-43d7-877c-edc9b5ebeecc.png,279,371,389,482,110,111,red blood cell,12210,1.009090909090909,0.990990990990991
38346,/images/674b0fd3-f247-4b7f-97f7-3e6c57c9ba9e.png,153,1214,249,1316,96,102,red blood cell,9792,1.0625,0.9411764705882353
63026,/images/f234a2de-f3c8-4521-a306-8cfdf52dd597.png,301,1233,378,1310,77,77,red blood cell,5929,1.0,1.0
40950,/images/550cf4ce-b641-44a3-8487-3e16d4049187.png,261,197,355,295,94,98,red blood cell,9212,1.0425531914893618,0.9591836734693877
2268,/images/fe851c88-692d-4199-87e0-d19d9c4eb591.png,519,307,625,419,106,112,red blood cell,11872,1.0566037735849056,0.9464285714285714
60933,/images/11b72c7b-5c52-44b7-adb7-21eacc25e441.png,841,1304,919,1393,78,89,red blood cell,6942,1.141025641025641,0.8764044943820225
58834,/images/434523fd-d4d9-4961-a7c2-d71d6ae68e13.png,837,783,950,901,113,118,red blood cell,13334,1.0442477876106195,0.9576271186440678
45729,/images/584d62ed-4329-45dd-94ce-e929d8b2bb74.png,219,792,323,884,104,92,red blood cell,9568,0.8846153846153846,1.1304347826086956
2329,/images/fe851c88-692d-4199-87e0-d19d9c4eb591.png,228,1028,315,1127,87,99,red blood cell,8613,1.1379310344827587,0.8787878787878788
79773,/images/03b9d6ad-39ca-4097-a98b-77f02b3c00a7.png,739,1024,823,1097,84,73,red blood cell,6132,0.8690476190476191,1.1506849315068493
56580,/images/a824b499-3736-4581-bbdc-be1b3b4cf756.png,724,450,845,569,121,119,red blood cell,14399,0.9834710743801653,1.0168067226890756
62032,/images/bdb5d571-27bc-4a42-ae45-aa5a9af40a81.png,1047,217,1144,328,97,111,red blood cell,10767,1.1443298969072164,0.8738738738738738
13848,/images/345cb914-7583-49df-96e3-3cf19c2ba8f1.png,385,503,503,623,118,120,red blood cell,14160,1.0169491525423728,0.9833333333333333
59183,/images/4736f545-1f1f-4d77-9241-d69cbf4dae35.png,509,1112,621,1208,112,96,red blood cell,10752,0.8571428571428571,1.1666666666666667
39320,/images/17ef5841-bd19-4610-ba47-7d321231847b.png,990,1022,1122,1147,132,125,red blood cell,16500,0.946969696969697,1.056
75246,/images/61dfc937-a428-44b4-94fb-d682bdb8dff0.png,663,944,742,1035,79,91,red blood cell,7189,1.1518987341772151,0.8681318681318682
49454,/images/f2574be3-81c6-4fc3-8a40-0230d1264f52.png,314,490,404,584,90,94,red blood cell,8460,1.0444444444444445,0.9574468085106383
52687,/images/9dc6ed5d-6698-48cf-aab3-fd156673729c.png,125,967,232,1073,107,106,red blood cell,11342,0.9906542056074766,1.009433962264151
27747,/images/e3c1442a-717f-41dd-bf97-81e1233ac9fa.png,789,258,885,355,96,97,red blood cell,9312,1.0104166666666667,0.9896907216494846
37364,/images/08f5a524-0554-49c2-83a8-ae9a6d51e8fd.png,241,1187,346,1297,105,110,red blood cell,11550,1.0476190476190477,0.9545454545454546
65836,/images/daea4860-a296-4f6d-acef-996ab0882676.png,771,558,883,676,112,118,red blood cell,13216,1.0535714285714286,0.9491525423728814
22058,/images/6b8048ed-ebd7-4789-ba87-c1ba94801481.png,79,861,221,979,142,118,red blood cell,16756,0.8309859154929577,1.2033898305084745
74229,/images/4e43fc22-dc08-4cde-b3ce-ce8a4f377c47.png,712,739,794,834,82,95,red blood cell,7790,1.1585365853658536,0.8631578947368421
54798,/images/b6364a57-72a9-43f3-8d02-9f53a992dc95.png,690,771,801,891,111,120,red blood cell,13320,1.0810810810810811,0.925
46189,/images/d8632217-ec33-4d0a-98e6-427824c58869.png,415,615,533,737,118,122,red blood cell,14396,1.0338983050847457,0.9672131147540983
19139,/images/bb795ddf-ce72-42d5-9006-124db4d5cf1c.png,467,854,592,968,125,114,red blood cell,14250,0.912,1.0964912280701755
64267,/images/83d4e1fe-da84-4175-a9e2-8efc18782dcf.png,547,1384,678,1499,131,115,red blood cell,15065,0.8778625954198473,1.1391304347826088
65143,/images/5e042380-6ef2-496f-8231-0ca550fbfa71.png,1043,729,1135,822,92,93,red blood cell,8556,1.0108695652173914,0.989247311827957
48591,/images/55836297-fc8e-4e00-9767-0d12b86e4604.png,656,463,762,564,106,101,red blood cell,10706,0.9528301886792453,1.0495049504950495
64759,/images/76021d69-8919-4688-95ef-7418eff620cc.png,2,196,95,301,93,105,red blood cell,9765,1.1290322580645162,0.8857142857142857
253,/images/0dcca702-a4ef-4fb3-a940-9c0c140b21c7.png,891,669,989,767,98,98,red blood cell,9604,1.0,1.0
39011,/images/79806898-0214-44bd-ba2c-b570e911be62.png,765,961,893,1096,128,135,red blood cell,17280,1.0546875,0.9481481481481482
54108,/images/d9345456-b76d-46cc-b81e-46d4a0a7b652.png,1,602,105,710,104,108,red blood cell,11232,1.0384615384615385,0.9629629629629629
60123,/images/ec60ab26-3343-4c5f-9667-cdae999c7d86.png,244,331,356,446,112,115,red blood cell,12880,1.0267857142857142,0.9739130434782609
44702,/images/867f30da-2568-4480-9968-cece78c61c64.png,512,1413,624,1527,112,114,red blood cell,12768,1.0178571428571428,0.9824561403508771
6990,/images/c776eb78-3323-4571-b39f-7ffc73ae63ce.png,583,514,682,628,99,114,red blood cell,11286,1.1515151515151516,0.868421052631579
40934,/images/550cf4ce-b641-44a3-8487-3e16d4049187.png,23,1025,128,1134,105,109,red blood cell,11445,1.0380952380952382,0.963302752293578
39449,/images/5a631871-2fc7-4a68-9c39-f3b9a0bf4a04.png,439,281,555,403,116,122,red blood cell,14152,1.0517241379310345,0.9508196721311475
64256,/images/83d4e1fe-da84-4175-a9e2-8efc18782dcf.png,1055,232,1167,335,112,103,red blood cell,11536,0.9196428571428571,1.087378640776699
74443,/images/06a3effb-996c-4767-afd2-6aa3b697cb4e.png,657,526,743,630,86,104,red blood cell,8944,1.2093023255813953,0.8269230769230769
61612,/images/4a717a39-80f8-4b75-a25e-c46d65d7dcd5.png,1103,1172,1200,1275,97,103,red blood cell,9991,1.0618556701030928,0.941747572815534
47739,/images/afbb264e-ff60-443a-83f5-49d09be1b835.png,886,1155,1004,1265,118,110,red blood cell,12980,0.9322033898305084,1.0727272727272728
72268,/images/ee57e743-a876-4f69-9fe5-bf5d01b44689.png,31,1121,150,1221,119,100,red blood cell,11900,0.8403361344537815,1.19
7255,/images/89f10192-d3dd-4996-a571-4c851dbdc983.png,1012,641,1128,744,116,103,red blood cell,11948,0.8879310344827587,1.1262135922330097
27690,/images/18dbe7c4-89d2-42a6-a969-1e951ab313b1.png,119,876,250,990,131,114,red blood cell,14934,0.8702290076335878,1.1491228070175439
54416,/images/22a464ef-c3da-4d56-b37e-e22e95d945e7.png,995,4,1096,103,101,99,red blood cell,9999,0.9801980198019802,1.02020202020202
35230,/images/a9159b11-ba49-4885-902e-00c8d5095b98.png,451,398,546,501,95,103,red blood cell,9785,1.0842105263157895,0.9223300970873787
41488,/images/c4494d4f-732f-431a-8a9d-62403f0b74fe.png,7,177,102,281,95,104,red blood cell,9880,1.0947368421052632,0.9134615384615384
65708,/images/c54fcef1-0c51-4426-9a93-15ec5f2bf58a.png,1038,281,1137,389,99,108,red blood cell,10692,1.0909090909090908,0.9166666666666666
54181,/images/3b5a8060-dec6-4a83-b7f2-b604e4e69dfc.png,36,346,159,463,123,117,red blood cell,14391,0.9512195121951219,1.0512820512820513
30748,/images/8e0dfc1f-e3eb-4a3f-a1c4-249bdfbfaa27.png,495,81,617,200,122,119,red blood cell,14518,0.9754098360655737,1.0252100840336134
26545,/images/4935818a-7e7a-4f44-a3b6-b361d1abfe16.png,0,595,120,712,120,117,red blood cell,14040,0.975,1.0256410256410255
36193,/images/17c06a23-bb77-49cb-9ffb-fbfc75fcc715.png,954,450,1052,561,98,111,red blood cell,10878,1.1326530612244898,0.8828828828828829
64976,/images/dec61ae1-5037-4c3a-8952-15371becca7d.png,1054,254,1144,331,90,77,red blood cell,6930,0.8555555555555555,1.1688311688311688
66624,/images/b88fe674-fb9a-41d4-b100-cb1c86440d44.png,237,807,354,914,117,107,red blood cell,12519,0.9145299145299145,1.0934579439252337
56962,/images/a93c35ba-1690-4358-8837-669bcd850bb7.png,617,1486,734,1596,117,110,red blood cell,12870,0.9401709401709402,1.0636363636363637
20011,/images/ebfd9f67-138e-49f0-9cef-a0352069eedb.png,210,308,315,396,105,88,red blood cell,9240,0.8380952380952381,1.1931818181818181
9821,/images/3859deaf-6ae1-49a3-9051-898d0f0d7de6.png,881,614,990,733,109,119,red blood cell,12971,1.091743119266055,0.9159663865546218
23241,/images/3dcd4f1b-ce43-4a34-b1ed-076bb42963b1.png,44,1193,167,1326,123,133,red blood cell,16359,1.08130081300813,0.924812030075188
22534,/images/bfe65b11-8aff-46aa-908b-1e989d25fdc4.png,356,1348,464,1468,108,120,red blood cell,12960,1.1111111111111112,0.9
1335,/images/6d91d1f0-636b-4f5a-a526-7c17fc857190.png,345,949,448,1036,103,87,red blood cell,8961,0.8446601941747572,1.1839080459770115
38729,/images/b426ef1d-4a59-4f90-b593-50226af60a60.png,398,49,523,151,125,102,red blood cell,12750,0.816,1.2254901960784315
60274,/images/7abc0d26-dd66-4ef4-8c4e-4a661e589a7f.png,876,95,984,209,108,114,red blood cell,12312,1.0555555555555556,0.9473684210526315
18407,/images/39cc33be-d752-40fe-b7a8-2e69a3517205.png,312,26,421,160,109,134,red blood cell,14606,1.2293577981651376,0.8134328358208955
62907,/images/4b346035-b8c0-46ca-8fdb-a01b1421ee4a.png,960,944,1057,1050,97,106,red blood cell,10282,1.092783505154639,0.9150943396226415
8120,/images/694222bb-cddf-469a-9526-f873c6fba58e.png,187,1214,272,1310,85,96,red blood cell,8160,1.1294117647058823,0.8854166666666666
70122,/images/c742ee2c-6814-46cd-af56-ae87bb9972f4.png,593,875,685,977,92,102,red blood cell,9384,1.108695652173913,0.9019607843137255
5812,/images/143f5959-5b6d-4f95-bcee-9e110450fc22.png,197,1432,320,1553,123,121,red blood cell,14883,0.983739837398374,1.0165289256198347
31701,/images/bd432159-5956-457c-bdeb-1b5e702ba513.png,519,47,644,160,125,113,red blood cell,14125,0.904,1.1061946902654867
40352,/images/eb86033f-4f1c-4e8c-ae84-e8e4c7e08626.png,4,997,85,1095,81,98,red blood cell,7938,1.2098765432098766,0.826530612244898
69217,/images/f274b784-b995-4a7e-a2c2-6cc31c24c4b4.png,66,258,170,364,104,106,red blood cell,11024,1.0192307692307692,0.9811320754716981
24141,/images/505355c9-23bf-4f90-8ebc-6a7ef50964d0.png,657,1435,759,1535,102,100,red blood cell,10200,0.9803921568627451,1.02
41912,/images/783ae4ad-6a35-4b3c-b19f-754974b67b2d.png,410,705,512,795,102,90,red blood cell,9180,0.8823529411764706,1.1333333333333333
57253,/images/6d05ed67-43e2-43af-9d57-70c7a6eeef5e.png,403,508,504,628,101,120,red blood cell,12120,1.188118811881188,0.8416666666666667
31331,/images/31c749e8-18d1-4105-b7e6-8319cceddae0.png,645,887,748,997,103,110,red blood cell,11330,1.0679611650485437,0.9363636363636364
6996,/images/c776eb78-3323-4571-b39f-7ffc73ae63ce.png,182,517,290,619,108,102,red blood cell,11016,0.9444444444444444,1.0588235294117647
48982,/images/df3d98b9-3dd7-4107-8d4a-ae1b7f247793.png,980,330,1096,431,116,101,red blood cell,11716,0.8706896551724138,1.1485148514851484
70253,/images/a5c3b3f8-7ceb-4573-a400-a76b9479af46.png,294,719,389,826,95,107,red blood cell,10165,1.1263157894736842,0.8878504672897196
38460,/images/674b0fd3-f247-4b7f-97f7-3e6c57c9ba9e.png,123,251,217,354,94,103,red blood cell,9682,1.0957446808510638,0.912621359223301
45395,/images/e4eea7ea-8989-46a9-9c98-25a178146b28.png,326,648,436,766,110,118,red blood cell,12980,1.0727272727272728,0.9322033898305084
3955,/images/f09acb0c-b270-4e91-99f8-410adfa7f34a.png,793,824,898,926,105,102,red blood cell,10710,0.9714285714285714,1.0294117647058822
49668,/images/9842445c-5899-4189-9f2e-3a3a179fdad3.png,544,1171,656,1301,112,130,red blood cell,14560,1.1607142857142858,0.8615384615384616
11652,/images/0ed416f9-7c20-4829-9016-559e4009568e.png,79,1290,193,1402,114,112,red blood cell,12768,0.9824561403508771,1.0178571428571428
53241,/images/d8f7e159-b7e3-49e4-86e8-aed8c5fbcd97.png,86,1320,179,1417,93,97,red blood cell,9021,1.043010752688172,0.9587628865979382
12275,/images/3b55c42f-ad59-422f-ba99-4f4f4ca9cb2e.png,115,1304,206,1412,91,108,red blood cell,9828,1.1868131868131868,0.8425925925925926
16463,/images/e474a20b-2769-48f1-a520-4f6ef5a0dbf5.png,1115,1465,1196,1548,81,83,red blood cell,6723,1.0246913580246915,0.9759036144578314
56163,/images/137d540f-d71e-47e8-bd9b-6cd0a6433c33.png,775,1144,876,1248,101,104,red blood cell,10504,1.0297029702970297,0.9711538461538461
77415,/images/c7ec51d5-9f45-4209-8357-39e9a984a733.png,214,873,329,989,115,116,red blood cell,13340,1.008695652173913,0.9913793103448276
46921,/images/9e0e1928-d19a-4100-b093-0b962ac09e05.png,84,459,182,568,98,109,red blood cell,10682,1.1122448979591837,0.8990825688073395
42583,/images/184b376b-03cb-4c2d-af51-fc1a62196293.png,767,1175,879,1296,112,121,red blood cell,13552,1.0803571428571428,0.9256198347107438
28540,/images/dbdfad64-110c-421f-a1c7-f68fd9e82d67.png,509,17,614,125,105,108,red blood cell,11340,1.0285714285714285,0.9722222222222222
703,/images/e61e6af2-7f8b-47b0-bbe7-acb2ed0299ab.png,134,1264,225,1367,91,103,red blood cell,9373,1.1318681318681318,0.883495145631068
75221,/images/61dfc937-a428-44b4-94fb-d682bdb8dff0.png,845,454,956,560,111,106,red blood cell,11766,0.954954954954955,1.0471698113207548
65467,/images/b523daee-317b-461d-bdc1-07b4add4d488.png,987,527,1064,604,77,77,red blood cell,5929,1.0,1.0
56968,/images/a93c35ba-1690-4358-8837-669bcd850bb7.png,411,552,537,662,126,110,red blood cell,13860,0.873015873015873,1.1454545454545455
33011,/images/6231d81d-9e84-4a5a-8cb8-47c6a37a0176.png,107,1338,217,1432,110,94,red blood cell,10340,0.8545454545454545,1.1702127659574468
36649,/images/21f001d6-f568-4ea4-82da-fab54c77c419.png,985,384,1079,476,94,92,red blood cell,8648,0.9787234042553191,1.0217391304347827
78464,/images/72029aca-f0bc-477f-b790-f345f86228ce.png,810,562,921,668,111,106,red blood cell,11766,0.954954954954955,1.0471698113207548
10101,/images/d1617cf7-eb56-42ee-85af-66c4748753c0.png,226,1296,348,1445,122,149,red blood cell,18178,1.221311475409836,0.8187919463087249
3261,/images/b901c906-91be-48c4-88ec-2c527544a258.png,411,1339,525,1445,114,106,red blood cell,12084,0.9298245614035088,1.0754716981132075
37302,/images/2fdbd9bc-bbaf-44c2-b40c-d193709639fa.png,732,379,846,516,114,137,red blood cell,15618,1.2017543859649122,0.8321167883211679
55715,/images/c32b8bb8-c89d-4ae9-9c77-5b9356ca35a1.png,1056,92,1156,183,100,91,red blood cell,9100,0.91,1.098901098901099
72015,/images/6ad3efc9-4392-4cee-98a5-186564a96373.png,260,374,347,476,87,102,red blood cell,8874,1.1724137931034482,0.8529411764705882
3286,/images/b901c906-91be-48c4-88ec-2c527544a258.png,741,651,863,760,122,109,red blood cell,13298,0.8934426229508197,1.1192660550458715
13177,/images/711f6b3f-cd63-46d1-834a-bc8e9aa9b43e.png,347,28,434,117,87,89,red blood cell,7743,1.0229885057471264,0.9775280898876404
77456,/images/a11ed7d0-12f6-468f-abad-5cba7d968123.png,345,1377,465,1493,120,116,red blood cell,13920,0.9666666666666667,1.0344827586206897
22233,/images/3d4d7ba7-6c7c-4ddd-b282-31fb5d80edb5.png,213,966,308,1075,95,109,red blood cell,10355,1.1473684210526316,0.8715596330275229
62137,/images/a63fa2c7-3ec8-4bb7-bde6-a39e09d2f806.png,189,827,313,953,124,126,red blood cell,15624,1.0161290322580645,0.9841269841269841
6860,/images/b21f6c6e-4b45-407a-b4c7-034a115f3ee4.png,259,1324,381,1451,122,127,red blood cell,15494,1.040983606557377,0.9606299212598425
15184,/images/3a8f468f-f9de-46a8-a7c8-f2be239fa207.png,878,940,971,1047,93,107,red blood cell,9951,1.1505376344086022,0.8691588785046729
14182,/images/c8fd1336-dd0a-4f97-abbf-be2c18b91e02.png,826,1340,949,1467,123,127,red blood cell,15621,1.032520325203252,0.968503937007874
7199,/images/56551792-4aa1-4301-9f8f-8bfebcd20050.png,573,1001,683,1112,110,111,red blood cell,12210,1.009090909090909,0.990990990990991
40197,/images/ef1a9020-5e45-450d-a237-165114308592.png,762,88,870,213,108,125,red blood cell,13500,1.1574074074074074,0.864
27571,/images/715761a2-745e-4743-9849-956a034ad3c4.png,278,216,393,315,115,99,red blood cell,11385,0.8608695652173913,1.1616161616161615
2908,/images/a1c140f9-75d7-42a3-b767-4c01a118892b.png,149,4,266,131,117,127,red blood cell,14859,1.0854700854700854,0.9212598425196851
59714,/images/f77d7469-d083-4c2d-a4ea-5a9ff162e3e2.png,354,1152,457,1248,103,96,red blood cell,9888,0.9320388349514563,1.0729166666666667
47118,/images/3d1b889e-bb4a-4ee6-b899-974ee7d956a7.png,93,347,194,447,101,100,red blood cell,10100,0.9900990099009901,1.01
13318,/images/030f3421-ed3f-4bf1-8f27-4d02590bffbc.png,581,1140,686,1239,105,99,red blood cell,10395,0.9428571428571428,1.0606060606060606
22483,/images/dd60b6a7-c545-45b9-8250-d1633aa1ac75.png,1037,667,1147,796,110,129,red blood cell,14190,1.1727272727272726,0.8527131782945736
11593,/images/b4dc3088-3fe2-4688-be24-70664a64e022.png,821,314,948,420,127,106,red blood cell,13462,0.8346456692913385,1.1981132075471699
55871,/images/afd39466-aafa-4d81-9520-483727418723.png,112,1381,201,1479,89,98,red blood cell,8722,1.101123595505618,0.9081632653061225
36110,/images/cb2fac19-90b0-48b4-bdc5-7dbbd58756d1.png,1065,1029,1171,1161,106,132,red blood cell,13992,1.2452830188679245,0.803030303030303
18648,/images/c22f7031-9cf8-48ce-b03b-1b12d0db4951.png,450,1061,546,1164,96,103,red blood cell,9888,1.0729166666666667,0.9320388349514563
39290,/images/697bdbc0-6e31-4e48-ac74-ba4ab5760d32.png,501,1259,612,1392,111,133,red blood cell,14763,1.1981981981981982,0.8345864661654135
55950,/images/afd39466-aafa-4d81-9520-483727418723.png,21,1490,109,1577,88,87,red blood cell,7656,0.9886363636363636,1.0114942528735633
44799,/images/6795acae-e84d-4e97-b9a1-b4f4f0a72cfd.png,821,567,927,661,106,94,red blood cell,9964,0.8867924528301887,1.127659574468085
57594,/images/8190ec37-9a5e-419f-89ed-fbfb079370db.png,207,909,289,1010,82,101,red blood cell,8282,1.2317073170731707,0.8118811881188119
10403,/images/46a2d369-4bea-4405-ac78-91bbe130b9a7.png,446,347,542,448,96,101,red blood cell,9696,1.0520833333333333,0.9504950495049505
43510,/images/2d857091-efcd-41c0-ba3f-226de90445c4.png,199,517,337,635,138,118,red blood cell,16284,0.855072463768116,1.1694915254237288
4801,/images/3fa1a4e3-c80d-49da-8f7b-a1abb0424f48.png,210,225,304,340,94,115,red blood cell,10810,1.2234042553191489,0.8173913043478261
45122,/images/56fbae44-4677-47f8-9c3a-22dac043c115.png,418,771,520,873,102,102,red blood cell,10404,1.0,1.0
61461,/images/7e837856-3519-4dc0-b357-4cdcfd30b4eb.png,359,941,458,1047,99,106,red blood cell,10494,1.0707070707070707,0.9339622641509434
64453,/images/34a70114-d3e3-4351-b8db-f6caab17e743.png,387,118,483,223,96,105,red blood cell,10080,1.09375,0.9142857142857143
41854,/images/c3b07675-9d02-477c-91fe-f0737867049b.png,699,118,806,250,107,132,red blood cell,14124,1.233644859813084,0.8106060606060606
33430,/images/244ac6fa-8a92-4214-9cf4-ae0811d9ec7e.png,722,1073,833,1173,111,100,red blood cell,11100,0.9009009009009009,1.11
40772,/images/252071ac-e9f2-41d2-abbb-87ef01b8a997.png,597,425,692,533,95,108,red blood cell,10260,1.1368421052631579,0.8796296296296297
17815,/images/1863da5f-c595-4541-a8f4-21fe78678168.png,382,485,465,583,83,98,red blood cell,8134,1.180722891566265,0.8469387755102041
60113,/images/ec60ab26-3343-4c5f-9667-cdae999c7d86.png,571,838,669,943,98,105,red blood cell,10290,1.0714285714285714,0.9333333333333333
3216,/images/96596a68-8c95-43f3-b74e-e9506c235144.png,999,758,1102,848,103,90,red blood cell,9270,0.8737864077669902,1.1444444444444444
16993,/images/57e1879e-4294-45e7-9c1b-627e8cca0271.png,856,180,961,305,105,125,red blood cell,13125,1.1904761904761905,0.84
34796,/images/4fc9a597-aaa8-43b0-ad1c-2eabbe442e84.png,624,303,749,430,125,127,red blood cell,15875,1.016,0.984251968503937
59081,/images/5e2cea49-0823-49d1-83cf-8fd1559cdd93.png,717,983,822,1082,105,99,red blood cell,10395,0.9428571428571428,1.0606060606060606
56270,/images/6b473806-e936-4b19-98cf-a2b94cac35ff.png,886,918,1001,1025,115,107,red blood cell,12305,0.9304347826086956,1.074766355140187
6149,/images/cbec07ed-69d3-40e7-8b04-b3bd6680885b.png,671,1163,780,1291,109,128,red blood cell,13952,1.1743119266055047,0.8515625
64180,/images/2a91387a-d30f-418d-ac3a-f7cfa6836261.png,54,607,171,716,117,109,red blood cell,12753,0.9316239316239316,1.073394495412844
55565,/images/a27b451d-44a6-4740-861a-9e7e99915563.png,487,33,586,121,99,88,red blood cell,8712,0.8888888888888888,1.125
6092,/images/c147584d-4c61-412a-bdaf-b02b22c18708.png,939,1477,1047,1590,108,113,red blood cell,12204,1.0462962962962963,0.9557522123893806
48341,/images/6fa2b30f-9b89-46ac-9b79-c0bc105d4271.png,877,524,999,646,122,122,red blood cell,14884,1.0,1.0
63603,/images/de0321fa-6f7d-4dd1-b96b-186701c3b1d9.png,1029,0,1160,127,131,127,red blood cell,16637,0.9694656488549618,1.031496062992126
64100,/images/0d3c2521-da55-4df5-bf06-56b3bd4fb2fc.png,672,861,774,950,102,89,red blood cell,9078,0.8725490196078431,1.146067415730337
43484,/images/2d857091-efcd-41c0-ba3f-226de90445c4.png,182,1410,293,1514,111,104,red blood cell,11544,0.9369369369369369,1.0673076923076923
24124,/images/505355c9-23bf-4f90-8ebc-6a7ef50964d0.png,503,611,608,715,105,104,red blood cell,10920,0.9904761904761905,1.0096153846153846
1154,/images/4411fea2-d785-4eeb-80c6-c739ab6114c4.png,971,156,1073,277,102,121,red blood cell,12342,1.1862745098039216,0.8429752066115702
42335,/images/5c5b7965-1a44-44b8-aa43-660823e61821.png,204,315,332,446,128,131,red blood cell,16768,1.0234375,0.9770992366412213
2878,/images/a1c140f9-75d7-42a3-b767-4c01a118892b.png,986,128,1102,254,116,126,red blood cell,14616,1.0862068965517242,0.9206349206349206
20252,/images/c66cb6b2-1480-446a-a9d2-b8032a3de0d7.png,231,1277,354,1390,123,113,red blood cell,13899,0.9186991869918699,1.0884955752212389
25199,/images/90171428-f208-428a-b40e-f57ee3bea457.png,463,154,578,258,115,104,red blood cell,11960,0.9043478260869565,1.1057692307692308
61852,/images/5f300fd1-7eec-41ac-bbd1-0f4a943c757c.png,764,420,873,530,109,110,red blood cell,11990,1.0091743119266054,0.990909090909091
18285,/images/947348fe-4c70-468e-8009-3c14daeca69b.png,928,773,1028,887,100,114,red blood cell,11400,1.14,0.8771929824561403
62879,/images/4b346035-b8c0-46ca-8fdb-a01b1421ee4a.png,207,1487,316,1598,109,111,red blood cell,12099,1.018348623853211,0.9819819819819819
77473,/images/a11ed7d0-12f6-468f-abad-5cba7d968123.png,693,23,825,149,132,126,red blood cell,16632,0.9545454545454546,1.0476190476190477
30352,/images/4aad9589-6b32-4522-bcd7-ca04687a02ca.png,571,493,701,622,130,129,red blood cell,16770,0.9923076923076923,1.0077519379844961
50576,/images/e98ea067-82b5-4a0d-87bf-b4bbdc10ddab.png,536,1339,647,1456,111,117,red blood cell,12987,1.054054054054054,0.9487179487179487
79567,/images/161978c3-3a05-47a5-9fee-be7d25693eae.png,161,137,253,227,92,90,red blood cell,8280,0.9782608695652174,1.0222222222222221
31644,/images/0d7bf56f-3b5a-40bd-971c-2ca33dd89b2c.png,225,1219,338,1331,113,112,red blood cell,12656,0.9911504424778761,1.0089285714285714
34857,/images/4fc9a597-aaa8-43b0-ad1c-2eabbe442e84.png,1022,1106,1138,1203,116,97,red blood cell,11252,0.8362068965517241,1.1958762886597938
30717,/images/8e0dfc1f-e3eb-4a3f-a1c4-249bdfbfaa27.png,1032,186,1150,307,118,121,red blood cell,14278,1.0254237288135593,0.9752066115702479
73205,/images/85546330-4efd-43e2-87aa-d53a30220bfc.png,1078,1459,1191,1552,113,93,red blood cell,10509,0.8230088495575221,1.2150537634408602
15525,/images/79f63258-24ce-4e69-a5cb-8529635a89a9.png,1,917,107,1005,106,88,red blood cell,9328,0.8301886792452831,1.2045454545454546
55349,/images/4fb83278-adc5-4424-9f45-b6d0db2955b6.png,304,1269,396,1381,92,112,red blood cell,10304,1.2173913043478262,0.8214285714285714
10676,/images/20d4f65e-6c63-433a-935c-d568d577967b.png,5,156,96,254,91,98,red blood cell,8918,1.0769230769230769,0.9285714285714286
5188,/images/16a51468-9f93-45df-9ae2-5a74c25c5a4b.png,81,774,178,876,97,102,red blood cell,9894,1.0515463917525774,0.9509803921568627
16432,/images/e474a20b-2769-48f1-a520-4f6ef5a0dbf5.png,848,1034,943,1134,95,100,red blood cell,9500,1.0526315789473684,0.95
44191,/images/8b494b40-cab5-49d3-893d-c805000fbe88.png,928,66,1036,160,108,94,red blood cell,10152,0.8703703703703703,1.148936170212766
25715,/images/412c9fa5-fcf4-402b-b1e4-3271f775058e.png,464,20,569,144,105,124,red blood cell,13020,1.180952380952381,0.8467741935483871
63937,/images/5e974892-0ebe-4037-8427-ea8616d6d3b8.png,141,1180,242,1294,101,114,red blood cell,11514,1.1287128712871286,0.8859649122807017
76116,/images/16244280-6c74-47d3-b544-9fd6831a6bf9.png,1051,950,1154,1052,103,102,red blood cell,10506,0.9902912621359223,1.0098039215686274
8123,/images/694222bb-cddf-469a-9526-f873c6fba58e.png,811,1362,914,1476,103,114,red blood cell,11742,1.1067961165048543,0.9035087719298246
58207,/images/2f68686f-1fe8-46e7-ad92-a08e3523ea79.png,869,718,970,824,101,106,red blood cell,10706,1.0495049504950495,0.9528301886792453
13643,/images/1e86933d-6a5a-4a3c-a0f2-ca22afd767b3.png,331,1104,465,1235,134,131,red blood cell,17554,0.9776119402985075,1.0229007633587786
72834,/images/31435107-c77d-42f8-a619-75cba6a5161b.png,1042,745,1141,854,99,109,red blood cell,10791,1.101010101010101,0.908256880733945
55362,/images/4fb83278-adc5-4424-9f45-b6d0db2955b6.png,585,830,702,938,117,108,red blood cell,12636,0.9230769230769231,1.0833333333333333
1725,/images/5f783f43-0090-4f8a-bd75-9562f4aa2dd5.png,386,1401,482,1493,96,92,red blood cell,8832,0.9583333333333334,1.0434782608695652
29484,/images/8cc6fe77-5f2f-4670-b4ac-1b49550241a8.png,538,855,655,984,117,129,red blood cell,15093,1.1025641025641026,0.9069767441860465
72353,/images/ee57e743-a876-4f69-9fe5-bf5d01b44689.png,651,546,754,633,103,87,red blood cell,8961,0.8446601941747572,1.1839080459770115
42212,/images/ca734448-0d52-42fa-b41c-17b2939e58ae.png,143,531,242,640,99,109,red blood cell,10791,1.101010101010101,0.908256880733945
72597,/images/a63ce82f-f3d1-4818-9035-d3d230e5f686.png,594,1351,697,1452,103,101,red blood cell,10403,0.9805825242718447,1.0198019801980198
11157,/images/6303f964-98ef-47c6-bb2d-283aa393f918.png,720,740,800,840,80,100,red blood cell,8000,1.25,0.8
4059,/images/e02edd82-c424-4dee-98a7-575640655d9b.png,657,270,770,380,113,110,red blood cell,12430,0.9734513274336283,1.0272727272727273
15223,/images/3a8f468f-f9de-46a8-a7c8-f2be239fa207.png,393,300,480,379,87,79,red blood cell,6873,0.9080459770114943,1.1012658227848102
3862,/images/73dd09d3-2bff-4b5e-b996-9da0b8b54a8f.png,532,581,654,704,122,123,red blood cell,15006,1.0081967213114753,0.991869918699187
70115,/images/c742ee2c-6814-46cd-af56-ae87bb9972f4.png,393,897,487,994,94,97,red blood cell,9118,1.0319148936170213,0.9690721649484536
62924,/images/4b346035-b8c0-46ca-8fdb-a01b1421ee4a.png,529,391,635,502,106,111,red blood cell,11766,1.0471698113207548,0.954954954954955
17120,/images/dc3bdfe9-1565-4cda-9c4e-0979846dab60.png,795,1376,901,1485,106,109,red blood cell,11554,1.028301886792453,0.9724770642201835
10351,/images/affa429c-0315-4c18-a002-13bb3ecab259.png,200,902,341,1025,141,123,red blood cell,17343,0.8723404255319149,1.146341463414634
28027,/images/c4d34e35-4db2-41de-ba77-1a94aa9ef788.png,977,153,1104,266,127,113,red blood cell,14351,0.889763779527559,1.1238938053097345
24663,/images/30948737-0d0d-4b68-b9ab-50577e0fe026.png,932,643,1033,764,101,121,red blood cell,12221,1.198019801980198,0.8347107438016529
33041,/images/6231d81d-9e84-4a5a-8cb8-47c6a37a0176.png,1008,160,1106,258,98,98,red blood cell,9604,1.0,1.0
30278,/images/cecbf663-0751-4e7f-b298-770c88afc2c1.png,120,1083,219,1190,99,107,red blood cell,10593,1.0808080808080809,0.9252336448598131
36748,/images/aa2dfa24-2dc3-4279-a232-f84780ace190.png,656,980,771,1085,115,105,red blood cell,12075,0.9130434782608695,1.0952380952380953
72352,/images/ee57e743-a876-4f69-9fe5-bf5d01b44689.png,800,498,884,587,84,89,red blood cell,7476,1.0595238095238095,0.9438202247191011
51170,/images/d64cd75a-df26-44d5-ac25-69061a4e4d57.png,19,105,140,232,121,127,red blood cell,15367,1.0495867768595042,0.952755905511811
33669,/images/84ee2ea3-9edd-4672-a1b3-f09c607d833a.png,567,579,690,689,123,110,red blood cell,13530,0.8943089430894309,1.1181818181818182
77237,/images/07a80340-f65e-4f58-9317-94bb6ebd5a28.png,463,1250,567,1361,104,111,red blood cell,11544,1.0673076923076923,0.9369369369369369
28676,/images/151f3af5-5e6e-4bcd-9389-4974fc68813e.png,943,8,1039,103,96,95,red blood cell,9120,0.9895833333333334,1.0105263157894737
57001,/images/9e82c996-2cfa-418d-9482-8ee23e9d0a5d.png,747,1024,854,1133,107,109,red blood cell,11663,1.0186915887850467,0.981651376146789
72211,/images/7d4d0646-26b5-46fa-ab25-452d986e887b.png,219,1336,325,1432,106,96,red blood cell,10176,0.9056603773584906,1.1041666666666667
46621,/images/da111ca5-520f-4ea8-97ad-ae5fce58ee91.png,328,153,428,250,100,97,red blood cell,9700,0.97,1.0309278350515463
51590,/images/d0347b49-8f98-4632-a384-1a4f57ac6374.png,769,993,881,1091,112,98,red blood cell,10976,0.875,1.1428571428571428
34645,/images/a0eedcb9-b85c-4612-b945-7e8227f53c35.png,570,571,670,662,100,91,red blood cell,9100,0.91,1.098901098901099
62594,/images/f7a4334a-4332-4de8-b39b-22da907976f2.png,493,706,598,803,105,97,red blood cell,10185,0.9238095238095239,1.0824742268041236
38968,/images/5939f341-a886-4f63-ae87-2219d000a1d4.png,96,392,216,520,120,128,red blood cell,15360,1.0666666666666667,0.9375
59176,/images/4736f545-1f1f-4d77-9241-d69cbf4dae35.png,1,441,120,562,119,121,red blood cell,14399,1.0168067226890756,0.9834710743801653
76245,/images/90a82250-1f68-48c9-9af9-15f18bf8c974.png,906,765,1008,855,102,90,red blood cell,9180,0.8823529411764706,1.1333333333333333
66019,/images/25c6cfb1-01d0-4864-87f9-02b7593683c7.png,828,123,916,224,88,101,red blood cell,8888,1.1477272727272727,0.8712871287128713
13033,/images/555c6ea2-c76c-4e71-af57-855d940c2b37.png,483,717,619,848,136,131,red blood cell,17816,0.9632352941176471,1.0381679389312977
72849,/images/31435107-c77d-42f8-a619-75cba6a5161b.png,179,951,272,1038,93,87,red blood cell,8091,0.9354838709677419,1.0689655172413792
8995,/images/ef815e3a-02a6-4cf8-9262-45bc74c50b00.png,64,496,166,595,102,99,red blood cell,10098,0.9705882352941176,1.0303030303030303
12263,/images/3b55c42f-ad59-422f-ba99-4f4f4ca9cb2e.png,938,225,1031,327,93,102,red blood cell,9486,1.096774193548387,0.9117647058823529
43917,/images/d7c7eb2c-2acd-4f86-8a5a-09ab3dd02d16.png,943,1401,1044,1498,101,97,red blood cell,9797,0.9603960396039604,1.041237113402062
43253,/images/fe1ee954-ba71-47b3-954a-d20ab940cd7b.png,300,1375,404,1496,104,121,red blood cell,12584,1.1634615384615385,0.859504132231405
8500,/images/dfc026a9-079f-4f45-8666-e0ccba5bb437.png,645,592,748,696,103,104,red blood cell,10712,1.0097087378640777,0.9903846153846154
10010,/images/b9ccf7ca-953f-4832-9575-5e70b2a8c224.png,1046,650,1146,744,100,94,red blood cell,9400,0.94,1.0638297872340425
33527,/images/795d0331-da56-4d45-a58a-54803408ffd9.png,0,1174,121,1292,121,118,red blood cell,14278,0.9752066115702479,1.0254237288135593
34805,/images/4fc9a597-aaa8-43b0-ad1c-2eabbe442e84.png,856,958,963,1069,107,111,red blood cell,11877,1.0373831775700935,0.963963963963964
23881,/images/c17523c5-90a0-4a6b-9b33-2b4a6cf58d36.png,130,240,240,356,110,116,red blood cell,12760,1.0545454545454545,0.9482758620689655
77908,/images/464055b6-3351-4636-a919-8be9840fb850.png,931,98,1033,201,102,103,red blood cell,10506,1.0098039215686274,0.9902912621359223
550,/images/67acd5bc-4658-4c6e-a9b9-cd8ea3a03418.png,916,153,1034,275,118,122,red blood cell,14396,1.0338983050847457,0.9672131147540983
54674,/images/6473ddb6-ad56-48a2-81e8-c7cb45f06825.png,793,454,876,550,83,96,red blood cell,7968,1.1566265060240963,0.8645833333333334
29517,/images/8cc6fe77-5f2f-4670-b4ac-1b49550241a8.png,240,970,338,1065,98,95,red blood cell,9310,0.9693877551020408,1.0315789473684212
71560,/images/b9c6db13-ca3a-4937-8ecf-e537047ed858.png,291,458,393,583,102,125,red blood cell,12750,1.2254901960784315,0.816
75306,/images/9ec1dcec-87c2-4aca-8e6b-0db3cd05509c.png,555,1022,654,1112,99,90,red blood cell,8910,0.9090909090909091,1.1
63034,/images/6afd8203-d61a-4e9b-a4cf-dcb53a16b57c.png,303,699,423,808,120,109,red blood cell,13080,0.9083333333333333,1.1009174311926606
46759,/images/da111ca5-520f-4ea8-97ad-ae5fce58ee91.png,756,1061,834,1154,78,93,red blood cell,7254,1.1923076923076923,0.8387096774193549
10549,/images/9fbf38ab-44b9-4096-a818-603017a4300e.png,717,310,837,420,120,110,red blood cell,13200,0.9166666666666666,1.0909090909090908
26123,/images/27388ff2-4000-4c9a-a2e3-addc448a5f92.png,455,483,592,612,137,129,red blood cell,17673,0.9416058394160584,1.062015503875969
53290,/images/d8f7e159-b7e3-49e4-86e8-aed8c5fbcd97.png,519,69,612,164,93,95,red blood cell,8835,1.021505376344086,0.9789473684210527
31799,/images/63ed5931-d93e-4f9b-a6f3-152713cb560e.png,794,1062,906,1168,112,106,red blood cell,11872,0.9464285714285714,1.0566037735849056
405,/images/84c88143-940d-4b62-bbd2-7acc4cadcb6b.png,458,1334,578,1455,120,121,red blood cell,14520,1.0083333333333333,0.9917355371900827
3787,/images/c9499a06-fb31-4552-a9e2-fb4ebb440859.png,655,814,765,949,110,135,red blood cell,14850,1.2272727272727273,0.8148148148148148
47250,/images/58ced55c-bf0d-4204-b6b2-4f8992d92779.png,33,729,144,859,111,130,red blood cell,14430,1.1711711711711712,0.8538461538461538
6804,/images/e36cb882-c6d0-4467-812e-d18c169a9a47.png,407,1358,527,1485,120,127,red blood cell,15240,1.0583333333333333,0.9448818897637795
8724,/images/92e4fd7b-79ef-49c2-a52b-9ef13dd720ef.png,1047,758,1161,882,114,124,red blood cell,14136,1.087719298245614,0.9193548387096774
48582,/images/f3d84be2-8af0-4d62-9f72-23d3dc08cbbe.png,660,224,774,347,114,123,red blood cell,14022,1.0789473684210527,0.926829268292683
54730,/images/10891eed-b0f2-4dd0-90cb-da185f6761b2.png,219,1394,319,1500,100,106,red blood cell,10600,1.06,0.9433962264150944
39012,/images/79806898-0214-44bd-ba2c-b570e911be62.png,10,527,115,639,105,112,red blood cell,11760,1.0666666666666667,0.9375
2138,/images/e94a811d-3145-4313-ba42-2d5ed283179f.png,1021,1036,1125,1140,104,104,red blood cell,10816,1.0,1.0
19155,/images/bb795ddf-ce72-42d5-9006-124db4d5cf1c.png,1099,614,1194,710,95,96,red blood cell,9120,1.0105263157894737,0.9895833333333334
68492,/images/74261741-4d6e-4dba-8ad4-4fbdf919c30f.png,408,405,504,502,96,97,red blood cell,9312,1.0104166666666667,0.9896907216494846
52618,/images/a6fe423a-5204-4378-bcfa-d6d298a3e9aa.png,994,1117,1107,1221,113,104,red blood cell,11752,0.9203539823008849,1.0865384615384615
48552,/images/f3d84be2-8af0-4d62-9f72-23d3dc08cbbe.png,907,803,1031,924,124,121,red blood cell,15004,0.9758064516129032,1.024793388429752
74648,/images/5ccca8ee-abea-458a-a891-bedd31c3ddc3.png,759,883,876,991,117,108,red blood cell,12636,0.9230769230769231,1.0833333333333333
16909,/images/f5419bc0-4415-41b6-b832-5326cfcc534b.png,460,1168,584,1281,124,113,red blood cell,14012,0.9112903225806451,1.0973451327433628
46100,/images/72088c26-d2dd-4906-b791-b8947fc7fbe4.png,875,809,972,914,97,105,red blood cell,10185,1.0824742268041236,0.9238095238095239
38746,/images/b426ef1d-4a59-4f90-b593-50226af60a60.png,1070,608,1186,713,116,105,red blood cell,12180,0.9051724137931034,1.1047619047619048
76249,/images/90a82250-1f68-48c9-9af9-15f18bf8c974.png,384,38,491,152,107,114,red blood cell,12198,1.0654205607476634,0.9385964912280702
35334,/images/452482bc-24a3-413e-ba03-fad4c9d61f3c.png,130,526,245,644,115,118,red blood cell,13570,1.0260869565217392,0.9745762711864406
44257,/images/4257342d-6d77-4671-a84b-1f0c36ccb367.png,495,1021,602,1131,107,110,red blood cell,11770,1.02803738317757,0.9727272727272728
51857,/images/d67398c5-8b0e-463f-a04e-8583c820786c.png,788,394,889,500,101,106,red blood cell,10706,1.0495049504950495,0.9528301886792453
39895,/images/af2e63a3-9fde-46aa-a867-81c5c259d1dc.png,533,34,637,131,104,97,red blood cell,10088,0.9326923076923077,1.0721649484536082
61803,/images/985627c9-7b85-40de-a106-eb9cc47b47cb.png,406,58,501,135,95,77,red blood cell,7315,0.8105263157894737,1.2337662337662338
31685,/images/bd432159-5956-457c-bdeb-1b5e702ba513.png,991,122,1098,236,107,114,red blood cell,12198,1.0654205607476634,0.9385964912280702
65986,/images/25c6cfb1-01d0-4864-87f9-02b7593683c7.png,852,568,947,678,95,110,red blood cell,10450,1.1578947368421053,0.8636363636363636
1798,/images/5f783f43-0090-4f8a-bd75-9562f4aa2dd5.png,1049,1205,1143,1300,94,95,red blood cell,8930,1.0106382978723405,0.9894736842105263
76488,/images/34df8890-272d-423a-ae78-ff8d068d3306.png,1109,769,1200,860,91,91,red blood cell,8281,1.0,1.0
35847,/images/027ab174-e47a-44f8-b85b-372449eeb7d8.png,844,1164,960,1284,116,120,red blood cell,13920,1.0344827586206897,0.9666666666666667
49678,/images/9842445c-5899-4189-9f2e-3a3a179fdad3.png,1073,632,1199,751,126,119,red blood cell,14994,0.9444444444444444,1.0588235294117647
28570,/images/dbdfad64-110c-421f-a1c7-f68fd9e82d67.png,53,1212,189,1335,136,123,red blood cell,16728,0.9044117647058824,1.1056910569105691
66218,/images/14005767-9296-4b48-8a9d-bbe9b2040005.png,949,449,1068,552,119,103,red blood cell,12257,0.865546218487395,1.1553398058252426
53773,/images/76b24246-8571-4e7b-8815-b185414a2c51.png,943,968,1037,1069,94,101,red blood cell,9494,1.074468085106383,0.9306930693069307
13248,/images/711f6b3f-cd63-46d1-834a-bc8e9aa9b43e.png,660,734,777,841,117,107,red blood cell,12519,0.9145299145299145,1.0934579439252337
33463,/images/9bd40bc6-4949-42d3-b38f-d60422932f65.png,1076,688,1195,806,119,118,red blood cell,14042,0.9915966386554622,1.0084745762711864
75134,/images/7fdc8be8-7579-4a5c-b369-8a07ee0a8b7d.png,91,402,186,496,95,94,red blood cell,8930,0.9894736842105263,1.0106382978723405
76954,/images/51e86aa9-caa0-4297-94e8-34a57d7f7e36.png,876,1376,975,1472,99,96,red blood cell,9504,0.9696969696969697,1.03125
34534,/images/fa1f9f89-cecb-4972-842c-d14c632f89a9.png,1033,1110,1139,1222,106,112,red blood cell,11872,1.0566037735849056,0.9464285714285714
35359,/images/452482bc-24a3-413e-ba03-fad4c9d61f3c.png,1034,957,1141,1073,107,116,red blood cell,12412,1.0841121495327102,0.9224137931034483
23968,/images/3d8fb5bf-3315-48fb-8ab1-802eafd550bc.png,902,1126,1006,1250,104,124,red blood cell,12896,1.1923076923076923,0.8387096774193549
71000,/images/deaa1931-5f97-45bf-8c00-be6ddeb37b9a.png,436,219,551,316,115,97,red blood cell,11155,0.8434782608695652,1.1855670103092784
23992,/images/3d8fb5bf-3315-48fb-8ab1-802eafd550bc.png,692,444,812,548,120,104,red blood cell,12480,0.8666666666666667,1.1538461538461537
38980,/images/5939f341-a886-4f63-ae87-2219d000a1d4.png,645,276,765,394,120,118,red blood cell,14160,0.9833333333333333,1.0169491525423728
48269,/images/71204a6d-814e-44b6-9cee-7b979f478021.png,802,892,910,1015,108,123,red blood cell,13284,1.1388888888888888,0.8780487804878049
47995,/images/eba73bff-fbe1-436d-9a5f-0a61331a0ea2.png,1018,509,1138,630,120,121,red blood cell,14520,1.0083333333333333,0.9917355371900827
8291,/images/65e3d6a6-012c-4b40-9a42-83078eb85e31.png,297,1072,402,1170,105,98,red blood cell,10290,0.9333333333333333,1.0714285714285714
59634,/images/a2754679-68b0-40f4-be01-bafad5ac1261.png,329,817,441,927,112,110,red blood cell,12320,0.9821428571428571,1.018181818181818
116,/images/10be6380-cbbb-4886-8b9e-ff56b1710576.png,51,1371,164,1490,113,119,red blood cell,13447,1.0530973451327434,0.9495798319327731
45561,/images/e597f7ce-46c6-4dce-9063-50a2703fdd45.png,909,349,1003,447,94,98,red blood cell,9212,1.0425531914893618,0.9591836734693877
37088,/images/d6942996-5664-4370-ad87-2bdcbd49ac16.png,684,864,802,988,118,124,red blood cell,14632,1.0508474576271187,0.9516129032258065
67533,/images/45902b63-be9a-49ae-9ede-3a8015671bc4.png,683,591,792,700,109,109,red blood cell,11881,1.0,1.0
62618,/images/f7a4334a-4332-4de8-b39b-22da907976f2.png,394,674,494,794,100,120,red blood cell,12000,1.2,0.8333333333333334
877,/images/dce55b59-c6c3-4693-aa75-6b348c8f52cd.png,224,800,338,904,114,104,red blood cell,11856,0.9122807017543859,1.0961538461538463
74298,/images/8939e14b-fcdf-48b1-acb9-6514a2fc2fc0.png,46,342,153,451,107,109,red blood cell,11663,1.0186915887850467,0.981651376146789
38818,/images/d0d3ae45-b434-4869-a518-427320ebe62d.png,952,1361,1068,1492,116,131,red blood cell,15196,1.1293103448275863,0.8854961832061069
47682,/images/4b3a49bc-8536-4760-9553-440a6f64db37.png,852,581,989,707,137,126,red blood cell,17262,0.9197080291970803,1.0873015873015872
56942,/images/a93c35ba-1690-4358-8837-669bcd850bb7.png,234,225,341,317,107,92,red blood cell,9844,0.8598130841121495,1.1630434782608696
6068,/images/c147584d-4c61-412a-bdaf-b02b22c18708.png,607,632,724,752,117,120,red blood cell,14040,1.0256410256410255,0.975
45434,/images/e4eea7ea-8989-46a9-9c98-25a178146b28.png,292,1335,384,1424,92,89,red blood cell,8188,0.967391304347826,1.0337078651685394
63551,/images/44b4a765-104e-4182-8871-e933c83c91ef.png,883,249,972,339,89,90,red blood cell,8010,1.0112359550561798,0.9888888888888889
76992,/images/51e86aa9-caa0-4297-94e8-34a57d7f7e36.png,76,1288,185,1387,109,99,red blood cell,10791,0.908256880733945,1.101010101010101
74572,/images/bbedfcbe-9528-4ba9-9d86-4ebba7589ac5.png,938,128,1035,218,97,90,red blood cell,8730,0.9278350515463918,1.0777777777777777
42999,/images/6c7095cd-ab6b-4f53-bd94-905d0cc95840.png,413,297,523,398,110,101,red blood cell,11110,0.9181818181818182,1.0891089108910892
68196,/images/ff1b23d0-3cef-459b-b81f-39bfcdb6526f.png,350,589,459,698,109,109,red blood cell,11881,1.0,1.0
11707,/images/0ed416f9-7c20-4829-9016-559e4009568e.png,947,332,1066,440,119,108,red blood cell,12852,0.907563025210084,1.1018518518518519
18203,/images/947348fe-4c70-468e-8009-3c14daeca69b.png,308,302,405,400,97,98,red blood cell,9506,1.0103092783505154,0.9897959183673469
9905,/images/b4261fa5-876d-48ea-b6da-ec7ca5b48fe2.png,383,124,506,259,123,135,red blood cell,16605,1.0975609756097562,0.9111111111111111
23778,/images/6b2ff7ca-c5b3-415c-9481-7b14efc6d7ef.png,204,616,320,727,116,111,red blood cell,12876,0.9568965517241379,1.045045045045045
11485,/images/834a30bb-26bf-4e60-9ea1-3250b926892e.png,754,1431,867,1552,113,121,red blood cell,13673,1.0707964601769913,0.9338842975206612
70384,/images/4876c9d0-b386-48fb-84e8-91bf87529161.png,388,224,496,333,108,109,red blood cell,11772,1.0092592592592593,0.9908256880733946
615,/images/065af549-320a-4862-b92a-8ef750d7b5fb.png,717,750,843,868,126,118,red blood cell,14868,0.9365079365079365,1.0677966101694916
46180,/images/d8632217-ec33-4d0a-98e6-427824c58869.png,997,96,1094,192,97,96,red blood cell,9312,0.9896907216494846,1.0104166666666667
68523,/images/74261741-4d6e-4dba-8ad4-4fbdf919c30f.png,896,410,974,495,78,85,red blood cell,6630,1.0897435897435896,0.9176470588235294
26070,/images/71925778-a26e-483e-a07c-f3aaf740122a.png,114,911,214,997,100,86,red blood cell,8600,0.86,1.1627906976744187
15713,/images/3892b776-f49a-4368-b0fa-7e855e76ccec.png,647,3,770,129,123,126,red blood cell,15498,1.024390243902439,0.9761904761904762
42471,/images/29648565-fe28-4517-ba72-68df0c82c9c5.png,428,1488,535,1599,107,111,red blood cell,11877,1.0373831775700935,0.963963963963964
46227,/images/d8632217-ec33-4d0a-98e6-427824c58869.png,347,605,469,725,122,120,red blood cell,14640,0.9836065573770492,1.0166666666666666
31501,/images/83ec1cb9-1714-4bf1-81f6-115fde84564d.png,248,898,364,1010,116,112,red blood cell,12992,0.9655172413793104,1.0357142857142858
21364,/images/5077f87d-a19f-494c-b911-14ccb03bd230.png,770,839,873,935,103,96,red blood cell,9888,0.9320388349514563,1.0729166666666667
777,/images/27fab82c-5bf0-426f-aeb9-47da829b6629.png,562,148,676,258,114,110,red blood cell,12540,0.9649122807017544,1.0363636363636364
31335,/images/31c749e8-18d1-4105-b7e6-8319cceddae0.png,870,685,993,793,123,108,red blood cell,13284,0.8780487804878049,1.1388888888888888
43258,/images/fe1ee954-ba71-47b3-954a-d20ab940cd7b.png,569,1169,715,1288,146,119,red blood cell,17374,0.815068493150685,1.226890756302521
3149,/images/729a38d6-66db-48e5-a00d-7d90d224290f.png,374,737,485,865,111,128,red blood cell,14208,1.1531531531531531,0.8671875
79923,/images/0b923ab7-ebff-4079-a4bb-af7da89f374e.png,992,1085,1096,1176,104,91,red blood cell,9464,0.875,1.1428571428571428
58013,/images/a7c91b63-b97c-4f4b-8d34-7ad2b08d7a17.png,668,1291,783,1416,115,125,red blood cell,14375,1.0869565217391304,0.92
51853,/images/d67398c5-8b0e-463f-a04e-8583c820786c.png,763,1440,870,1538,107,98,red blood cell,10486,0.9158878504672897,1.0918367346938775
20070,/images/ebfd9f67-138e-49f0-9cef-a0352069eedb.png,1012,1202,1123,1322,111,120,red blood cell,13320,1.0810810810810811,0.925
79244,/images/05ac7b2a-6a77-4464-926b-8570f7c01693.png,1022,296,1139,410,117,114,red blood cell,13338,0.9743589743589743,1.0263157894736843
48465,/images/e13f2327-fbf4-4d84-a8c1-09cb1e449c8c.png,519,763,645,889,126,126,red blood cell,15876,1.0,1.0
17759,/images/b5143aae-6e98-4dc6-b546-980cb472de67.png,130,850,249,951,119,101,red blood cell,12019,0.8487394957983193,1.1782178217821782
16976,/images/8eeb378e-90f0-47ea-ac1c-2a201eb8d090.png,80,633,181,750,101,117,red blood cell,11817,1.1584158415841583,0.8632478632478633
53047,/images/69b5b3de-ec64-4e5d-bcc2-44f495e06e76.png,331,1490,435,1588,104,98,red blood cell,10192,0.9423076923076923,1.0612244897959184
22940,/images/ecd68ba2-48af-4866-826a-7cd1c147c055.png,1053,732,1162,848,109,116,red blood cell,12644,1.0642201834862386,0.9396551724137931
66183,/images/14005767-9296-4b48-8a9d-bbe9b2040005.png,571,412,684,521,113,109,red blood cell,12317,0.9646017699115044,1.036697247706422
65076,/images/ff3b9d4d-373c-48ef-a75a-d23e2c2ade87.png,604,1514,682,1596,78,82,red blood cell,6396,1.0512820512820513,0.9512195121951219
57972,/images/7942691b-6376-4c75-ae8a-ddf65454dcb2.png,565,651,676,763,111,112,red blood cell,12432,1.009009009009009,0.9910714285714286
75293,/images/9ec1dcec-87c2-4aca-8e6b-0db3cd05509c.png,366,639,448,721,82,82,red blood cell,6724,1.0,1.0
18388,/images/39cc33be-d752-40fe-b7a8-2e69a3517205.png,978,1268,1097,1380,119,112,red blood cell,13328,0.9411764705882353,1.0625
44700,/images/867f30da-2568-4480-9968-cece78c61c64.png,413,1143,521,1251,108,108,red blood cell,11664,1.0,1.0
65541,/images/01b38a56-13eb-447b-89ee-fc21cb40dcc1.png,574,1085,692,1203,118,118,red blood cell,13924,1.0,1.0
72181,/images/005e60b6-77b8-458c-b57c-bfe0c7e7df78.png,949,74,1049,194,100,120,red blood cell,12000,1.2,0.8333333333333334
25044,/images/ed0bee2f-05e0-4392-8357-19750cec577c.png,386,1396,482,1476,96,80,red blood cell,7680,0.8333333333333334,1.2
31083,/images/9c48fdf4-621d-4f40-bcd7-6a28cd530de7.png,60,927,192,1033,132,106,red blood cell,13992,0.803030303030303,1.2452830188679245
73266,/images/67a4fb91-6f38-4ca2-8f20-6b2f5f1b29a7.png,473,16,562,111,89,95,red blood cell,8455,1.0674157303370786,0.9368421052631579
42950,/images/ff37dd9b-2e3c-444d-9d29-6db186cfa2fb.png,617,321,736,443,119,122,red blood cell,14518,1.0252100840336134,0.9754098360655737
49143,/images/df3d98b9-3dd7-4107-8d4a-ae1b7f247793.png,492,944,585,1035,93,91,red blood cell,8463,0.978494623655914,1.021978021978022
49139,/images/df3d98b9-3dd7-4107-8d4a-ae1b7f247793.png,780,1090,882,1177,102,87,red blood cell,8874,0.8529411764705882,1.1724137931034482
14979,/images/5d1418d3-1559-4725-ad4a-9afb6eaecdfd.png,915,37,1006,132,91,95,red blood cell,8645,1.043956043956044,0.9578947368421052
259,/images/0dcca702-a4ef-4fb3-a940-9c0c140b21c7.png,756,1059,865,1161,109,102,red blood cell,11118,0.9357798165137615,1.0686274509803921
25362,/images/c52f8cc8-afd7-441c-9f1f-18b6e16d79cf.png,457,64,584,195,127,131,red blood cell,16637,1.031496062992126,0.9694656488549618
13356,/images/a7f1bbb1-6058-4642-bd66-cfb90dce762e.png,1023,897,1129,1026,106,129,red blood cell,13674,1.2169811320754718,0.8217054263565892
24121,/images/505355c9-23bf-4f90-8ebc-6a7ef50964d0.png,312,1190,427,1308,115,118,red blood cell,13570,1.0260869565217392,0.9745762711864406
77497,/images/2d2e81f3-e329-4765-9ba1-2c95f12dc9f3.png,896,1311,991,1403,95,92,red blood cell,8740,0.968421052631579,1.0326086956521738
17106,/images/dc3bdfe9-1565-4cda-9c4e-0979846dab60.png,429,1440,543,1560,114,120,red blood cell,13680,1.0526315789473684,0.95
43010,/images/6c7095cd-ab6b-4f53-bd94-905d0cc95840.png,58,1305,164,1429,106,124,red blood cell,13144,1.169811320754717,0.8548387096774194
26165,/images/04de27ff-0d36-4da3-a829-e93851d76981.png,924,1218,1040,1339,116,121,red blood cell,14036,1.043103448275862,0.9586776859504132
19235,/images/b4d22412-a495-43a9-bec0-73a2322f8dad.png,389,811,492,924,103,113,red blood cell,11639,1.0970873786407767,0.911504424778761
60442,/images/93b47b14-7f78-4b31-8897-d63a81fdab01.png,436,566,553,683,117,117,red blood cell,13689,1.0,1.0
15782,/images/64113b22-03b1-4ab8-89ab-b2f32154fbbd.png,965,614,1060,716,95,102,red blood cell,9690,1.0736842105263158,0.9313725490196079
22986,/images/b687c30d-cf15-445c-b3f6-5aca86584708.png,791,747,912,872,121,125,red blood cell,15125,1.0330578512396693,0.968
45270,/images/9e793460-d94c-47ac-b3a7-0d6ad86357da.png,187,105,317,241,130,136,red blood cell,17680,1.0461538461538462,0.9558823529411765
10204,/images/e3ea07d7-884a-412e-874a-40fd6b856736.png,224,941,331,1059,107,118,red blood cell,12626,1.102803738317757,0.9067796610169492
34423,/images/b4bde4e8-f48b-4ae2-be01-86d8c91d0af9.png,339,816,445,913,106,97,red blood cell,10282,0.9150943396226415,1.092783505154639
59698,/images/a2754679-68b0-40f4-be01-bafad5ac1261.png,199,434,289,536,90,102,red blood cell,9180,1.1333333333333333,0.8823529411764706
14149,/images/eaf4b781-b3aa-41ce-8c5e-287979b4e15a.png,1045,1282,1140,1364,95,82,red blood cell,7790,0.8631578947368421,1.1585365853658536
15492,/images/79f63258-24ce-4e69-a5cb-8529635a89a9.png,507,552,599,640,92,88,red blood cell,8096,0.9565217391304348,1.0454545454545454
60632,/images/724e0c34-32cd-41f1-ae37-586038bc67ab.png,939,268,1042,386,103,118,red blood cell,12154,1.145631067961165,0.8728813559322034
51456,/images/baa87bf8-786c-444c-81e8-9fa0a41d8149.png,404,1336,501,1449,97,113,red blood cell,10961,1.1649484536082475,0.8584070796460177
54687,/images/6473ddb6-ad56-48a2-81e8-c7cb45f06825.png,731,381,819,466,88,85,red blood cell,7480,0.9659090909090909,1.035294117647059
20749,/images/eeac81a5-9202-4965-b7de-35b12910cdf6.png,1020,914,1125,1011,105,97,red blood cell,10185,0.9238095238095239,1.0824742268041236
52906,/images/abb2f9d6-26fa-4328-983c-959ef6717c05.png,813,548,917,662,104,114,red blood cell,11856,1.0961538461538463,0.9122807017543859
28954,/images/b12ae3b1-613c-4c0e-9163-3c5cc314abf5.png,57,1484,170,1599,113,115,red blood cell,12995,1.0176991150442478,0.9826086956521739
26121,/images/27388ff2-4000-4c9a-a2e3-addc448a5f92.png,216,712,343,830,127,118,red blood cell,14986,0.9291338582677166,1.076271186440678
8812,/images/ae17a099-18b5-4a42-a901-850ea056423e.png,213,1151,310,1241,97,90,red blood cell,8730,0.9278350515463918,1.0777777777777777
5621,/images/afa470d9-c74c-41cd-b4dc-7bf93fde8263.png,389,1424,486,1518,97,94,red blood cell,9118,0.9690721649484536,1.0319148936170213
77126,/images/dd6f047e-af73-43df-9c46-354534fc20e0.png,336,1436,447,1552,111,116,red blood cell,12876,1.045045045045045,0.9568965517241379
30406,/images/58d75854-be99-484e-89f0-4ab208fe07e0.png,554,634,664,744,110,110,red blood cell,12100,1.0,1.0
39855,/images/af2e63a3-9fde-46aa-a867-81c5c259d1dc.png,352,525,482,656,130,131,red blood cell,17030,1.0076923076923077,0.9923664122137404
41834,/images/c3b07675-9d02-477c-91fe-f0737867049b.png,228,726,340,855,112,129,red blood cell,14448,1.1517857142857142,0.8682170542635659
54512,/images/db871d17-28fd-4ceb-b421-e4e4afa0a7a0.png,5,451,125,571,120,120,red blood cell,14400,1.0,1.0
23060,/images/be5bb7d0-7c3f-4bb9-8bb4-f8bc8d875943.png,242,664,369,787,127,123,red blood cell,15621,0.968503937007874,1.032520325203252
29863,/images/9cdee92c-6267-4188-a41e-125bc0abb9ae.png,860,11,963,119,103,108,red blood cell,11124,1.0485436893203883,0.9537037037037037
49457,/images/f2574be3-81c6-4fc3-8a40-0230d1264f52.png,182,394,273,475,91,81,red blood cell,7371,0.8901098901098901,1.123456790123457
21261,/images/fc8df086-39e0-43f8-b0c7-2d23a349539b.png,404,1201,500,1321,96,120,red blood cell,11520,1.25,0.8
8955,/images/04628a94-b674-469b-aff6-b476b70df87d.png,384,1016,504,1126,120,110,red blood cell,13200,0.9166666666666666,1.0909090909090908
49076,/images/df3d98b9-3dd7-4107-8d4a-ae1b7f247793.png,100,1463,194,1567,94,104,red blood cell,9776,1.1063829787234043,0.9038461538461539
9977,/images/b9ccf7ca-953f-4832-9575-5e70b2a8c224.png,90,582,203,692,113,110,red blood cell,12430,0.9734513274336283,1.0272727272727273
78101,/images/105af41b-13cc-4ad1-8a1f-8bc4d47cdd94.png,303,233,397,321,94,88,red blood cell,8272,0.9361702127659575,1.0681818181818181
64151,/images/0d3c2521-da55-4df5-bf06-56b3bd4fb2fc.png,489,596,583,685,94,89,red blood cell,8366,0.9468085106382979,1.0561797752808988
64526,/images/6ba5d0b8-cdc7-4266-9d78-db76faa312e9.png,292,947,388,1040,96,93,red blood cell,8928,0.96875,1.032258064516129
29665,/images/b85fc640-de49-4f7e-afc0-978ff020f2e2.png,1006,1078,1119,1187,113,109,red blood cell,12317,0.9646017699115044,1.036697247706422
72146,/images/005e60b6-77b8-458c-b57c-bfe0c7e7df78.png,856,281,951,382,95,101,red blood cell,9595,1.063157894736842,0.9405940594059405
16703,/images/d6352a03-ef81-421d-915e-226499555d20.png,762,810,893,926,131,116,red blood cell,15196,0.8854961832061069,1.1293103448275863
30796,/images/93a306b8-594a-4c7f-8b4a-127fb6ad8f1a.png,241,801,374,918,133,117,red blood cell,15561,0.8796992481203008,1.1367521367521367
8795,/images/ae17a099-18b5-4a42-a901-850ea056423e.png,450,1011,540,1111,90,100,red blood cell,9000,1.1111111111111112,0.9
64274,/images/83d4e1fe-da84-4175-a9e2-8efc18782dcf.png,118,957,216,1051,98,94,red blood cell,9212,0.9591836734693877,1.0425531914893618
66647,/images/b88fe674-fb9a-41d4-b100-cb1c86440d44.png,1017,891,1126,993,109,102,red blood cell,11118,0.9357798165137615,1.0686274509803921
3930,/images/f09acb0c-b270-4e91-99f8-410adfa7f34a.png,863,563,959,657,96,94,red blood cell,9024,0.9791666666666666,1.0212765957446808
22458,/images/99d6a7e5-128e-4455-841d-8fbd1663905e.png,682,1291,806,1412,124,121,red blood cell,15004,0.9758064516129032,1.024793388429752
21151,/images/fb05b297-180a-4171-b633-09d5616d7534.png,337,1206,421,1309,84,103,red blood cell,8652,1.2261904761904763,0.8155339805825242
22213,/images/3d4d7ba7-6c7c-4ddd-b282-31fb5d80edb5.png,393,300,513,409,120,109,red blood cell,13080,0.9083333333333333,1.1009174311926606
18854,/images/d1b48634-9ad5-46e8-b816-42d1d97c93cd.png,616,1071,745,1191,129,120,red blood cell,15480,0.9302325581395349,1.075
71750,/images/093a831a-bf71-4333-bc06-942ae70cb164.png,722,1079,837,1188,115,109,red blood cell,12535,0.9478260869565217,1.055045871559633
72346,/images/ee57e743-a876-4f69-9fe5-bf5d01b44689.png,260,1148,343,1230,83,82,red blood cell,6806,0.9879518072289156,1.0121951219512195
70558,/images/8cca114a-ed05-4b87-95b7-fae02487f08c.png,436,1111,540,1207,104,96,red blood cell,9984,0.9230769230769231,1.0833333333333333
76229,/images/90a82250-1f68-48c9-9af9-15f18bf8c974.png,737,403,844,511,107,108,red blood cell,11556,1.0093457943925233,0.9907407407407407
33461,/images/9bd40bc6-4949-42d3-b38f-d60422932f65.png,348,375,480,510,132,135,red blood cell,17820,1.0227272727272727,0.9777777777777777
37712,/images/003a89b0-a095-417a-8dd6-f408339bbc68.png,208,1300,342,1425,134,125,red blood cell,16750,0.9328358208955224,1.072
46622,/images/da111ca5-520f-4ea8-97ad-ae5fce58ee91.png,531,677,651,787,120,110,red blood cell,13200,0.9166666666666666,1.0909090909090908
70365,/images/4876c9d0-b386-48fb-84e8-91bf87529161.png,221,552,319,648,98,96,red blood cell,9408,0.9795918367346939,1.0208333333333333
58503,/images/5cac6ddf-c8c6-45de-bce0-a1db64b14fb5.png,286,1097,390,1221,104,124,red blood cell,12896,1.1923076923076923,0.8387096774193549
9374,/images/e3a4b3e7-9500-4b6c-a402-b6d3f45e714b.png,290,381,408,506,118,125,red blood cell,14750,1.0593220338983051,0.944
26363,/images/ef1419e0-3a3a-458a-b3b2-7efddac50404.png,489,950,614,1070,125,120,red blood cell,15000,0.96,1.0416666666666667
11353,/images/2f6224be-50d0-4e85-94ef-88315df561b6.png,78,218,162,313,84,95,red blood cell,7980,1.130952380952381,0.8842105263157894
63889,/images/5e974892-0ebe-4037-8427-ea8616d6d3b8.png,146,330,248,421,102,91,red blood cell,9282,0.8921568627450981,1.120879120879121
14540,/images/458cb2e9-5a7f-437c-ac5d-a56f98a3efdf.png,697,402,793,496,96,94,red blood cell,9024,0.9791666666666666,1.0212765957446808
11152,/images/6303f964-98ef-47c6-bb2d-283aa393f918.png,629,180,738,272,109,92,red blood cell,10028,0.8440366972477065,1.184782608695652
51963,/images/4f62b14e-c6f4-4155-8f50-881558f83fae.png,294,576,389,658,95,82,red blood cell,7790,0.8631578947368421,1.1585365853658536
72241,/images/7d4d0646-26b5-46fa-ab25-452d986e887b.png,541,381,629,470,88,89,red blood cell,7832,1.0113636363636365,0.9887640449438202
18321,/images/9ca20b10-e2fd-4bd2-93ef-78298f763ed5.png,537,25,639,138,102,113,red blood cell,11526,1.107843137254902,0.9026548672566371
62278,/images/e0ff3476-226f-4125-b182-8e524d5503dd.png,177,289,283,393,106,104,red blood cell,11024,0.9811320754716981,1.0192307692307692
49285,/images/99b13257-b9d9-422f-8262-802da0bdc510.png,882,897,999,1018,117,121,red blood cell,14157,1.0341880341880343,0.9669421487603306
47261,/images/58ced55c-bf0d-4204-b6b2-4f8992d92779.png,231,433,326,535,95,102,red blood cell,9690,1.0736842105263158,0.9313725490196079
32510,/images/d31dd2c0-ae8e-4499-86bb-7cabb6e438b9.png,119,801,238,920,119,119,red blood cell,14161,1.0,1.0
62344,/images/e0ff3476-226f-4125-b182-8e524d5503dd.png,627,493,720,587,93,94,red blood cell,8742,1.010752688172043,0.9893617021276596
16844,/images/4823c1fe-a7f9-4b92-959f-0d9be09cd14b.png,276,23,364,105,88,82,red blood cell,7216,0.9318181818181818,1.0731707317073171
49899,/images/5e17f8e6-fd8d-426c-b444-1515d14f04b7.png,807,427,914,540,107,113,red blood cell,12091,1.0560747663551402,0.9469026548672567
34849,/images/4fc9a597-aaa8-43b0-ad1c-2eabbe442e84.png,757,795,850,907,93,112,red blood cell,10416,1.2043010752688172,0.8303571428571429
69988,/images/3e36698f-8c09-4c8b-8948-737310bf97e5.png,963,1250,1066,1364,103,114,red blood cell,11742,1.1067961165048543,0.9035087719298246
19436,/images/5487faad-24a7-46b6-92d8-479d3a8d229f.png,564,22,662,129,98,107,red blood cell,10486,1.0918367346938775,0.9158878504672897
28534,/images/dbdfad64-110c-421f-a1c7-f68fd9e82d67.png,698,304,812,427,114,123,red blood cell,14022,1.0789473684210527,0.926829268292683
65907,/images/d7581cb0-7a12-471d-a3d8-68dcea362213.png,981,416,1081,530,100,114,red blood cell,11400,1.14,0.8771929824561403
61799,/images/985627c9-7b85-40de-a106-eb9cc47b47cb.png,955,1129,1036,1218,81,89,red blood cell,7209,1.0987654320987654,0.9101123595505618
47754,/images/6b5ed184-cb15-4d54-93bb-9a3ca00184a1.png,1072,999,1193,1128,121,129,red blood cell,15609,1.0661157024793388,0.937984496124031
18570,/images/c22f7031-9cf8-48ce-b03b-1b12d0db4951.png,247,1266,336,1354,89,88,red blood cell,7832,0.9887640449438202,1.0113636363636365
12343,/images/3b55c42f-ad59-422f-ba99-4f4f4ca9cb2e.png,677,1362,780,1449,103,87,red blood cell,8961,0.8446601941747572,1.1839080459770115
73214,/images/85546330-4efd-43e2-87aa-d53a30220bfc.png,764,1036,851,1118,87,82,red blood cell,7134,0.9425287356321839,1.0609756097560976
8536,/images/dfc026a9-079f-4f45-8666-e0ccba5bb437.png,191,472,313,590,122,118,red blood cell,14396,0.9672131147540983,1.0338983050847457
27910,/images/46f5bd4f-8bea-48d1-a1da-4dea28e3b814.png,105,471,223,592,118,121,red blood cell,14278,1.0254237288135593,0.9752066115702479
20457,/images/9d819c89-4ea9-4e75-9b03-da87fa6c6f4d.png,696,590,836,703,140,113,red blood cell,15820,0.8071428571428572,1.238938053097345
24255,/images/bb3ae957-0f6d-4615-bfe5-24fbca50b459.png,453,457,566,583,113,126,red blood cell,14238,1.1150442477876106,0.8968253968253969
32997,/images/6231d81d-9e84-4a5a-8cb8-47c6a37a0176.png,576,887,671,985,95,98,red blood cell,9310,1.0315789473684212,0.9693877551020408
43291,/images/36569710-a574-40be-ad42-897a6e74a128.png,282,1418,401,1536,119,118,red blood cell,14042,0.9915966386554622,1.0084745762711864
46553,/images/edd09b2e-2673-4405-8ac0-e476e003e96a.png,275,347,394,467,119,120,red blood cell,14280,1.0084033613445378,0.9916666666666667
24926,/images/ed0bee2f-05e0-4392-8357-19750cec577c.png,633,116,732,216,99,100,red blood cell,9900,1.0101010101010102,0.99
55090,/images/3768c577-4e5e-4d70-8c4d-93d8aacd5baa.png,797,1380,896,1473,99,93,red blood cell,9207,0.9393939393939394,1.064516129032258
2617,/images/a23f5539-bfe6-4885-9a0e-dba972475ea9.png,565,334,651,420,86,86,red blood cell,7396,1.0,1.0
78091,/images/105af41b-13cc-4ad1-8a1f-8bc4d47cdd94.png,969,486,1067,587,98,101,red blood cell,9898,1.030612244897959,0.9702970297029703
26318,/images/580210c2-a8ed-4720-b71c-a77945968abc.png,1056,424,1172,545,116,121,red blood cell,14036,1.043103448275862,0.9586776859504132
20607,/images/0f2a6cda-afec-437b-8803-8d3176b072c1.png,668,1219,781,1335,113,116,red blood cell,13108,1.0265486725663717,0.9741379310344828
62686,/images/9e1b0217-0926-4fd1-bb9e-a815c05deb59.png,364,354,494,477,130,123,red blood cell,15990,0.9461538461538461,1.056910569105691
58892,/images/8a7deb24-d2b4-4acf-86c4-3aadd39157fa.png,697,25,809,139,112,114,red blood cell,12768,1.0178571428571428,0.9824561403508771
74680,/images/5ccca8ee-abea-458a-a891-bedd31c3ddc3.png,184,43,292,157,108,114,red blood cell,12312,1.0555555555555556,0.9473684210526315
19599,/images/883d9731-a04d-4f84-83c9-d3bef954759d.png,497,626,634,750,137,124,red blood cell,16988,0.9051094890510949,1.1048387096774193
979,/images/a8cb75ba-3f2f-40d8-8bc7-c79ebd1b9603.png,505,280,608,377,103,97,red blood cell,9991,0.941747572815534,1.0618556701030928
50714,/images/6b4c79f5-b194-4586-be9f-e339c5af4188.png,89,1457,195,1572,106,115,red blood cell,12190,1.0849056603773586,0.9217391304347826
4236,/images/ac3358f1-ef9a-4ccc-b66c-da5e47e352e0.png,283,106,402,233,119,127,red blood cell,15113,1.0672268907563025,0.937007874015748
62684,/images/9e1b0217-0926-4fd1-bb9e-a815c05deb59.png,798,1364,925,1481,127,117,red blood cell,14859,0.9212598425196851,1.0854700854700854
44282,/images/4257342d-6d77-4671-a84b-1f0c36ccb367.png,20,1466,141,1577,121,111,red blood cell,13431,0.9173553719008265,1.09009009009009
13971,/images/31af9c31-7868-44a6-8eb4-82ce118af425.png,826,155,940,280,114,125,red blood cell,14250,1.0964912280701755,0.912
63742,/images/06401963-8b02-46c5-ab2a-3d70bd01623f.png,253,1216,365,1328,112,112,red blood cell,12544,1.0,1.0
34595,/images/a0eedcb9-b85c-4612-b945-7e8227f53c35.png,184,537,270,615,86,78,red blood cell,6708,0.9069767441860465,1.1025641025641026
69804,/images/2bd15b6e-fe2d-49f3-b394-940d024d1f91.png,64,1158,146,1256,82,98,red blood cell,8036,1.1951219512195121,0.8367346938775511
42629,/images/184b376b-03cb-4c2d-af51-fc1a62196293.png,480,275,576,389,96,114,red blood cell,10944,1.1875,0.8421052631578947
71523,/images/191071ab-6515-428c-9f05-8e4309542b75.png,8,974,99,1075,91,101,red blood cell,9191,1.10989010989011,0.900990099009901
2321,/images/fe851c88-692d-4199-87e0-d19d9c4eb591.png,583,393,687,491,104,98,red blood cell,10192,0.9423076923076923,1.0612244897959184
79292,/images/05ac7b2a-6a77-4464-926b-8570f7c01693.png,594,1466,686,1575,92,109,red blood cell,10028,1.184782608695652,0.8440366972477065
26741,/images/2518f6e4-29cc-4ae4-a914-b215a4c56099.png,712,51,842,161,130,110,red blood cell,14300,0.8461538461538461,1.1818181818181819
40368,/images/db249e5a-4142-432c-8288-bacd10d7273d.png,477,716,577,822,100,106,red blood cell,10600,1.06,0.9433962264150944
40678,/images/252071ac-e9f2-41d2-abbb-87ef01b8a997.png,618,376,720,491,102,115,red blood cell,11730,1.1274509803921569,0.8869565217391304
64373,/images/0a7bfa8a-ee52-4f7a-b9c5-2919ecfa93ef.png,763,449,854,535,91,86,red blood cell,7826,0.945054945054945,1.058139534883721
77724,/images/4849866a-73a2-4fcf-a407-2d0a25a09a89.png,288,1213,388,1329,100,116,red blood cell,11600,1.16,0.8620689655172413
28097,/images/f1f9df6d-c4cb-4b42-9ca2-8fb47b1b0e91.png,736,1061,841,1182,105,121,red blood cell,12705,1.1523809523809523,0.8677685950413223
28338,/images/34e024a5-5698-42d4-972f-fee234b4bd64.png,1041,795,1149,907,108,112,red blood cell,12096,1.037037037037037,0.9642857142857143
73509,/images/5f2b32bd-fdca-4d6f-b13a-ee9f83626c8d.png,724,1099,817,1215,93,116,red blood cell,10788,1.2473118279569892,0.8017241379310345
60280,/images/7abc0d26-dd66-4ef4-8c4e-4a661e589a7f.png,363,840,464,921,101,81,red blood cell,8181,0.801980198019802,1.2469135802469136
53781,/images/76b24246-8571-4e7b-8815-b185414a2c51.png,700,1041,808,1150,108,109,red blood cell,11772,1.0092592592592593,0.9908256880733946
30858,/images/fbc1f360-4382-48bb-a32e-3f5f2f9dbe57.png,536,621,633,727,97,106,red blood cell,10282,1.092783505154639,0.9150943396226415
17258,/images/471f75c6-bd5d-4c20-bcc1-258e836f4d69.png,16,247,110,342,94,95,red blood cell,8930,1.0106382978723405,0.9894736842105263
54174,/images/c415532c-4cce-4580-9fcd-623c172a1abd.png,649,289,757,416,108,127,red blood cell,13716,1.1759259259259258,0.8503937007874016
19866,/images/b318889c-3c60-477c-b8f6-d18cb01a59df.png,554,453,663,558,109,105,red blood cell,11445,0.963302752293578,1.0380952380952382
66570,/images/b87fb62d-2c36-4f68-aba9-37fcd7d46eef.png,654,1132,747,1234,93,102,red blood cell,9486,1.096774193548387,0.9117647058823529
34712,/images/6294153c-6db3-4f2b-a8ff-9c087225e737.png,234,104,358,227,124,123,red blood cell,15252,0.9919354838709677,1.008130081300813
58191,/images/2f68686f-1fe8-46e7-ad92-a08e3523ea79.png,41,916,152,1026,111,110,red blood cell,12210,0.990990990990991,1.009090909090909
66653,/images/b88fe674-fb9a-41d4-b100-cb1c86440d44.png,405,150,504,266,99,116,red blood cell,11484,1.1717171717171717,0.853448275862069
69926,/images/9edba799-e169-46cd-b100-c9f8fc7a8c7d.png,461,1280,572,1409,111,129,red blood cell,14319,1.162162162162162,0.8604651162790697
61425,/images/e16c0dab-780d-4035-872e-1bb91e49f9d2.png,969,827,1056,935,87,108,red blood cell,9396,1.2413793103448276,0.8055555555555556
5474,/images/3f106606-9a21-40d5-b849-273866fe0f49.png,365,880,484,978,119,98,red blood cell,11662,0.8235294117647058,1.2142857142857142
33362,/images/f632981c-1330-4078-8a12-691beb2dab02.png,16,1371,105,1474,89,103,red blood cell,9167,1.1573033707865168,0.8640776699029126
45821,/images/584d62ed-4329-45dd-94ce-e929d8b2bb74.png,206,889,283,972,77,83,red blood cell,6391,1.077922077922078,0.927710843373494
60005,/images/49288109-80e9-4ec8-96d1-26a0166b8883.png,794,1368,901,1493,107,125,red blood cell,13375,1.1682242990654206,0.856
6492,/images/640c4a52-3742-4f57-aee3-9e3dc0887622.png,925,1216,1031,1314,106,98,red blood cell,10388,0.9245283018867925,1.0816326530612246
3287,/images/b901c906-91be-48c4-88ec-2c527544a258.png,885,682,1005,806,120,124,red blood cell,14880,1.0333333333333334,0.967741935483871
22462,/images/99d6a7e5-128e-4455-841d-8fbd1663905e.png,249,697,357,822,108,125,red blood cell,13500,1.1574074074074074,0.864
32512,/images/d31dd2c0-ae8e-4499-86bb-7cabb6e438b9.png,1,1026,131,1143,130,117,red blood cell,15210,0.9,1.1111111111111112
25973,/images/e683144c-0465-43a2-86b1-3cf52599d5e0.png,38,445,143,543,105,98,red blood cell,10290,0.9333333333333333,1.0714285714285714
41512,/images/2f3ebec8-ef64-420d-9aa0-c2fcadc27d74.png,650,1176,768,1309,118,133,red blood cell,15694,1.1271186440677967,0.8872180451127819
56081,/images/ffb7be9a-65df-4f0b-99ae-cfd34e81cd34.png,1048,1263,1152,1362,104,99,red blood cell,10296,0.9519230769230769,1.0505050505050506
74174,/images/4e43fc22-dc08-4cde-b3ce-ce8a4f377c47.png,312,1177,418,1283,106,106,red blood cell,11236,1.0,1.0
64147,/images/0d3c2521-da55-4df5-bf06-56b3bd4fb2fc.png,845,1347,940,1454,95,107,red blood cell,10165,1.1263157894736842,0.8878504672897196
70532,/images/8cca114a-ed05-4b87-95b7-fae02487f08c.png,400,1420,489,1504,89,84,red blood cell,7476,0.9438202247191011,1.0595238095238095
1835,/images/5f783f43-0090-4f8a-bd75-9562f4aa2dd5.png,14,1326,116,1429,102,103,red blood cell,10506,1.0098039215686274,0.9902912621359223
9722,/images/53afd70c-08a7-4b9a-b137-7003b2ecbeab.png,862,10,987,129,125,119,red blood cell,14875,0.952,1.050420168067227
66291,/images/e8058bed-c362-4e1c-85dc-62f80f32938f.png,1055,258,1161,357,106,99,red blood cell,10494,0.9339622641509434,1.0707070707070707
77069,/images/637957ef-df75-4a7b-86d5-9f6e9c042ca2.png,454,468,564,578,110,110,red blood cell,12100,1.0,1.0
4195,/images/ac3358f1-ef9a-4ccc-b66c-da5e47e352e0.png,1057,533,1184,640,127,107,red blood cell,13589,0.84251968503937,1.1869158878504673
43310,/images/36569710-a574-40be-ad42-897a6e74a128.png,232,58,355,180,123,122,red blood cell,15006,0.991869918699187,1.0081967213114753
58447,/images/5cac6ddf-c8c6-45de-bce0-a1db64b14fb5.png,634,16,748,121,114,105,red blood cell,11970,0.9210526315789473,1.0857142857142856
52498,/images/d1144956-5a0c-4bd2-b67d-8498c82d6a12.png,1092,1471,1189,1569,97,98,red blood cell,9506,1.0103092783505154,0.9897959183673469
38265,/images/b834cbf7-ff97-49d9-9561-566c9343735c.png,442,114,541,217,99,103,red blood cell,10197,1.0404040404040404,0.9611650485436893
42400,/images/1a27ebe9-93a1-4898-af69-f276057d4012.png,815,205,947,329,132,124,red blood cell,16368,0.9393939393939394,1.064516129032258
55869,/images/afd39466-aafa-4d81-9520-483727418723.png,404,1334,495,1423,91,89,red blood cell,8099,0.978021978021978,1.0224719101123596
49443,/images/f2574be3-81c6-4fc3-8a40-0230d1264f52.png,115,1114,218,1204,103,90,red blood cell,9270,0.8737864077669902,1.1444444444444444
78898,/images/4d0a1598-e4dd-45c4-8a90-dd7c780fe1da.png,572,848,685,967,113,119,red blood cell,13447,1.0530973451327434,0.9495798319327731
28486,/images/dc4270fb-e5c2-414f-96e9-6769ba1d77e4.png,270,432,377,538,107,106,red blood cell,11342,0.9906542056074766,1.009433962264151
62891,/images/4b346035-b8c0-46ca-8fdb-a01b1421ee4a.png,579,1333,674,1431,95,98,red blood cell,9310,1.0315789473684212,0.9693877551020408
994,/images/a8cb75ba-3f2f-40d8-8bc7-c79ebd1b9603.png,1007,1059,1112,1171,105,112,red blood cell,11760,1.0666666666666667,0.9375
32007,/images/9eb66577-7857-43dc-a879-8f2c9d7f780f.png,488,150,586,252,98,102,red blood cell,9996,1.0408163265306123,0.9607843137254902
8773,/images/29dc8176-dfe1-40e0-8247-2dc3c530057e.png,909,1355,1012,1470,103,115,red blood cell,11845,1.116504854368932,0.8956521739130435
58056,/images/a7c91b63-b97c-4f4b-8d34-7ad2b08d7a17.png,1050,1332,1154,1441,104,109,red blood cell,11336,1.0480769230769231,0.9541284403669725
66002,/images/25c6cfb1-01d0-4864-87f9-02b7593683c7.png,789,732,882,836,93,104,red blood cell,9672,1.118279569892473,0.8942307692307693
51883,/images/d67398c5-8b0e-463f-a04e-8583c820786c.png,485,194,600,290,115,96,red blood cell,11040,0.8347826086956521,1.1979166666666667
50918,/images/0906111b-bac7-4541-a6dc-da435c0724a8.png,757,1371,854,1455,97,84,red blood cell,8148,0.865979381443299,1.1547619047619047
7138,/images/56551792-4aa1-4301-9f8f-8bfebcd20050.png,189,1276,308,1401,119,125,red blood cell,14875,1.050420168067227,0.952
4897,/images/61cd8c7d-394d-42d3-9ed4-e09559110bed.png,915,26,1026,144,111,118,red blood cell,13098,1.063063063063063,0.940677966101695
71097,/images/2dbf6f69-e020-4948-9e49-4b33edb7cebd.png,768,15,888,142,120,127,red blood cell,15240,1.0583333333333333,0.9448818897637795
69856,/images/9edba799-e169-46cd-b100-c9f8fc7a8c7d.png,305,26,417,137,112,111,red blood cell,12432,0.9910714285714286,1.009009009009009
9714,/images/53afd70c-08a7-4b9a-b137-7003b2ecbeab.png,36,238,152,340,116,102,red blood cell,11832,0.8793103448275862,1.1372549019607843
16174,/images/1e978dfa-d339-4025-809d-09cee76728ed.png,186,393,305,513,119,120,red blood cell,14280,1.0084033613445378,0.9916666666666667
534,/images/67acd5bc-4658-4c6e-a9b9-cd8ea3a03418.png,376,54,471,153,95,99,red blood cell,9405,1.0421052631578946,0.9595959595959596
63019,/images/f234a2de-f3c8-4521-a306-8cfdf52dd597.png,480,811,564,885,84,74,red blood cell,6216,0.8809523809523809,1.135135135135135
9048,/images/ef815e3a-02a6-4cf8-9262-45bc74c50b00.png,847,1016,952,1131,105,115,red blood cell,12075,1.0952380952380953,0.9130434782608695
44458,/images/edd3862f-04e1-49cf-97dd-ca566d17e71a.png,165,1141,260,1246,95,105,red blood cell,9975,1.105263157894737,0.9047619047619048
32303,/images/1c406ce1-023b-47fc-a2cd-5ea2e255de65.png,787,215,908,354,121,139,red blood cell,16819,1.1487603305785123,0.8705035971223022
54339,/images/19370afd-f897-47d8-bfae-c0d257bbf795.png,378,392,491,518,113,126,red blood cell,14238,1.1150442477876106,0.8968253968253969
70442,/images/8cca114a-ed05-4b87-95b7-fae02487f08c.png,423,702,529,807,106,105,red blood cell,11130,0.9905660377358491,1.0095238095238095
1736,/images/5f783f43-0090-4f8a-bd75-9562f4aa2dd5.png,1022,668,1124,766,102,98,red blood cell,9996,0.9607843137254902,1.0408163265306123
33540,/images/255d5f0c-87fc-4337-bb51-07c440df4f1b.png,761,925,888,1046,127,121,red blood cell,15367,0.952755905511811,1.0495867768595042
75165,/images/7fdc8be8-7579-4a5c-b369-8a07ee0a8b7d.png,501,998,593,1087,92,89,red blood cell,8188,0.967391304347826,1.0337078651685394
56335,/images/4372709c-f356-4906-be17-415384d916e8.png,815,670,914,757,99,87,red blood cell,8613,0.8787878787878788,1.1379310344827587
76273,/images/1574565f-f45b-4160-947e-25ce1a81aaca.png,985,163,1088,265,103,102,red blood cell,10506,0.9902912621359223,1.0098039215686274
73470,/images/5f2b32bd-fdca-4d6f-b13a-ee9f83626c8d.png,660,598,757,692,97,94,red blood cell,9118,0.9690721649484536,1.0319148936170213
58589,/images/7fd2d254-b062-4f3d-8970-687e73c5a00a.png,1067,1015,1173,1129,106,114,red blood cell,12084,1.0754716981132075,0.9298245614035088
74098,/images/9fe8bdc8-847d-434e-93e5-ae14ff3b45e1.png,63,320,194,435,131,115,red blood cell,15065,0.8778625954198473,1.1391304347826088
65477,/images/da49db57-0c2f-4213-b322-c88c19fb9296.png,207,498,311,603,104,105,red blood cell,10920,1.0096153846153846,0.9904761904761905
47987,/images/eba73bff-fbe1-436d-9a5f-0a61331a0ea2.png,843,695,943,791,100,96,red blood cell,9600,0.96,1.0416666666666667
12644,/images/0901f9d1-be4f-4c19-8e83-dd724dded9f5.png,1060,997,1172,1116,112,119,red blood cell,13328,1.0625,0.9411764705882353
7127,/images/64a678d4-9048-4491-90c7-1924f38be19a.png,330,1463,461,1585,131,122,red blood cell,15982,0.9312977099236641,1.0737704918032787
75017,/images/9147a21d-0de2-4c04-88da-b788311696ac.png,311,1435,441,1556,130,121,red blood cell,15730,0.9307692307692308,1.0743801652892562
40058,/images/6fd30823-3b77-40c9-ba5d-e1eda9660674.png,448,167,565,288,117,121,red blood cell,14157,1.0341880341880343,0.9669421487603306
33674,/images/84ee2ea3-9edd-4672-a1b3-f09c607d833a.png,1047,572,1167,675,120,103,red blood cell,12360,0.8583333333333333,1.1650485436893203
10776,/images/fac4b0e2-6b52-4c0e-b762-4fa65d552856.png,737,1269,856,1387,119,118,red blood cell,14042,0.9915966386554622,1.0084745762711864
31109,/images/9c48fdf4-621d-4f40-bcd7-6a28cd530de7.png,233,918,334,1023,101,105,red blood cell,10605,1.0396039603960396,0.9619047619047619
34582,/images/a0eedcb9-b85c-4612-b945-7e8227f53c35.png,820,1464,922,1554,102,90,red blood cell,9180,0.8823529411764706,1.1333333333333333
42971,/images/ff37dd9b-2e3c-444d-9d29-6db186cfa2fb.png,101,443,212,567,111,124,red blood cell,13764,1.117117117117117,0.8951612903225806
19480,/images/a85cd1ae-0c94-4387-8305-84ab8d96d137.png,968,389,1089,510,121,121,red blood cell,14641,1.0,1.0
46785,/images/02fb5e19-6f94-4787-bb78-e550a29a3cbd.png,923,694,1049,812,126,118,red blood cell,14868,0.9365079365079365,1.0677966101694916
73733,/images/22cbf509-c9bf-46ec-bfce-f079c6b76c8c.png,373,84,502,198,129,114,red blood cell,14706,0.8837209302325582,1.131578947368421
58854,/images/434523fd-d4d9-4961-a7c2-d71d6ae68e13.png,205,606,291,693,86,87,red blood cell,7482,1.0116279069767442,0.9885057471264368
22284,/images/787abd97-dd37-4212-8b43-61696eb3abc0.png,900,158,1017,281,117,123,red blood cell,14391,1.0512820512820513,0.9512195121951219
29603,/images/42845335-4ab2-4963-806d-0985d1382a31.png,425,1006,549,1125,124,119,red blood cell,14756,0.9596774193548387,1.0420168067226891
17600,/images/70a95e58-ba60-4c1f-adcd-49c198dc2ba0.png,1090,322,1180,422,90,100,red blood cell,9000,1.1111111111111112,0.9
70780,/images/b62d47f9-2ff5-4902-abdc-b3610acfc7ba.png,1021,729,1140,837,119,108,red blood cell,12852,0.907563025210084,1.1018518518518519
51332,/images/b4f3b2a4-f4b9-48de-ac5d-0e681b77be27.png,237,1166,353,1271,116,105,red blood cell,12180,0.9051724137931034,1.1047619047619048
48844,/images/fed6ba05-36a5-45dc-a4e1-9baa7de2c622.png,235,1378,329,1467,94,89,red blood cell,8366,0.9468085106382979,1.0561797752808988
16306,/images/d5009906-bce1-4353-90b4-f4c79362f4cf.png,250,218,361,331,111,113,red blood cell,12543,1.018018018018018,0.9823008849557522
19326,/images/b4d22412-a495-43a9-bec0-73a2322f8dad.png,359,162,456,267,97,105,red blood cell,10185,1.0824742268041236,0.9238095238095239
66325,/images/fcdf6632-c03f-49a8-9fb3-42e87c99b9d0.png,767,503,870,603,103,100,red blood cell,10300,0.970873786407767,1.03
14839,/images/f8b6a868-60e9-4569-ae69-638a0c39834d.png,522,1173,635,1295,113,122,red blood cell,13786,1.079646017699115,0.9262295081967213
24306,/images/4d8a4ce8-0f9c-4f21-8844-4cf0e5514bbf.png,669,670,768,769,99,99,red blood cell,9801,1.0,1.0
69460,/images/664c570b-4822-413c-9724-11b1d91fac44.png,876,426,1001,545,125,119,red blood cell,14875,0.952,1.050420168067227
50977,/images/ef8fcfa4-8466-4186-8c69-f5f4904eb489.png,523,1364,648,1484,125,120,red blood cell,15000,0.96,1.0416666666666667
15157,/images/3a8f468f-f9de-46a8-a7c8-f2be239fa207.png,709,144,814,236,105,92,red blood cell,9660,0.8761904761904762,1.141304347826087
60924,/images/11b72c7b-5c52-44b7-adb7-21eacc25e441.png,991,1017,1077,1093,86,76,red blood cell,6536,0.8837209302325582,1.131578947368421
28153,/images/cd2774a0-dab2-4d68-aae9-7568b9f3d2a6.png,548,638,662,742,114,104,red blood cell,11856,0.9122807017543859,1.0961538461538463
41497,/images/2f3ebec8-ef64-420d-9aa0-c2fcadc27d74.png,879,235,996,345,117,110,red blood cell,12870,0.9401709401709402,1.0636363636363637
41007,/images/8e078333-8fa0-45be-a46e-fa05708cb365.png,741,503,854,623,113,120,red blood cell,13560,1.0619469026548674,0.9416666666666667
30732,/images/8e0dfc1f-e3eb-4a3f-a1c4-249bdfbfaa27.png,744,1106,852,1220,108,114,red blood cell,12312,1.0555555555555556,0.9473684210526315
1664,/images/5f783f43-0090-4f8a-bd75-9562f4aa2dd5.png,626,834,734,931,108,97,red blood cell,10476,0.8981481481481481,1.1134020618556701
3546,/images/25132962-ff5d-4737-995f-c54d8490539b.png,544,496,648,608,104,112,red blood cell,11648,1.0769230769230769,0.9285714285714286
49524,/images/9f33e0ea-065b-4703-9df9-15829b891860.png,944,1145,1044,1268,100,123,red blood cell,12300,1.23,0.8130081300813008
52927,/images/abb2f9d6-26fa-4328-983c-959ef6717c05.png,994,906,1067,993,73,87,red blood cell,6351,1.1917808219178083,0.8390804597701149
68132,/images/5dec94a3-e3ca-4a58-9702-88e5a83ef612.png,758,479,847,576,89,97,red blood cell,8633,1.0898876404494382,0.9175257731958762
37765,/images/fe0c5e48-f65e-488c-9c3c-1ea7c7835c0c.png,1026,370,1120,456,94,86,red blood cell,8084,0.9148936170212766,1.0930232558139534
4301,/images/882b91b7-5906-4091-bad4-688d4375eeb5.png,168,44,287,174,119,130,red blood cell,15470,1.0924369747899159,0.9153846153846154
41577,/images/0fcd1ebe-ee4a-40a0-b787-29cee18bfa1b.png,282,1364,370,1462,88,98,red blood cell,8624,1.1136363636363635,0.8979591836734694
19080,/images/6e39fb0a-aa41-4b16-b783-7589e97bf289.png,729,759,859,867,130,108,red blood cell,14040,0.8307692307692308,1.2037037037037037
64816,/images/a74b6d6a-7e04-40ac-9292-d62f13f7ded3.png,583,780,679,892,96,112,red blood cell,10752,1.1666666666666667,0.8571428571428571
70397,/images/4876c9d0-b386-48fb-84e8-91bf87529161.png,184,620,288,712,104,92,red blood cell,9568,0.8846153846153846,1.1304347826086956
64221,/images/2a91387a-d30f-418d-ac3a-f7cfa6836261.png,1043,1078,1134,1185,91,107,red blood cell,9737,1.1758241758241759,0.8504672897196262
7621,/images/21cc498b-8cb2-42ed-8f80-bfa27b86ef11.png,387,814,506,916,119,102,red blood cell,12138,0.8571428571428571,1.1666666666666667
8174,/images/694222bb-cddf-469a-9526-f873c6fba58e.png,843,1051,965,1159,122,108,red blood cell,13176,0.8852459016393442,1.1296296296296295
41639,/images/0fcd1ebe-ee4a-40a0-b787-29cee18bfa1b.png,276,548,356,636,80,88,red blood cell,7040,1.1,0.9090909090909091
66545,/images/b87fb62d-2c36-4f68-aba9-37fcd7d46eef.png,140,1138,233,1236,93,98,red blood cell,9114,1.053763440860215,0.9489795918367347
57261,/images/6d05ed67-43e2-43af-9d57-70c7a6eeef5e.png,539,626,654,763,115,137,red blood cell,15755,1.191304347826087,0.8394160583941606
44660,/images/8002cb71-0f25-4fa4-a46f-b49e5aeded0c.png,135,495,246,609,111,114,red blood cell,12654,1.027027027027027,0.9736842105263158
49708,/images/9842445c-5899-4189-9f2e-3a3a179fdad3.png,1061,522,1183,631,122,109,red blood cell,13298,0.8934426229508197,1.1192660550458715
11250,/images/6303f964-98ef-47c6-bb2d-283aa393f918.png,816,510,900,585,84,75,red blood cell,6300,0.8928571428571429,1.12
26443,/images/2c4d72f1-71a6-4bf1-b5d9-8023c7bbec74.png,1041,517,1151,625,110,108,red blood cell,11880,0.9818181818181818,1.0185185185185186
31165,/images/1976cd04-d24f-457c-b423-7e4cdb05de9e.png,882,1326,1007,1435,125,109,red blood cell,13625,0.872,1.146788990825688
3931,/images/f09acb0c-b270-4e91-99f8-410adfa7f34a.png,1039,678,1139,793,100,115,red blood cell,11500,1.15,0.8695652173913043
70011,/images/3e36698f-8c09-4c8b-8948-737310bf97e5.png,667,1243,775,1359,108,116,red blood cell,12528,1.0740740740740742,0.9310344827586207
79935,/images/0b923ab7-ebff-4079-a4bb-af7da89f374e.png,140,1391,302,1545,162,154,red blood cell,24948,0.9506172839506173,1.051948051948052
56670,/images/89b3d781-2f81-4d23-bed4-84da064df7f3.png,288,581,405,699,117,118,red blood cell,13806,1.0085470085470085,0.9915254237288136
5996,/images/97eff653-3908-4e66-931f-eab36bc336c8.png,1033,1077,1150,1199,117,122,red blood cell,14274,1.0427350427350428,0.9590163934426229
2769,/images/a89cace5-c818-4f23-a432-052b3433b81e.png,883,515,1001,642,118,127,red blood cell,14986,1.076271186440678,0.9291338582677166
19986,/images/8e69098c-fae0-47a3-8833-c2bfdfb1a416.png,254,1421,401,1549,147,128,red blood cell,18816,0.8707482993197279,1.1484375
62679,/images/f7a4334a-4332-4de8-b39b-22da907976f2.png,254,1106,344,1192,90,86,red blood cell,7740,0.9555555555555556,1.0465116279069768
69617,/images/4a49841f-216c-4815-8140-b8762c4f6603.png,310,572,394,662,84,90,red blood cell,7560,1.0714285714285714,0.9333333333333333
15983,/images/c7c1b873-0548-4a73-9618-f60912e164df.png,533,30,631,128,98,98,red blood cell,9604,1.0,1.0
46495,/images/21417261-475a-456f-b03f-57ac85a6e106.png,1031,551,1141,663,110,112,red blood cell,12320,1.018181818181818,0.9821428571428571
72517,/images/22516db4-8687-4051-90c4-2bb1ca3204a5.png,50,239,177,390,127,151,red blood cell,19177,1.188976377952756,0.8410596026490066
20010,/images/8e69098c-fae0-47a3-8833-c2bfdfb1a416.png,698,372,827,515,129,143,red blood cell,18447,1.1085271317829457,0.9020979020979021
49832,/images/5e17f8e6-fd8d-426c-b444-1515d14f04b7.png,96,1419,194,1515,98,96,red blood cell,9408,0.9795918367346939,1.0208333333333333
77201,/images/fe691faa-3bc7-475e-b558-aa8fe7b795bc.png,536,983,641,1097,105,114,red blood cell,11970,1.0857142857142856,0.9210526315789473
59995,/images/49288109-80e9-4ec8-96d1-26a0166b8883.png,658,223,747,320,89,97,red blood cell,8633,1.0898876404494382,0.9175257731958762
6474,/images/640c4a52-3742-4f57-aee3-9e3dc0887622.png,945,1332,1053,1432,108,100,red blood cell,10800,0.9259259259259259,1.08
22859,/images/95d5e689-c1d1-4ae8-a659-cc20c62a99f0.png,197,424,321,558,124,134,red blood cell,16616,1.0806451612903225,0.9253731343283582
4618,/images/9615ff33-b3fc-4d1e-9c05-0b8e3ef936df.png,972,1263,1093,1383,121,120,red blood cell,14520,0.9917355371900827,1.0083333333333333
71237,/images/86495bbf-687b-429c-b9d3-6c2681ade7e2.png,185,902,300,1019,115,117,red blood cell,13455,1.017391304347826,0.9829059829059829
72902,/images/a20d0b4b-6e2e-4507-bc22-f321dedc4ed9.png,552,311,682,429,130,118,red blood cell,15340,0.9076923076923077,1.1016949152542372
75212,/images/61dfc937-a428-44b4-94fb-d682bdb8dff0.png,936,528,1052,651,116,123,red blood cell,14268,1.0603448275862069,0.943089430894309
43941,/images/d7c7eb2c-2acd-4f86-8a5a-09ab3dd02d16.png,164,122,294,253,130,131,red blood cell,17030,1.0076923076923077,0.9923664122137404
52582,/images/0546d843-d778-4aca-b8b5-bfe23d7c87da.png,780,895,892,1001,112,106,red blood cell,11872,0.9464285714285714,1.0566037735849056
56654,/images/4adcaa26-aa1f-47b5-bdf0-18c9f814f576.png,737,808,855,908,118,100,red blood cell,11800,0.847457627118644,1.18
9162,/images/d3ed519e-2152-4e30-838d-a3ea23be512f.png,784,1014,898,1116,114,102,red blood cell,11628,0.8947368421052632,1.1176470588235294
43733,/images/ef83ed4c-2724-4d5f-8abe-1a18d25cea35.png,487,1337,600,1458,113,121,red blood cell,13673,1.0707964601769913,0.9338842975206612
57580,/images/8190ec37-9a5e-419f-89ed-fbfb079370db.png,23,321,127,432,104,111,red blood cell,11544,1.0673076923076923,0.9369369369369369
74062,/images/fe436c09-b680-4f4c-8faf-aa10a55a335b.png,556,777,669,875,113,98,red blood cell,11074,0.8672566371681416,1.153061224489796
73781,/images/22cbf509-c9bf-46ec-bfce-f079c6b76c8c.png,130,515,250,631,120,116,red blood cell,13920,0.9666666666666667,1.0344827586206897
65518,/images/da49db57-0c2f-4213-b322-c88c19fb9296.png,644,613,740,711,96,98,red blood cell,9408,1.0208333333333333,0.9795918367346939
58698,/images/e4827c85-311a-4df1-89c2-99dad0c3558c.png,727,741,833,839,106,98,red blood cell,10388,0.9245283018867925,1.0816326530612246
53307,/images/d8f7e159-b7e3-49e4-86e8-aed8c5fbcd97.png,930,1013,1017,1116,87,103,red blood cell,8961,1.1839080459770115,0.8446601941747572
46489,/images/21417261-475a-456f-b03f-57ac85a6e106.png,470,935,598,1054,128,119,red blood cell,15232,0.9296875,1.0756302521008403
58690,/images/a4d7a7e1-5ae1-486d-b6ee-c9af1476ccad.png,693,977,784,1063,91,86,red blood cell,7826,0.945054945054945,1.058139534883721
28422,/images/a6d85204-24b8-4b23-a8b1-c3e8b93f9f22.png,497,167,606,280,109,113,red blood cell,12317,1.036697247706422,0.9646017699115044
37419,/images/08f5a524-0554-49c2-83a8-ae9a6d51e8fd.png,1039,979,1159,1083,120,104,red blood cell,12480,0.8666666666666667,1.1538461538461537
63954,/images/5e974892-0ebe-4037-8427-ea8616d6d3b8.png,28,1068,128,1168,100,100,red blood cell,10000,1.0,1.0
13975,/images/31af9c31-7868-44a6-8eb4-82ce118af425.png,951,529,1057,627,106,98,red blood cell,10388,0.9245283018867925,1.0816326530612246
66091,/images/191f87a4-6f2d-49e7-bba0-08e3aa78ddaf.png,212,643,317,754,105,111,red blood cell,11655,1.0571428571428572,0.9459459459459459
38860,/images/d79b4e90-c45d-4f5d-a498-49c3e323c291.png,1033,652,1140,757,107,105,red blood cell,11235,0.9813084112149533,1.019047619047619
14738,/images/1fdf99d1-a494-4174-bcd7-efbe457ab899.png,890,1384,998,1503,108,119,red blood cell,12852,1.1018518518518519,0.907563025210084
59743,/images/f77d7469-d083-4c2d-a4ea-5a9ff162e3e2.png,965,951,1066,1037,101,86,red blood cell,8686,0.8514851485148515,1.1744186046511629
56917,/images/f28e6d66-af71-40c1-b30c-da71d7230a3f.png,1095,912,1199,1009,104,97,red blood cell,10088,0.9326923076923077,1.0721649484536082
41751,/images/32a1ea24-b6b7-4253-ad3e-bdf99c2c9b9d.png,500,345,632,452,132,107,red blood cell,14124,0.8106060606060606,1.233644859813084
4272,/images/882b91b7-5906-4091-bad4-688d4375eeb5.png,1044,1159,1144,1272,100,113,red blood cell,11300,1.13,0.8849557522123894
72379,/images/a15e0fa8-2620-4f66-896e-175115c9dc3d.png,959,822,1071,929,112,107,red blood cell,11984,0.9553571428571429,1.0467289719626167
20041,/images/ebfd9f67-138e-49f0-9cef-a0352069eedb.png,629,782,739,895,110,113,red blood cell,12430,1.0272727272727273,0.9734513274336283
4597,/images/f1de7c7e-e7d3-45ae-a66c-58538bf6cac1.png,172,955,294,1068,122,113,red blood cell,13786,0.9262295081967213,1.079646017699115
13004,/images/b10ea12f-cd36-4f2c-994a-67d1665269ab.png,887,1420,987,1506,100,86,red blood cell,8600,0.86,1.1627906976744187
51875,/images/d67398c5-8b0e-463f-a04e-8583c820786c.png,1007,1427,1122,1534,115,107,red blood cell,12305,0.9304347826086956,1.074766355140187
30154,/images/a1669b59-fe09-4fe6-ba9f-06bec6725502.png,680,300,792,412,112,112,red blood cell,12544,1.0,1.0
51965,/images/4f62b14e-c6f4-4155-8f50-881558f83fae.png,972,746,1071,863,99,117,red blood cell,11583,1.1818181818181819,0.8461538461538461
53256,/images/d8f7e159-b7e3-49e4-86e8-aed8c5fbcd97.png,834,766,925,874,91,108,red blood cell,9828,1.1868131868131868,0.8425925925925926
78457,/images/72029aca-f0bc-477f-b790-f345f86228ce.png,558,1120,665,1223,107,103,red blood cell,11021,0.9626168224299065,1.0388349514563107
17952,/images/eb77e4a9-acb0-4d83-8055-2c5fcaa54b45.png,539,281,626,361,87,80,red blood cell,6960,0.9195402298850575,1.0875
49112,/images/df3d98b9-3dd7-4107-8d4a-ae1b7f247793.png,82,252,167,341,85,89,red blood cell,7565,1.0470588235294118,0.9550561797752809
799,/images/27fab82c-5bf0-426f-aeb9-47da829b6629.png,307,738,418,848,111,110,red blood cell,12210,0.990990990990991,1.009090909090909
15484,/images/79f63258-24ce-4e69-a5cb-8529635a89a9.png,193,1006,290,1116,97,110,red blood cell,10670,1.134020618556701,0.8818181818181818
29869,/images/9cdee92c-6267-4188-a41e-125bc0abb9ae.png,881,1388,974,1483,93,95,red blood cell,8835,1.021505376344086,0.9789473684210527
79104,/images/1c90231b-2830-42d9-884e-7301edb16933.png,992,13,1100,112,108,99,red blood cell,10692,0.9166666666666666,1.0909090909090908
79576,/images/161978c3-3a05-47a5-9fee-be7d25693eae.png,701,50,809,176,108,126,red blood cell,13608,1.1666666666666667,0.8571428571428571
46173,/images/d8632217-ec33-4d0a-98e6-427824c58869.png,922,913,1033,1024,111,111,red blood cell,12321,1.0,1.0
24059,/images/5107dcb7-164f-4e10-bbff-822b39b76efc.png,915,753,1037,875,122,122,red blood cell,14884,1.0,1.0
78133,/images/bb137718-20ba-457d-8ffe-4f9420ecaab6.png,499,1070,603,1181,104,111,red blood cell,11544,1.0673076923076923,0.9369369369369369
10612,/images/20d4f65e-6c63-433a-935c-d568d577967b.png,950,520,1055,621,105,101,red blood cell,10605,0.9619047619047619,1.0396039603960396
55128,/images/29d4b75f-d400-4702-a9ac-e5a4ed1a1db1.png,45,546,175,669,130,123,red blood cell,15990,0.9461538461538461,1.056910569105691
55685,/images/c32b8bb8-c89d-4ae9-9c77-5b9356ca35a1.png,507,1028,610,1138,103,110,red blood cell,11330,1.0679611650485437,0.9363636363636364
76698,/images/3317d733-ec0d-45e6-b631-40457392f343.png,120,1439,235,1562,115,123,red blood cell,14145,1.0695652173913044,0.9349593495934959
33146,/images/6231d81d-9e84-4a5a-8cb8-47c6a37a0176.png,516,452,615,548,99,96,red blood cell,9504,0.9696969696969697,1.03125
26071,/images/71925778-a26e-483e-a07c-f3aaf740122a.png,187,5,320,120,133,115,red blood cell,15295,0.8646616541353384,1.1565217391304348
18903,/images/e9e78ff8-831b-46e9-9785-3eee9acbfcd8.png,339,647,434,746,95,99,red blood cell,9405,1.0421052631578946,0.9595959595959596
60902,/images/11b72c7b-5c52-44b7-adb7-21eacc25e441.png,237,1373,327,1457,90,84,red blood cell,7560,0.9333333333333333,1.0714285714285714
7758,/images/e726dac6-f962-449c-acff-4dd56847b685.png,433,1025,532,1131,99,106,red blood cell,10494,1.0707070707070707,0.9339622641509434
56171,/images/137d540f-d71e-47e8-bd9b-6cd0a6433c33.png,480,77,602,185,122,108,red blood cell,13176,0.8852459016393442,1.1296296296296295
52562,/images/0546d843-d778-4aca-b8b5-bfe23d7c87da.png,809,1092,912,1205,103,113,red blood cell,11639,1.0970873786407767,0.911504424778761
37536,/images/205306da-0ed8-475a-ace6-f2f81d4be88a.png,915,274,1019,383,104,109,red blood cell,11336,1.0480769230769231,0.9541284403669725
67297,/images/49c4dbd3-6269-4d4c-9648-a2146c57bab1.png,379,442,484,552,105,110,red blood cell,11550,1.0476190476190477,0.9545454545454546
38906,/images/d79b4e90-c45d-4f5d-a498-49c3e323c291.png,436,1012,548,1125,112,113,red blood cell,12656,1.0089285714285714,0.9911504424778761
1795,/images/5f783f43-0090-4f8a-bd75-9562f4aa2dd5.png,788,1458,884,1536,96,78,red blood cell,7488,0.8125,1.2307692307692308
70100,/images/c742ee2c-6814-46cd-af56-ae87bb9972f4.png,396,1168,516,1279,120,111,red blood cell,13320,0.925,1.0810810810810811
65277,/images/45ac9409-5537-44ed-90cd-5c8a1ae0e1e0.png,532,1465,646,1577,114,112,red blood cell,12768,0.9824561403508771,1.0178571428571428
74366,/images/06a3effb-996c-4767-afd2-6aa3b697cb4e.png,186,608,302,737,116,129,red blood cell,14964,1.1120689655172413,0.8992248062015504
36662,/images/21f001d6-f568-4ea4-82da-fab54c77c419.png,1102,821,1198,914,96,93,red blood cell,8928,0.96875,1.032258064516129
4288,/images/882b91b7-5906-4091-bad4-688d4375eeb5.png,598,1465,714,1577,116,112,red blood cell,12992,0.9655172413793104,1.0357142857142858
79972,/images/e640ae51-cbf1-4a84-b7cf-d38b17f59c2f.png,101,177,200,282,99,105,red blood cell,10395,1.0606060606060606,0.9428571428571428
34511,/images/fa1f9f89-cecb-4972-842c-d14c632f89a9.png,51,222,146,336,95,114,red blood cell,10830,1.2,0.8333333333333334
32505,/images/d31dd2c0-ae8e-4499-86bb-7cabb6e438b9.png,458,40,580,185,122,145,red blood cell,17690,1.1885245901639345,0.8413793103448276
16637,/images/bc377041-e098-45c4-9651-2b1ea90d1d7e.png,618,1072,733,1197,115,125,red blood cell,14375,1.0869565217391304,0.92
65326,/images/24418314-f7a4-49fc-a03e-ec597ca6796e.png,425,1257,513,1353,88,96,red blood cell,8448,1.0909090909090908,0.9166666666666666
60895,/images/11b72c7b-5c52-44b7-adb7-21eacc25e441.png,993,866,1088,967,95,101,red blood cell,9595,1.063157894736842,0.9405940594059405
75601,/images/c35ee701-fde2-46b5-b178-1fe3f1ea7da2.png,917,1154,1023,1273,106,119,red blood cell,12614,1.1226415094339623,0.8907563025210085
22347,/images/78c35732-7e31-4153-842e-55ab1cd656f6.png,483,133,602,248,119,115,red blood cell,13685,0.9663865546218487,1.0347826086956522
47421,/images/3e753a44-3264-438c-8389-a7822e4a84cc.png,764,52,902,181,138,129,red blood cell,17802,0.9347826086956522,1.069767441860465
49741,/images/5e17f8e6-fd8d-426c-b444-1515d14f04b7.png,967,218,1075,334,108,116,red blood cell,12528,1.0740740740740742,0.9310344827586207
52696,/images/9dc6ed5d-6698-48cf-aab3-fd156673729c.png,1040,707,1132,813,92,106,red blood cell,9752,1.1521739130434783,0.8679245283018868
28199,/images/c244166d-12ca-445f-9ed9-a13d9caa412f.png,433,1015,543,1145,110,130,red blood cell,14300,1.1818181818181819,0.8461538461538461
75407,/images/468c261d-f5d8-423f-883e-48af2bbbc5d1.png,185,570,271,656,86,86,red blood cell,7396,1.0,1.0
988,/images/a8cb75ba-3f2f-40d8-8bc7-c79ebd1b9603.png,939,1030,1061,1147,122,117,red blood cell,14274,0.9590163934426229,1.0427350427350428
35165,/images/bfc61c48-685d-470b-86b1-e4c7eb85c4fd.png,460,1464,585,1596,125,132,red blood cell,16500,1.056,0.946969696969697
64892,/images/dec61ae1-5037-4c3a-8952-15371becca7d.png,879,1304,971,1416,92,112,red blood cell,10304,1.2173913043478262,0.8214285714285714
5789,/images/143f5959-5b6d-4f95-bcee-9e110450fc22.png,325,29,462,140,137,111,red blood cell,15207,0.8102189781021898,1.2342342342342343
9998,/images/b9ccf7ca-953f-4832-9575-5e70b2a8c224.png,573,107,667,203,94,96,red blood cell,9024,1.0212765957446808,0.9791666666666666
5018,/images/b7d0ae11-a393-4aec-8f68-6ba07147f78a.png,791,453,907,575,116,122,red blood cell,14152,1.0517241379310345,0.9508196721311475
57452,/images/00d04a90-80e5-4bce-9511-1b64eabb7a47.png,834,874,942,971,108,97,red blood cell,10476,0.8981481481481481,1.1134020618556701
38638,/images/3b601a1b-26d8-4873-afcf-fdd1b1e0010c.png,765,1373,875,1504,110,131,red blood cell,14410,1.190909090909091,0.8396946564885496
29220,/images/6274fe0d-0d71-40be-b61b-f0bd5b5df1e2.png,377,1500,489,1599,112,99,red blood cell,11088,0.8839285714285714,1.1313131313131313
45299,/images/9e793460-d94c-47ac-b3a7-0d6ad86357da.png,173,627,284,750,111,123,red blood cell,13653,1.1081081081081081,0.9024390243902439
77830,/images/6bc7b53c-5a98-48ef-a9de-59a476707ea4.png,12,935,114,1041,102,106,red blood cell,10812,1.0392156862745099,0.9622641509433962
6016,/images/72732579-a812-4496-b2dd-ea1556924337.png,23,1393,141,1513,118,120,red blood cell,14160,1.0169491525423728,0.9833333333333333
6618,/images/640c4a52-3742-4f57-aee3-9e3dc0887622.png,1052,832,1143,939,91,107,red blood cell,9737,1.1758241758241759,0.8504672897196262
43746,/images/ef83ed4c-2724-4d5f-8abe-1a18d25cea35.png,984,755,1093,873,109,118,red blood cell,12862,1.0825688073394495,0.923728813559322
20163,/images/df49578a-60d4-4a3b-9ee0-79d9d59bc72a.png,888,1153,1020,1279,132,126,red blood cell,16632,0.9545454545454546,1.0476190476190477
11319,/images/2f6224be-50d0-4e85-94ef-88315df561b6.png,1049,1349,1159,1471,110,122,red blood cell,13420,1.1090909090909091,0.9016393442622951
28329,/images/34e024a5-5698-42d4-972f-fee234b4bd64.png,349,202,451,297,102,95,red blood cell,9690,0.9313725490196079,1.0736842105263158
60049,/images/e63e1607-f344-43d6-a0d8-e10cf2e5054a.png,639,275,736,367,97,92,red blood cell,8924,0.9484536082474226,1.0543478260869565
1425,/images/5f17d2fb-22fa-4aa6-9dad-6a1d50c03815.png,1066,733,1183,845,117,112,red blood cell,13104,0.9572649572649573,1.0446428571428572
78256,/images/adff6e1d-ba9d-4c7b-a8fe-1ec458eaeeb8.png,149,932,253,1038,104,106,red blood cell,11024,1.0192307692307692,0.9811320754716981
51626,/images/d0347b49-8f98-4632-a384-1a4f57ac6374.png,745,464,838,565,93,101,red blood cell,9393,1.086021505376344,0.9207920792079208
56459,/images/d75933ed-d26e-4d1f-bda3-96bc0d77fb36.png,948,469,1056,579,108,110,red blood cell,11880,1.0185185185185186,0.9818181818181818
46364,/images/fcc2b245-f47f-447f-8527-275b0005677c.png,996,1073,1115,1185,119,112,red blood cell,13328,0.9411764705882353,1.0625
20967,/images/d4fef0c5-6597-48b6-97e9-32ed504488e6.png,314,835,456,970,142,135,red blood cell,19170,0.9507042253521126,1.0518518518518518
69487,/images/664c570b-4822-413c-9724-11b1d91fac44.png,158,537,253,625,95,88,red blood cell,8360,0.9263157894736842,1.0795454545454546
6706,/images/95fea6d8-413f-421e-b331-5d51c31df150.png,541,599,639,701,98,102,red blood cell,9996,1.0408163265306123,0.9607843137254902
7477,/images/37a94c0f-e5d4-46fc-b4f8-994d477995fd.png,1022,660,1125,779,103,119,red blood cell,12257,1.1553398058252426,0.865546218487395
68592,/images/31653d0f-c4e6-4e12-8005-518c2de34687.png,768,341,863,438,95,97,red blood cell,9215,1.0210526315789474,0.979381443298969
45527,/images/94b5a9a1-1c88-4400-aca4-3d56f543fc4a.png,962,745,1097,855,135,110,red blood cell,14850,0.8148148148148148,1.2272727272727273
2932,/images/00a02700-2ea2-4590-9e15-ffc9160fd3de.png,474,1125,590,1252,116,127,red blood cell,14732,1.0948275862068966,0.9133858267716536
69183,/images/f274b784-b995-4a7e-a2c2-6cc31c24c4b4.png,53,725,153,827,100,102,red blood cell,10200,1.02,0.9803921568627451
74091,/images/fe436c09-b680-4f4c-8faf-aa10a55a335b.png,813,355,920,477,107,122,red blood cell,13054,1.1401869158878504,0.8770491803278688
33264,/images/5721e41b-90ef-4851-8587-8dc71227ef90.png,831,1402,954,1524,123,122,red blood cell,15006,0.991869918699187,1.0081967213114753
17619,/images/70a95e58-ba60-4c1f-adcd-49c198dc2ba0.png,315,1454,415,1545,100,91,red blood cell,9100,0.91,1.098901098901099
3891,/images/65e865f3-acfb-4d01-a75f-ff5a535ffa6a.png,1002,558,1121,690,119,132,red blood cell,15708,1.1092436974789917,0.9015151515151515
22208,/images/3d4d7ba7-6c7c-4ddd-b282-31fb5d80edb5.png,39,226,146,323,107,97,red blood cell,10379,0.9065420560747663,1.1030927835051547
65909,/images/d7581cb0-7a12-471d-a3d8-68dcea362213.png,1000,1205,1096,1298,96,93,red blood cell,8928,0.96875,1.032258064516129
41130,/images/2240b991-48f6-4c59-9b62-5a8b5e541fae.png,727,796,848,916,121,120,red blood cell,14520,0.9917355371900827,1.0083333333333333
39330,/images/17ef5841-bd19-4610-ba47-7d321231847b.png,888,724,1004,841,116,117,red blood cell,13572,1.0086206896551724,0.9914529914529915
39184,/images/2aeb7b85-7df9-4a63-8d37-2eecaaa190e7.png,801,1161,915,1254,114,93,red blood cell,10602,0.8157894736842105,1.2258064516129032
44707,/images/867f30da-2568-4480-9968-cece78c61c64.png,155,535,263,649,108,114,red blood cell,12312,1.0555555555555556,0.9473684210526315
7625,/images/21cc498b-8cb2-42ed-8f80-bfa27b86ef11.png,722,129,837,235,115,106,red blood cell,12190,0.9217391304347826,1.0849056603773586
58366,/images/50f2f514-6c8e-4c79-b3b3-0be56dd0b78b.png,864,291,983,411,119,120,red blood cell,14280,1.0084033613445378,0.9916666666666667
12779,/images/b634137b-bc8b-4e88-b0e3-b536ad6e7e18.png,216,1354,328,1456,112,102,red blood cell,11424,0.9107142857142857,1.0980392156862746
77035,/images/637957ef-df75-4a7b-86d5-9f6e9c042ca2.png,545,1268,644,1389,99,121,red blood cell,11979,1.2222222222222223,0.8181818181818182
45584,/images/e597f7ce-46c6-4dce-9063-50a2703fdd45.png,434,747,535,837,101,90,red blood cell,9090,0.8910891089108911,1.1222222222222222
43454,/images/5a539312-6cfa-43e6-8d5d-db883f343ad9.png,126,196,249,312,123,116,red blood cell,14268,0.943089430894309,1.0603448275862069
10764,/images/20d4f65e-6c63-433a-935c-d568d577967b.png,1120,896,1198,990,78,94,red blood cell,7332,1.205128205128205,0.8297872340425532
45454,/images/e4eea7ea-8989-46a9-9c98-25a178146b28.png,137,124,228,210,91,86,red blood cell,7826,0.945054945054945,1.058139534883721
71584,/images/b9c6db13-ca3a-4937-8ecf-e537047ed858.png,254,896,357,981,103,85,red blood cell,8755,0.8252427184466019,1.2117647058823529
29884,/images/bc1a58fd-736b-4812-a051-2c376cff50b7.png,887,1087,1013,1207,126,120,red blood cell,15120,0.9523809523809523,1.05
16934,/images/8eeb378e-90f0-47ea-ac1c-2a201eb8d090.png,812,984,929,1099,117,115,red blood cell,13455,0.9829059829059829,1.017391304347826
21115,/images/fb05b297-180a-4171-b633-09d5616d7534.png,492,777,584,878,92,101,red blood cell,9292,1.0978260869565217,0.9108910891089109
39521,/images/5a631871-2fc7-4a68-9c39-f3b9a0bf4a04.png,587,98,702,212,115,114,red blood cell,13110,0.991304347826087,1.0087719298245614
44059,/images/8b494b40-cab5-49d3-893d-c805000fbe88.png,515,1244,624,1354,109,110,red blood cell,11990,1.0091743119266054,0.990909090909091
40161,/images/b34e65f6-c32e-42f1-a437-4a037c75a231.png,434,1442,522,1536,88,94,red blood cell,8272,1.0681818181818181,0.9361702127659575
4738,/images/3fa1a4e3-c80d-49da-8f7b-a1abb0424f48.png,1043,1043,1164,1160,121,117,red blood cell,14157,0.9669421487603306,1.0341880341880343
34649,/images/a0eedcb9-b85c-4612-b945-7e8227f53c35.png,120,118,222,243,102,125,red blood cell,12750,1.2254901960784315,0.816
1956,/images/b95ceeeb-8870-4492-9037-2091ff268c5a.png,33,939,153,1062,120,123,red blood cell,14760,1.025,0.975609756097561
54596,/images/59dc7da9-35d1-421e-a61b-1e9637bfbfa1.png,1018,1245,1119,1351,101,106,red blood cell,10706,1.0495049504950495,0.9528301886792453
37118,/images/d6942996-5664-4370-ad87-2bdcbd49ac16.png,686,446,796,550,110,104,red blood cell,11440,0.9454545454545454,1.0576923076923077
48349,/images/6fa2b30f-9b89-46ac-9b79-c0bc105d4271.png,39,293,152,405,113,112,red blood cell,12656,0.9911504424778761,1.0089285714285714
37352,/images/4d88e2d2-5aad-410c-9bbc-702ee9496995.png,68,1242,177,1367,109,125,red blood cell,13625,1.146788990825688,0.872
26895,/images/71bbdc58-11af-41f2-9a93-3fe9257c5cf3.png,584,1368,692,1481,108,113,red blood cell,12204,1.0462962962962963,0.9557522123893806
44040,/images/8b494b40-cab5-49d3-893d-c805000fbe88.png,162,262,272,366,110,104,red blood cell,11440,0.9454545454545454,1.0576923076923077
30612,/images/f939782b-f5a2-40a3-9c22-6c6d7e18edc3.png,519,1003,620,1117,101,114,red blood cell,11514,1.1287128712871286,0.8859649122807017
24617,/images/c03d9b87-e19b-402b-ad86-b30d6e8aeb59.png,417,1200,513,1303,96,103,red blood cell,9888,1.0729166666666667,0.9320388349514563
70960,/images/deaa1931-5f97-45bf-8c00-be6ddeb37b9a.png,273,1165,400,1283,127,118,red blood cell,14986,0.9291338582677166,1.076271186440678
19402,/images/5487faad-24a7-46b6-92d8-479d3a8d229f.png,683,278,788,390,105,112,red blood cell,11760,1.0666666666666667,0.9375
45792,/images/584d62ed-4329-45dd-94ce-e929d8b2bb74.png,1013,1170,1108,1276,95,106,red blood cell,10070,1.1157894736842104,0.8962264150943396
54539,/images/db871d17-28fd-4ceb-b421-e4e4afa0a7a0.png,888,1422,992,1521,104,99,red blood cell,10296,0.9519230769230769,1.0505050505050506
30911,/images/533c47c9-02a6-419b-961b-81797f022f6c.png,689,718,791,840,102,122,red blood cell,12444,1.196078431372549,0.8360655737704918
5887,/images/a30da226-b452-408a-a556-bfae4d521464.png,62,961,172,1070,110,109,red blood cell,11990,0.990909090909091,1.0091743119266054
66465,/images/5f66d20c-fbfe-44ec-a01b-8a09da24807e.png,1065,646,1159,741,94,95,red blood cell,8930,1.0106382978723405,0.9894736842105263
18281,/images/947348fe-4c70-468e-8009-3c14daeca69b.png,560,718,654,811,94,93,red blood cell,8742,0.9893617021276596,1.010752688172043
39890,/images/af2e63a3-9fde-46aa-a867-81c5c259d1dc.png,684,447,815,560,131,113,red blood cell,14803,0.8625954198473282,1.1592920353982301
53303,/images/d8f7e159-b7e3-49e4-86e8-aed8c5fbcd97.png,1038,571,1131,670,93,99,red blood cell,9207,1.064516129032258,0.9393939393939394
40092,/images/6fd30823-3b77-40c9-ba5d-e1eda9660674.png,279,979,400,1090,121,111,red blood cell,13431,0.9173553719008265,1.09009009009009
6172,/images/27cdd837-e40f-491e-8adb-61e493189832.png,1074,1017,1182,1105,108,88,red blood cell,9504,0.8148148148148148,1.2272727272727273
21305,/images/8dace03a-10c4-4d59-bcd9-a2c314c5df33.png,1068,430,1173,532,105,102,red blood cell,10710,0.9714285714285714,1.0294117647058822
51589,/images/d0347b49-8f98-4632-a384-1a4f57ac6374.png,694,119,812,232,118,113,red blood cell,13334,0.9576271186440678,1.0442477876106195
66833,/images/9106a6bb-1352-411f-ac26-0d6fe48c16a8.png,600,176,730,292,130,116,red blood cell,15080,0.8923076923076924,1.1206896551724137
13503,/images/370277f8-436b-4103-8210-b4feb5ab95ea.png,657,924,747,1016,90,92,red blood cell,8280,1.0222222222222221,0.9782608695652174
42685,/images/3abbc4d3-1d7e-40c9-9963-33732da7cc50.png,549,766,639,869,90,103,red blood cell,9270,1.1444444444444444,0.8737864077669902
55188,/images/9c5f48c0-0544-4c0c-92b4-59b7d7b7814c.png,708,56,815,165,107,109,red blood cell,11663,1.0186915887850467,0.981651376146789
40252,/images/f05ffdca-dc3a-47bd-a231-2a0d9bd1d50e.png,937,1456,1055,1578,118,122,red blood cell,14396,1.0338983050847457,0.9672131147540983
68976,/images/b5246b58-6f40-4c9e-8024-f49b0ed6bdbd.png,1001,635,1104,734,103,99,red blood cell,10197,0.9611650485436893,1.0404040404040404
18209,/images/947348fe-4c70-468e-8009-3c14daeca69b.png,1024,699,1140,807,116,108,red blood cell,12528,0.9310344827586207,1.0740740740740742
26068,/images/71925778-a26e-483e-a07c-f3aaf740122a.png,1009,305,1127,424,118,119,red blood cell,14042,1.0084745762711864,0.9915966386554622
72600,/images/a63ce82f-f3d1-4818-9035-d3d230e5f686.png,568,1112,675,1207,107,95,red blood cell,10165,0.8878504672897196,1.1263157894736842
61103,/images/80da32ce-8c22-470e-9f35-558c5f7a5df9.png,432,136,537,246,105,110,red blood cell,11550,1.0476190476190477,0.9545454545454546
74441,/images/06a3effb-996c-4767-afd2-6aa3b697cb4e.png,270,560,338,644,68,84,red blood cell,5712,1.2352941176470589,0.8095238095238095
48731,/images/bc832bde-d3ea-4a8e-be90-7a3329dcc314.png,791,867,904,975,113,108,red blood cell,12204,0.9557522123893806,1.0462962962962963
60854,/images/11b72c7b-5c52-44b7-adb7-21eacc25e441.png,652,641,753,749,101,108,red blood cell,10908,1.0693069306930694,0.9351851851851852
38581,/images/f8b14fc4-dd6b-4ad0-a96d-c62845f48681.png,24,1102,158,1228,134,126,red blood cell,16884,0.9402985074626866,1.0634920634920635
11182,/images/6303f964-98ef-47c6-bb2d-283aa393f918.png,1051,214,1145,297,94,83,red blood cell,7802,0.8829787234042553,1.1325301204819278
44589,/images/6388e241-09a2-4fbe-a712-07d8fe714c51.png,474,1271,590,1391,116,120,red blood cell,13920,1.0344827586206897,0.9666666666666667
48155,/images/913099c5-8085-4908-bf4b-1f098bbfcf66.png,297,1035,409,1149,112,114,red blood cell,12768,1.0178571428571428,0.9824561403508771
78179,/images/2bed2796-75a9-4d93-bb2d-e3ccbe1a5cbe.png,531,700,632,801,101,101,red blood cell,10201,1.0,1.0
8742,/images/29dc8176-dfe1-40e0-8247-2dc3c530057e.png,513,811,631,928,118,117,red blood cell,13806,0.9915254237288136,1.0085470085470085
28246,/images/036404d1-b9fc-497b-bbe1-f4d9c5ac3ce0.png,346,594,439,705,93,111,red blood cell,10323,1.1935483870967742,0.8378378378378378
41866,/images/783ae4ad-6a35-4b3c-b19f-754974b67b2d.png,136,1192,254,1309,118,117,red blood cell,13806,0.9915254237288136,1.0085470085470085
39381,/images/fbcb2ef0-3c97-4d7a-8b96-0147c73f3941.png,276,1187,377,1276,101,89,red blood cell,8989,0.8811881188118812,1.1348314606741574
70312,/images/90246988-0d6d-4bf8-8a76-94107de4121e.png,23,415,106,500,83,85,red blood cell,7055,1.0240963855421688,0.9764705882352941
53011,/images/42e87148-a015-4148-923a-fb83016f64e7.png,1054,114,1174,232,120,118,red blood cell,14160,0.9833333333333333,1.0169491525423728
8330,/images/65e3d6a6-012c-4b40-9a42-83078eb85e31.png,832,116,903,194,71,78,red blood cell,5538,1.0985915492957747,0.9102564102564102
69341,/images/2ac343e4-c889-47c1-8fe2-461b626def76.png,674,1437,783,1555,109,118,red blood cell,12862,1.0825688073394495,0.923728813559322
60094,/images/e63e1607-f344-43d6-a0d8-e10cf2e5054a.png,138,1418,277,1545,139,127,red blood cell,17653,0.9136690647482014,1.094488188976378
796,/images/27fab82c-5bf0-426f-aeb9-47da829b6629.png,203,336,305,451,102,115,red blood cell,11730,1.1274509803921569,0.8869565217391304
20447,/images/781d4bea-c6a9-4b36-ae10-ba9e328c87fe.png,922,493,1038,609,116,116,red blood cell,13456,1.0,1.0
35370,/images/452482bc-24a3-413e-ba03-fad4c9d61f3c.png,305,23,419,123,114,100,red blood cell,11400,0.8771929824561403,1.14
13239,/images/711f6b3f-cd63-46d1-834a-bc8e9aa9b43e.png,843,951,942,1056,99,105,red blood cell,10395,1.0606060606060606,0.9428571428571428
50501,/images/79f2fbab-169d-4062-820d-3dfd12f062c8.png,372,840,477,946,105,106,red blood cell,11130,1.0095238095238095,0.9905660377358491
28643,/images/861c3e06-aada-47a0-99ae-94fbc2772cc0.png,865,517,988,632,123,115,red blood cell,14145,0.9349593495934959,1.0695652173913044
12747,/images/b634137b-bc8b-4e88-b0e3-b536ad6e7e18.png,470,1260,561,1361,91,101,red blood cell,9191,1.10989010989011,0.900990099009901
45465,/images/e4eea7ea-8989-46a9-9c98-25a178146b28.png,416,448,498,528,82,80,red blood cell,6560,0.975609756097561,1.025
74627,/images/5ccca8ee-abea-458a-a891-bedd31c3ddc3.png,957,973,1071,1088,114,115,red blood cell,13110,1.0087719298245614,0.991304347826087
30299,/images/cecbf663-0751-4e7f-b298-770c88afc2c1.png,117,1242,212,1343,95,101,red blood cell,9595,1.063157894736842,0.9405940594059405
71791,/images/093a831a-bf71-4333-bc06-942ae70cb164.png,874,1298,974,1397,100,99,red blood cell,9900,0.99,1.0101010101010102
66100,/images/191f87a4-6f2d-49e7-bba0-08e3aa78ddaf.png,464,1117,578,1241,114,124,red blood cell,14136,1.087719298245614,0.9193548387096774
23434,/images/8757be1e-b832-407a-8e95-62abae485b24.png,698,404,790,504,92,100,red blood cell,9200,1.0869565217391304,0.92
68395,/images/040112be-3c8d-49aa-93f1-522f94a592ff.png,250,621,357,731,107,110,red blood cell,11770,1.02803738317757,0.9727272727272728
38950,/images/5939f341-a886-4f63-ae87-2219d000a1d4.png,704,1109,814,1224,110,115,red blood cell,12650,1.0454545454545454,0.9565217391304348
3733,/images/dacf7e3f-1d8c-42a0-8539-3abe3971c956.png,1039,1031,1177,1156,138,125,red blood cell,17250,0.9057971014492754,1.104
7143,/images/56551792-4aa1-4301-9f8f-8bfebcd20050.png,1032,716,1148,851,116,135,red blood cell,15660,1.1637931034482758,0.8592592592592593
4482,/images/cf90d82f-2814-4fb7-a3ff-a86b7c5efca7.png,61,1266,190,1394,129,128,red blood cell,16512,0.9922480620155039,1.0078125
50865,/images/0906111b-bac7-4541-a6dc-da435c0724a8.png,852,344,953,443,101,99,red blood cell,9999,0.9801980198019802,1.02020202020202
60226,/images/214f1d15-a081-476e-992d-6c3a77f03d59.png,364,163,467,273,103,110,red blood cell,11330,1.0679611650485437,0.9363636363636364
37812,/images/8d56197c-21d7-4cb6-92df-80637efd129b.png,689,955,814,1085,125,130,red blood cell,16250,1.04,0.9615384615384616
10390,/images/46a2d369-4bea-4405-ac78-91bbe130b9a7.png,65,72,164,168,99,96,red blood cell,9504,0.9696969696969697,1.03125
52615,/images/a6fe423a-5204-4378-bcfa-d6d298a3e9aa.png,75,407,203,527,128,120,red blood cell,15360,0.9375,1.0666666666666667
72264,/images/ee57e743-a876-4f69-9fe5-bf5d01b44689.png,260,744,356,842,96,98,red blood cell,9408,1.0208333333333333,0.9795918367346939
3943,/images/f09acb0c-b270-4e91-99f8-410adfa7f34a.png,220,1429,313,1532,93,103,red blood cell,9579,1.10752688172043,0.9029126213592233
47827,/images/5a105b89-c592-4d78-b208-7db6c6572752.png,32,724,173,837,141,113,red blood cell,15933,0.8014184397163121,1.247787610619469
10484,/images/46a2d369-4bea-4405-ac78-91bbe130b9a7.png,821,914,908,999,87,85,red blood cell,7395,0.9770114942528736,1.0235294117647058
44464,/images/edd3862f-04e1-49cf-97dd-ca566d17e71a.png,447,1502,558,1600,111,98,red blood cell,10878,0.8828828828828829,1.1326530612244898
38570,/images/c3ae7090-fc68-41b4-85a1-8d9bce9825a7.png,435,1455,547,1571,112,116,red blood cell,12992,1.0357142857142858,0.9655172413793104
74574,/images/bbedfcbe-9528-4ba9-9d86-4ebba7589ac5.png,1067,1008,1164,1118,97,110,red blood cell,10670,1.134020618556701,0.8818181818181818
62481,/images/7dfbfeaf-e3b1-4159-8dcd-d7f731280ac8.png,742,1015,834,1108,92,93,red blood cell,8556,1.0108695652173914,0.989247311827957
73089,/images/f39e2289-fedd-4d12-9e64-ffdafb89247e.png,294,1055,403,1162,109,107,red blood cell,11663,0.981651376146789,1.0186915887850467
33216,/images/877d5e7f-19b6-40e7-81bd-c92f25e72503.png,697,878,821,1005,124,127,red blood cell,15748,1.0241935483870968,0.9763779527559056
6769,/images/672e4ecf-a56b-462e-b83b-76f4efaa6634.png,506,121,634,228,128,107,red blood cell,13696,0.8359375,1.1962616822429906
39479,/images/5a631871-2fc7-4a68-9c39-f3b9a0bf4a04.png,175,588,259,691,84,103,red blood cell,8652,1.2261904761904763,0.8155339805825242
52054,/images/de6d3020-9347-473b-9146-8909627790f6.png,656,722,776,840,120,118,red blood cell,14160,0.9833333333333333,1.0169491525423728
34870,/images/a4fbb9f2-9b75-4fdc-877d-2feaafac25b3.png,416,392,516,494,100,102,red blood cell,10200,1.02,0.9803921568627451
78855,/images/4d0a1598-e4dd-45c4-8a90-dd7c780fe1da.png,1020,1454,1118,1547,98,93,red blood cell,9114,0.9489795918367347,1.053763440860215
37283,/images/2fdbd9bc-bbaf-44c2-b40c-d193709639fa.png,50,814,170,924,120,110,red blood cell,13200,0.9166666666666666,1.0909090909090908
75103,/images/073c10c9-5749-44b5-b08b-1be556a960f0.png,690,629,786,734,96,105,red blood cell,10080,1.09375,0.9142857142857143
77412,/images/c7ec51d5-9f45-4209-8357-39e9a984a733.png,1007,1385,1099,1482,92,97,red blood cell,8924,1.0543478260869565,0.9484536082474226
67107,/images/4272cbd7-5b0a-4bf7-b690-dee1c128f07b.png,139,222,240,316,101,94,red blood cell,9494,0.9306930693069307,1.074468085106383
62901,/images/4b346035-b8c0-46ca-8fdb-a01b1421ee4a.png,984,1451,1082,1562,98,111,red blood cell,10878,1.1326530612244898,0.8828828828828829
72239,/images/7d4d0646-26b5-46fa-ab25-452d986e887b.png,399,420,500,516,101,96,red blood cell,9696,0.9504950495049505,1.0520833333333333
6328,/images/c6575e75-c8ce-4766-841f-1137b9e0956c.png,165,1427,268,1521,103,94,red blood cell,9682,0.912621359223301,1.0957446808510638
21623,/images/66183740-e1e5-43c9-8539-a87028bb3621.png,972,994,1083,1112,111,118,red blood cell,13098,1.063063063063063,0.940677966101695
19669,/images/627d6331-7bb9-4d1a-b20d-e6541af4d0f9.png,163,473,264,570,101,97,red blood cell,9797,0.9603960396039604,1.041237113402062
75977,/images/034c8d57-04d5-4786-93a4-6ae8fde2c258.png,983,1258,1057,1341,74,83,red blood cell,6142,1.1216216216216217,0.891566265060241
31848,/images/f62d4fb6-df7c-446c-94a8-d5aede0b1e0c.png,798,184,913,291,115,107,red blood cell,12305,0.9304347826086956,1.074766355140187
44073,/images/8b494b40-cab5-49d3-893d-c805000fbe88.png,654,562,743,665,89,103,red blood cell,9167,1.1573033707865168,0.8640776699029126
29913,/images/f2a8a483-b254-43aa-817f-7d525adb8911.png,215,343,327,467,112,124,red blood cell,13888,1.1071428571428572,0.9032258064516129
68001,/images/bcaefb02-682a-41b9-acc7-e6cc010f5b30.png,372,709,470,816,98,107,red blood cell,10486,1.0918367346938775,0.9158878504672897
32239,/images/f4722a74-35e7-42bd-8ef6-dfff04b9cd22.png,918,1272,1024,1379,106,107,red blood cell,11342,1.009433962264151,0.9906542056074766
62970,/images/f234a2de-f3c8-4521-a306-8cfdf52dd597.png,929,1396,1025,1486,96,90,red blood cell,8640,0.9375,1.0666666666666667
2126,/images/e94a811d-3145-4313-ba42-2d5ed283179f.png,118,1281,209,1371,91,90,red blood cell,8190,0.989010989010989,1.011111111111111
323,/images/0dcca702-a4ef-4fb3-a940-9c0c140b21c7.png,774,873,866,978,92,105,red blood cell,9660,1.141304347826087,0.8761904761904762
2255,/images/fe851c88-692d-4199-87e0-d19d9c4eb591.png,25,541,155,649,130,108,red blood cell,14040,0.8307692307692308,1.2037037037037037
46972,/images/9ebd623d-5534-4dd9-bff8-cdedf322db35.png,487,584,586,685,99,101,red blood cell,9999,1.02020202020202,0.9801980198019802
11148,/images/6303f964-98ef-47c6-bb2d-283aa393f918.png,856,991,958,1096,102,105,red blood cell,10710,1.0294117647058822,0.9714285714285714
61688,/images/a3c0a876-be12-4ede-8aed-18b32a64401b.png,805,984,886,1083,81,99,red blood cell,8019,1.2222222222222223,0.8181818181818182
12840,/images/b10ea12f-cd36-4f2c-994a-67d1665269ab.png,199,738,308,843,109,105,red blood cell,11445,0.963302752293578,1.0380952380952382
5875,/images/a30da226-b452-408a-a556-bfae4d521464.png,860,1181,992,1307,132,126,red blood cell,16632,0.9545454545454546,1.0476190476190477
15388,/images/035f6c4b-0897-46ab-9c3b-5f3b0feff043.png,740,7,857,120,117,113,red blood cell,13221,0.9658119658119658,1.0353982300884956
9543,/images/a18f122f-3a3e-4478-8ac4-91b83e050e65.png,664,453,799,574,135,121,red blood cell,16335,0.8962962962962963,1.115702479338843
40477,/images/db249e5a-4142-432c-8288-bacd10d7273d.png,391,960,505,1057,114,97,red blood cell,11058,0.8508771929824561,1.175257731958763
7077,/images/8be185e7-2a1a-441c-a5c7-b50a9eb926cb.png,218,920,347,1047,129,127,red blood cell,16383,0.9844961240310077,1.015748031496063
17668,/images/b5143aae-6e98-4dc6-b546-980cb472de67.png,208,683,304,791,96,108,red blood cell,10368,1.125,0.8888888888888888
62019,/images/bdb5d571-27bc-4a42-ae45-aa5a9af40a81.png,453,689,581,800,128,111,red blood cell,14208,0.8671875,1.1531531531531531
47363,/images/477e541c-0519-4542-9b13-8ee7922644d3.png,947,175,1068,279,121,104,red blood cell,12584,0.859504132231405,1.1634615384615385
28237,/images/036404d1-b9fc-497b-bbe1-f4d9c5ac3ce0.png,498,1476,612,1574,114,98,red blood cell,11172,0.8596491228070176,1.163265306122449
74580,/images/bbedfcbe-9528-4ba9-9d86-4ebba7589ac5.png,1118,759,1199,840,81,81,red blood cell,6561,1.0,1.0
16961,/images/8eeb378e-90f0-47ea-ac1c-2a201eb8d090.png,776,280,872,385,96,105,red blood cell,10080,1.09375,0.9142857142857143
27740,/images/e3c1442a-717f-41dd-bf97-81e1233ac9fa.png,190,1423,295,1527,105,104,red blood cell,10920,0.9904761904761905,1.0096153846153846
76128,/images/16244280-6c74-47d3-b544-9fd6831a6bf9.png,665,190,764,294,99,104,red blood cell,10296,1.0505050505050506,0.9519230769230769
24344,/images/4d8a4ce8-0f9c-4f21-8844-4cf0e5514bbf.png,853,181,958,288,105,107,red blood cell,11235,1.019047619047619,0.9813084112149533
61623,/images/a3c0a876-be12-4ede-8aed-18b32a64401b.png,170,406,272,516,102,110,red blood cell,11220,1.0784313725490196,0.9272727272727272
45303,/images/9e793460-d94c-47ac-b3a7-0d6ad86357da.png,366,695,479,810,113,115,red blood cell,12995,1.0176991150442478,0.9826086956521739
61753,/images/985627c9-7b85-40de-a106-eb9cc47b47cb.png,1082,1314,1175,1404,93,90,red blood cell,8370,0.967741935483871,1.0333333333333334
48175,/images/913099c5-8085-4908-bf4b-1f098bbfcf66.png,287,256,409,371,122,115,red blood cell,14030,0.9426229508196722,1.0608695652173914
46497,/images/21417261-475a-456f-b03f-57ac85a6e106.png,91,677,210,814,119,137,red blood cell,16303,1.1512605042016806,0.8686131386861314
76476,/images/34df8890-272d-423a-ae78-ff8d068d3306.png,58,816,161,903,103,87,red blood cell,8961,0.8446601941747572,1.1839080459770115
47869,/images/ab27173b-6e30-4957-bd68-29194328fd39.png,378,620,477,716,99,96,red blood cell,9504,0.9696969696969697,1.03125
31581,/images/0d7bf56f-3b5a-40bd-971c-2ca33dd89b2c.png,380,835,478,938,98,103,red blood cell,10094,1.0510204081632653,0.9514563106796117
54345,/images/19370afd-f897-47d8-bfae-c0d257bbf795.png,504,652,606,752,102,100,red blood cell,10200,0.9803921568627451,1.02
59746,/images/f77d7469-d083-4c2d-a4ea-5a9ff162e3e2.png,142,596,246,681,104,85,red blood cell,8840,0.8173076923076923,1.223529411764706
71406,/images/bcb447c9-5d37-414f-a513-d7076b04a532.png,1083,1337,1175,1433,92,96,red blood cell,8832,1.0434782608695652,0.9583333333333334
41042,/images/e871f52c-77a6-4813-80d4-95bd97985f1a.png,437,1051,558,1186,121,135,red blood cell,16335,1.115702479338843,0.8962962962962963
33031,/images/6231d81d-9e84-4a5a-8cb8-47c6a37a0176.png,194,23,281,105,87,82,red blood cell,7134,0.9425287356321839,1.0609756097560976
79289,/images/05ac7b2a-6a77-4464-926b-8570f7c01693.png,428,871,511,973,83,102,red blood cell,8466,1.2289156626506024,0.8137254901960784
20333,/images/98976666-9125-47fe-9601-43c41e58dfb4.png,450,602,551,703,101,101,red blood cell,10201,1.0,1.0
10929,/images/1380f9b4-bf54-4492-90c3-743c7aa8898b.png,40,344,148,450,108,106,red blood cell,11448,0.9814814814814815,1.0188679245283019
70141,/images/c742ee2c-6814-46cd-af56-ae87bb9972f4.png,104,776,200,888,96,112,red blood cell,10752,1.1666666666666667,0.8571428571428571
48060,/images/1d4f06e1-9c9b-487e-84cd-e7e50cc754da.png,658,1196,789,1314,131,118,red blood cell,15458,0.9007633587786259,1.1101694915254237
68111,/images/29d40b60-cde1-45b5-b403-692437a77ac1.png,452,130,544,208,92,78,red blood cell,7176,0.8478260869565217,1.1794871794871795
21624,/images/66183740-e1e5-43c9-8539-a87028bb3621.png,587,1209,705,1339,118,130,red blood cell,15340,1.1016949152542372,0.9076923076923077
1380,/images/6d91d1f0-636b-4f5a-a526-7c17fc857190.png,235,1470,327,1564,92,94,red blood cell,8648,1.0217391304347827,0.9787234042553191
1259,/images/6d91d1f0-636b-4f5a-a526-7c17fc857190.png,353,384,456,476,103,92,red blood cell,9476,0.8932038834951457,1.1195652173913044
13756,/images/1b369bcf-ced4-4ae2-9196-2664bd2b1738.png,843,352,972,471,129,119,red blood cell,15351,0.9224806201550387,1.084033613445378
67686,/images/2b128a1a-95ed-408b-b9f8-8795cc814d80.png,358,807,460,927,102,120,red blood cell,12240,1.1764705882352942,0.85
1368,/images/6d91d1f0-636b-4f5a-a526-7c17fc857190.png,1031,300,1132,400,101,100,red blood cell,10100,0.9900990099009901,1.01
29674,/images/b85fc640-de49-4f7e-afc0-978ff020f2e2.png,516,1100,625,1228,109,128,red blood cell,13952,1.1743119266055047,0.8515625
34547,/images/3af90874-59f3-4f0c-a7e6-cc889e80c605.png,313,275,439,407,126,132,red blood cell,16632,1.0476190476190477,0.9545454545454546
57449,/images/00d04a90-80e5-4bce-9511-1b64eabb7a47.png,863,351,969,458,106,107,red blood cell,11342,1.009433962264151,0.9906542056074766
18838,/images/d1b48634-9ad5-46e8-b816-42d1d97c93cd.png,880,952,1001,1059,121,107,red blood cell,12947,0.8842975206611571,1.1308411214953271
64728,/images/76021d69-8919-4688-95ef-7418eff620cc.png,345,1305,429,1409,84,104,red blood cell,8736,1.2380952380952381,0.8076923076923077
4127,/images/d3b79739-aea2-4804-8c7a-183b7ed07de3.png,92,1140,199,1263,107,123,red blood cell,13161,1.1495327102803738,0.8699186991869918
11448,/images/dca685a8-a609-45d8-93d7-da1e4165b9bd.png,51,1471,183,1591,132,120,red blood cell,15840,0.9090909090909091,1.1
21505,/images/7625dfc4-858a-4c8e-907c-8943d665e9a7.png,1005,731,1117,845,112,114,red blood cell,12768,1.0178571428571428,0.9824561403508771
44123,/images/8b494b40-cab5-49d3-893d-c805000fbe88.png,1049,1200,1147,1282,98,82,red blood cell,8036,0.8367346938775511,1.1951219512195121
10876,/images/b78b88f0-154a-4b54-8aaf-85d37a42a0f9.png,312,205,427,331,115,126,red blood cell,14490,1.0956521739130434,0.9126984126984127
6771,/images/672e4ecf-a56b-462e-b83b-76f4efaa6634.png,754,47,862,159,108,112,red blood cell,12096,1.037037037037037,0.9642857142857143
44241,/images/4257342d-6d77-4671-a84b-1f0c36ccb367.png,556,437,652,541,96,104,red blood cell,9984,1.0833333333333333,0.9230769230769231
18151,/images/947348fe-4c70-468e-8009-3c14daeca69b.png,933,885,1022,996,89,111,red blood cell,9879,1.247191011235955,0.8018018018018018
954,/images/a8cb75ba-3f2f-40d8-8bc7-c79ebd1b9603.png,621,766,730,884,109,118,red blood cell,12862,1.0825688073394495,0.923728813559322
55758,/images/68f34a9c-f73d-4238-8f55-4b05a8a2154c.png,1060,1144,1146,1246,86,102,red blood cell,8772,1.186046511627907,0.8431372549019608
51576,/images/d0347b49-8f98-4632-a384-1a4f57ac6374.png,64,790,166,894,102,104,red blood cell,10608,1.0196078431372548,0.9807692307692307
76360,/images/3dad6483-ac30-4d2b-b045-9f24fe6ff75e.png,841,105,945,213,104,108,red blood cell,11232,1.0384615384615385,0.9629629629629629
19917,/images/0ca25c88-457f-4f03-bbc1-98fb6663f1d1.png,1069,1463,1160,1568,91,105,red blood cell,9555,1.1538461538461537,0.8666666666666667
32854,/images/2a6370b0-08f1-4c11-a639-265d4419c9a3.png,167,279,285,398,118,119,red blood cell,14042,1.0084745762711864,0.9915966386554622
34315,/images/0d2aba33-6920-4001-bd54-59fe0bf9f50e.png,3,179,126,289,123,110,red blood cell,13530,0.8943089430894309,1.1181818181818182
15779,/images/64113b22-03b1-4ab8-89ab-b2f32154fbbd.png,788,315,914,440,126,125,red blood cell,15750,0.9920634920634921,1.008
8907,/images/29539cb0-1c52-46b2-9302-552f8349dc71.png,175,170,290,313,115,143,red blood cell,16445,1.2434782608695651,0.8041958041958042
1955,/images/b95ceeeb-8870-4492-9037-2091ff268c5a.png,591,481,695,596,104,115,red blood cell,11960,1.1057692307692308,0.9043478260869565
35542,/images/3e33ee12-ef02-4287-8318-7ad3b284a617.png,450,871,567,994,117,123,red blood cell,14391,1.0512820512820513,0.9512195121951219
46361,/images/fcc2b245-f47f-447f-8527-275b0005677c.png,411,349,530,456,119,107,red blood cell,12733,0.8991596638655462,1.1121495327102804
68930,/images/bbaa004f-05dc-4cb8-8768-e148085bb0f9.png,457,1172,556,1270,99,98,red blood cell,9702,0.98989898989899,1.010204081632653
69914,/images/9edba799-e169-46cd-b100-c9f8fc7a8c7d.png,1067,854,1175,967,108,113,red blood cell,12204,1.0462962962962963,0.9557522123893806
1999,/images/bfefa21c-11e1-4dab-ac5d-8ff6f046d65f.png,828,47,950,170,122,123,red blood cell,15006,1.0081967213114753,0.991869918699187
59366,/images/565513be-2c20-4ee3-94f3-093869515d3d.png,412,759,507,861,95,102,red blood cell,9690,1.0736842105263158,0.9313725490196079
60146,/images/214f1d15-a081-476e-992d-6c3a77f03d59.png,604,1302,706,1417,102,115,red blood cell,11730,1.1274509803921569,0.8869565217391304
26992,/images/1f337b61-1b0d-4539-91f9-73d4a0798a4a.png,847,986,959,1104,112,118,red blood cell,13216,1.0535714285714286,0.9491525423728814
59690,/images/a2754679-68b0-40f4-be01-bafad5ac1261.png,639,938,741,1027,102,89,red blood cell,9078,0.8725490196078431,1.146067415730337
75141,/images/7fdc8be8-7579-4a5c-b369-8a07ee0a8b7d.png,549,432,638,525,89,93,red blood cell,8277,1.0449438202247192,0.956989247311828
236,/images/2559636b-f01a-4414-93da-210c3b12d153.png,204,1044,297,1137,93,93,red blood cell,8649,1.0,1.0
56361,/images/4372709c-f356-4906-be17-415384d916e8.png,1040,1491,1152,1584,112,93,red blood cell,10416,0.8303571428571429,1.2043010752688172
65796,/images/daea4860-a296-4f6d-acef-996ab0882676.png,290,1166,395,1267,105,101,red blood cell,10605,0.9619047619047619,1.0396039603960396
53963,/images/540a5fee-175b-4b92-bf62-1ea9b59c86c6.png,809,140,898,231,89,91,red blood cell,8099,1.0224719101123596,0.978021978021978
431,/images/84c88143-940d-4b62-bbd2-7acc4cadcb6b.png,30,1080,138,1212,108,132,red blood cell,14256,1.2222222222222223,0.8181818181818182
17776,/images/1863da5f-c595-4541-a8f4-21fe78678168.png,421,630,513,722,92,92,red blood cell,8464,1.0,1.0
79790,/images/fc15659f-6264-4dd5-ab17-43d89fb297b9.png,709,1045,814,1162,105,117,red blood cell,12285,1.1142857142857143,0.8974358974358975
51899,/images/d67398c5-8b0e-463f-a04e-8583c820786c.png,271,538,386,634,115,96,red blood cell,11040,0.8347826086956521,1.1979166666666667
37925,/images/56a57a8d-c9b9-432a-a3b0-32a09355806c.png,1090,727,1187,834,97,107,red blood cell,10379,1.1030927835051547,0.9065420560747663
67887,/images/41ebf9a1-24dc-454e-8bf8-508218f5ee57.png,1,774,86,864,85,90,red blood cell,7650,1.0588235294117647,0.9444444444444444
38561,/images/c3ae7090-fc68-41b4-85a1-8d9bce9825a7.png,1078,1282,1200,1390,122,108,red blood cell,13176,0.8852459016393442,1.1296296296296295
57034,/images/9e82c996-2cfa-418d-9482-8ee23e9d0a5d.png,484,722,579,818,95,96,red blood cell,9120,1.0105263157894737,0.9895833333333334
38791,/images/b426ef1d-4a59-4f90-b593-50226af60a60.png,666,76,775,189,109,113,red blood cell,12317,1.036697247706422,0.9646017699115044
69647,/images/4a49841f-216c-4815-8140-b8762c4f6603.png,0,603,93,684,93,81,red blood cell,7533,0.8709677419354839,1.1481481481481481
75786,/images/f48bf825-13c4-42fc-8dd8-10cc4ae6b202.png,717,71,835,176,118,105,red blood cell,12390,0.8898305084745762,1.1238095238095238
50470,/images/a2de1248-7bc0-44dc-b508-70a357eedd68.png,858,386,974,497,116,111,red blood cell,12876,0.9568965517241379,1.045045045045045
70826,/images/b62d47f9-2ff5-4902-abdc-b3610acfc7ba.png,570,499,649,594,79,95,red blood cell,7505,1.2025316455696202,0.8315789473684211
55713,/images/c32b8bb8-c89d-4ae9-9c77-5b9356ca35a1.png,658,260,757,352,99,92,red blood cell,9108,0.9292929292929293,1.076086956521739
50363,/images/3d32a988-449d-4d58-b71f-abbfdc3f2fbc.png,564,1012,652,1104,88,92,red blood cell,8096,1.0454545454545454,0.9565217391304348
55886,/images/afd39466-aafa-4d81-9520-483727418723.png,969,774,1068,872,99,98,red blood cell,9702,0.98989898989899,1.010204081632653
2250,/images/5bf91ff9-80df-49c0-9c3e-599357d95530.png,718,289,821,399,103,110,red blood cell,11330,1.0679611650485437,0.9363636363636364
40401,/images/db249e5a-4142-432c-8288-bacd10d7273d.png,648,1156,741,1242,93,86,red blood cell,7998,0.9247311827956989,1.0813953488372092
79598,/images/161978c3-3a05-47a5-9fee-be7d25693eae.png,856,120,929,194,73,74,red blood cell,5402,1.0136986301369864,0.9864864864864865
46603,/images/da111ca5-520f-4ea8-97ad-ae5fce58ee91.png,449,444,554,543,105,99,red blood cell,10395,0.9428571428571428,1.0606060606060606
47729,/images/afbb264e-ff60-443a-83f5-49d09be1b835.png,516,724,641,863,125,139,red blood cell,17375,1.112,0.8992805755395683
10030,/images/26799d2b-a289-4eff-9218-0aad77e05e41.png,914,702,1037,837,123,135,red blood cell,16605,1.0975609756097562,0.9111111111111111
51107,/images/4748ba2b-6771-41d9-93a5-af9ccd559261.png,363,503,502,630,139,127,red blood cell,17653,0.9136690647482014,1.094488188976378
67669,/images/2b128a1a-95ed-408b-b9f8-8795cc814d80.png,371,124,486,241,115,117,red blood cell,13455,1.017391304347826,0.9829059829059829
22386,/images/78c35732-7e31-4153-842e-55ab1cd656f6.png,95,585,186,683,91,98,red blood cell,8918,1.0769230769230769,0.9285714285714286
45651,/images/584d62ed-4329-45dd-94ce-e929d8b2bb74.png,194,120,291,225,97,105,red blood cell,10185,1.0824742268041236,0.9238095238095239
62118,/images/f5c51193-8a27-4ef3-83ad-771395d63caf.png,1057,942,1152,1052,95,110,red blood cell,10450,1.1578947368421053,0.8636363636363636
13641,/images/1e86933d-6a5a-4a3c-a0f2-ca22afd767b3.png,132,1123,233,1235,101,112,red blood cell,11312,1.108910891089109,0.9017857142857143
4994,/images/2cc3c4ad-670f-41b6-8910-0704cbc192ef.png,1085,695,1192,802,107,107,red blood cell,11449,1.0,1.0
60378,/images/1c87b997-a8e6-48ca-bf40-19b9a7fd6a96.png,251,172,333,265,82,93,red blood cell,7626,1.1341463414634145,0.8817204301075269
15225,/images/3a8f468f-f9de-46a8-a7c8-f2be239fa207.png,453,948,533,1047,80,99,red blood cell,7920,1.2375,0.8080808080808081
3916,/images/65e865f3-acfb-4d01-a75f-ff5a535ffa6a.png,725,583,853,689,128,106,red blood cell,13568,0.828125,1.2075471698113207
3280,/images/b901c906-91be-48c4-88ec-2c527544a258.png,505,1435,624,1547,119,112,red blood cell,13328,0.9411764705882353,1.0625
59565,/images/6bfe6a90-8a69-4171-8e7f-42dc9417c6d9.png,542,773,627,859,85,86,red blood cell,7310,1.011764705882353,0.9883720930232558
52852,/images/58f7e1da-3478-48f4-958c-e9b1cb8696aa.png,202,951,324,1051,122,100,red blood cell,12200,0.819672131147541,1.22
75242,/images/61dfc937-a428-44b4-94fb-d682bdb8dff0.png,980,659,1084,778,104,119,red blood cell,12376,1.1442307692307692,0.8739495798319328
71939,/images/61575482-91e1-4db9-83c7-687b7ddbbfc4.png,861,236,950,329,89,93,red blood cell,8277,1.0449438202247192,0.956989247311828
61490,/images/7e837856-3519-4dc0-b357-4cdcfd30b4eb.png,256,235,356,320,100,85,red blood cell,8500,0.85,1.1764705882352942
19250,/images/b4d22412-a495-43a9-bec0-73a2322f8dad.png,426,711,537,828,111,117,red blood cell,12987,1.054054054054054,0.9487179487179487
37601,/images/205306da-0ed8-475a-ace6-f2f81d4be88a.png,828,39,935,137,107,98,red blood cell,10486,0.9158878504672897,1.0918367346938775
61586,/images/4a717a39-80f8-4b75-a25e-c46d65d7dcd5.png,855,260,957,369,102,109,red blood cell,11118,1.0686274509803921,0.9357798165137615
45078,/images/56fbae44-4677-47f8-9c3a-22dac043c115.png,943,178,1052,293,109,115,red blood cell,12535,1.055045871559633,0.9478260869565217
16707,/images/d6352a03-ef81-421d-915e-226499555d20.png,923,1179,1046,1298,123,119,red blood cell,14637,0.967479674796748,1.0336134453781514
1922,/images/02ea7aa8-c142-4a3d-939f-e77689741341.png,485,1389,618,1513,133,124,red blood cell,16492,0.9323308270676691,1.0725806451612903
66250,/images/e8058bed-c362-4e1c-85dc-62f80f32938f.png,615,506,715,607,100,101,red blood cell,10100,1.01,0.9900990099009901
75818,/images/c4c7ed75-dbdf-4bb6-b6ba-718903cf7264.png,702,1318,796,1431,94,113,red blood cell,10622,1.202127659574468,0.831858407079646
5370,/images/716273ea-19c4-49af-8604-df587b295eca.png,238,428,362,559,124,131,red blood cell,16244,1.0564516129032258,0.9465648854961832
16144,/images/66557580-fd38-4d4b-80d8-88611ecc78c6.png,194,148,325,261,131,113,red blood cell,14803,0.8625954198473282,1.1592920353982301
14420,/images/3b13e20f-ec0d-44ec-b2f4-eaebfa09150e.png,43,1085,146,1199,103,114,red blood cell,11742,1.1067961165048543,0.9035087719298246
36183,/images/749df49e-5212-49ea-9e88-7d66f258f1df.png,634,614,746,735,112,121,red blood cell,13552,1.0803571428571428,0.9256198347107438
47705,/images/afbb264e-ff60-443a-83f5-49d09be1b835.png,964,76,1084,192,120,116,red blood cell,13920,0.9666666666666667,1.0344827586206897
47139,/images/3d1b889e-bb4a-4ee6-b899-974ee7d956a7.png,1007,289,1109,413,102,124,red blood cell,12648,1.2156862745098038,0.8225806451612904
38441,/images/674b0fd3-f247-4b7f-97f7-3e6c57c9ba9e.png,124,1006,228,1120,104,114,red blood cell,11856,1.0961538461538463,0.9122807017543859
22335,/images/49b03a6e-6b26-4a96-a061-e05647a02138.png,276,787,377,894,101,107,red blood cell,10807,1.0594059405940595,0.9439252336448598
8217,/images/65e3d6a6-012c-4b40-9a42-83078eb85e31.png,734,757,818,837,84,80,red blood cell,6720,0.9523809523809523,1.05
44065,/images/8b494b40-cab5-49d3-893d-c805000fbe88.png,180,375,284,482,104,107,red blood cell,11128,1.0288461538461537,0.9719626168224299
77690,/images/07d15855-eb9b-46a9-b894-7cfe4d097826.png,854,277,966,379,112,102,red blood cell,11424,0.9107142857142857,1.0980392156862746
47502,/images/adff132d-3af0-4cef-942c-58fc09729bee.png,775,1183,886,1300,111,117,red blood cell,12987,1.054054054054054,0.9487179487179487
7170,/images/56551792-4aa1-4301-9f8f-8bfebcd20050.png,954,491,1081,616,127,125,red blood cell,15875,0.984251968503937,1.016
14702,/images/4e2873dd-651e-4ecc-ac70-7335cf21a469.png,1009,1094,1123,1210,114,116,red blood cell,13224,1.0175438596491229,0.9827586206896551
10181,/images/09ecf7be-28e2-4531-b9e2-07e01c44097d.png,1080,113,1200,226,120,113,red blood cell,13560,0.9416666666666667,1.0619469026548674
76955,/images/51e86aa9-caa0-4297-94e8-34a57d7f7e36.png,515,962,615,1058,100,96,red blood cell,9600,0.96,1.0416666666666667
64658,/images/6dfafdf1-f588-4e80-8cf8-0126e1bf7af9.png,131,221,251,330,120,109,red blood cell,13080,0.9083333333333333,1.1009174311926606
25514,/images/f6ab936d-924b-4038-aa47-71b07c26b4e2.png,510,494,624,613,114,119,red blood cell,13566,1.043859649122807,0.957983193277311
50868,/images/0906111b-bac7-4541-a6dc-da435c0724a8.png,1089,864,1191,974,102,110,red blood cell,11220,1.0784313725490196,0.9272727272727272
71234,/images/86495bbf-687b-429c-b9d3-6c2681ade7e2.png,651,1347,755,1449,104,102,red blood cell,10608,0.9807692307692307,1.0196078431372548
49836,/images/5e17f8e6-fd8d-426c-b444-1515d14f04b7.png,142,809,240,894,98,85,red blood cell,8330,0.8673469387755102,1.1529411764705881
37396,/images/08f5a524-0554-49c2-83a8-ae9a6d51e8fd.png,850,1445,957,1539,107,94,red blood cell,10058,0.8785046728971962,1.1382978723404256
72115,/images/64b0e49a-0e48-447d-8872-c1dd255e7a21.png,809,867,897,950,88,83,red blood cell,7304,0.9431818181818182,1.0602409638554218
75753,/images/d12c5f45-6b20-46d6-a66f-c5a4683c25b3.png,82,510,193,616,111,106,red blood cell,11766,0.954954954954955,1.0471698113207548
36606,/images/21f001d6-f568-4ea4-82da-fab54c77c419.png,149,63,240,162,91,99,red blood cell,9009,1.0879120879120878,0.9191919191919192
60910,/images/11b72c7b-5c52-44b7-adb7-21eacc25e441.png,323,1335,429,1424,106,89,red blood cell,9434,0.839622641509434,1.1910112359550562
13139,/images/711f6b3f-cd63-46d1-834a-bc8e9aa9b43e.png,731,1052,827,1165,96,113,red blood cell,10848,1.1770833333333333,0.8495575221238938
64967,/images/dec61ae1-5037-4c3a-8952-15371becca7d.png,982,1407,1085,1501,103,94,red blood cell,9682,0.912621359223301,1.0957446808510638
16651,/images/bc377041-e098-45c4-9651-2b1ea90d1d7e.png,162,597,288,723,126,126,red blood cell,15876,1.0,1.0
76280,/images/1574565f-f45b-4160-947e-25ce1a81aaca.png,1013,551,1119,662,106,111,red blood cell,11766,1.0471698113207548,0.954954954954955
53460,/images/766d5547-8dd2-4c8d-b78e-3007f83932e8.png,653,911,732,995,79,84,red blood cell,6636,1.0632911392405062,0.9404761904761905
9353,/images/261562a8-ffd8-4e0e-919b-22e267000b74.png,270,583,377,684,107,101,red blood cell,10807,0.9439252336448598,1.0594059405940595
51238,/images/216f9d43-6869-4ba1-9106-4f5ea6aac223.png,391,1008,512,1121,121,113,red blood cell,13673,0.9338842975206612,1.0707964601769913
25269,/images/587e5464-d70b-4279-8562-010279f6efbd.png,517,126,616,248,99,122,red blood cell,12078,1.2323232323232323,0.8114754098360656
74387,/images/06a3effb-996c-4767-afd2-6aa3b697cb4e.png,43,821,138,925,95,104,red blood cell,9880,1.0947368421052632,0.9134615384615384
55293,/images/4fb83278-adc5-4424-9f45-b6d0db2955b6.png,395,259,515,371,120,112,red blood cell,13440,0.9333333333333333,1.0714285714285714
6705,/images/95fea6d8-413f-421e-b331-5d51c31df150.png,729,490,852,610,123,120,red blood cell,14760,0.975609756097561,1.025
71762,/images/093a831a-bf71-4333-bc06-942ae70cb164.png,71,782,181,882,110,100,red blood cell,11000,0.9090909090909091,1.1
26794,/images/2518f6e4-29cc-4ae4-a914-b215a4c56099.png,586,1040,681,1143,95,103,red blood cell,9785,1.0842105263157895,0.9223300970873787
39162,/images/2aeb7b85-7df9-4a63-8d37-2eecaaa190e7.png,381,1135,519,1257,138,122,red blood cell,16836,0.8840579710144928,1.1311475409836065
64852,/images/a74b6d6a-7e04-40ac-9292-d62f13f7ded3.png,82,1239,159,1333,77,94,red blood cell,7238,1.2207792207792207,0.8191489361702128
20574,/images/0f2a6cda-afec-437b-8803-8d3176b072c1.png,56,1125,171,1235,115,110,red blood cell,12650,0.9565217391304348,1.0454545454545454
76098,/images/16244280-6c74-47d3-b544-9fd6831a6bf9.png,814,1164,921,1270,107,106,red blood cell,11342,0.9906542056074766,1.009433962264151
63922,/images/5e974892-0ebe-4037-8427-ea8616d6d3b8.png,16,587,117,693,101,106,red blood cell,10706,1.0495049504950495,0.9528301886792453
67349,/images/49c4dbd3-6269-4d4c-9648-a2146c57bab1.png,564,1153,664,1267,100,114,red blood cell,11400,1.14,0.8771929824561403
19640,/images/a3ada657-de00-44db-b1e2-54ba17e39983.png,340,1257,475,1382,135,125,red blood cell,16875,0.9259259259259259,1.08
23988,/images/3d8fb5bf-3315-48fb-8ab1-802eafd550bc.png,191,16,314,155,123,139,red blood cell,17097,1.1300813008130082,0.8848920863309353
28580,/images/dbdfad64-110c-421f-a1c7-f68fd9e82d67.png,972,1324,1094,1474,122,150,red blood cell,18300,1.2295081967213115,0.8133333333333334
26728,/images/2518f6e4-29cc-4ae4-a914-b215a4c56099.png,6,477,116,574,110,97,red blood cell,10670,0.8818181818181818,1.134020618556701
60069,/images/e63e1607-f344-43d6-a0d8-e10cf2e5054a.png,119,350,219,447,100,97,red blood cell,9700,0.97,1.0309278350515463
77872,/images/464055b6-3351-4636-a919-8be9840fb850.png,470,473,593,580,123,107,red blood cell,13161,0.8699186991869918,1.1495327102803738
10658,/images/20d4f65e-6c63-433a-935c-d568d577967b.png,48,910,149,1013,101,103,red blood cell,10403,1.0198019801980198,0.9805825242718447
59427,/images/a7c3c52f-3b40-4c92-a212-df9462cf25d8.png,1050,153,1151,258,101,105,red blood cell,10605,1.0396039603960396,0.9619047619047619
57974,/images/7942691b-6376-4c75-ae8a-ddf65454dcb2.png,245,961,373,1087,128,126,red blood cell,16128,0.984375,1.0158730158730158
26341,/images/580210c2-a8ed-4720-b71c-a77945968abc.png,462,328,582,456,120,128,red blood cell,15360,1.0666666666666667,0.9375
63860,/images/5e974892-0ebe-4037-8427-ea8616d6d3b8.png,28,371,121,466,93,95,red blood cell,8835,1.021505376344086,0.9789473684210527
57826,/images/c9ad92d4-b408-4506-916e-def47b2e6ed0.png,891,1249,991,1360,100,111,red blood cell,11100,1.11,0.9009009009009009
23092,/images/be5bb7d0-7c3f-4bb9-8bb4-f8bc8d875943.png,38,1096,145,1190,107,94,red blood cell,10058,0.8785046728971962,1.1382978723404256
37553,/images/205306da-0ed8-475a-ace6-f2f81d4be88a.png,882,687,974,775,92,88,red blood cell,8096,0.9565217391304348,1.0454545454545454
64247,/images/83d4e1fe-da84-4175-a9e2-8efc18782dcf.png,610,993,709,1092,99,99,red blood cell,9801,1.0,1.0
9811,/images/3859deaf-6ae1-49a3-9051-898d0f0d7de6.png,535,554,645,644,110,90,red blood cell,9900,0.8181818181818182,1.2222222222222223
25077,/images/b02f6804-1697-4a5e-9be7-61931903ab55.png,394,1414,500,1544,106,130,red blood cell,13780,1.2264150943396226,0.8153846153846154
51980,/images/4f62b14e-c6f4-4155-8f50-881558f83fae.png,1051,686,1127,769,76,83,red blood cell,6308,1.0921052631578947,0.9156626506024096
49432,/images/f2574be3-81c6-4fc3-8a40-0230d1264f52.png,1056,1459,1164,1579,108,120,red blood cell,12960,1.1111111111111112,0.9
30556,/images/7d9c1422-6332-44e9-b134-3ac94f07b0f0.png,1064,1229,1177,1342,113,113,red blood cell,12769,1.0,1.0
24707,/images/78a5d1c3-44dd-44bc-ad5b-5e25bdcc4fae.png,203,448,323,576,120,128,red blood cell,15360,1.0666666666666667,0.9375
44796,/images/6795acae-e84d-4e97-b9a1-b4f4f0a72cfd.png,116,834,213,934,97,100,red blood cell,9700,1.0309278350515463,0.97
54336,/images/19370afd-f897-47d8-bfae-c0d257bbf795.png,901,225,995,329,94,104,red blood cell,9776,1.1063829787234043,0.9038461538461539
26388,/images/ef1419e0-3a3a-458a-b3b2-7efddac50404.png,30,755,163,871,133,116,red blood cell,15428,0.8721804511278195,1.146551724137931
71781,/images/093a831a-bf71-4333-bc06-942ae70cb164.png,811,1417,919,1527,108,110,red blood cell,11880,1.0185185185185186,0.9818181818181818
51254,/images/216f9d43-6869-4ba1-9106-4f5ea6aac223.png,880,1375,996,1491,116,116,red blood cell,13456,1.0,1.0
70163,/images/b338766f-19b9-4874-bcc5-ae22b3c533e6.png,444,1282,547,1379,103,97,red blood cell,9991,0.941747572815534,1.0618556701030928
42273,/images/ca734448-0d52-42fa-b41c-17b2939e58ae.png,375,646,488,746,113,100,red blood cell,11300,0.8849557522123894,1.13
67915,/images/41ebf9a1-24dc-454e-8bf8-508218f5ee57.png,232,552,322,654,90,102,red blood cell,9180,1.1333333333333333,0.8823529411764706
74787,/images/91e93160-eb8d-4de0-b6bc-b98ec33d1663.png,999,1328,1106,1432,107,104,red blood cell,11128,0.9719626168224299,1.0288461538461537
37904,/images/56a57a8d-c9b9-432a-a3b0-32a09355806c.png,387,311,487,402,100,91,red blood cell,9100,0.91,1.098901098901099
67829,/images/04de3a31-fc09-40be-9c2c-9830c57f809d.png,203,999,329,1112,126,113,red blood cell,14238,0.8968253968253969,1.1150442477876106
15708,/images/3892b776-f49a-4368-b0fa-7e855e76ccec.png,877,414,985,519,108,105,red blood cell,11340,0.9722222222222222,1.0285714285714285
528,/images/67acd5bc-4658-4c6e-a9b9-cd8ea3a03418.png,804,33,928,146,124,113,red blood cell,14012,0.9112903225806451,1.0973451327433628
24640,/images/30948737-0d0d-4b68-b9ab-50577e0fe026.png,392,1012,532,1124,140,112,red blood cell,15680,0.8,1.25
61382,/images/e16c0dab-780d-4035-872e-1bb91e49f9d2.png,1048,134,1152,239,104,105,red blood cell,10920,1.0096153846153846,0.9904761904761905
47964,/images/eba73bff-fbe1-436d-9a5f-0a61331a0ea2.png,566,402,701,528,135,126,red blood cell,17010,0.9333333333333333,1.0714285714285714
33553,/images/255d5f0c-87fc-4337-bb51-07c440df4f1b.png,26,652,149,787,123,135,red blood cell,16605,1.0975609756097562,0.9111111111111111
39327,/images/17ef5841-bd19-4610-ba47-7d321231847b.png,7,38,127,162,120,124,red blood cell,14880,1.0333333333333334,0.967741935483871
75842,/images/c4c7ed75-dbdf-4bb6-b6ba-718903cf7264.png,688,169,798,286,110,117,red blood cell,12870,1.0636363636363637,0.9401709401709402
32561,/images/3f26fbbc-deb1-494f-b71c-c7cb3d4819fb.png,447,876,584,1013,137,137,red blood cell,18769,1.0,1.0
17211,/images/471f75c6-bd5d-4c20-bcc1-258e836f4d69.png,684,1335,789,1434,105,99,red blood cell,10395,0.9428571428571428,1.0606060606060606
65020,/images/ff3b9d4d-373c-48ef-a75a-d23e2c2ade87.png,685,1014,772,1110,87,96,red blood cell,8352,1.103448275862069,0.90625
71854,/images/093a831a-bf71-4333-bc06-942ae70cb164.png,350,452,444,551,94,99,red blood cell,9306,1.053191489361702,0.9494949494949495
7772,/images/e726dac6-f962-449c-acff-4dd56847b685.png,53,592,130,682,77,90,red blood cell,6930,1.1688311688311688,0.8555555555555555
23124,/images/be5bb7d0-7c3f-4bb9-8bb4-f8bc8d875943.png,304,931,410,1042,106,111,red blood cell,11766,1.0471698113207548,0.954954954954955
14284,/images/6382976c-ee87-4916-b798-4ef1373b2df0.png,1033,666,1141,763,108,97,red blood cell,10476,0.8981481481481481,1.1134020618556701
71963,/images/61575482-91e1-4db9-83c7-687b7ddbbfc4.png,150,465,233,542,83,77,red blood cell,6391,0.927710843373494,1.077922077922078
79250,/images/05ac7b2a-6a77-4464-926b-8570f7c01693.png,816,880,918,977,102,97,red blood cell,9894,0.9509803921568627,1.0515463917525774
57448,/images/00d04a90-80e5-4bce-9511-1b64eabb7a47.png,383,1227,470,1327,87,100,red blood cell,8700,1.1494252873563218,0.87
59992,/images/49288109-80e9-4ec8-96d1-26a0166b8883.png,824,711,931,821,107,110,red blood cell,11770,1.02803738317757,0.9727272727272728
77406,/images/c7ec51d5-9f45-4209-8357-39e9a984a733.png,337,1468,434,1563,97,95,red blood cell,9215,0.979381443298969,1.0210526315789474
30764,/images/8e0dfc1f-e3eb-4a3f-a1c4-249bdfbfaa27.png,979,994,1085,1116,106,122,red blood cell,12932,1.150943396226415,0.8688524590163934
34527,/images/fa1f9f89-cecb-4972-842c-d14c632f89a9.png,630,609,750,729,120,120,red blood cell,14400,1.0,1.0
2159,/images/e94a811d-3145-4313-ba42-2d5ed283179f.png,998,372,1095,461,97,89,red blood cell,8633,0.9175257731958762,1.0898876404494382
218,/images/2559636b-f01a-4414-93da-210c3b12d153.png,38,992,154,1113,116,121,red blood cell,14036,1.043103448275862,0.9586776859504132
32899,/images/e40000b4-1b26-42ce-909d-4715e04f0a6e.png,456,885,580,1012,124,127,red blood cell,15748,1.0241935483870968,0.9763779527559056
75917,/images/3006096f-ceeb-42be-b69e-785179d7438b.png,501,785,602,882,101,97,red blood cell,9797,0.9603960396039604,1.041237113402062
44579,/images/6388e241-09a2-4fbe-a712-07d8fe714c51.png,599,384,708,510,109,126,red blood cell,13734,1.1559633027522935,0.8650793650793651
51461,/images/baa87bf8-786c-444c-81e8-9fa0a41d8149.png,585,1106,684,1203,99,97,red blood cell,9603,0.9797979797979798,1.0206185567010309
50921,/images/ef8fcfa4-8466-4186-8c69-f5f4904eb489.png,104,558,201,661,97,103,red blood cell,9991,1.0618556701030928,0.941747572815534
35056,/images/67582df6-bf13-4c83-a531-1214692b70de.png,553,515,663,625,110,110,red blood cell,12100,1.0,1.0
75406,/images/468c261d-f5d8-423f-883e-48af2bbbc5d1.png,601,1092,697,1170,96,78,red blood cell,7488,0.8125,1.2307692307692308
26603,/images/5893e081-04f2-4e33-9851-bed5f0e4d333.png,159,122,239,199,80,77,red blood cell,6160,0.9625,1.0389610389610389
78986,/images/6144887d-a1c1-46db-91a1-f7ff5bf8c8a5.png,50,796,137,888,87,92,red blood cell,8004,1.0574712643678161,0.9456521739130435
51842,/images/f07174a5-f799-4286-ac43-5b0f5c5777ac.png,52,1482,133,1568,81,86,red blood cell,6966,1.0617283950617284,0.9418604651162791
30900,/images/fbc1f360-4382-48bb-a32e-3f5f2f9dbe57.png,941,678,1056,780,115,102,red blood cell,11730,0.8869565217391304,1.1274509803921569
55022,/images/1f8f08ea-b5b3-4f68-94d4-3cc071b7dce8.png,823,1217,925,1328,102,111,red blood cell,11322,1.088235294117647,0.918918918918919
7884,/images/98c25ffe-c329-420a-bc22-b082f565eac9.png,322,1338,469,1457,147,119,red blood cell,17493,0.8095238095238095,1.2352941176470589
28080,/images/f1f9df6d-c4cb-4b42-9ca2-8fb47b1b0e91.png,598,505,725,629,127,124,red blood cell,15748,0.9763779527559056,1.0241935483870968
78814,/images/19979a60-df80-4111-bf69-81a7e9c4dd0b.png,334,127,444,236,110,109,red blood cell,11990,0.990909090909091,1.0091743119266054
45319,/images/e4eea7ea-8989-46a9-9c98-25a178146b28.png,43,821,165,927,122,106,red blood cell,12932,0.8688524590163934,1.150943396226415
58922,/images/8a7deb24-d2b4-4acf-86c4-3aadd39157fa.png,27,347,129,431,102,84,red blood cell,8568,0.8235294117647058,1.2142857142857142
35902,/images/33068c1a-48f7-470b-8e49-e2f0888042e9.png,67,485,193,611,126,126,red blood cell,15876,1.0,1.0
63978,/images/5e974892-0ebe-4037-8427-ea8616d6d3b8.png,382,1262,480,1353,98,91,red blood cell,8918,0.9285714285714286,1.0769230769230769
75346,/images/9ec1dcec-87c2-4aca-8e6b-0db3cd05509c.png,97,116,185,204,88,88,red blood cell,7744,1.0,1.0
28522,/images/dbdfad64-110c-421f-a1c7-f68fd9e82d67.png,304,60,400,174,96,114,red blood cell,10944,1.1875,0.8421052631578947
32812,/images/67f5ca94-d84e-490e-bf0d-4ffba7bdbe30.png,868,838,979,960,111,122,red blood cell,13542,1.0990990990990992,0.9098360655737705
24297,/images/4d8a4ce8-0f9c-4f21-8844-4cf0e5514bbf.png,705,450,804,552,99,102,red blood cell,10098,1.0303030303030303,0.9705882352941176
18146,/images/947348fe-4c70-468e-8009-3c14daeca69b.png,569,1099,676,1201,107,102,red blood cell,10914,0.9532710280373832,1.0490196078431373
61673,/images/a3c0a876-be12-4ede-8aed-18b32a64401b.png,803,1137,898,1254,95,117,red blood cell,11115,1.231578947368421,0.811965811965812
15773,/images/64113b22-03b1-4ab8-89ab-b2f32154fbbd.png,737,238,843,329,106,91,red blood cell,9646,0.8584905660377359,1.164835164835165
23325,/images/e5731221-814c-4894-a44e-e46b71460fa4.png,628,208,729,325,101,117,red blood cell,11817,1.1584158415841583,0.8632478632478633
68197,/images/ff1b23d0-3cef-459b-b81f-39bfcdb6526f.png,431,84,531,184,100,100,red blood cell,10000,1.0,1.0
13532,/images/370277f8-436b-4103-8210-b4feb5ab95ea.png,220,229,324,318,104,89,red blood cell,9256,0.8557692307692307,1.1685393258426966
7152,/images/56551792-4aa1-4301-9f8f-8bfebcd20050.png,10,986,120,1108,110,122,red blood cell,13420,1.1090909090909091,0.9016393442622951
61185,/images/80da32ce-8c22-470e-9f35-558c5f7a5df9.png,859,0,965,111,106,111,red blood cell,11766,1.0471698113207548,0.954954954954955
56166,/images/137d540f-d71e-47e8-bd9b-6cd0a6433c33.png,104,1365,199,1465,95,100,red blood cell,9500,1.0526315789473684,0.95
7770,/images/e726dac6-f962-449c-acff-4dd56847b685.png,141,1272,242,1376,101,104,red blood cell,10504,1.0297029702970297,0.9711538461538461
76862,/images/2165fe38-b474-467d-be11-d1d728085efd.png,32,2,130,106,98,104,red blood cell,10192,1.0612244897959184,0.9423076923076923
68648,/images/31653d0f-c4e6-4e12-8005-518c2de34687.png,634,1170,723,1244,89,74,red blood cell,6586,0.8314606741573034,1.2027027027027026
70418,/images/4876c9d0-b386-48fb-84e8-91bf87529161.png,809,916,918,1022,109,106,red blood cell,11554,0.9724770642201835,1.028301886792453
21416,/images/b701b5c5-b922-4315-b12a-aac4ec65ee8b.png,736,888,842,994,106,106,red blood cell,11236,1.0,1.0
73141,/images/f39e2289-fedd-4d12-9e64-ffdafb89247e.png,869,832,955,935,86,103,red blood cell,8858,1.197674418604651,0.8349514563106796
22225,/images/3d4d7ba7-6c7c-4ddd-b282-31fb5d80edb5.png,1075,643,1192,760,117,117,red blood cell,13689,1.0,1.0
44365,/images/415409ac-97b3-4cd9-b203-11ef00662352.png,595,1001,707,1128,112,127,red blood cell,14224,1.1339285714285714,0.8818897637795275
43416,/images/367663b2-5d09-4020-ab0a-c2200e7a1c8c.png,588,1424,690,1528,102,104,red blood cell,10608,1.0196078431372548,0.9807692307692307
2537,/images/a23f5539-bfe6-4885-9a0e-dba972475ea9.png,233,1279,333,1387,100,108,red blood cell,10800,1.08,0.9259259259259259
6728,/images/672e4ecf-a56b-462e-b83b-76f4efaa6634.png,627,89,743,211,116,122,red blood cell,14152,1.0517241379310345,0.9508196721311475
7848,/images/1493d140-c9d5-4c3a-9caf-3eafb290a49b.png,636,1379,774,1498,138,119,red blood cell,16422,0.8623188405797102,1.1596638655462186
77315,/images/07a80340-f65e-4f58-9317-94bb6ebd5a28.png,5,931,91,1018,86,87,red blood cell,7482,1.0116279069767442,0.9885057471264368
54735,/images/10891eed-b0f2-4dd0-90cb-da185f6761b2.png,39,454,144,563,105,109,red blood cell,11445,1.0380952380952382,0.963302752293578
19057,/images/6e39fb0a-aa41-4b16-b783-7589e97bf289.png,218,1041,329,1163,111,122,red blood cell,13542,1.0990990990990992,0.9098360655737705
18869,/images/d1b48634-9ad5-46e8-b816-42d1d97c93cd.png,711,203,814,296,103,93,red blood cell,9579,0.9029126213592233,1.10752688172043
69542,/images/664c570b-4822-413c-9724-11b1d91fac44.png,316,1507,409,1600,93,93,red blood cell,8649,1.0,1.0
29700,/images/f25a2ac8-cb6e-4e05-a0cd-cc00ac47718a.png,983,767,1088,876,105,109,red blood cell,11445,1.0380952380952382,0.963302752293578
68255,/images/a6391703-0820-4913-a7cd-e843ff0d84ba.png,676,82,799,197,123,115,red blood cell,14145,0.9349593495934959,1.0695652173913044
40182,/images/ef1a9020-5e45-450d-a237-165114308592.png,1021,1027,1145,1154,124,127,red blood cell,15748,1.0241935483870968,0.9763779527559056
25184,/images/90171428-f208-428a-b40e-f57ee3bea457.png,255,411,359,533,104,122,red blood cell,12688,1.1730769230769231,0.8524590163934426
2344,/images/fe851c88-692d-4199-87e0-d19d9c4eb591.png,1067,691,1162,788,95,97,red blood cell,9215,1.0210526315789474,0.979381443298969
12312,/images/3b55c42f-ad59-422f-ba99-4f4f4ca9cb2e.png,1070,391,1156,473,86,82,red blood cell,7052,0.9534883720930233,1.048780487804878
52567,/images/0546d843-d778-4aca-b8b5-bfe23d7c87da.png,245,162,358,264,113,102,red blood cell,11526,0.9026548672566371,1.107843137254902
65740,/images/daea4860-a296-4f6d-acef-996ab0882676.png,623,556,735,667,112,111,red blood cell,12432,0.9910714285714286,1.009009009009009
24237,/images/bb3ae957-0f6d-4615-bfe5-24fbca50b459.png,133,106,244,211,111,105,red blood cell,11655,0.9459459459459459,1.0571428571428572
72548,/images/01b99da8-b66b-464b-a7ee-1cadab8db18b.png,1076,502,1193,614,117,112,red blood cell,13104,0.9572649572649573,1.0446428571428572
384,/images/7c66d2fd-68ee-4628-b860-9d7ad25b2a80.png,866,679,969,787,103,108,red blood cell,11124,1.0485436893203883,0.9537037037037037
36397,/images/4a0a05e1-11ad-4bfc-bfa3-adf3b9bd0b56.png,116,1415,228,1533,112,118,red blood cell,13216,1.0535714285714286,0.9491525423728814
168,/images/13099edb-35d9-438f-b093-2cf2ebf9d255.png,378,1100,486,1227,108,127,red blood cell,13716,1.1759259259259258,0.8503937007874016
44308,/images/4257342d-6d77-4671-a84b-1f0c36ccb367.png,215,765,337,878,122,113,red blood cell,13786,0.9262295081967213,1.079646017699115
41188,/images/eed298b3-35f2-4127-88ad-0c4a9062207b.png,1055,624,1154,713,99,89,red blood cell,8811,0.898989898989899,1.1123595505617978
40334,/images/eb86033f-4f1c-4e8c-ae84-e8e4c7e08626.png,567,187,678,308,111,121,red blood cell,13431,1.09009009009009,0.9173553719008265
72723,/images/6ab870ba-b24b-49a9-9570-8eafe63aa74e.png,793,243,880,333,87,90,red blood cell,7830,1.0344827586206897,0.9666666666666667
50283,/images/3d32a988-449d-4d58-b71f-abbfdc3f2fbc.png,326,662,438,764,112,102,red blood cell,11424,0.9107142857142857,1.0980392156862746
25502,/images/f6ab936d-924b-4038-aa47-71b07c26b4e2.png,898,658,1015,766,117,108,red blood cell,12636,0.9230769230769231,1.0833333333333333
58377,/images/50f2f514-6c8e-4c79-b3b3-0be56dd0b78b.png,0,155,105,267,105,112,red blood cell,11760,1.0666666666666667,0.9375
33403,/images/f632981c-1330-4078-8a12-691beb2dab02.png,180,759,297,868,117,109,red blood cell,12753,0.9316239316239316,1.073394495412844
3792,/images/3e764461-22ee-44d3-925d-cd658ff7d154.png,501,684,610,796,109,112,red blood cell,12208,1.0275229357798166,0.9732142857142857
27561,/images/715761a2-745e-4743-9849-956a034ad3c4.png,175,697,273,795,98,98,red blood cell,9604,1.0,1.0
73406,/images/c890ee00-daa5-4b20-9cd5-930748ecc4e0.png,1034,1518,1120,1600,86,82,red blood cell,7052,0.9534883720930233,1.048780487804878
54705,/images/6473ddb6-ad56-48a2-81e8-c7cb45f06825.png,993,1228,1086,1325,93,97,red blood cell,9021,1.043010752688172,0.9587628865979382
78204,/images/2bed2796-75a9-4d93-bb2d-e3ccbe1a5cbe.png,416,508,528,624,112,116,red blood cell,12992,1.0357142857142858,0.9655172413793104
51607,/images/d0347b49-8f98-4632-a384-1a4f57ac6374.png,340,1097,430,1209,90,112,red blood cell,10080,1.2444444444444445,0.8035714285714286
32916,/images/e40000b4-1b26-42ce-909d-4715e04f0a6e.png,327,98,441,209,114,111,red blood cell,12654,0.9736842105263158,1.027027027027027
2901,/images/a1c140f9-75d7-42a3-b767-4c01a118892b.png,274,729,395,868,121,139,red blood cell,16819,1.1487603305785123,0.8705035971223022
59263,/images/03c8da48-04b9-4520-b674-44a0ecd35688.png,317,1477,420,1576,103,99,red blood cell,10197,0.9611650485436893,1.0404040404040404
22142,/images/ca677c3c-083f-4d54-9dec-39f79f6a17d8.png,749,988,860,1106,111,118,red blood cell,13098,1.063063063063063,0.940677966101695
18948,/images/e9e78ff8-831b-46e9-9785-3eee9acbfcd8.png,46,345,137,441,91,96,red blood cell,8736,1.054945054945055,0.9479166666666666
34589,/images/a0eedcb9-b85c-4612-b945-7e8227f53c35.png,1002,1136,1102,1247,100,111,red blood cell,11100,1.11,0.9009009009009009
13665,/images/1e86933d-6a5a-4a3c-a0f2-ca22afd767b3.png,98,1326,188,1423,90,97,red blood cell,8730,1.0777777777777777,0.9278350515463918
79199,/images/eb0173a3-7e5e-4f53-8124-03d9d6317844.png,14,414,132,527,118,113,red blood cell,13334,0.9576271186440678,1.0442477876106195
46114,/images/72088c26-d2dd-4906-b791-b8947fc7fbe4.png,617,185,716,272,99,87,red blood cell,8613,0.8787878787878788,1.1379310344827587
36080,/images/ca9626bc-21a4-46f4-ba94-e7ee7a4cf735.png,239,469,354,597,115,128,red blood cell,14720,1.1130434782608696,0.8984375
37463,/images/c6530038-6d4e-49e1-8427-d1d3acc9fa21.png,899,927,1008,1047,109,120,red blood cell,13080,1.1009174311926606,0.9083333333333333
35998,/images/5836500a-221e-40ca-a8be-caaa37f7d300.png,293,543,395,635,102,92,red blood cell,9384,0.9019607843137255,1.108695652173913
28165,/images/cd2774a0-dab2-4d68-aae9-7568b9f3d2a6.png,856,319,975,440,119,121,red blood cell,14399,1.0168067226890756,0.9834710743801653
32582,/images/3f26fbbc-deb1-494f-b71c-c7cb3d4819fb.png,156,306,286,429,130,123,red blood cell,15990,0.9461538461538461,1.056910569105691
76010,/images/4c7d2382-a962-4237-a053-955eea3decd8.png,68,1022,162,1115,94,93,red blood cell,8742,0.9893617021276596,1.010752688172043
3063,/images/5a386082-397f-4524-a6f9-c2b8efe5014d.png,590,266,717,371,127,105,red blood cell,13335,0.8267716535433071,1.2095238095238094
67660,/images/2b128a1a-95ed-408b-b9f8-8795cc814d80.png,1037,962,1132,1059,95,97,red blood cell,9215,1.0210526315789474,0.979381443298969
70165,/images/b338766f-19b9-4874-bcc5-ae22b3c533e6.png,972,899,1075,1004,103,105,red blood cell,10815,1.0194174757281553,0.9809523809523809
65951,/images/25c6cfb1-01d0-4864-87f9-02b7593683c7.png,202,523,290,611,88,88,red blood cell,7744,1.0,1.0
29430,/images/b4e5e08d-6427-46f3-aca8-a4df165a151d.png,632,693,748,791,116,98,red blood cell,11368,0.8448275862068966,1.183673469387755
77635,/images/07d15855-eb9b-46a9-b894-7cfe4d097826.png,826,562,928,674,102,112,red blood cell,11424,1.0980392156862746,0.9107142857142857
5416,/images/75579b27-8191-4044-859b-268be969c42b.png,692,1088,821,1204,129,116,red blood cell,14964,0.8992248062015504,1.1120689655172413
8945,/images/04628a94-b674-469b-aff6-b476b70df87d.png,1001,251,1113,374,112,123,red blood cell,13776,1.0982142857142858,0.9105691056910569
19890,/images/b318889c-3c60-477c-b8f6-d18cb01a59df.png,585,1378,669,1466,84,88,red blood cell,7392,1.0476190476190477,0.9545454545454546
47348,/images/477e541c-0519-4542-9b13-8ee7922644d3.png,77,1363,178,1472,101,109,red blood cell,11009,1.0792079207920793,0.926605504587156
18125,/images/947348fe-4c70-468e-8009-3c14daeca69b.png,465,1253,563,1362,98,109,red blood cell,10682,1.1122448979591837,0.8990825688073395
71220,/images/86495bbf-687b-429c-b9d3-6c2681ade7e2.png,69,220,181,328,112,108,red blood cell,12096,0.9642857142857143,1.037037037037037
60034,/images/49288109-80e9-4ec8-96d1-26a0166b8883.png,344,201,430,297,86,96,red blood cell,8256,1.1162790697674418,0.8958333333333334
14043,/images/eaf4b781-b3aa-41ce-8c5e-287979b4e15a.png,139,1196,244,1289,105,93,red blood cell,9765,0.8857142857142857,1.1290322580645162
4834,/images/c6ab535c-30e5-4b6b-8273-1ec8d78cdd13.png,995,1304,1108,1419,113,115,red blood cell,12995,1.0176991150442478,0.9826086956521739
77257,/images/07a80340-f65e-4f58-9317-94bb6ebd5a28.png,565,363,645,461,80,98,red blood cell,7840,1.225,0.8163265306122449
36901,/images/b2e34f5f-904e-4473-9dc7-c6bc1ce12640.png,295,774,401,868,106,94,red blood cell,9964,0.8867924528301887,1.127659574468085
6739,/images/672e4ecf-a56b-462e-b83b-76f4efaa6634.png,82,61,184,173,102,112,red blood cell,11424,1.0980392156862746,0.9107142857142857
7351,/images/89f10192-d3dd-4996-a571-4c851dbdc983.png,263,1378,368,1481,105,103,red blood cell,10815,0.9809523809523809,1.0194174757281553
25682,/images/c118ff18-f9f2-4617-bddb-dc4091fb8f5f.png,192,989,306,1107,114,118,red blood cell,13452,1.0350877192982457,0.9661016949152542
22358,/images/78c35732-7e31-4153-842e-55ab1cd656f6.png,1000,346,1127,470,127,124,red blood cell,15748,0.9763779527559056,1.0241935483870968
9152,/images/d3ed519e-2152-4e30-838d-a3ea23be512f.png,537,1059,624,1159,87,100,red blood cell,8700,1.1494252873563218,0.87
34964,/images/2b369d75-9c55-43e0-b352-d981aea544e3.png,846,138,972,253,126,115,red blood cell,14490,0.9126984126984127,1.0956521739130434
2739,/images/a89cace5-c818-4f23-a432-052b3433b81e.png,436,723,527,812,91,89,red blood cell,8099,0.978021978021978,1.0224719101123596
79910,/images/0b923ab7-ebff-4079-a4bb-af7da89f374e.png,1048,1367,1150,1475,102,108,red blood cell,11016,1.0588235294117647,0.9444444444444444
13441,/images/370277f8-436b-4103-8210-b4feb5ab95ea.png,472,258,573,350,101,92,red blood cell,9292,0.9108910891089109,1.0978260869565217
38307,/images/674b0fd3-f247-4b7f-97f7-3e6c57c9ba9e.png,313,1117,407,1220,94,103,red blood cell,9682,1.0957446808510638,0.912621359223301
52527,/images/d1144956-5a0c-4bd2-b67d-8498c82d6a12.png,782,463,881,571,99,108,red blood cell,10692,1.0909090909090908,0.9166666666666666
64879,/images/a74b6d6a-7e04-40ac-9292-d62f13f7ded3.png,1110,1480,1196,1566,86,86,red blood cell,7396,1.0,1.0
72164,/images/005e60b6-77b8-458c-b57c-bfe0c7e7df78.png,1087,511,1191,619,104,108,red blood cell,11232,1.0384615384615385,0.9629629629629629
35749,/images/4063945d-03fc-4ce3-a04c-17435dce8f91.png,655,676,776,792,121,116,red blood cell,14036,0.9586776859504132,1.043103448275862
4202,/images/ac3358f1-ef9a-4ccc-b66c-da5e47e352e0.png,464,628,564,734,100,106,red blood cell,10600,1.06,0.9433962264150944
70252,/images/a5c3b3f8-7ceb-4573-a400-a76b9479af46.png,966,818,1073,926,107,108,red blood cell,11556,1.0093457943925233,0.9907407407407407
53255,/images/d8f7e159-b7e3-49e4-86e8-aed8c5fbcd97.png,1086,521,1199,627,113,106,red blood cell,11978,0.9380530973451328,1.0660377358490567
12339,/images/3b55c42f-ad59-422f-ba99-4f4f4ca9cb2e.png,137,1470,235,1579,98,109,red blood cell,10682,1.1122448979591837,0.8990825688073395
61340,/images/e16c0dab-780d-4035-872e-1bb91e49f9d2.png,780,1317,885,1415,105,98,red blood cell,10290,0.9333333333333333,1.0714285714285714
15701,/images/3892b776-f49a-4368-b0fa-7e855e76ccec.png,584,652,704,786,120,134,red blood cell,16080,1.1166666666666667,0.8955223880597015
65701,/images/c54fcef1-0c51-4426-9a93-15ec5f2bf58a.png,553,80,668,194,115,114,red blood cell,13110,0.991304347826087,1.0087719298245614
79221,/images/eb0173a3-7e5e-4f53-8124-03d9d6317844.png,714,765,819,894,105,129,red blood cell,13545,1.2285714285714286,0.813953488372093
8361,/images/9a1cd456-310c-47b6-a1f8-0fbd8e33d1fd.png,516,1087,638,1216,122,129,red blood cell,15738,1.0573770491803278,0.9457364341085271
62346,/images/e0ff3476-226f-4125-b182-8e524d5503dd.png,425,448,528,547,103,99,red blood cell,10197,0.9611650485436893,1.0404040404040404
12362,/images/3b55c42f-ad59-422f-ba99-4f4f4ca9cb2e.png,75,201,180,295,105,94,red blood cell,9870,0.8952380952380953,1.1170212765957446
26974,/images/1f337b61-1b0d-4539-91f9-73d4a0798a4a.png,454,733,571,836,117,103,red blood cell,12051,0.8803418803418803,1.1359223300970873
56730,/images/b3606d0e-6fe5-478a-bb4b-64d7c4889d86.png,340,45,443,152,103,107,red blood cell,11021,1.0388349514563107,0.9626168224299065
34532,/images/fa1f9f89-cecb-4972-842c-d14c632f89a9.png,1028,619,1134,737,106,118,red blood cell,12508,1.1132075471698113,0.8983050847457628
72262,/images/ee57e743-a876-4f69-9fe5-bf5d01b44689.png,232,597,356,722,124,125,red blood cell,15500,1.0080645161290323,0.992
17344,/images/3d302619-473d-4c5b-af43-8833ff94233f.png,986,1493,1100,1598,114,105,red blood cell,11970,0.9210526315789473,1.0857142857142856
25995,/images/612bdd3c-da43-4321-a76b-c73c614928d1.png,208,1396,328,1517,120,121,red blood cell,14520,1.0083333333333333,0.9917355371900827
6862,/images/b21f6c6e-4b45-407a-b4c7-034a115f3ee4.png,86,5,186,119,100,114,red blood cell,11400,1.14,0.8771929824561403
49946,/images/05804cf0-f854-4099-97c2-df287f7c8a8c.png,426,1010,540,1139,114,129,red blood cell,14706,1.131578947368421,0.8837209302325582
6216,/images/effd6334-516f-4d48-9f3c-5272a99780fb.png,195,56,304,161,109,105,red blood cell,11445,0.963302752293578,1.0380952380952382
58159,/images/d615b706-8f50-4d96-8de5-6858897528d0.png,688,1168,791,1277,103,109,red blood cell,11227,1.058252427184466,0.944954128440367
13188,/images/711f6b3f-cd63-46d1-834a-bc8e9aa9b43e.png,179,707,272,816,93,109,red blood cell,10137,1.1720430107526882,0.8532110091743119
52030,/images/6c3f81d7-5670-46bd-9eaa-9b426413abb7.png,403,1129,517,1233,114,104,red blood cell,11856,0.9122807017543859,1.0961538461538463
58099,/images/a7c91b63-b97c-4f4b-8d34-7ad2b08d7a17.png,471,197,551,274,80,77,red blood cell,6160,0.9625,1.0389610389610389
39739,/images/56adbb1e-96a8-40a5-a5a2-243c97ea889b.png,170,235,276,364,106,129,red blood cell,13674,1.2169811320754718,0.8217054263565892
47396,/images/477e541c-0519-4542-9b13-8ee7922644d3.png,296,656,393,751,97,95,red blood cell,9215,0.979381443298969,1.0210526315789474
17532,/images/e80bad38-66d0-473e-85dd-92142dba37e6.png,823,630,956,743,133,113,red blood cell,15029,0.849624060150376,1.176991150442478
40529,/images/e3ade58d-086c-47fa-9120-76beacb45395.png,599,818,720,938,121,120,red blood cell,14520,0.9917355371900827,1.0083333333333333
20632,/images/0f2a6cda-afec-437b-8803-8d3176b072c1.png,389,502,506,612,117,110,red blood cell,12870,0.9401709401709402,1.0636363636363637
17582,/images/e80bad38-66d0-473e-85dd-92142dba37e6.png,1059,27,1181,156,122,129,red blood cell,15738,1.0573770491803278,0.9457364341085271
53793,/images/76b24246-8571-4e7b-8815-b185414a2c51.png,1065,493,1153,579,88,86,red blood cell,7568,0.9772727272727273,1.0232558139534884
59812,/images/acb16781-11ad-4327-874a-5c9c35dcb085.png,872,187,984,293,112,106,red blood cell,11872,0.9464285714285714,1.0566037735849056
67971,/images/bcaefb02-682a-41b9-acc7-e6cc010f5b30.png,443,1136,547,1238,104,102,red blood cell,10608,0.9807692307692307,1.0196078431372548
17322,/images/3d302619-473d-4c5b-af43-8833ff94233f.png,630,1199,729,1296,99,97,red blood cell,9603,0.9797979797979798,1.0206185567010309
40317,/images/eb86033f-4f1c-4e8c-ae84-e8e4c7e08626.png,94,1023,192,1140,98,117,red blood cell,11466,1.1938775510204083,0.8376068376068376
5936,/images/e0e6b676-c39c-4542-8adf-de257a8e92e2.png,784,1245,915,1358,131,113,red blood cell,14803,0.8625954198473282,1.1592920353982301
23342,/images/a7688988-2bcc-4458-83d3-5e482da5f87b.png,1046,1022,1150,1120,104,98,red blood cell,10192,0.9423076923076923,1.0612244897959184
6398,/images/1ecb0405-a6e9-4485-819e-2fbbf2b718aa.png,394,506,509,633,115,127,red blood cell,14605,1.1043478260869566,0.905511811023622
68154,/images/5dec94a3-e3ca-4a58-9702-88e5a83ef612.png,677,531,779,633,102,102,red blood cell,10404,1.0,1.0
72471,/images/a15e0fa8-2620-4f66-896e-175115c9dc3d.png,834,830,919,919,85,89,red blood cell,7565,1.0470588235294118,0.9550561797752809
79852,/images/a054a8e2-55f2-4508-97df-207f76b89be2.png,150,275,266,382,116,107,red blood cell,12412,0.9224137931034483,1.0841121495327102
31903,/images/f62d4fb6-df7c-446c-94a8-d5aede0b1e0c.png,107,147,229,256,122,109,red blood cell,13298,0.8934426229508197,1.1192660550458715
7214,/images/89f10192-d3dd-4996-a571-4c851dbdc983.png,1078,397,1185,510,107,113,red blood cell,12091,1.0560747663551402,0.9469026548672567
65666,/images/397f37bc-a3a4-4257-9430-c8fc5716f8b1.png,942,1388,1030,1479,88,91,red blood cell,8008,1.0340909090909092,0.967032967032967
2290,/images/fe851c88-692d-4199-87e0-d19d9c4eb591.png,569,667,665,775,96,108,red blood cell,10368,1.125,0.8888888888888888
8370,/images/9a1cd456-310c-47b6-a1f8-0fbd8e33d1fd.png,987,1414,1102,1544,115,130,red blood cell,14950,1.1304347826086956,0.8846153846153846
55919,/images/afd39466-aafa-4d81-9520-483727418723.png,1017,1046,1112,1135,95,89,red blood cell,8455,0.9368421052631579,1.0674157303370786
30182,/images/a1669b59-fe09-4fe6-ba9f-06bec6725502.png,517,442,647,552,130,110,red blood cell,14300,0.8461538461538461,1.1818181818181819
28859,/images/686ed568-d5f8-475e-81ad-edab9dd473a0.png,802,1337,900,1432,98,95,red blood cell,9310,0.9693877551020408,1.0315789473684212
45736,/images/584d62ed-4329-45dd-94ce-e929d8b2bb74.png,761,830,850,937,89,107,red blood cell,9523,1.202247191011236,0.8317757009345794
16301,/images/d5009906-bce1-4353-90b4-f4c79362f4cf.png,954,652,1073,777,119,125,red blood cell,14875,1.050420168067227,0.952
33673,/images/84ee2ea3-9edd-4672-a1b3-f09c607d833a.png,581,117,678,219,97,102,red blood cell,9894,1.0515463917525774,0.9509803921568627
49532,/images/9f33e0ea-065b-4703-9df9-15829b891860.png,174,1416,296,1519,122,103,red blood cell,12566,0.8442622950819673,1.1844660194174756
37877,/images/56a57a8d-c9b9-432a-a3b0-32a09355806c.png,433,1275,537,1388,104,113,red blood cell,11752,1.0865384615384615,0.9203539823008849
57948,/images/09bcedaa-e007-4692-a13f-ab02c3f872c4.png,912,1152,1010,1237,98,85,red blood cell,8330,0.8673469387755102,1.1529411764705881
21425,/images/b701b5c5-b922-4315-b12a-aac4ec65ee8b.png,138,1113,246,1228,108,115,red blood cell,12420,1.0648148148148149,0.9391304347826087
64858,/images/a74b6d6a-7e04-40ac-9292-d62f13f7ded3.png,1,355,92,458,91,103,red blood cell,9373,1.1318681318681318,0.883495145631068
27611,/images/715761a2-745e-4743-9849-956a034ad3c4.png,914,926,1007,1027,93,101,red blood cell,9393,1.086021505376344,0.9207920792079208
7639,/images/21cc498b-8cb2-42ed-8f80-bfa27b86ef11.png,48,1181,176,1303,128,122,red blood cell,15616,0.953125,1.0491803278688525
13342,/images/a7f1bbb1-6058-4642-bd66-cfb90dce762e.png,161,427,268,533,107,106,red blood cell,11342,0.9906542056074766,1.009433962264151
62903,/images/4b346035-b8c0-46ca-8fdb-a01b1421ee4a.png,990,361,1101,460,111,99,red blood cell,10989,0.8918918918918919,1.121212121212121
26337,/images/580210c2-a8ed-4720-b71c-a77945968abc.png,327,424,440,552,113,128,red blood cell,14464,1.1327433628318584,0.8828125
7353,/images/89f10192-d3dd-4996-a571-4c851dbdc983.png,55,976,167,1077,112,101,red blood cell,11312,0.9017857142857143,1.108910891089109
54572,/images/59dc7da9-35d1-421e-a61b-1e9637bfbfa1.png,898,140,1003,238,105,98,red blood cell,10290,0.9333333333333333,1.0714285714285714
63560,/images/de0321fa-6f7d-4dd1-b96b-186701c3b1d9.png,292,787,412,899,120,112,red blood cell,13440,0.9333333333333333,1.0714285714285714
5747,/images/21a50e4c-b750-46b5-801f-5429ede7dea9.png,917,1021,1037,1152,120,131,red blood cell,15720,1.0916666666666666,0.916030534351145
58732,/images/e4827c85-311a-4df1-89c2-99dad0c3558c.png,819,375,937,490,118,115,red blood cell,13570,0.9745762711864406,1.0260869565217392
45555,/images/e597f7ce-46c6-4dce-9063-50a2703fdd45.png,594,480,693,586,99,106,red blood cell,10494,1.0707070707070707,0.9339622641509434
76416,/images/34df8890-272d-423a-ae78-ff8d068d3306.png,318,747,429,869,111,122,red blood cell,13542,1.0990990990990992,0.9098360655737705
29647,/images/b85fc640-de49-4f7e-afc0-978ff020f2e2.png,32,1375,149,1488,117,113,red blood cell,13221,0.9658119658119658,1.0353982300884956
13841,/images/345cb914-7583-49df-96e3-3cf19c2ba8f1.png,668,20,779,139,111,119,red blood cell,13209,1.072072072072072,0.9327731092436975
47940,/images/ab27173b-6e30-4957-bd68-29194328fd39.png,86,109,193,218,107,109,red blood cell,11663,1.0186915887850467,0.981651376146789
58801,/images/434523fd-d4d9-4961-a7c2-d71d6ae68e13.png,494,1108,589,1199,95,91,red blood cell,8645,0.9578947368421052,1.043956043956044
4064,/images/e02edd82-c424-4dee-98a7-575640655d9b.png,984,247,1094,352,110,105,red blood cell,11550,0.9545454545454546,1.0476190476190477
21263,/images/fc8df086-39e0-43f8-b0c7-2d23a349539b.png,88,869,214,998,126,129,red blood cell,16254,1.0238095238095237,0.9767441860465116
64547,/images/6ba5d0b8-cdc7-4266-9d78-db76faa312e9.png,623,600,722,700,99,100,red blood cell,9900,1.0101010101010102,0.99
47675,/images/4b3a49bc-8536-4760-9553-440a6f64db37.png,387,832,500,949,113,117,red blood cell,13221,1.0353982300884956,0.9658119658119658
28637,/images/861c3e06-aada-47a0-99ae-94fbc2772cc0.png,260,935,375,1048,115,113,red blood cell,12995,0.9826086956521739,1.0176991150442478
24132,/images/505355c9-23bf-4f90-8ebc-6a7ef50964d0.png,361,410,478,510,117,100,red blood cell,11700,0.8547008547008547,1.17
65154,/images/5e042380-6ef2-496f-8231-0ca550fbfa71.png,846,1020,928,1098,82,78,red blood cell,6396,0.9512195121951219,1.0512820512820513
75131,/images/7fdc8be8-7579-4a5c-b369-8a07ee0a8b7d.png,358,1187,471,1304,113,117,red blood cell,13221,1.0353982300884956,0.9658119658119658
35318,/images/516bf1d5-5d00-4985-926c-3993e9bc3ff5.png,115,1157,237,1285,122,128,red blood cell,15616,1.0491803278688525,0.953125
31683,/images/bd432159-5956-457c-bdeb-1b5e702ba513.png,796,46,912,162,116,116,red blood cell,13456,1.0,1.0
11884,/images/2e8d6a43-0110-4bf4-8e70-20567e513b81.png,620,325,715,418,95,93,red blood cell,8835,0.9789473684210527,1.021505376344086
8593,/images/a6aa3b72-2970-4c78-b655-ea8dfe6e018c.png,556,236,670,356,114,120,red blood cell,13680,1.0526315789473684,0.95
34735,/images/6294153c-6db3-4f2b-a8ff-9c087225e737.png,755,1147,865,1266,110,119,red blood cell,13090,1.0818181818181818,0.9243697478991597
43574,/images/e0ef520d-7b65-485d-9888-e6859f189f70.png,585,1073,689,1172,104,99,red blood cell,10296,0.9519230769230769,1.0505050505050506
64974,/images/dec61ae1-5037-4c3a-8952-15371becca7d.png,0,456,77,537,77,81,red blood cell,6237,1.051948051948052,0.9506172839506173
19157,/images/bb795ddf-ce72-42d5-9006-124db4d5cf1c.png,590,1020,682,1118,92,98,red blood cell,9016,1.065217391304348,0.9387755102040817
20669,/images/e6d7c5e1-43fc-4712-86d5-aa70252b978f.png,343,792,468,917,125,125,red blood cell,15625,1.0,1.0
7631,/images/21cc498b-8cb2-42ed-8f80-bfa27b86ef11.png,206,1109,330,1240,124,131,red blood cell,16244,1.0564516129032258,0.9465648854961832
33049,/images/6231d81d-9e84-4a5a-8cb8-47c6a37a0176.png,238,1303,338,1402,100,99,red blood cell,9900,0.99,1.0101010101010102
12634,/images/0901f9d1-be4f-4c19-8e83-dd724dded9f5.png,947,330,1065,450,118,120,red blood cell,14160,1.0169491525423728,0.9833333333333333
79423,/images/dcb21739-3c36-459d-b3cc-1be5871d6fe7.png,297,1241,404,1342,107,101,red blood cell,10807,0.9439252336448598,1.0594059405940595
48913,/images/5dec0204-af81-44ef-a942-8a173669c123.png,364,621,471,718,107,97,red blood cell,10379,0.9065420560747663,1.1030927835051547
66974,/images/3b4440f7-a69b-4042-a9d0-d6958abcdf4e.png,986,1243,1079,1342,93,99,red blood cell,9207,1.064516129032258,0.9393939393939394
32306,/images/1c406ce1-023b-47fc-a2cd-5ea2e255de65.png,301,580,401,699,100,119,red blood cell,11900,1.19,0.8403361344537815
7843,/images/1493d140-c9d5-4c3a-9caf-3eafb290a49b.png,471,487,584,615,113,128,red blood cell,14464,1.1327433628318584,0.8828125
60672,/images/45651e76-4bd0-45e5-895b-edec65f51987.png,917,564,1032,666,115,102,red blood cell,11730,0.8869565217391304,1.1274509803921569
59036,/images/597bbff8-6592-41cf-8946-e59b0d1f289a.png,14,583,131,684,117,101,red blood cell,11817,0.8632478632478633,1.1584158415841583
24646,/images/30948737-0d0d-4b68-b9ab-50577e0fe026.png,482,1281,610,1403,128,122,red blood cell,15616,0.953125,1.0491803278688525
7048,/images/8be185e7-2a1a-441c-a5c7-b50a9eb926cb.png,203,1501,324,1599,121,98,red blood cell,11858,0.8099173553719008,1.2346938775510203
2931,/images/00a02700-2ea2-4590-9e15-ffc9160fd3de.png,611,835,717,954,106,119,red blood cell,12614,1.1226415094339623,0.8907563025210085
14809,/images/f8b6a868-60e9-4569-ae69-638a0c39834d.png,770,1463,880,1573,110,110,red blood cell,12100,1.0,1.0
63793,/images/6013bff0-dc4b-4bde-9409-0f6139c3495c.png,525,915,615,1012,90,97,red blood cell,8730,1.0777777777777777,0.9278350515463918
71890,/images/61575482-91e1-4db9-83c7-687b7ddbbfc4.png,533,1003,643,1116,110,113,red blood cell,12430,1.0272727272727273,0.9734513274336283
41758,/images/32a1ea24-b6b7-4253-ad3e-bdf99c2c9b9d.png,760,349,881,468,121,119,red blood cell,14399,0.9834710743801653,1.0168067226890756
52879,/images/abb2f9d6-26fa-4328-983c-959ef6717c05.png,748,1344,858,1444,110,100,red blood cell,11000,0.9090909090909091,1.1
17811,/images/1863da5f-c595-4541-a8f4-21fe78678168.png,9,1378,106,1473,97,95,red blood cell,9215,0.979381443298969,1.0210526315789474
11369,/images/2f6224be-50d0-4e85-94ef-88315df561b6.png,880,922,991,1029,111,107,red blood cell,11877,0.963963963963964,1.0373831775700935
56872,/images/a588091c-5e4c-4e61-914d-e96f3ee3e505.png,1029,1451,1159,1557,130,106,red blood cell,13780,0.8153846153846154,1.2264150943396226
70838,/images/bf002a25-6535-4621-be19-56d468be5413.png,22,166,125,290,103,124,red blood cell,12772,1.203883495145631,0.8306451612903226
47607,/images/06cd484f-e864-4fee-8819-688b45eed98e.png,45,117,151,235,106,118,red blood cell,12508,1.1132075471698113,0.8983050847457628
8346,/images/65e3d6a6-012c-4b40-9a42-83078eb85e31.png,324,1376,428,1460,104,84,red blood cell,8736,0.8076923076923077,1.2380952380952381
75100,/images/073c10c9-5749-44b5-b08b-1be556a960f0.png,1083,778,1197,904,114,126,red blood cell,14364,1.105263157894737,0.9047619047619048
46863,/images/63055d1b-5221-4c80-8b39-37ac069a1b5c.png,693,707,810,811,117,104,red blood cell,12168,0.8888888888888888,1.125
73533,/images/7624ac36-1cf9-42fb-844d-376078309553.png,555,683,662,789,107,106,red blood cell,11342,0.9906542056074766,1.009433962264151
66956,/images/9acf303a-fcba-4e52-be3e-8d061aa5e72a.png,993,172,1077,252,84,80,red blood cell,6720,0.9523809523809523,1.05
58031,/images/a7c91b63-b97c-4f4b-8d34-7ad2b08d7a17.png,988,957,1092,1052,104,95,red blood cell,9880,0.9134615384615384,1.0947368421052632
62410,/images/9af1ee02-87fd-42bc-963e-fa9ac3eb45bb.png,125,1225,216,1316,91,91,red blood cell,8281,1.0,1.0
50863,/images/0906111b-bac7-4541-a6dc-da435c0724a8.png,823,638,950,758,127,120,red blood cell,15240,0.9448818897637795,1.0583333333333333
6699,/images/95fea6d8-413f-421e-b331-5d51c31df150.png,8,785,113,902,105,117,red blood cell,12285,1.1142857142857143,0.8974358974358975
40243,/images/f05ffdca-dc3a-47bd-a231-2a0d9bd1d50e.png,207,425,344,546,137,121,red blood cell,16577,0.8832116788321168,1.1322314049586777
6299,/images/c6575e75-c8ce-4766-841f-1137b9e0956c.png,914,176,1026,276,112,100,red blood cell,11200,0.8928571428571429,1.12
29387,/images/30167dc1-f739-4036-b5c4-5fad435c2c67.png,264,897,369,1010,105,113,red blood cell,11865,1.0761904761904761,0.9292035398230089
15917,/images/c7c1b873-0548-4a73-9618-f60912e164df.png,494,14,597,100,103,86,red blood cell,8858,0.8349514563106796,1.197674418604651
26003,/images/612bdd3c-da43-4321-a76b-c73c614928d1.png,671,1022,790,1143,119,121,red blood cell,14399,1.0168067226890756,0.9834710743801653
40637,/images/252071ac-e9f2-41d2-abbb-87ef01b8a997.png,123,1260,229,1353,106,93,red blood cell,9858,0.8773584905660378,1.1397849462365592
40446,/images/db249e5a-4142-432c-8288-bacd10d7273d.png,966,442,1075,541,109,99,red blood cell,10791,0.908256880733945,1.101010101010101
8835,/images/91827f1a-9b04-4ef0-972c-12e90e60c516.png,323,395,441,526,118,131,red blood cell,15458,1.1101694915254237,0.9007633587786259
64419,/images/0a7bfa8a-ee52-4f7a-b9c5-2919ecfa93ef.png,959,1510,1045,1591,86,81,red blood cell,6966,0.9418604651162791,1.0617283950617284
4983,/images/2cc3c4ad-670f-41b6-8910-0704cbc192ef.png,31,1083,122,1192,91,109,red blood cell,9919,1.1978021978021978,0.8348623853211009
59844,/images/acb16781-11ad-4327-874a-5c9c35dcb085.png,938,1316,1031,1422,93,106,red blood cell,9858,1.1397849462365592,0.8773584905660378
59328,/images/03c8da48-04b9-4520-b674-44a0ecd35688.png,560,666,635,746,75,80,red blood cell,6000,1.0666666666666667,0.9375
67129,/images/4272cbd7-5b0a-4bf7-b690-dee1c128f07b.png,164,9,250,104,86,95,red blood cell,8170,1.1046511627906976,0.9052631578947369
79611,/images/a4409217-be11-4478-90a5-b406057d154d.png,241,1424,343,1537,102,113,red blood cell,11526,1.107843137254902,0.9026548672566371
33159,/images/6231d81d-9e84-4a5a-8cb8-47c6a37a0176.png,779,615,876,716,97,101,red blood cell,9797,1.041237113402062,0.9603960396039604
20077,/images/ebfd9f67-138e-49f0-9cef-a0352069eedb.png,0,201,107,306,107,105,red blood cell,11235,0.9813084112149533,1.019047619047619
21582,/images/49efc89d-9cba-44f7-8257-7f911b73f68a.png,685,504,787,617,102,113,red blood cell,11526,1.107843137254902,0.9026548672566371
54598,/images/59dc7da9-35d1-421e-a61b-1e9637bfbfa1.png,488,1439,611,1555,123,116,red blood cell,14268,0.943089430894309,1.0603448275862069
15991,/images/c7c1b873-0548-4a73-9618-f60912e164df.png,782,1502,885,1600,103,98,red blood cell,10094,0.9514563106796117,1.0510204081632653
34909,/images/a4fbb9f2-9b75-4fdc-877d-2feaafac25b3.png,370,1289,464,1369,94,80,red blood cell,7520,0.851063829787234,1.175
58972,/images/a0eeeb10-d0cb-48d9-8c22-2c3a3c908d00.png,806,717,920,824,114,107,red blood cell,12198,0.9385964912280702,1.0654205607476634
549,/images/67acd5bc-4658-4c6e-a9b9-cd8ea3a03418.png,762,835,873,951,111,116,red blood cell,12876,1.045045045045045,0.9568965517241379
75083,/images/073c10c9-5749-44b5-b08b-1be556a960f0.png,473,883,588,1006,115,123,red blood cell,14145,1.0695652173913044,0.9349593495934959
62649,/images/f7a4334a-4332-4de8-b39b-22da907976f2.png,626,1089,702,1169,76,80,red blood cell,6080,1.0526315789473684,0.95
1534,/images/0ac747cd-ff32-49bf-bc1a-3e9b7702ce9c.png,644,1358,739,1453,95,95,red blood cell,9025,1.0,1.0
24337,/images/4d8a4ce8-0f9c-4f21-8844-4cf0e5514bbf.png,594,1051,690,1146,96,95,red blood cell,9120,0.9895833333333334,1.0105263157894737
17371,/images/04018590-4e66-4cb9-ad2d-83570f1b29ae.png,283,654,408,783,125,129,red blood cell,16125,1.032,0.9689922480620154
35527,/images/3e33ee12-ef02-4287-8318-7ad3b284a617.png,923,914,1026,1028,103,114,red blood cell,11742,1.1067961165048543,0.9035087719298246
47161,/images/3d1b889e-bb4a-4ee6-b899-974ee7d956a7.png,339,1041,448,1147,109,106,red blood cell,11554,0.9724770642201835,1.028301886792453
63967,/images/5e974892-0ebe-4037-8427-ea8616d6d3b8.png,1001,336,1090,432,89,96,red blood cell,8544,1.0786516853932584,0.9270833333333334
22757,/images/8490c623-3d88-4532-baf5-0d266a45b16f.png,39,1347,143,1449,104,102,red blood cell,10608,0.9807692307692307,1.0196078431372548
49342,/images/28c96a4a-4549-4761-99e4-ace4ea7e7ac9.png,702,939,819,1052,117,113,red blood cell,13221,0.9658119658119658,1.0353982300884956
17865,/images/eb77e4a9-acb0-4d83-8055-2c5fcaa54b45.png,252,1256,346,1339,94,83,red blood cell,7802,0.8829787234042553,1.1325301204819278
9838,/images/3859deaf-6ae1-49a3-9051-898d0f0d7de6.png,748,1405,855,1517,107,112,red blood cell,11984,1.0467289719626167,0.9553571428571429
32994,/images/6231d81d-9e84-4a5a-8cb8-47c6a37a0176.png,765,1018,871,1118,106,100,red blood cell,10600,0.9433962264150944,1.06
18631,/images/c22f7031-9cf8-48ce-b03b-1b12d0db4951.png,844,1337,940,1431,96,94,red blood cell,9024,0.9791666666666666,1.0212765957446808
76850,/images/2165fe38-b474-467d-be11-d1d728085efd.png,277,869,380,990,103,121,red blood cell,12463,1.174757281553398,0.8512396694214877
35844,/images/027ab174-e47a-44f8-b85b-372449eeb7d8.png,154,1480,263,1584,109,104,red blood cell,11336,0.9541284403669725,1.0480769230769231
38144,/images/33bdb7b5-ad5b-4a73-bbc2-3350f8c2ac0c.png,876,455,996,562,120,107,red blood cell,12840,0.8916666666666667,1.1214953271028036
47715,/images/afbb264e-ff60-443a-83f5-49d09be1b835.png,328,28,455,152,127,124,red blood cell,15748,0.9763779527559056,1.0241935483870968
68134,/images/5dec94a3-e3ca-4a58-9702-88e5a83ef612.png,68,195,165,284,97,89,red blood cell,8633,0.9175257731958762,1.0898876404494382
69586,/images/4a49841f-216c-4815-8140-b8762c4f6603.png,589,1411,688,1514,99,103,red blood cell,10197,1.0404040404040404,0.9611650485436893
70345,/images/90246988-0d6d-4bf8-8a76-94107de4121e.png,867,124,978,247,111,123,red blood cell,13653,1.1081081081081081,0.9024390243902439
38722,/images/b5acf759-1115-42f0-a753-656736192528.png,828,1132,940,1241,112,109,red blood cell,12208,0.9732142857142857,1.0275229357798166
21013,/images/666601e7-608d-4d19-999f-8fc6ab373a55.png,930,1374,1059,1485,129,111,red blood cell,14319,0.8604651162790697,1.162162162162162
11293,/images/6303f964-98ef-47c6-bb2d-283aa393f918.png,606,747,700,830,94,83,red blood cell,7802,0.8829787234042553,1.1325301204819278
30338,/images/4aad9589-6b32-4522-bcd7-ca04687a02ca.png,404,246,498,349,94,103,red blood cell,9682,1.0957446808510638,0.912621359223301
65014,/images/ff3b9d4d-373c-48ef-a75a-d23e2c2ade87.png,166,339,259,430,93,91,red blood cell,8463,0.978494623655914,1.021978021978022
76516,/images/38c69905-8a4f-451a-8d0a-b855dc88dd16.png,235,274,361,397,126,123,red blood cell,15498,0.9761904761904762,1.024390243902439
15106,/images/3a8f468f-f9de-46a8-a7c8-f2be239fa207.png,50,293,145,401,95,108,red blood cell,10260,1.1368421052631579,0.8796296296296297
66266,/images/e8058bed-c362-4e1c-85dc-62f80f32938f.png,1059,1245,1171,1352,112,107,red blood cell,11984,0.9553571428571429,1.0467289719626167
28428,/images/a6d85204-24b8-4b23-a8b1-c3e8b93f9f22.png,132,1222,250,1331,118,109,red blood cell,12862,0.923728813559322,1.0825688073394495
55596,/images/c32b8bb8-c89d-4ae9-9c77-5b9356ca35a1.png,104,65,218,167,114,102,red blood cell,11628,0.8947368421052632,1.1176470588235294
32566,/images/3f26fbbc-deb1-494f-b71c-c7cb3d4819fb.png,729,47,852,182,123,135,red blood cell,16605,1.0975609756097562,0.9111111111111111
60139,/images/ec60ab26-3343-4c5f-9667-cdae999c7d86.png,572,1161,696,1264,124,103,red blood cell,12772,0.8306451612903226,1.203883495145631
28197,/images/c244166d-12ca-445f-9ed9-a13d9caa412f.png,735,519,855,659,120,140,red blood cell,16800,1.1666666666666667,0.8571428571428571
8915,/images/04628a94-b674-469b-aff6-b476b70df87d.png,912,945,1024,1069,112,124,red blood cell,13888,1.1071428571428572,0.9032258064516129
80033,/images/38d1b930-dd97-4248-9160-e9389a1a8dd7.png,185,627,318,744,133,117,red blood cell,15561,0.8796992481203008,1.1367521367521367
10343,/images/affa429c-0315-4c18-a002-13bb3ecab259.png,978,699,1100,816,122,117,red blood cell,14274,0.9590163934426229,1.0427350427350428
69885,/images/9edba799-e169-46cd-b100-c9f8fc7a8c7d.png,1065,558,1173,681,108,123,red blood cell,13284,1.1388888888888888,0.8780487804878049
61557,/images/4a717a39-80f8-4b75-a25e-c46d65d7dcd5.png,125,1448,241,1560,116,112,red blood cell,12992,0.9655172413793104,1.0357142857142858
76338,/images/3dad6483-ac30-4d2b-b045-9f24fe6ff75e.png,261,1398,366,1498,105,100,red blood cell,10500,0.9523809523809523,1.05
71132,/images/b666fcc2-d0b2-441e-bc5a-c660345eeb5d.png,683,369,784,472,101,103,red blood cell,10403,1.0198019801980198,0.9805825242718447
77514,/images/2d2e81f3-e329-4765-9ba1-2c95f12dc9f3.png,769,468,872,573,103,105,red blood cell,10815,1.0194174757281553,0.9809523809523809
9452,/images/e3a4b3e7-9500-4b6c-a402-b6d3f45e714b.png,502,1344,631,1481,129,137,red blood cell,17673,1.062015503875969,0.9416058394160584
37797,/images/8d56197c-21d7-4cb6-92df-80637efd129b.png,14,402,135,530,121,128,red blood cell,15488,1.0578512396694215,0.9453125
21314,/images/8dace03a-10c4-4d59-bcd9-a2c314c5df33.png,505,1434,630,1555,125,121,red blood cell,15125,0.968,1.0330578512396693
17349,/images/04018590-4e66-4cb9-ad2d-83570f1b29ae.png,539,602,657,743,118,141,red blood cell,16638,1.194915254237288,0.8368794326241135
47654,/images/4b3a49bc-8536-4760-9553-440a6f64db37.png,697,1076,823,1192,126,116,red blood cell,14616,0.9206349206349206,1.0862068965517242
51617,/images/d0347b49-8f98-4632-a384-1a4f57ac6374.png,589,1163,680,1270,91,107,red blood cell,9737,1.1758241758241759,0.8504672897196262
18842,/images/d1b48634-9ad5-46e8-b816-42d1d97c93cd.png,760,1273,881,1389,121,116,red blood cell,14036,0.9586776859504132,1.043103448275862
41254,/images/eed298b3-35f2-4127-88ad-0c4a9062207b.png,498,261,597,365,99,104,red blood cell,10296,1.0505050505050506,0.9519230769230769
65164,/images/5e042380-6ef2-496f-8231-0ca550fbfa71.png,389,987,486,1067,97,80,red blood cell,7760,0.8247422680412371,1.2125
72463,/images/a15e0fa8-2620-4f66-896e-175115c9dc3d.png,442,480,564,591,122,111,red blood cell,13542,0.9098360655737705,1.0990990990990992
38784,/images/b426ef1d-4a59-4f90-b593-50226af60a60.png,612,1,714,104,102,103,red blood cell,10506,1.0098039215686274,0.9902912621359223
34373,/images/1a48cbc1-5423-47e5-8ca5-2ab4f83a05a5.png,405,1269,530,1371,125,102,red blood cell,12750,0.816,1.2254901960784315
60888,/images/11b72c7b-5c52-44b7-adb7-21eacc25e441.png,999,1237,1097,1335,98,98,red blood cell,9604,1.0,1.0
30099,/images/81c3c8f0-d5a9-4dda-afd5-e86f6afd9424.png,263,1424,362,1525,99,101,red blood cell,9999,1.02020202020202,0.9801980198019802
7273,/images/89f10192-d3dd-4996-a571-4c851dbdc983.png,267,1136,394,1239,127,103,red blood cell,13081,0.8110236220472441,1.233009708737864
78092,/images/105af41b-13cc-4ad1-8a1f-8bc4d47cdd94.png,918,866,1034,977,116,111,red blood cell,12876,0.9568965517241379,1.045045045045045
40143,/images/b34e65f6-c32e-42f1-a437-4a037c75a231.png,544,1420,646,1527,102,107,red blood cell,10914,1.0490196078431373,0.9532710280373832
64553,/images/6ba5d0b8-cdc7-4266-9d78-db76faa312e9.png,1067,1022,1167,1124,100,102,red blood cell,10200,1.02,0.9803921568627451
3410,/images/fd1302e2-3cd2-4a1a-9c13-00f810a9c41b.png,1019,579,1119,684,100,105,red blood cell,10500,1.05,0.9523809523809523
51944,/images/4f62b14e-c6f4-4155-8f50-881558f83fae.png,9,76,120,187,111,111,red blood cell,12321,1.0,1.0
2462,/images/fe851c88-692d-4199-87e0-d19d9c4eb591.png,384,1488,473,1589,89,101,red blood cell,8989,1.1348314606741574,0.8811881188118812
39660,/images/04d21589-b777-43c2-86b5-038cbf8c3a4e.png,567,1413,663,1515,96,102,red blood cell,9792,1.0625,0.9411764705882353
34625,/images/a0eedcb9-b85c-4612-b945-7e8227f53c35.png,714,123,822,222,108,99,red blood cell,10692,0.9166666666666666,1.0909090909090908
31135,/images/1976cd04-d24f-457c-b423-7e4cdb05de9e.png,1006,1333,1114,1435,108,102,red blood cell,11016,0.9444444444444444,1.0588235294117647
17465,/images/56077789-8580-41b4-89d6-deea227e5c60.png,1075,887,1179,1002,104,115,red blood cell,11960,1.1057692307692308,0.9043478260869565
23607,/images/79d7a014-21ff-40f1-9ac4-a69839390654.png,360,235,475,345,115,110,red blood cell,12650,0.9565217391304348,1.0454545454545454
70574,/images/8cca114a-ed05-4b87-95b7-fae02487f08c.png,581,948,668,1049,87,101,red blood cell,8787,1.160919540229885,0.8613861386138614
23270,/images/157ac97a-396e-4f6c-94c6-72a4d06ccc5f.png,80,316,199,438,119,122,red blood cell,14518,1.0252100840336134,0.9754098360655737
46278,/images/815bf40c-371a-4d34-aa41-c549c8221881.png,158,1374,284,1517,126,143,red blood cell,18018,1.1349206349206349,0.8811188811188811
36543,/images/21f001d6-f568-4ea4-82da-fab54c77c419.png,101,477,195,581,94,104,red blood cell,9776,1.1063829787234043,0.9038461538461539
50777,/images/db0a1123-0b35-48d7-8337-3b1ebd6af0cc.png,661,505,775,619,114,114,red blood cell,12996,1.0,1.0
75057,/images/073c10c9-5749-44b5-b08b-1be556a960f0.png,975,1037,1072,1131,97,94,red blood cell,9118,0.9690721649484536,1.0319148936170213
50945,/images/ef8fcfa4-8466-4186-8c69-f5f4904eb489.png,562,698,666,802,104,104,red blood cell,10816,1.0,1.0
32003,/images/9eb66577-7857-43dc-a879-8f2c9d7f780f.png,773,1224,878,1314,105,90,red blood cell,9450,0.8571428571428571,1.1666666666666667
29710,/images/f25a2ac8-cb6e-4e05-a0cd-cc00ac47718a.png,171,88,282,202,111,114,red blood cell,12654,1.027027027027027,0.9736842105263158
8878,/images/29539cb0-1c52-46b2-9302-552f8349dc71.png,173,1351,291,1474,118,123,red blood cell,14514,1.0423728813559323,0.959349593495935
73260,/images/67a4fb91-6f38-4ca2-8f20-6b2f5f1b29a7.png,722,980,827,1087,105,107,red blood cell,11235,1.019047619047619,0.9813084112149533
174,/images/13099edb-35d9-438f-b093-2cf2ebf9d255.png,1028,30,1144,137,116,107,red blood cell,12412,0.9224137931034483,1.0841121495327102
57021,/images/9e82c996-2cfa-418d-9482-8ee23e9d0a5d.png,257,144,363,266,106,122,red blood cell,12932,1.150943396226415,0.8688524590163934
49445,/images/f2574be3-81c6-4fc3-8a40-0230d1264f52.png,913,1155,1012,1260,99,105,red blood cell,10395,1.0606060606060606,0.9428571428571428
3471,/images/ad36bd67-594b-4f63-93e3-886af0bc618e.png,400,411,510,510,110,99,red blood cell,10890,0.9,1.1111111111111112
38253,/images/b834cbf7-ff97-49d9-9561-566c9343735c.png,600,894,716,1019,116,125,red blood cell,14500,1.0775862068965518,0.928
3976,/images/f09acb0c-b270-4e91-99f8-410adfa7f34a.png,880,59,969,155,89,96,red blood cell,8544,1.0786516853932584,0.9270833333333334
79610,/images/a4409217-be11-4478-90a5-b406057d154d.png,491,426,613,537,122,111,red blood cell,13542,0.9098360655737705,1.0990990990990992
58824,/images/434523fd-d4d9-4961-a7c2-d71d6ae68e13.png,607,338,708,441,101,103,red blood cell,10403,1.0198019801980198,0.9805825242718447
20886,/images/c2ec116f-f091-422c-926c-70b548a8f6ef.png,825,410,940,518,115,108,red blood cell,12420,0.9391304347826087,1.0648148148148149
74709,/images/5ccca8ee-abea-458a-a891-bedd31c3ddc3.png,1086,1195,1192,1300,106,105,red blood cell,11130,0.9905660377358491,1.0095238095238095
65655,/images/397f37bc-a3a4-4257-9430-c8fc5716f8b1.png,873,284,977,386,104,102,red blood cell,10608,0.9807692307692307,1.0196078431372548
19127,/images/2196389c-45ec-46b5-bc6c-1f4a33df7f7c.png,412,44,540,153,128,109,red blood cell,13952,0.8515625,1.1743119266055047
48146,/images/913099c5-8085-4908-bf4b-1f098bbfcf66.png,610,476,732,592,122,116,red blood cell,14152,0.9508196721311475,1.0517241379310345
24401,/images/4d8a4ce8-0f9c-4f21-8844-4cf0e5514bbf.png,940,565,1036,663,96,98,red blood cell,9408,1.0208333333333333,0.9795918367346939
62441,/images/7dfbfeaf-e3b1-4159-8dcd-d7f731280ac8.png,682,805,806,917,124,112,red blood cell,13888,0.9032258064516129,1.1071428571428572
37416,/images/08f5a524-0554-49c2-83a8-ae9a6d51e8fd.png,509,1478,601,1566,92,88,red blood cell,8096,0.9565217391304348,1.0454545454545454
19395,/images/5487faad-24a7-46b6-92d8-479d3a8d229f.png,1005,56,1104,160,99,104,red blood cell,10296,1.0505050505050506,0.9519230769230769
53052,/images/69b5b3de-ec64-4e5d-bcc2-44f495e06e76.png,43,996,148,1098,105,102,red blood cell,10710,0.9714285714285714,1.0294117647058822
51317,/images/b4f3b2a4-f4b9-48de-ac5d-0e681b77be27.png,848,557,962,669,114,112,red blood cell,12768,0.9824561403508771,1.0178571428571428
65649,/images/397f37bc-a3a4-4257-9430-c8fc5716f8b1.png,736,1209,832,1308,96,99,red blood cell,9504,1.03125,0.9696969696969697
74211,/images/4e43fc22-dc08-4cde-b3ce-ce8a4f377c47.png,541,276,633,383,92,107,red blood cell,9844,1.1630434782608696,0.8598130841121495
62694,/images/9e1b0217-0926-4fd1-bb9e-a815c05deb59.png,266,1091,374,1201,108,110,red blood cell,11880,1.0185185185185186,0.9818181818181818
48459,/images/e13f2327-fbf4-4d84-a8c1-09cb1e449c8c.png,723,1438,856,1563,133,125,red blood cell,16625,0.9398496240601504,1.064
16470,/images/9e5437c6-b0d3-473b-b7c3-8f5afeb90c7a.png,638,607,758,734,120,127,red blood cell,15240,1.0583333333333333,0.9448818897637795
69657,/images/f0713bee-2a71-4ced-b953-4041ea99496a.png,117,494,241,612,124,118,red blood cell,14632,0.9516129032258065,1.0508474576271187
39627,/images/04d21589-b777-43c2-86b5-038cbf8c3a4e.png,409,1451,531,1576,122,125,red blood cell,15250,1.0245901639344261,0.976
20515,/images/cbde7f7e-2458-4dda-9db2-3d5ccf950ced.png,912,1001,1035,1131,123,130,red blood cell,15990,1.056910569105691,0.9461538461538461
28673,/images/151f3af5-5e6e-4bcd-9389-4974fc68813e.png,486,1173,599,1271,113,98,red blood cell,11074,0.8672566371681416,1.153061224489796
79888,/images/a054a8e2-55f2-4508-97df-207f76b89be2.png,978,180,1086,298,108,118,red blood cell,12744,1.0925925925925926,0.9152542372881356
73818,/images/3eba916c-998b-40a7-993c-7ed916c2a04c.png,445,616,542,730,97,114,red blood cell,11058,1.175257731958763,0.8508771929824561
33197,/images/877d5e7f-19b6-40e7-81bd-c92f25e72503.png,1017,1202,1143,1323,126,121,red blood cell,15246,0.9603174603174603,1.0413223140495869
76474,/images/34df8890-272d-423a-ae78-ff8d068d3306.png,598,597,707,725,109,128,red blood cell,13952,1.1743119266055047,0.8515625
30674,/images/f939782b-f5a2-40a3-9c22-6c6d7e18edc3.png,501,137,596,231,95,94,red blood cell,8930,0.9894736842105263,1.0106382978723405
46408,/images/bbecf1a8-a728-4c83-87f8-4dfbac0a1e03.png,121,943,240,1050,119,107,red blood cell,12733,0.8991596638655462,1.1121495327102804
25598,/images/770b8ca4-8377-479b-9ad5-5455ec3b44f8.png,451,1168,571,1294,120,126,red blood cell,15120,1.05,0.9523809523809523
73158,/images/f39e2289-fedd-4d12-9e64-ffdafb89247e.png,1013,0,1127,104,114,104,red blood cell,11856,0.9122807017543859,1.0961538461538463
15885,/images/c7c1b873-0548-4a73-9618-f60912e164df.png,665,921,759,1004,94,83,red blood cell,7802,0.8829787234042553,1.1325301204819278
62183,/images/a72cd558-b7ac-4bf2-a344-2ce6c73a354e.png,440,83,552,180,112,97,red blood cell,10864,0.8660714285714286,1.1546391752577319
35932,/images/f8242b97-b8d5-48b5-b808-0b0f75a5de97.png,661,669,783,812,122,143,red blood cell,17446,1.1721311475409837,0.8531468531468531
49915,/images/05804cf0-f854-4099-97c2-df287f7c8a8c.png,216,1005,341,1110,125,105,red blood cell,13125,0.84,1.1904761904761905
29031,/images/4c13e22e-dfd1-4fa1-b373-be9d0c272c0f.png,430,563,532,662,102,99,red blood cell,10098,0.9705882352941176,1.0303030303030303
67309,/images/49c4dbd3-6269-4d4c-9648-a2146c57bab1.png,657,390,776,501,119,111,red blood cell,13209,0.9327731092436975,1.072072072072072
35026,/images/67582df6-bf13-4c83-a531-1214692b70de.png,588,1170,702,1299,114,129,red blood cell,14706,1.131578947368421,0.8837209302325582
79948,/images/e640ae51-cbf1-4a84-b7cf-d38b17f59c2f.png,882,1303,978,1412,96,109,red blood cell,10464,1.1354166666666667,0.8807339449541285
4469,/images/cf90d82f-2814-4fb7-a3ff-a86b7c5efca7.png,1071,546,1192,673,121,127,red blood cell,15367,1.0495867768595042,0.952755905511811
24422,/images/4d8a4ce8-0f9c-4f21-8844-4cf0e5514bbf.png,951,11,1047,128,96,117,red blood cell,11232,1.21875,0.8205128205128205
62177,/images/a72cd558-b7ac-4bf2-a344-2ce6c73a354e.png,990,589,1103,707,113,118,red blood cell,13334,1.0442477876106195,0.9576271186440678
78946,/images/4d0a1598-e4dd-45c4-8a90-dd7c780fe1da.png,860,153,944,241,84,88,red blood cell,7392,1.0476190476190477,0.9545454545454546
66401,/images/e5fd5949-4cd0-4cb6-837a-02c26a5eb87a.png,700,596,823,728,123,132,red blood cell,16236,1.0731707317073171,0.9318181818181818
5765,/images/21a50e4c-b750-46b5-801f-5429ede7dea9.png,981,1298,1103,1426,122,128,red blood cell,15616,1.0491803278688525,0.953125
23330,/images/e5731221-814c-4894-a44e-e46b71460fa4.png,1050,1133,1156,1253,106,120,red blood cell,12720,1.1320754716981132,0.8833333333333333
66344,/images/fcdf6632-c03f-49a8-9fb3-42e87c99b9d0.png,871,421,973,525,102,104,red blood cell,10608,1.0196078431372548,0.9807692307692307
38802,/images/d0d3ae45-b434-4869-a518-427320ebe62d.png,769,510,893,628,124,118,red blood cell,14632,0.9516129032258065,1.0508474576271187
75272,/images/9ec1dcec-87c2-4aca-8e6b-0db3cd05509c.png,176,504,284,610,108,106,red blood cell,11448,0.9814814814814815,1.0188679245283019
54131,/images/c415532c-4cce-4580-9fcd-623c172a1abd.png,280,1149,390,1259,110,110,red blood cell,12100,1.0,1.0
24256,/images/bb3ae957-0f6d-4615-bfe5-24fbca50b459.png,262,922,372,1020,110,98,red blood cell,10780,0.8909090909090909,1.1224489795918366
46690,/images/da111ca5-520f-4ea8-97ad-ae5fce58ee91.png,537,921,657,1038,120,117,red blood cell,14040,0.975,1.0256410256410255
4648,/images/9615ff33-b3fc-4d1e-9c05-0b8e3ef936df.png,488,445,593,552,105,107,red blood cell,11235,1.019047619047619,0.9813084112149533
55836,/images/68f34a9c-f73d-4238-8f55-4b05a8a2154c.png,918,1178,993,1247,75,69,red blood cell,5175,0.92,1.0869565217391304
37230,/images/71881a39-a30c-40c7-8c4a-9f64c93e79d9.png,33,1126,144,1253,111,127,red blood cell,14097,1.1441441441441442,0.8740157480314961
23670,/images/79d7a014-21ff-40f1-9ac4-a69839390654.png,409,857,501,965,92,108,red blood cell,9936,1.173913043478261,0.8518518518518519
41288,/images/2374ae5b-c2df-4db5-afea-c54180aa22e3.png,70,964,191,1091,121,127,red blood cell,15367,1.0495867768595042,0.952755905511811
18543,/images/c22f7031-9cf8-48ce-b03b-1b12d0db4951.png,244,61,330,153,86,92,red blood cell,7912,1.069767441860465,0.9347826086956522
57526,/images/00d04a90-80e5-4bce-9511-1b64eabb7a47.png,830,107,912,191,82,84,red blood cell,6888,1.024390243902439,0.9761904761904762
63795,/images/6013bff0-dc4b-4bde-9409-0f6139c3495c.png,304,696,414,793,110,97,red blood cell,10670,0.8818181818181818,1.134020618556701
10475,/images/46a2d369-4bea-4405-ac78-91bbe130b9a7.png,249,224,329,309,80,85,red blood cell,6800,1.0625,0.9411764705882353
43275,/images/36569710-a574-40be-ad42-897a6e74a128.png,938,1148,1037,1257,99,109,red blood cell,10791,1.101010101010101,0.908256880733945
27252,/images/9f38055f-4fe6-47fd-a6dd-c0743db4eccf.png,863,291,982,396,119,105,red blood cell,12495,0.8823529411764706,1.1333333333333333
25521,/images/f6ab936d-924b-4038-aa47-71b07c26b4e2.png,773,1334,888,1466,115,132,red blood cell,15180,1.1478260869565218,0.8712121212121212
69603,/images/4a49841f-216c-4815-8140-b8762c4f6603.png,1036,432,1146,540,110,108,red blood cell,11880,0.9818181818181818,1.0185185185185186
19870,/images/b318889c-3c60-477c-b8f6-d18cb01a59df.png,249,261,354,351,105,90,red blood cell,9450,0.8571428571428571,1.1666666666666667
51191,/images/ad8731b7-0dae-4983-9dc6-dec31767d761.png,1031,848,1135,941,104,93,red blood cell,9672,0.8942307692307693,1.118279569892473
68515,/images/74261741-4d6e-4dba-8ad4-4fbdf919c30f.png,629,81,733,190,104,109,red blood cell,11336,1.0480769230769231,0.9541284403669725
63713,/images/06401963-8b02-46c5-ab2a-3d70bd01623f.png,961,496,1071,611,110,115,red blood cell,12650,1.0454545454545454,0.9565217391304348
10534,/images/46a2d369-4bea-4405-ac78-91bbe130b9a7.png,914,478,1024,581,110,103,red blood cell,11330,0.9363636363636364,1.0679611650485437
23750,/images/6b2ff7ca-c5b3-415c-9481-7b14efc6d7ef.png,275,486,376,598,101,112,red blood cell,11312,1.108910891089109,0.9017857142857143
17051,/images/57e1879e-4294-45e7-9c1b-627e8cca0271.png,1028,1422,1148,1536,120,114,red blood cell,13680,0.95,1.0526315789473684
53679,/images/6f67a66b-56ec-4c36-ae7c-f250d3b86a23.png,447,382,550,493,103,111,red blood cell,11433,1.0776699029126213,0.9279279279279279
55992,/images/4c460388-e0c1-4970-8527-c9e5b42bea49.png,344,1197,440,1315,96,118,red blood cell,11328,1.2291666666666667,0.8135593220338984
78487,/images/72029aca-f0bc-477f-b790-f345f86228ce.png,560,1218,674,1342,114,124,red blood cell,14136,1.087719298245614,0.9193548387096774
20727,/images/79b3a64f-2fb9-46e0-85d4-2bdd59c2075e.png,638,783,739,884,101,101,red blood cell,10201,1.0,1.0
78052,/images/105af41b-13cc-4ad1-8a1f-8bc4d47cdd94.png,725,1307,842,1430,117,123,red blood cell,14391,1.0512820512820513,0.9512195121951219
28189,/images/c244166d-12ca-445f-9ed9-a13d9caa412f.png,513,321,640,440,127,119,red blood cell,15113,0.937007874015748,1.0672268907563025
16927,/images/8eeb378e-90f0-47ea-ac1c-2a201eb8d090.png,222,651,336,765,114,114,red blood cell,12996,1.0,1.0
42269,/images/ca734448-0d52-42fa-b41c-17b2939e58ae.png,778,43,885,156,107,113,red blood cell,12091,1.0560747663551402,0.9469026548672567
62492,/images/7dfbfeaf-e3b1-4159-8dcd-d7f731280ac8.png,636,314,738,423,102,109,red blood cell,11118,1.0686274509803921,0.9357798165137615
25665,/images/770b8ca4-8377-479b-9ad5-5455ec3b44f8.png,858,85,993,199,135,114,red blood cell,15390,0.8444444444444444,1.1842105263157894
36352,/images/4a0a05e1-11ad-4bfc-bfa3-adf3b9bd0b56.png,276,217,377,329,101,112,red blood cell,11312,1.108910891089109,0.9017857142857143
62041,/images/bdb5d571-27bc-4a42-ae45-aa5a9af40a81.png,15,194,103,277,88,83,red blood cell,7304,0.9431818181818182,1.0602409638554218
27199,/images/bca27923-b270-45df-a0bf-3e1a7d135b2c.png,671,239,776,335,105,96,red blood cell,10080,0.9142857142857143,1.09375
77180,/images/fe691faa-3bc7-475e-b558-aa8fe7b795bc.png,336,838,444,954,108,116,red blood cell,12528,1.0740740740740742,0.9310344827586207
28816,/images/686ed568-d5f8-475e-81ad-edab9dd473a0.png,114,1355,205,1453,91,98,red blood cell,8918,1.0769230769230769,0.9285714285714286
14419,/images/3b13e20f-ec0d-44ec-b2f4-eaebfa09150e.png,1067,879,1176,989,109,110,red blood cell,11990,1.0091743119266054,0.990909090909091
27388,/images/9f38055f-4fe6-47fd-a6dd-c0743db4eccf.png,320,1317,416,1413,96,96,red blood cell,9216,1.0,1.0
43245,/images/fe1ee954-ba71-47b3-954a-d20ab940cd7b.png,1006,1319,1125,1435,119,116,red blood cell,13804,0.9747899159663865,1.0258620689655173
19339,/images/b4d22412-a495-43a9-bec0-73a2322f8dad.png,1104,257,1181,342,77,85,red blood cell,6545,1.103896103896104,0.9058823529411765
45094,/images/56fbae44-4677-47f8-9c3a-22dac043c115.png,1007,1406,1128,1524,121,118,red blood cell,14278,0.9752066115702479,1.0254237288135593
74815,/images/91e93160-eb8d-4de0-b6bc-b98ec33d1663.png,576,991,661,1076,85,85,red blood cell,7225,1.0,1.0
79269,/images/05ac7b2a-6a77-4464-926b-8570f7c01693.png,90,623,179,705,89,82,red blood cell,7298,0.9213483146067416,1.0853658536585367
5129,/images/a777e78c-ad1f-4380-9ab2-b4f9f32b2d78.png,188,224,302,334,114,110,red blood cell,12540,0.9649122807017544,1.0363636363636364
80063,/images/99e979d4-ee97-4d7f-9da6-00bead40db4d.png,900,1472,1013,1580,113,108,red blood cell,12204,0.9557522123893806,1.0462962962962963
37485,/images/c6530038-6d4e-49e1-8427-d1d3acc9fa21.png,577,1495,686,1599,109,104,red blood cell,11336,0.9541284403669725,1.0480769230769231
30144,/images/a1669b59-fe09-4fe6-ba9f-06bec6725502.png,553,961,680,1091,127,130,red blood cell,16510,1.0236220472440944,0.9769230769230769
30387,/images/58d75854-be99-484e-89f0-4ab208fe07e0.png,1035,1163,1126,1251,91,88,red blood cell,8008,0.967032967032967,1.0340909090909092
63645,/images/d9c9479e-f1ea-4d6e-861f-843ff9a90d19.png,816,758,912,846,96,88,red blood cell,8448,0.9166666666666666,1.0909090909090908
30623,/images/f939782b-f5a2-40a3-9c22-6c6d7e18edc3.png,1067,107,1178,233,111,126,red blood cell,13986,1.135135135135135,0.8809523809523809
68671,/images/77e76e62-2c71-4b52-9b21-0d1bcde9f9bf.png,892,528,1008,624,116,96,red blood cell,11136,0.8275862068965517,1.2083333333333333
78771,/images/9174f910-3859-4839-8e30-2c3b25269322.png,94,869,198,953,104,84,red blood cell,8736,0.8076923076923077,1.2380952380952381
55189,/images/9c5f48c0-0544-4c0c-92b4-59b7d7b7814c.png,77,744,176,853,99,109,red blood cell,10791,1.101010101010101,0.908256880733945
11811,/images/3cdcb09b-6a8c-43ca-b1d0-c1a289202f65.png,548,169,650,269,102,100,red blood cell,10200,0.9803921568627451,1.02
27099,/images/f232eec3-02c0-43f9-bf32-3e60245397e2.png,362,40,483,152,121,112,red blood cell,13552,0.9256198347107438,1.0803571428571428
49366,/images/28c96a4a-4549-4761-99e4-ace4ea7e7ac9.png,935,983,1050,1091,115,108,red blood cell,12420,0.9391304347826087,1.0648148148148149
50749,/images/6b4c79f5-b194-4586-be9f-e339c5af4188.png,503,612,626,729,123,117,red blood cell,14391,0.9512195121951219,1.0512820512820513
33442,/images/244ac6fa-8a92-4214-9cf4-ae0811d9ec7e.png,128,457,242,549,114,92,red blood cell,10488,0.8070175438596491,1.2391304347826086
12228,/images/5a0628af-4c0a-4ba6-a935-4ec94c9c700e.png,777,162,897,271,120,109,red blood cell,13080,0.9083333333333333,1.1009174311926606
2429,/images/fe851c88-692d-4199-87e0-d19d9c4eb591.png,247,199,352,290,105,91,red blood cell,9555,0.8666666666666667,1.1538461538461537
75209,/images/61dfc937-a428-44b4-94fb-d682bdb8dff0.png,91,1147,214,1264,123,117,red blood cell,14391,0.9512195121951219,1.0512820512820513
32355,/images/a6526894-e290-482d-ac43-f1df34864817.png,159,742,270,852,111,110,red blood cell,12210,0.990990990990991,1.009090909090909
21183,/images/fb05b297-180a-4171-b633-09d5616d7534.png,139,695,235,806,96,111,red blood cell,10656,1.15625,0.8648648648648649
31859,/images/f62d4fb6-df7c-446c-94a8-d5aede0b1e0c.png,227,351,332,475,105,124,red blood cell,13020,1.180952380952381,0.8467741935483871
51050,/images/7eb95580-693f-41b6-9338-174be1430c23.png,822,743,953,851,131,108,red blood cell,14148,0.8244274809160306,1.212962962962963
40440,/images/db249e5a-4142-432c-8288-bacd10d7273d.png,132,450,259,568,127,118,red blood cell,14986,0.9291338582677166,1.076271186440678
37744,/images/fe0c5e48-f65e-488c-9c3c-1ea7c7835c0c.png,931,643,1032,738,101,95,red blood cell,9595,0.9405940594059405,1.063157894736842
24529,/images/109fbb82-bc3c-41ac-984d-e2da86202873.png,116,1050,228,1163,112,113,red blood cell,12656,1.0089285714285714,0.9911504424778761
10432,/images/46a2d369-4bea-4405-ac78-91bbe130b9a7.png,96,432,176,532,80,100,red blood cell,8000,1.25,0.8
41319,/images/2374ae5b-c2df-4db5-afea-c54180aa22e3.png,934,773,1029,882,95,109,red blood cell,10355,1.1473684210526316,0.8715596330275229
61757,/images/985627c9-7b85-40de-a106-eb9cc47b47cb.png,23,759,121,857,98,98,red blood cell,9604,1.0,1.0
27201,/images/bca27923-b270-45df-a0bf-3e1a7d135b2c.png,681,122,794,234,113,112,red blood cell,12656,0.9911504424778761,1.0089285714285714
71839,/images/093a831a-bf71-4333-bc06-942ae70cb164.png,956,1026,1063,1116,107,90,red blood cell,9630,0.8411214953271028,1.1888888888888889
14072,/images/eaf4b781-b3aa-41ce-8c5e-287979b4e15a.png,0,574,98,696,98,122,red blood cell,11956,1.2448979591836735,0.8032786885245902
50458,/images/a2de1248-7bc0-44dc-b508-70a357eedd68.png,0,1396,102,1484,102,88,red blood cell,8976,0.8627450980392157,1.1590909090909092
68858,/images/aa3ad405-828e-4986-8251-20fd981f34d3.png,771,244,849,327,78,83,red blood cell,6474,1.064102564102564,0.9397590361445783
16086,/images/7e25ced3-5caf-47f8-ad0c-42946bd4468b.png,1065,80,1180,179,115,99,red blood cell,11385,0.8608695652173913,1.1616161616161615
70002,/images/3e36698f-8c09-4c8b-8948-737310bf97e5.png,315,766,411,877,96,111,red blood cell,10656,1.15625,0.8648648648648649
34049,/images/1012abf2-cb05-4337-86c5-513ec4ca904d.png,512,344,621,456,109,112,red blood cell,12208,1.0275229357798166,0.9732142857142857
43621,/images/a4851ed0-1499-4eae-9157-dcd34773254f.png,651,224,755,347,104,123,red blood cell,12792,1.1826923076923077,0.8455284552845529
13825,/images/345cb914-7583-49df-96e3-3cf19c2ba8f1.png,916,265,1043,393,127,128,red blood cell,16256,1.0078740157480315,0.9921875
65013,/images/ff3b9d4d-373c-48ef-a75a-d23e2c2ade87.png,372,251,475,365,103,114,red blood cell,11742,1.1067961165048543,0.9035087719298246
76793,/images/2165fe38-b474-467d-be11-d1d728085efd.png,369,802,482,901,113,99,red blood cell,11187,0.8761061946902655,1.1414141414141414
38974,/images/5939f341-a886-4f63-ae87-2219d000a1d4.png,194,905,304,1016,110,111,red blood cell,12210,1.009090909090909,0.990990990990991
7329,/images/89f10192-d3dd-4996-a571-4c851dbdc983.png,16,1387,100,1484,84,97,red blood cell,8148,1.1547619047619047,0.865979381443299
14244,/images/6382976c-ee87-4916-b798-4ef1373b2df0.png,995,555,1097,662,102,107,red blood cell,10914,1.0490196078431373,0.9532710280373832
51324,/images/b4f3b2a4-f4b9-48de-ac5d-0e681b77be27.png,942,916,1059,1030,117,114,red blood cell,13338,0.9743589743589743,1.0263157894736843
28441,/images/c3042130-a6e2-458f-9fde-bb012f68f5f2.png,271,1061,384,1161,113,100,red blood cell,11300,0.8849557522123894,1.13
56193,/images/137d540f-d71e-47e8-bd9b-6cd0a6433c33.png,683,941,794,1034,111,93,red blood cell,10323,0.8378378378378378,1.1935483870967742
37236,/images/71881a39-a30c-40c7-8c4a-9f64c93e79d9.png,438,1380,574,1494,136,114,red blood cell,15504,0.8382352941176471,1.1929824561403508
33407,/images/f632981c-1330-4078-8a12-691beb2dab02.png,967,990,1076,1114,109,124,red blood cell,13516,1.1376146788990826,0.8790322580645161
75220,/images/61dfc937-a428-44b4-94fb-d682bdb8dff0.png,41,1492,147,1588,106,96,red blood cell,10176,0.9056603773584906,1.1041666666666667
18849,/images/d1b48634-9ad5-46e8-b816-42d1d97c93cd.png,713,730,806,828,93,98,red blood cell,9114,1.053763440860215,0.9489795918367347
55445,/images/d67655e6-0a80-4a86-b552-1f5e85788377.png,865,1167,952,1260,87,93,red blood cell,8091,1.0689655172413792,0.9354838709677419
1647,/images/7094c11a-1e62-4f98-894e-d17d138a88e9.png,595,261,706,362,111,101,red blood cell,11211,0.9099099099099099,1.099009900990099
64397,/images/0a7bfa8a-ee52-4f7a-b9c5-2919ecfa93ef.png,679,1163,774,1254,95,91,red blood cell,8645,0.9578947368421052,1.043956043956044
61207,/images/0da07970-3146-479c-8a07-f61ed32814a9.png,967,1473,1079,1586,112,113,red blood cell,12656,1.0089285714285714,0.9911504424778761
63553,/images/44b4a765-104e-4182-8871-e933c83c91ef.png,512,1088,613,1194,101,106,red blood cell,10706,1.0495049504950495,0.9528301886792453
52552,/images/0546d843-d778-4aca-b8b5-bfe23d7c87da.png,381,1388,486,1488,105,100,red blood cell,10500,0.9523809523809523,1.05
23051,/images/0d095f3a-9243-472b-90b4-0ce8309e778c.png,901,1154,1005,1275,104,121,red blood cell,12584,1.1634615384615385,0.859504132231405
55791,/images/68f34a9c-f73d-4238-8f55-4b05a8a2154c.png,867,1241,964,1337,97,96,red blood cell,9312,0.9896907216494846,1.0104166666666667
48911,/images/5dec0204-af81-44ef-a942-8a173669c123.png,526,456,654,563,128,107,red blood cell,13696,0.8359375,1.1962616822429906
48264,/images/71204a6d-814e-44b6-9cee-7b979f478021.png,355,135,447,227,92,92,red blood cell,8464,1.0,1.0
19792,/images/68e69cfb-1a07-48d2-8abe-46b46fe264ed.png,969,876,1072,969,103,93,red blood cell,9579,0.9029126213592233,1.10752688172043
66564,/images/b87fb62d-2c36-4f68-aba9-37fcd7d46eef.png,1089,921,1199,1029,110,108,red blood cell,11880,0.9818181818181818,1.0185185185185186
35439,/images/002f20ad-2ace-499c-9335-c9080bc3e6b5.png,98,731,212,848,114,117,red blood cell,13338,1.0263157894736843,0.9743589743589743
37534,/images/205306da-0ed8-475a-ace6-f2f81d4be88a.png,822,210,924,322,102,112,red blood cell,11424,1.0980392156862746,0.9107142857142857
23558,/images/177f883a-f0f1-4b8e-b598-2ca4bab27381.png,60,427,179,537,119,110,red blood cell,13090,0.9243697478991597,1.0818181818181818
29285,/images/6274fe0d-0d71-40be-b61b-f0bd5b5df1e2.png,823,302,903,379,80,77,red blood cell,6160,0.9625,1.0389610389610389
49847,/images/5e17f8e6-fd8d-426c-b444-1515d14f04b7.png,572,9,672,114,100,105,red blood cell,10500,1.05,0.9523809523809523
62535,/images/7dfbfeaf-e3b1-4159-8dcd-d7f731280ac8.png,230,1404,329,1492,99,88,red blood cell,8712,0.8888888888888888,1.125
14969,/images/5d1418d3-1559-4725-ad4a-9afb6eaecdfd.png,428,1328,533,1439,105,111,red blood cell,11655,1.0571428571428572,0.9459459459459459
79435,/images/dcb21739-3c36-459d-b3cc-1be5871d6fe7.png,845,1482,942,1566,97,84,red blood cell,8148,0.865979381443299,1.1547619047619047
43434,/images/367663b2-5d09-4020-ab0a-c2200e7a1c8c.png,115,814,230,936,115,122,red blood cell,14030,1.0608695652173914,0.9426229508196722
37522,/images/205306da-0ed8-475a-ace6-f2f81d4be88a.png,469,761,555,845,86,84,red blood cell,7224,0.9767441860465116,1.0238095238095237
10962,/images/c442e2d6-aaf9-417a-9905-4737a1115f33.png,711,37,824,151,113,114,red blood cell,12882,1.008849557522124,0.9912280701754386
68346,/images/0f735cca-051c-4048-a1fa-cb36f389e12f.png,1064,135,1198,265,134,130,red blood cell,17420,0.9701492537313433,1.0307692307692307
70075,/images/b8339d7b-85ec-48d0-83e8-c8f831070459.png,501,1072,625,1193,124,121,red blood cell,15004,0.9758064516129032,1.024793388429752
66652,/images/b88fe674-fb9a-41d4-b100-cb1c86440d44.png,139,1030,254,1141,115,111,red blood cell,12765,0.9652173913043478,1.0360360360360361
55946,/images/afd39466-aafa-4d81-9520-483727418723.png,812,332,921,444,109,112,red blood cell,12208,1.0275229357798166,0.9732142857142857
46730,/images/da111ca5-520f-4ea8-97ad-ae5fce58ee91.png,439,345,540,428,101,83,red blood cell,8383,0.8217821782178217,1.216867469879518
73836,/images/3eba916c-998b-40a7-993c-7ed916c2a04c.png,1105,19,1199,121,94,102,red blood cell,9588,1.0851063829787233,0.9215686274509803
47062,/images/997eabd9-55bf-4683-83c4-4cee4673a4ef.png,565,1298,672,1401,107,103,red blood cell,11021,0.9626168224299065,1.0388349514563107
37642,/images/205306da-0ed8-475a-ace6-f2f81d4be88a.png,917,585,1015,677,98,92,red blood cell,9016,0.9387755102040817,1.065217391304348
22609,/images/406e05f0-4444-414c-bb40-f4cb08e75ac9.png,569,874,680,997,111,123,red blood cell,13653,1.1081081081081081,0.9024390243902439
6429,/images/1ecb0405-a6e9-4485-819e-2fbbf2b718aa.png,710,1414,808,1506,98,92,red blood cell,9016,0.9387755102040817,1.065217391304348
1643,/images/7094c11a-1e62-4f98-894e-d17d138a88e9.png,1061,98,1159,207,98,109,red blood cell,10682,1.1122448979591837,0.8990825688073395
66975,/images/3b4440f7-a69b-4042-a9d0-d6958abcdf4e.png,368,163,464,275,96,112,red blood cell,10752,1.1666666666666667,0.8571428571428571
38377,/images/674b0fd3-f247-4b7f-97f7-3e6c57c9ba9e.png,754,926,852,1015,98,89,red blood cell,8722,0.9081632653061225,1.101123595505618
20319,/images/98976666-9125-47fe-9601-43c41e58dfb4.png,513,904,621,1024,108,120,red blood cell,12960,1.1111111111111112,0.9
18781,/images/cc882eae-a341-4783-bd19-8bdedf798538.png,237,399,339,511,102,112,red blood cell,11424,1.0980392156862746,0.9107142857142857
66643,/images/b88fe674-fb9a-41d4-b100-cb1c86440d44.png,337,512,440,620,103,108,red blood cell,11124,1.0485436893203883,0.9537037037037037
40444,/images/db249e5a-4142-432c-8288-bacd10d7273d.png,559,300,696,424,137,124,red blood cell,16988,0.9051094890510949,1.1048387096774193
29513,/images/8cc6fe77-5f2f-4670-b4ac-1b49550241a8.png,1049,825,1160,926,111,101,red blood cell,11211,0.9099099099099099,1.099009900990099
57990,/images/7942691b-6376-4c75-ae8a-ddf65454dcb2.png,0,1082,111,1190,111,108,red blood cell,11988,0.972972972972973,1.0277777777777777
49091,/images/df3d98b9-3dd7-4107-8d4a-ae1b7f247793.png,473,544,567,635,94,91,red blood cell,8554,0.9680851063829787,1.032967032967033
11535,/images/834a30bb-26bf-4e60-9ea1-3250b926892e.png,1077,412,1183,521,106,109,red blood cell,11554,1.028301886792453,0.9724770642201835
34156,/images/f1cda808-69a9-4d10-ba0a-6607c98e362d.png,633,728,746,843,113,115,red blood cell,12995,1.0176991150442478,0.9826086956521739
61150,/images/80da32ce-8c22-470e-9f35-558c5f7a5df9.png,982,188,1077,285,95,97,red blood cell,9215,1.0210526315789474,0.979381443298969
47021,/images/9ebd623d-5534-4dd9-bff8-cdedf322db35.png,109,1131,186,1224,77,93,red blood cell,7161,1.2077922077922079,0.8279569892473119
43200,/images/fe1ee954-ba71-47b3-954a-d20ab940cd7b.png,961,29,1075,145,114,116,red blood cell,13224,1.0175438596491229,0.9827586206896551
32406,/images/3911fcd2-4e26-4ad9-aaf0-d1c5bf41defc.png,84,1320,198,1428,114,108,red blood cell,12312,0.9473684210526315,1.0555555555555556
21239,/images/0ceb4539-5c4c-487d-9826-452a88b5d537.png,332,555,422,662,90,107,red blood cell,9630,1.1888888888888889,0.8411214953271028
19510,/images/a85cd1ae-0c94-4387-8305-84ab8d96d137.png,334,136,444,242,110,106,red blood cell,11660,0.9636363636363636,1.0377358490566038
70707,/images/8ab5c462-045e-4b59-b53a-9b2bc3ed2487.png,55,1391,159,1495,104,104,red blood cell,10816,1.0,1.0
21572,/images/49efc89d-9cba-44f7-8257-7f911b73f68a.png,70,1024,169,1132,99,108,red blood cell,10692,1.0909090909090908,0.9166666666666666
19853,/images/b318889c-3c60-477c-b8f6-d18cb01a59df.png,232,897,351,1001,119,104,red blood cell,12376,0.8739495798319328,1.1442307692307692
49429,/images/f2574be3-81c6-4fc3-8a40-0230d1264f52.png,79,323,186,440,107,117,red blood cell,12519,1.0934579439252337,0.9145299145299145
58352,/images/50f2f514-6c8e-4c79-b3b3-0be56dd0b78b.png,1015,330,1134,460,119,130,red blood cell,15470,1.0924369747899159,0.9153846153846154
44728,/images/ccb4b13d-ab20-4222-892f-5adf70249aaa.png,125,625,232,739,107,114,red blood cell,12198,1.0654205607476634,0.9385964912280702
61855,/images/5f300fd1-7eec-41ac-bbd1-0f4a943c757c.png,282,884,378,981,96,97,red blood cell,9312,1.0104166666666667,0.9896907216494846
58951,/images/a0eeeb10-d0cb-48d9-8c22-2c3a3c908d00.png,954,589,1072,705,118,116,red blood cell,13688,0.9830508474576272,1.0172413793103448
61745,/images/985627c9-7b85-40de-a106-eb9cc47b47cb.png,229,1377,343,1483,114,106,red blood cell,12084,0.9298245614035088,1.0754716981132075
55599,/images/c32b8bb8-c89d-4ae9-9c77-5b9356ca35a1.png,720,741,829,848,109,107,red blood cell,11663,0.981651376146789,1.0186915887850467
55388,/images/4fb83278-adc5-4424-9f45-b6d0db2955b6.png,425,2,530,101,105,99,red blood cell,10395,0.9428571428571428,1.0606060606060606
6244,/images/effd6334-516f-4d48-9f3c-5272a99780fb.png,924,1113,1028,1228,104,115,red blood cell,11960,1.1057692307692308,0.9043478260869565
24345,/images/4d8a4ce8-0f9c-4f21-8844-4cf0e5514bbf.png,1090,548,1188,643,98,95,red blood cell,9310,0.9693877551020408,1.0315789473684212
73532,/images/7624ac36-1cf9-42fb-844d-376078309553.png,777,933,884,1033,107,100,red blood cell,10700,0.9345794392523364,1.07
3528,/images/ad36bd67-594b-4f63-93e3-886af0bc618e.png,551,1323,670,1419,119,96,red blood cell,11424,0.8067226890756303,1.2395833333333333
78801,/images/9174f910-3859-4839-8e30-2c3b25269322.png,710,636,804,753,94,117,red blood cell,10998,1.2446808510638299,0.8034188034188035
37523,/images/205306da-0ed8-475a-ace6-f2f81d4be88a.png,34,1109,122,1194,88,85,red blood cell,7480,0.9659090909090909,1.035294117647059
54667,/images/6473ddb6-ad56-48a2-81e8-c7cb45f06825.png,904,1015,1004,1114,100,99,red blood cell,9900,0.99,1.0101010101010102
27157,/images/f232eec3-02c0-43f9-bf32-3e60245397e2.png,213,1037,329,1162,116,125,red blood cell,14500,1.0775862068965518,0.928
32005,/images/9eb66577-7857-43dc-a879-8f2c9d7f780f.png,139,62,229,154,90,92,red blood cell,8280,1.0222222222222221,0.9782608695652174
55928,/images/afd39466-aafa-4d81-9520-483727418723.png,220,434,308,525,88,91,red blood cell,8008,1.0340909090909092,0.967032967032967
26850,/images/2518f6e4-29cc-4ae4-a914-b215a4c56099.png,281,820,395,930,114,110,red blood cell,12540,0.9649122807017544,1.0363636363636364
65131,/images/5e042380-6ef2-496f-8231-0ca550fbfa71.png,328,423,423,516,95,93,red blood cell,8835,0.9789473684210527,1.021505376344086
37167,/images/d6942996-5664-4370-ad87-2bdcbd49ac16.png,1015,222,1134,354,119,132,red blood cell,15708,1.1092436974789917,0.9015151515151515
79313,/images/05ac7b2a-6a77-4464-926b-8570f7c01693.png,389,1003,471,1077,82,74,red blood cell,6068,0.9024390243902439,1.1081081081081081
9073,/images/21c2a8aa-407c-4569-8212-96fcafa84138.png,643,252,786,375,143,123,red blood cell,17589,0.8601398601398601,1.1626016260162602
18226,/images/947348fe-4c70-468e-8009-3c14daeca69b.png,142,249,236,334,94,85,red blood cell,7990,0.9042553191489362,1.1058823529411765
36419,/images/cfe6086f-eb0b-4cb0-a430-8cd7de6556e2.png,171,1238,261,1330,90,92,red blood cell,8280,1.0222222222222221,0.9782608695652174
59820,/images/acb16781-11ad-4327-874a-5c9c35dcb085.png,78,1349,188,1455,110,106,red blood cell,11660,0.9636363636363636,1.0377358490566038
19881,/images/b318889c-3c60-477c-b8f6-d18cb01a59df.png,908,51,1010,139,102,88,red blood cell,8976,0.8627450980392157,1.1590909090909092
26613,/images/5893e081-04f2-4e33-9851-bed5f0e4d333.png,114,855,225,985,111,130,red blood cell,14430,1.1711711711711712,0.8538461538461538
72873,/images/31435107-c77d-42f8-a619-75cba6a5161b.png,240,724,345,813,105,89,red blood cell,9345,0.8476190476190476,1.1797752808988764
31857,/images/f62d4fb6-df7c-446c-94a8-d5aede0b1e0c.png,595,165,710,291,115,126,red blood cell,14490,1.0956521739130434,0.9126984126984127
60237,/images/abf4cf2a-4532-4772-9f0f-9e123cc1713d.png,927,782,1030,891,103,109,red blood cell,11227,1.058252427184466,0.944954128440367
2789,/images/e79bd81b-f878-4bee-9be2-d91a722c031e.png,166,354,286,478,120,124,red blood cell,14880,1.0333333333333334,0.967741935483871
42022,/images/46a03374-64c7-49ac-81c9-c3d62542bbf3.png,483,901,585,991,102,90,red blood cell,9180,0.8823529411764706,1.1333333333333333
42904,/images/7d4c2160-317f-48d1-a60a-788ec300b3e8.png,822,208,930,317,108,109,red blood cell,11772,1.0092592592592593,0.9908256880733946
22095,/images/ac4d6507-d710-497b-ad7c-e0dd75c1d06d.png,541,647,657,763,116,116,red blood cell,13456,1.0,1.0
15565,/images/169d541c-daed-468e-8b41-0f1abccdf319.png,812,918,923,1051,111,133,red blood cell,14763,1.1981981981981982,0.8345864661654135
42780,/images/7c68c343-a7d3-4d26-b330-a5bb97ab8d9c.png,477,1245,592,1374,115,129,red blood cell,14835,1.1217391304347826,0.8914728682170543
4082,/images/e02edd82-c424-4dee-98a7-575640655d9b.png,380,205,502,346,122,141,red blood cell,17202,1.1557377049180328,0.8652482269503546
72158,/images/005e60b6-77b8-458c-b57c-bfe0c7e7df78.png,958,536,1061,657,103,121,red blood cell,12463,1.174757281553398,0.8512396694214877
63364,/images/9f4bc3b4-abb0-4bcb-baa8-ec9f25e2b9c6.png,110,806,219,905,109,99,red blood cell,10791,0.908256880733945,1.101010101010101
33629,/images/00c8364b-8c85-4502-bcfe-64736fe76815.png,672,376,772,475,100,99,red blood cell,9900,0.99,1.0101010101010102
57051,/images/9e82c996-2cfa-418d-9482-8ee23e9d0a5d.png,458,1233,562,1341,104,108,red blood cell,11232,1.0384615384615385,0.9629629629629629
47,/images/8d02117d-6c71-4e47-b50a-6cc8d5eb1d55.png,498,560,608,651,110,91,red blood cell,10010,0.8272727272727273,1.2087912087912087
60704,/images/45651e76-4bd0-45e5-895b-edec65f51987.png,841,947,943,1072,102,125,red blood cell,12750,1.2254901960784315,0.816
57796,/images/c9ad92d4-b408-4506-916e-def47b2e6ed0.png,250,341,348,432,98,91,red blood cell,8918,0.9285714285714286,1.0769230769230769
34922,/images/a4fbb9f2-9b75-4fdc-877d-2feaafac25b3.png,510,1005,606,1105,96,100,red blood cell,9600,1.0416666666666667,0.96
9205,/images/6e7ed596-1b76-4998-8147-a846d53d91c5.png,497,1103,631,1228,134,125,red blood cell,16750,0.9328358208955224,1.072
57429,/images/00d04a90-80e5-4bce-9511-1b64eabb7a47.png,504,833,603,936,99,103,red blood cell,10197,1.0404040404040404,0.9611650485436893
17666,/images/b5143aae-6e98-4dc6-b546-980cb472de67.png,1012,140,1120,251,108,111,red blood cell,11988,1.0277777777777777,0.972972972972973
56305,/images/6b473806-e936-4b19-98cf-a2b94cac35ff.png,981,1260,1129,1381,148,121,red blood cell,17908,0.8175675675675675,1.2231404958677685
66873,/images/9acf303a-fcba-4e52-be3e-8d061aa5e72a.png,73,301,161,398,88,97,red blood cell,8536,1.1022727272727273,0.9072164948453608
46732,/images/da111ca5-520f-4ea8-97ad-ae5fce58ee91.png,949,448,1044,548,95,100,red blood cell,9500,1.0526315789473684,0.95
54438,/images/22a464ef-c3da-4d56-b37e-e22e95d945e7.png,1050,742,1166,841,116,99,red blood cell,11484,0.853448275862069,1.1717171717171717
49561,/images/9f33e0ea-065b-4703-9df9-15829b891860.png,539,233,658,340,119,107,red blood cell,12733,0.8991596638655462,1.1121495327102804
29224,/images/6274fe0d-0d71-40be-b61b-f0bd5b5df1e2.png,422,1364,540,1463,118,99,red blood cell,11682,0.8389830508474576,1.1919191919191918
73942,/images/2ae3e6e6-7482-4ab8-ad73-b530b5c2ee3b.png,307,688,389,780,82,92,red blood cell,7544,1.1219512195121952,0.8913043478260869
69007,/images/b5246b58-6f40-4c9e-8024-f49b0ed6bdbd.png,150,495,242,589,92,94,red blood cell,8648,1.0217391304347827,0.9787234042553191
48836,/images/fed6ba05-36a5-45dc-a4e1-9baa7de2c622.png,962,567,1051,652,89,85,red blood cell,7565,0.9550561797752809,1.0470588235294118
18627,/images/c22f7031-9cf8-48ce-b03b-1b12d0db4951.png,615,1022,704,1109,89,87,red blood cell,7743,0.9775280898876404,1.0229885057471264
42990,/images/ff37dd9b-2e3c-444d-9d29-6db186cfa2fb.png,1102,240,1196,336,94,96,red blood cell,9024,1.0212765957446808,0.9791666666666666
20504,/images/cbde7f7e-2458-4dda-9db2-3d5ccf950ced.png,910,648,1030,772,120,124,red blood cell,14880,1.0333333333333334,0.967741935483871
77053,/images/637957ef-df75-4a7b-86d5-9f6e9c042ca2.png,350,64,460,164,110,100,red blood cell,11000,0.9090909090909091,1.1
28727,/images/151f3af5-5e6e-4bcd-9389-4974fc68813e.png,648,475,761,593,113,118,red blood cell,13334,1.0442477876106195,0.9576271186440678
34073,/images/de5d19b7-e670-4ac7-843b-7ce7bcebdf45.png,637,631,752,749,115,118,red blood cell,13570,1.0260869565217392,0.9745762711864406
36477,/images/cfe6086f-eb0b-4cb0-a430-8cd7de6556e2.png,988,136,1083,231,95,95,red blood cell,9025,1.0,1.0
57878,/images/f4c2b43f-a2e7-4746-8034-0b34aebba8ee.png,608,1470,744,1599,136,129,red blood cell,17544,0.9485294117647058,1.054263565891473
4303,/images/882b91b7-5906-4091-bad4-688d4375eeb5.png,928,933,1046,1046,118,113,red blood cell,13334,0.9576271186440678,1.0442477876106195
48815,/images/fed6ba05-36a5-45dc-a4e1-9baa7de2c622.png,614,1486,710,1595,96,109,red blood cell,10464,1.1354166666666667,0.8807339449541285
9576,/images/239f17eb-a2e2-47e9-82e3-fa0d9a70fb9f.png,336,758,470,881,134,123,red blood cell,16482,0.917910447761194,1.089430894308943
21203,/images/0ceb4539-5c4c-487d-9826-452a88b5d537.png,482,228,587,338,105,110,red blood cell,11550,1.0476190476190477,0.9545454545454546
27502,/images/f5869ba8-6253-426b-93f3-82af59a86144.png,982,1102,1097,1212,115,110,red blood cell,12650,0.9565217391304348,1.0454545454545454
63925,/images/5e974892-0ebe-4037-8427-ea8616d6d3b8.png,593,439,704,553,111,114,red blood cell,12654,1.027027027027027,0.9736842105263158
20812,/images/c2ec116f-f091-422c-926c-70b548a8f6ef.png,46,811,142,904,96,93,red blood cell,8928,0.96875,1.032258064516129
52977,/images/e81bf478-27ff-458c-ac30-9e1f8480bc5c.png,664,518,756,621,92,103,red blood cell,9476,1.1195652173913044,0.8932038834951457
79527,/images/161978c3-3a05-47a5-9fee-be7d25693eae.png,322,775,414,869,92,94,red blood cell,8648,1.0217391304347827,0.9787234042553191
58044,/images/a7c91b63-b97c-4f4b-8d34-7ad2b08d7a17.png,1033,786,1144,902,111,116,red blood cell,12876,1.045045045045045,0.9568965517241379
1073,/images/edcb4d77-a4d3-465d-9b59-eb3087766b1c.png,391,448,497,558,106,110,red blood cell,11660,1.0377358490566038,0.9636363636363636
54491,/images/22a464ef-c3da-4d56-b37e-e22e95d945e7.png,1101,497,1175,575,74,78,red blood cell,5772,1.054054054054054,0.9487179487179487
55236,/images/8ad7ba46-5db8-4ba9-b3e0-3cac52f7efc3.png,934,1498,1037,1597,103,99,red blood cell,10197,0.9611650485436893,1.0404040404040404
44989,/images/13bab3c3-3f79-44d9-a287-0ae6d71eff31.png,804,1221,920,1333,116,112,red blood cell,12992,0.9655172413793104,1.0357142857142858
41818,/images/c3b07675-9d02-477c-91fe-f0737867049b.png,323,582,441,705,118,123,red blood cell,14514,1.0423728813559323,0.959349593495935
3255,/images/b901c906-91be-48c4-88ec-2c527544a258.png,1009,1460,1128,1579,119,119,red blood cell,14161,1.0,1.0
68793,/images/aa3ad405-828e-4986-8251-20fd981f34d3.png,311,402,408,507,97,105,red blood cell,10185,1.0824742268041236,0.9238095238095239
65981,/images/25c6cfb1-01d0-4864-87f9-02b7593683c7.png,935,885,1034,995,99,110,red blood cell,10890,1.1111111111111112,0.9
76462,/images/34df8890-272d-423a-ae78-ff8d068d3306.png,577,1090,662,1189,85,99,red blood cell,8415,1.1647058823529413,0.8585858585858586
78304,/images/24115f58-a7d6-4022-a95a-86b515a78d3e.png,314,398,435,516,121,118,red blood cell,14278,0.9752066115702479,1.0254237288135593
6113,/images/c147584d-4c61-412a-bdaf-b02b22c18708.png,0,718,118,835,118,117,red blood cell,13806,0.9915254237288136,1.0085470085470085
21673,/images/66183740-e1e5-43c9-8539-a87028bb3621.png,496,766,610,869,114,103,red blood cell,11742,0.9035087719298246,1.1067961165048543
76422,/images/34df8890-272d-423a-ae78-ff8d068d3306.png,419,680,502,769,83,89,red blood cell,7387,1.072289156626506,0.9325842696629213
56015,/images/177a3141-fa93-426a-9b52-7da71547ce44.png,57,1287,155,1384,98,97,red blood cell,9506,0.9897959183673469,1.0103092783505154
76894,/images/2165fe38-b474-467d-be11-d1d728085efd.png,1020,194,1120,286,100,92,red blood cell,9200,0.92,1.0869565217391304
379,/images/7c66d2fd-68ee-4628-b860-9d7ad25b2a80.png,401,842,514,939,113,97,red blood cell,10961,0.8584070796460177,1.1649484536082475
63265,/images/d3283f5b-3b3a-40ea-800b-79960ca851cb.png,106,313,202,426,96,113,red blood cell,10848,1.1770833333333333,0.8495575221238938
54729,/images/10891eed-b0f2-4dd0-90cb-da185f6761b2.png,900,1029,1019,1146,119,117,red blood cell,13923,0.9831932773109243,1.017094017094017
36834,/images/dfac6c92-8f0f-429a-8caf-9b7732bf78da.png,724,294,857,407,133,113,red blood cell,15029,0.849624060150376,1.176991150442478
35312,/images/516bf1d5-5d00-4985-926c-3993e9bc3ff5.png,675,911,808,1027,133,116,red blood cell,15428,0.8721804511278195,1.146551724137931
73251,/images/67a4fb91-6f38-4ca2-8f20-6b2f5f1b29a7.png,205,1388,303,1490,98,102,red blood cell,9996,1.0408163265306123,0.9607843137254902
79308,/images/05ac7b2a-6a77-4464-926b-8570f7c01693.png,1015,1222,1112,1308,97,86,red blood cell,8342,0.8865979381443299,1.127906976744186
30325,/images/cecbf663-0751-4e7f-b298-770c88afc2c1.png,839,682,944,773,105,91,red blood cell,9555,0.8666666666666667,1.1538461538461537
61052,/images/6e86206f-dafe-4c28-bacc-7b83b2d40f0c.png,324,1352,452,1467,128,115,red blood cell,14720,0.8984375,1.1130434782608696
62803,/images/631340cc-cedf-4bca-a3d8-a0731a5482b4.png,939,1374,1071,1488,132,114,red blood cell,15048,0.8636363636363636,1.1578947368421053
53683,/images/6f67a66b-56ec-4c36-ae7c-f250d3b86a23.png,120,1212,233,1321,113,109,red blood cell,12317,0.9646017699115044,1.036697247706422
29202,/images/6274fe0d-0d71-40be-b61b-f0bd5b5df1e2.png,882,1269,964,1351,82,82,red blood cell,6724,1.0,1.0
64799,/images/a74b6d6a-7e04-40ac-9292-d62f13f7ded3.png,414,649,496,744,82,95,red blood cell,7790,1.1585365853658536,0.8631578947368421
43810,/images/c84edeb4-311c-4e82-88f9-ae0505b3ad13.png,532,731,645,846,113,115,red blood cell,12995,1.0176991150442478,0.9826086956521739
2202,/images/5bf91ff9-80df-49c0-9c3e-599357d95530.png,960,145,1080,258,120,113,red blood cell,13560,0.9416666666666667,1.0619469026548674
24317,/images/4d8a4ce8-0f9c-4f21-8844-4cf0e5514bbf.png,253,232,372,348,119,116,red blood cell,13804,0.9747899159663865,1.0258620689655173
38714,/images/b5acf759-1115-42f0-a753-656736192528.png,849,256,976,369,127,113,red blood cell,14351,0.889763779527559,1.1238938053097345
73361,/images/c890ee00-daa5-4b20-9cd5-930748ecc4e0.png,514,441,609,538,95,97,red blood cell,9215,1.0210526315789474,0.979381443298969
25727,/images/412c9fa5-fcf4-402b-b1e4-3271f775058e.png,623,1198,741,1322,118,124,red blood cell,14632,1.0508474576271187,0.9516129032258065
14004,/images/eaf4b781-b3aa-41ce-8c5e-287979b4e15a.png,746,507,856,613,110,106,red blood cell,11660,0.9636363636363636,1.0377358490566038
34561,/images/3af90874-59f3-4f0c-a7e6-cc889e80c605.png,953,565,1080,681,127,116,red blood cell,14732,0.9133858267716536,1.0948275862068966
1640,/images/7094c11a-1e62-4f98-894e-d17d138a88e9.png,652,263,747,366,95,103,red blood cell,9785,1.0842105263157895,0.9223300970873787
9042,/images/ef815e3a-02a6-4cf8-9262-45bc74c50b00.png,1084,297,1187,406,103,109,red blood cell,11227,1.058252427184466,0.944954128440367
19493,/images/a85cd1ae-0c94-4387-8305-84ab8d96d137.png,548,680,677,791,129,111,red blood cell,14319,0.8604651162790697,1.162162162162162
3725,/images/dacf7e3f-1d8c-42a0-8539-3abe3971c956.png,523,1254,640,1390,117,136,red blood cell,15912,1.1623931623931625,0.8602941176470589
8077,/images/694222bb-cddf-469a-9526-f873c6fba58e.png,626,1507,711,1597,85,90,red blood cell,7650,1.0588235294117647,0.9444444444444444
79018,/images/6144887d-a1c1-46db-91a1-f7ff5bf8c8a5.png,190,1298,273,1377,83,79,red blood cell,6557,0.9518072289156626,1.0506329113924051
66875,/images/9acf303a-fcba-4e52-be3e-8d061aa5e72a.png,610,986,708,1075,98,89,red blood cell,8722,0.9081632653061225,1.101123595505618
15749,/images/64113b22-03b1-4ab8-89ab-b2f32154fbbd.png,354,980,489,1100,135,120,red blood cell,16200,0.8888888888888888,1.125
4450,/images/21ea4841-8998-4c04-b345-bc99cd8ecee6.png,148,306,263,421,115,115,red blood cell,13225,1.0,1.0
79464,/images/a2fc0093-8645-43c7-bdee-ec8ca9484815.png,3,1438,110,1544,107,106,red blood cell,11342,0.9906542056074766,1.009433962264151
66939,/images/9acf303a-fcba-4e52-be3e-8d061aa5e72a.png,104,1357,195,1436,91,79,red blood cell,7189,0.8681318681318682,1.1518987341772151
5025,/images/b7d0ae11-a393-4aec-8f68-6ba07147f78a.png,208,719,331,834,123,115,red blood cell,14145,0.9349593495934959,1.0695652173913044
57127,/images/7d041c38-11f2-4186-8a24-29d7d0f5c3cf.png,315,1126,413,1218,98,92,red blood cell,9016,0.9387755102040817,1.065217391304348
13236,/images/711f6b3f-cd63-46d1-834a-bc8e9aa9b43e.png,884,933,971,1031,87,98,red blood cell,8526,1.1264367816091954,0.8877551020408163
21185,/images/fb05b297-180a-4171-b633-09d5616d7534.png,19,1106,115,1223,96,117,red blood cell,11232,1.21875,0.8205128205128205
20939,/images/c2ec116f-f091-422c-926c-70b548a8f6ef.png,930,1444,1019,1527,89,83,red blood cell,7387,0.9325842696629213,1.072289156626506
41896,/images/783ae4ad-6a35-4b3c-b19f-754974b67b2d.png,111,925,224,1041,113,116,red blood cell,13108,1.0265486725663717,0.9741379310344828
55897,/images/afd39466-aafa-4d81-9520-483727418723.png,1029,1406,1125,1503,96,97,red blood cell,9312,1.0104166666666667,0.9896907216494846
8177,/images/694222bb-cddf-469a-9526-f873c6fba58e.png,980,260,1074,352,94,92,red blood cell,8648,0.9787234042553191,1.0217391304347827
69366,/images/2ac343e4-c889-47c1-8fe2-461b626def76.png,587,221,709,328,122,107,red blood cell,13054,0.8770491803278688,1.1401869158878504
33466,/images/9bd40bc6-4949-42d3-b38f-d60422932f65.png,166,1125,286,1247,120,122,red blood cell,14640,1.0166666666666666,0.9836065573770492
52869,/images/58f7e1da-3478-48f4-958c-e9b1cb8696aa.png,917,1240,1033,1336,116,96,red blood cell,11136,0.8275862068965517,1.2083333333333333
73940,/images/2ae3e6e6-7482-4ab8-ad73-b530b5c2ee3b.png,942,918,1039,1027,97,109,red blood cell,10573,1.1237113402061856,0.8899082568807339
40082,/images/6fd30823-3b77-40c9-ba5d-e1eda9660674.png,790,850,915,958,125,108,red blood cell,13500,0.864,1.1574074074074074
44869,/images/83ec8923-6232-40d7-ba1f-a1b8bf7cb66c.png,158,541,266,646,108,105,red blood cell,11340,0.9722222222222222,1.0285714285714285
13824,/images/345cb914-7583-49df-96e3-3cf19c2ba8f1.png,502,1173,632,1298,130,125,red blood cell,16250,0.9615384615384616,1.04
60186,/images/214f1d15-a081-476e-992d-6c3a77f03d59.png,695,1366,794,1464,99,98,red blood cell,9702,0.98989898989899,1.010204081632653
65241,/images/45ac9409-5537-44ed-90cd-5c8a1ae0e1e0.png,1025,476,1131,569,106,93,red blood cell,9858,0.8773584905660378,1.1397849462365592
66219,/images/14005767-9296-4b48-8a9d-bbe9b2040005.png,856,152,968,262,112,110,red blood cell,12320,0.9821428571428571,1.018181818181818
5046,/images/b7d0ae11-a393-4aec-8f68-6ba07147f78a.png,1068,1195,1176,1301,108,106,red blood cell,11448,0.9814814814814815,1.0188679245283019
14028,/images/eaf4b781-b3aa-41ce-8c5e-287979b4e15a.png,635,984,726,1081,91,97,red blood cell,8827,1.065934065934066,0.9381443298969072
69817,/images/2bd15b6e-fe2d-49f3-b394-940d024d1f91.png,1079,641,1176,729,97,88,red blood cell,8536,0.9072164948453608,1.1022727272727273
9405,/images/e3a4b3e7-9500-4b6c-a402-b6d3f45e714b.png,881,752,988,852,107,100,red blood cell,10700,0.9345794392523364,1.07
56337,/images/4372709c-f356-4906-be17-415384d916e8.png,770,72,871,179,101,107,red blood cell,10807,1.0594059405940595,0.9439252336448598
28144,/images/cd2774a0-dab2-4d68-aae9-7568b9f3d2a6.png,92,1022,201,1145,109,123,red blood cell,13407,1.128440366972477,0.8861788617886179
18630,/images/c22f7031-9cf8-48ce-b03b-1b12d0db4951.png,796,1308,903,1413,107,105,red blood cell,11235,0.9813084112149533,1.019047619047619
40690,/images/252071ac-e9f2-41d2-abbb-87ef01b8a997.png,938,971,1024,1066,86,95,red blood cell,8170,1.1046511627906976,0.9052631578947369
63997,/images/5e974892-0ebe-4037-8427-ea8616d6d3b8.png,452,1264,565,1355,113,91,red blood cell,10283,0.8053097345132744,1.2417582417582418
60552,/images/58065a0c-d4c5-40fd-bcdc-037f61788482.png,103,952,205,1051,102,99,red blood cell,10098,0.9705882352941176,1.0303030303030303
698,/images/e61e6af2-7f8b-47b0-bbe7-acb2ed0299ab.png,792,1020,894,1134,102,114,red blood cell,11628,1.1176470588235294,0.8947368421052632
67899,/images/41ebf9a1-24dc-454e-8bf8-508218f5ee57.png,288,838,381,935,93,97,red blood cell,9021,1.043010752688172,0.9587628865979382
17846,/images/eb77e4a9-acb0-4d83-8055-2c5fcaa54b45.png,704,652,817,765,113,113,red blood cell,12769,1.0,1.0
37444,/images/c6530038-6d4e-49e1-8427-d1d3acc9fa21.png,90,881,216,987,126,106,red blood cell,13356,0.8412698412698413,1.1886792452830188
79373,/images/dcb21739-3c36-459d-b3cc-1be5871d6fe7.png,345,875,447,959,102,84,red blood cell,8568,0.8235294117647058,1.2142857142857142
37514,/images/205306da-0ed8-475a-ace6-f2f81d4be88a.png,37,376,154,480,117,104,red blood cell,12168,0.8888888888888888,1.125
50095,/images/e98baeb2-aa58-4cce-8c61-66685dd2b239.png,623,1177,755,1287,132,110,red blood cell,14520,0.8333333333333334,1.2
67994,/images/bcaefb02-682a-41b9-acc7-e6cc010f5b30.png,946,278,1052,387,106,109,red blood cell,11554,1.028301886792453,0.9724770642201835
41009,/images/8e078333-8fa0-45be-a46e-fa05708cb365.png,947,437,1080,548,133,111,red blood cell,14763,0.8345864661654135,1.1981981981981982
46721,/images/da111ca5-520f-4ea8-97ad-ae5fce58ee91.png,1015,1079,1124,1172,109,93,red blood cell,10137,0.8532110091743119,1.1720430107526882
42257,/images/ca734448-0d52-42fa-b41c-17b2939e58ae.png,490,941,615,1042,125,101,red blood cell,12625,0.808,1.2376237623762376
64788,/images/a74b6d6a-7e04-40ac-9292-d62f13f7ded3.png,1012,849,1123,947,111,98,red blood cell,10878,0.8828828828828829,1.1326530612244898
60389,/images/1c87b997-a8e6-48ca-bf40-19b9a7fd6a96.png,2,806,82,901,80,95,red blood cell,7600,1.1875,0.8421052631578947
63648,/images/d9c9479e-f1ea-4d6e-861f-843ff9a90d19.png,149,769,261,886,112,117,red blood cell,13104,1.0446428571428572,0.9572649572649573
69965,/images/089c9744-f906-41d8-908d-1e37919a8658.png,630,848,729,970,99,122,red blood cell,12078,1.2323232323232323,0.8114754098360656
54525,/images/db871d17-28fd-4ceb-b421-e4e4afa0a7a0.png,454,967,567,1093,113,126,red blood cell,14238,1.1150442477876106,0.8968253968253969
50432,/images/a2de1248-7bc0-44dc-b508-70a357eedd68.png,831,110,953,231,122,121,red blood cell,14762,0.9918032786885246,1.0082644628099173
78554,/images/c5084fb8-2b62-464c-8a77-1a07ea653266.png,13,669,129,788,116,119,red blood cell,13804,1.0258620689655173,0.9747899159663865
63943,/images/5e974892-0ebe-4037-8427-ea8616d6d3b8.png,1093,834,1192,953,99,119,red blood cell,11781,1.202020202020202,0.8319327731092437
2328,/images/fe851c88-692d-4199-87e0-d19d9c4eb591.png,295,525,396,633,101,108,red blood cell,10908,1.0693069306930694,0.9351851851851852
54004,/images/5e4f7425-11e6-4f9e-be2d-5a27deb9d1b4.png,32,375,146,482,114,107,red blood cell,12198,0.9385964912280702,1.0654205607476634
51996,/images/4f62b14e-c6f4-4155-8f50-881558f83fae.png,441,1284,553,1383,112,99,red blood cell,11088,0.8839285714285714,1.1313131313131313
52386,/images/a2a20600-f851-4db7-90f9-6f7be027c8b5.png,1045,846,1161,968,116,122,red blood cell,14152,1.0517241379310345,0.9508196721311475
67102,/images/4272cbd7-5b0a-4bf7-b690-dee1c128f07b.png,284,1231,381,1322,97,91,red blood cell,8827,0.9381443298969072,1.065934065934066
60250,/images/abf4cf2a-4532-4772-9f0f-9e123cc1713d.png,552,1160,650,1259,98,99,red blood cell,9702,1.010204081632653,0.98989898989899
69555,/images/4a49841f-216c-4815-8140-b8762c4f6603.png,935,387,1050,502,115,115,red blood cell,13225,1.0,1.0
41779,/images/28bd16ba-2bcf-46af-b889-41b78d2a50c0.png,906,1047,1023,1167,117,120,red blood cell,14040,1.0256410256410255,0.975
1930,/images/02ea7aa8-c142-4a3d-939f-e77689741341.png,823,145,928,270,105,125,red blood cell,13125,1.1904761904761905,0.84
7583,/images/21cc498b-8cb2-42ed-8f80-bfa27b86ef11.png,727,1272,850,1394,123,122,red blood cell,15006,0.991869918699187,1.0081967213114753
39571,/images/5a631871-2fc7-4a68-9c39-f3b9a0bf4a04.png,593,261,694,362,101,101,red blood cell,10201,1.0,1.0
43437,/images/367663b2-5d09-4020-ab0a-c2200e7a1c8c.png,181,825,301,954,120,129,red blood cell,15480,1.075,0.9302325581395349
60685,/images/45651e76-4bd0-45e5-895b-edec65f51987.png,673,440,785,542,112,102,red blood cell,11424,0.9107142857142857,1.0980392156862746
37316,/images/4d88e2d2-5aad-410c-9bbc-702ee9496995.png,578,798,706,920,128,122,red blood cell,15616,0.953125,1.0491803278688525
46997,/images/9ebd623d-5534-4dd9-bff8-cdedf322db35.png,1091,642,1193,753,102,111,red blood cell,11322,1.088235294117647,0.918918918918919
31215,/images/1976cd04-d24f-457c-b423-7e4cdb05de9e.png,900,1257,999,1369,99,112,red blood cell,11088,1.1313131313131313,0.8839285714285714
67958,/images/bcaefb02-682a-41b9-acc7-e6cc010f5b30.png,448,20,565,137,117,117,red blood cell,13689,1.0,1.0
35167,/images/bfc61c48-685d-470b-86b1-e4c7eb85c4fd.png,978,165,1112,302,134,137,red blood cell,18358,1.0223880597014925,0.9781021897810219
62528,/images/7dfbfeaf-e3b1-4159-8dcd-d7f731280ac8.png,413,116,512,213,99,97,red blood cell,9603,0.9797979797979798,1.0206185567010309
29908,/images/f2a8a483-b254-43aa-817f-7d525adb8911.png,1075,1338,1190,1459,115,121,red blood cell,13915,1.0521739130434782,0.9504132231404959
38559,/images/c3ae7090-fc68-41b4-85a1-8d9bce9825a7.png,947,1253,1073,1380,126,127,red blood cell,16002,1.007936507936508,0.9921259842519685
78349,/images/24115f58-a7d6-4022-a95a-86b515a78d3e.png,780,472,878,571,98,99,red blood cell,9702,1.010204081632653,0.98989898989899
63903,/images/5e974892-0ebe-4037-8427-ea8616d6d3b8.png,539,881,654,973,115,92,red blood cell,10580,0.8,1.25
43032,/images/1345dc89-a3d9-4b71-8a75-b3bff01ba518.png,957,275,1063,370,106,95,red blood cell,10070,0.8962264150943396,1.1157894736842104
41544,/images/0fcd1ebe-ee4a-40a0-b787-29cee18bfa1b.png,863,39,969,158,106,119,red blood cell,12614,1.1226415094339623,0.8907563025210085
69983,/images/3e36698f-8c09-4c8b-8948-737310bf97e5.png,313,963,427,1083,114,120,red blood cell,13680,1.0526315789473684,0.95
10945,/images/c442e2d6-aaf9-417a-9905-4737a1115f33.png,201,455,321,567,120,112,red blood cell,13440,0.9333333333333333,1.0714285714285714
45051,/images/13bab3c3-3f79-44d9-a287-0ae6d71eff31.png,652,544,742,656,90,112,red blood cell,10080,1.2444444444444445,0.8035714285714286
18373,/images/39cc33be-d752-40fe-b7a8-2e69a3517205.png,424,411,539,537,115,126,red blood cell,14490,1.0956521739130434,0.9126984126984127
10441,/images/46a2d369-4bea-4405-ac78-91bbe130b9a7.png,236,1303,334,1390,98,87,red blood cell,8526,0.8877551020408163,1.1264367816091954
78211,/images/2bed2796-75a9-4d93-bb2d-e3ccbe1a5cbe.png,939,1216,1042,1306,103,90,red blood cell,9270,0.8737864077669902,1.1444444444444444
65289,/images/24418314-f7a4-49fc-a03e-ec597ca6796e.png,480,260,588,378,108,118,red blood cell,12744,1.0925925925925926,0.9152542372881356
65301,/images/24418314-f7a4-49fc-a03e-ec597ca6796e.png,667,233,785,356,118,123,red blood cell,14514,1.0423728813559323,0.959349593495935
37881,/images/56a57a8d-c9b9-432a-a3b0-32a09355806c.png,228,1227,327,1330,99,103,red blood cell,10197,1.0404040404040404,0.9611650485436893
60285,/images/7abc0d26-dd66-4ef4-8c4e-4a661e589a7f.png,911,1460,1027,1573,116,113,red blood cell,13108,0.9741379310344828,1.0265486725663717
41663,/images/0fcd1ebe-ee4a-40a0-b787-29cee18bfa1b.png,887,1193,985,1282,98,89,red blood cell,8722,0.9081632653061225,1.101123595505618
12986,/images/b10ea12f-cd36-4f2c-994a-67d1665269ab.png,928,601,1010,690,82,89,red blood cell,7298,1.0853658536585367,0.9213483146067416
61662,/images/a3c0a876-be12-4ede-8aed-18b32a64401b.png,421,939,513,1033,92,94,red blood cell,8648,1.0217391304347827,0.9787234042553191
60117,/images/ec60ab26-3343-4c5f-9667-cdae999c7d86.png,1058,207,1155,296,97,89,red blood cell,8633,0.9175257731958762,1.0898876404494382
35259,/images/a9159b11-ba49-4885-902e-00c8d5095b98.png,602,672,702,779,100,107,red blood cell,10700,1.07,0.9345794392523364
25643,/images/770b8ca4-8377-479b-9ad5-5455ec3b44f8.png,308,1287,422,1421,114,134,red blood cell,15276,1.1754385964912282,0.8507462686567164
79840,/images/a054a8e2-55f2-4508-97df-207f76b89be2.png,778,930,894,1047,116,117,red blood cell,13572,1.0086206896551724,0.9914529914529915
48579,/images/f3d84be2-8af0-4d62-9f72-23d3dc08cbbe.png,0,1048,110,1143,110,95,red blood cell,10450,0.8636363636363636,1.1578947368421053
23768,/images/6b2ff7ca-c5b3-415c-9481-7b14efc6d7ef.png,521,289,631,393,110,104,red blood cell,11440,0.9454545454545454,1.0576923076923077
26631,/images/16ec6e1f-5020-40b3-ba26-51c340d03ee7.png,739,1098,870,1231,131,133,red blood cell,17423,1.015267175572519,0.9849624060150376
24736,/images/78a5d1c3-44dd-44bc-ad5b-5e25bdcc4fae.png,312,1461,424,1574,112,113,red blood cell,12656,1.0089285714285714,0.9911504424778761
76380,/images/3dad6483-ac30-4d2b-b045-9f24fe6ff75e.png,598,923,718,1023,120,100,red blood cell,12000,0.8333333333333334,1.2
38713,/images/b5acf759-1115-42f0-a753-656736192528.png,108,1120,201,1215,93,95,red blood cell,8835,1.021505376344086,0.9789473684210527
76566,/images/38c69905-8a4f-451a-8d0a-b855dc88dd16.png,1078,1421,1178,1515,100,94,red blood cell,9400,0.94,1.0638297872340425
77087,/images/a0e2ef53-d39b-40cf-b8b6-4b148ac339ec.png,868,1320,968,1436,100,116,red blood cell,11600,1.16,0.8620689655172413
67975,/images/bcaefb02-682a-41b9-acc7-e6cc010f5b30.png,1,637,75,725,74,88,red blood cell,6512,1.1891891891891893,0.8409090909090909
60092,/images/e63e1607-f344-43d6-a0d8-e10cf2e5054a.png,934,558,1046,665,112,107,red blood cell,11984,0.9553571428571429,1.0467289719626167
41482,/images/c4494d4f-732f-431a-8a9d-62403f0b74fe.png,983,69,1097,204,114,135,red blood cell,15390,1.1842105263157894,0.8444444444444444
49323,/images/99b13257-b9d9-422f-8262-802da0bdc510.png,706,1405,792,1503,86,98,red blood cell,8428,1.1395348837209303,0.8775510204081632
6856,/images/b21f6c6e-4b45-407a-b4c7-034a115f3ee4.png,82,254,209,380,127,126,red blood cell,16002,0.9921259842519685,1.007936507936508
71601,/images/390ad256-e1ed-476a-9f14-2dc34e0da632.png,1014,404,1147,537,133,133,red blood cell,17689,1.0,1.0
63350,/images/9f4bc3b4-abb0-4bcb-baa8-ec9f25e2b9c6.png,787,1428,878,1528,91,100,red blood cell,9100,1.098901098901099,0.91
40121,/images/b34e65f6-c32e-42f1-a437-4a037c75a231.png,421,1343,526,1436,105,93,red blood cell,9765,0.8857142857142857,1.1290322580645162
18116,/images/947348fe-4c70-468e-8009-3c14daeca69b.png,225,316,325,430,100,114,red blood cell,11400,1.14,0.8771929824561403
75738,/images/d12c5f45-6b20-46d6-a66f-c5a4683c25b3.png,172,1223,278,1315,106,92,red blood cell,9752,0.8679245283018868,1.1521739130434783
38591,/images/f8b14fc4-dd6b-4ad0-a96d-c62845f48681.png,956,488,1081,599,125,111,red blood cell,13875,0.888,1.1261261261261262
34995,/images/2b369d75-9c55-43e0-b352-d981aea544e3.png,504,777,620,896,116,119,red blood cell,13804,1.0258620689655173,0.9747899159663865
36816,/images/dfac6c92-8f0f-429a-8caf-9b7732bf78da.png,728,1120,829,1216,101,96,red blood cell,9696,0.9504950495049505,1.0520833333333333
10661,/images/20d4f65e-6c63-433a-935c-d568d577967b.png,965,1435,1079,1557,114,122,red blood cell,13908,1.0701754385964912,0.9344262295081968
38562,/images/c3ae7090-fc68-41b4-85a1-8d9bce9825a7.png,994,1425,1112,1533,118,108,red blood cell,12744,0.9152542372881356,1.0925925925925926
14458,/images/3b13e20f-ec0d-44ec-b2f4-eaebfa09150e.png,973,1070,1082,1180,109,110,red blood cell,11990,1.0091743119266054,0.990909090909091
43265,/images/36569710-a574-40be-ad42-897a6e74a128.png,342,649,453,755,111,106,red blood cell,11766,0.954954954954955,1.0471698113207548
28948,/images/b12ae3b1-613c-4c0e-9163-3c5cc314abf5.png,835,1037,966,1168,131,131,red blood cell,17161,1.0,1.0
30621,/images/f939782b-f5a2-40a3-9c22-6c6d7e18edc3.png,797,358,904,477,107,119,red blood cell,12733,1.1121495327102804,0.8991596638655462
74592,/images/bbedfcbe-9528-4ba9-9d86-4ebba7589ac5.png,181,1296,278,1395,97,99,red blood cell,9603,1.0206185567010309,0.9797979797979798
4912,/images/755e5bf8-e8e1-492b-a32f-f7d87cccaa40.png,806,670,925,791,119,121,red blood cell,14399,1.0168067226890756,0.9834710743801653
79720,/images/03b9d6ad-39ca-4097-a98b-77f02b3c00a7.png,832,465,920,542,88,77,red blood cell,6776,0.875,1.1428571428571428
40484,/images/db249e5a-4142-432c-8288-bacd10d7273d.png,997,1382,1085,1489,88,107,red blood cell,9416,1.2159090909090908,0.822429906542056
9698,/images/53afd70c-08a7-4b9a-b137-7003b2ecbeab.png,611,81,730,200,119,119,red blood cell,14161,1.0,1.0
59505,/images/6bfe6a90-8a69-4171-8e7f-42dc9417c6d9.png,754,949,867,1061,113,112,red blood cell,12656,0.9911504424778761,1.0089285714285714
63726,/images/06401963-8b02-46c5-ab2a-3d70bd01623f.png,534,959,649,1069,115,110,red blood cell,12650,0.9565217391304348,1.0454545454545454
70385,/images/4876c9d0-b386-48fb-84e8-91bf87529161.png,727,680,823,775,96,95,red blood cell,9120,0.9895833333333334,1.0105263157894737
38854,/images/d79b4e90-c45d-4f5d-a498-49c3e323c291.png,650,1217,759,1324,109,107,red blood cell,11663,0.981651376146789,1.0186915887850467
12538,/images/8e4bdd0d-1c72-4836-ae3e-05e2e50e4983.png,696,1335,792,1438,96,103,red blood cell,9888,1.0729166666666667,0.9320388349514563
39631,/images/04d21589-b777-43c2-86b5-038cbf8c3a4e.png,296,1279,411,1397,115,118,red blood cell,13570,1.0260869565217392,0.9745762711864406
42634,/images/184b376b-03cb-4c2d-af51-fc1a62196293.png,37,5,139,105,102,100,red blood cell,10200,0.9803921568627451,1.02
57321,/images/aaade430-4c49-4038-97b7-f8cdd937db57.png,715,274,814,375,99,101,red blood cell,9999,1.02020202020202,0.9801980198019802
35001,/images/2b369d75-9c55-43e0-b352-d981aea544e3.png,102,1390,213,1495,111,105,red blood cell,11655,0.9459459459459459,1.0571428571428572
34714,/images/6294153c-6db3-4f2b-a8ff-9c087225e737.png,969,248,1089,365,120,117,red blood cell,14040,0.975,1.0256410256410255
63938,/images/5e974892-0ebe-4037-8427-ea8616d6d3b8.png,8,526,128,623,120,97,red blood cell,11640,0.8083333333333333,1.2371134020618557
10268,/images/f91670db-be74-474c-bd72-68120aed4756.png,868,1473,959,1585,91,112,red blood cell,10192,1.2307692307692308,0.8125
22319,/images/49b03a6e-6b26-4a96-a061-e05647a02138.png,165,1099,255,1191,90,92,red blood cell,8280,1.0222222222222221,0.9782608695652174
3034,/images/5a386082-397f-4524-a6f9-c2b8efe5014d.png,785,238,909,339,124,101,red blood cell,12524,0.8145161290322581,1.2277227722772277
65425,/images/b523daee-317b-461d-bdc1-07b4add4d488.png,1013,613,1112,703,99,90,red blood cell,8910,0.9090909090909091,1.1
58020,/images/a7c91b63-b97c-4f4b-8d34-7ad2b08d7a17.png,543,496,655,614,112,118,red blood cell,13216,1.0535714285714286,0.9491525423728814
46664,/images/da111ca5-520f-4ea8-97ad-ae5fce58ee91.png,463,616,568,725,105,109,red blood cell,11445,1.0380952380952382,0.963302752293578
42178,/images/04c07425-57c7-415c-a0bc-36857bbd4049.png,406,420,526,536,120,116,red blood cell,13920,0.9666666666666667,1.0344827586206897
52904,/images/abb2f9d6-26fa-4328-983c-959ef6717c05.png,655,1035,752,1130,97,95,red blood cell,9215,0.979381443298969,1.0210526315789474
39085,/images/7bde7de1-889b-4218-b0e1-e2c04f6a7986.png,70,322,181,439,111,117,red blood cell,12987,1.054054054054054,0.9487179487179487
29449,/images/8cc6fe77-5f2f-4670-b4ac-1b49550241a8.png,922,72,1028,191,106,119,red blood cell,12614,1.1226415094339623,0.8907563025210085
18918,/images/e9e78ff8-831b-46e9-9785-3eee9acbfcd8.png,505,230,612,332,107,102,red blood cell,10914,0.9532710280373832,1.0490196078431373
72230,/images/7d4d0646-26b5-46fa-ab25-452d986e887b.png,1093,961,1176,1054,83,93,red blood cell,7719,1.1204819277108433,0.8924731182795699
16412,/images/e474a20b-2769-48f1-a520-4f6ef5a0dbf5.png,812,1180,913,1287,101,107,red blood cell,10807,1.0594059405940595,0.9439252336448598
18806,/images/cc882eae-a341-4783-bd19-8bdedf798538.png,174,525,273,624,99,99,red blood cell,9801,1.0,1.0
40561,/images/29861cf9-9a1e-4733-8309-4bd10706b4a3.png,412,1377,542,1497,130,120,red blood cell,15600,0.9230769230769231,1.0833333333333333
49172,/images/a9daf82a-a46d-4296-bd72-2c374ed0a193.png,177,547,285,653,108,106,red blood cell,11448,0.9814814814814815,1.0188679245283019
14136,/images/eaf4b781-b3aa-41ce-8c5e-287979b4e15a.png,825,1131,917,1218,92,87,red blood cell,8004,0.9456521739130435,1.0574712643678161
44776,/images/6795acae-e84d-4e97-b9a1-b4f4f0a72cfd.png,274,714,389,830,115,116,red blood cell,13340,1.008695652173913,0.9913793103448276
52499,/images/d1144956-5a0c-4bd2-b67d-8498c82d6a12.png,601,523,695,623,94,100,red blood cell,9400,1.0638297872340425,0.94
65134,/images/5e042380-6ef2-496f-8231-0ca550fbfa71.png,517,1177,637,1287,120,110,red blood cell,13200,0.9166666666666666,1.0909090909090908
28433,/images/a6d85204-24b8-4b23-a8b1-c3e8b93f9f22.png,1061,1332,1146,1416,85,84,red blood cell,7140,0.9882352941176471,1.0119047619047619
1944,/images/b95ceeeb-8870-4492-9037-2091ff268c5a.png,143,894,250,1013,107,119,red blood cell,12733,1.1121495327102804,0.8991596638655462
62674,/images/f7a4334a-4332-4de8-b39b-22da907976f2.png,671,229,748,304,77,75,red blood cell,5775,0.974025974025974,1.0266666666666666
79730,/images/03b9d6ad-39ca-4097-a98b-77f02b3c00a7.png,358,600,466,712,108,112,red blood cell,12096,1.037037037037037,0.9642857142857143
45403,/images/e4eea7ea-8989-46a9-9c98-25a178146b28.png,197,341,279,422,82,81,red blood cell,6642,0.9878048780487805,1.0123456790123457
24430,/images/b78ba2c8-ecb3-45b2-9cda-2c8088fa95d1.png,8,763,135,894,127,131,red blood cell,16637,1.031496062992126,0.9694656488549618
40696,/images/252071ac-e9f2-41d2-abbb-87ef01b8a997.png,368,89,477,186,109,97,red blood cell,10573,0.8899082568807339,1.1237113402061856
9648,/images/d997337e-e4a8-4ef0-b8ba-975e6c43b62c.png,754,1239,881,1359,127,120,red blood cell,15240,0.9448818897637795,1.0583333333333333
20267,/images/c66cb6b2-1480-446a-a9d2-b8032a3de0d7.png,291,70,400,180,109,110,red blood cell,11990,1.0091743119266054,0.990909090909091
9663,/images/d997337e-e4a8-4ef0-b8ba-975e6c43b62c.png,279,52,395,180,116,128,red blood cell,14848,1.103448275862069,0.90625
80055,/images/99e979d4-ee97-4d7f-9da6-00bead40db4d.png,1023,828,1134,935,111,107,red blood cell,11877,0.963963963963964,1.0373831775700935
50589,/images/e98ea067-82b5-4a0d-87bf-b4bbdc10ddab.png,267,1495,378,1600,111,105,red blood cell,11655,0.9459459459459459,1.0571428571428572
4307,/images/882b91b7-5906-4091-bad4-688d4375eeb5.png,622,569,726,663,104,94,red blood cell,9776,0.9038461538461539,1.1063829787234043
2288,/images/fe851c88-692d-4199-87e0-d19d9c4eb591.png,956,866,1061,964,105,98,red blood cell,10290,0.9333333333333333,1.0714285714285714
13629,/images/d47cd049-d78b-4ba3-a7d4-399be4dd1dde.png,710,950,838,1081,128,131,red blood cell,16768,1.0234375,0.9770992366412213
51273,/images/216f9d43-6869-4ba1-9106-4f5ea6aac223.png,136,155,225,251,89,96,red blood cell,8544,1.0786516853932584,0.9270833333333334
4873,/images/61cd8c7d-394d-42d3-9ed4-e09559110bed.png,523,1279,650,1392,127,113,red blood cell,14351,0.889763779527559,1.1238938053097345
845,/images/c7a2d648-47cb-4b39-afa4-1b7fcfe51934.png,877,267,990,384,113,117,red blood cell,13221,1.0353982300884956,0.9658119658119658
37791,/images/fe0c5e48-f65e-488c-9c3c-1ea7c7835c0c.png,183,1012,298,1125,115,113,red blood cell,12995,0.9826086956521739,1.0176991150442478
16812,/images/4823c1fe-a7f9-4b92-959f-0d9be09cd14b.png,499,64,613,180,114,116,red blood cell,13224,1.0175438596491229,0.9827586206896551
4991,/images/2cc3c4ad-670f-41b6-8910-0704cbc192ef.png,679,896,788,1005,109,109,red blood cell,11881,1.0,1.0
73099,/images/f39e2289-fedd-4d12-9e64-ffdafb89247e.png,1046,1193,1155,1316,109,123,red blood cell,13407,1.128440366972477,0.8861788617886179
26078,/images/71925778-a26e-483e-a07c-f3aaf740122a.png,369,585,501,708,132,123,red blood cell,16236,0.9318181818181818,1.0731707317073171
30524,/images/5955289d-19e5-45ef-a012-c8ea08ef45e2.png,485,670,609,774,124,104,red blood cell,12896,0.8387096774193549,1.1923076923076923
47880,/images/ab27173b-6e30-4957-bd68-29194328fd39.png,511,1266,617,1379,106,113,red blood cell,11978,1.0660377358490567,0.9380530973451328
12800,/images/b634137b-bc8b-4e88-b0e3-b536ad6e7e18.png,618,365,714,447,96,82,red blood cell,7872,0.8541666666666666,1.170731707317073
33103,/images/6231d81d-9e84-4a5a-8cb8-47c6a37a0176.png,1012,585,1111,686,99,101,red blood cell,9999,1.02020202020202,0.9801980198019802
50851,/images/db0a1123-0b35-48d7-8337-3b1ebd6af0cc.png,508,674,626,784,118,110,red blood cell,12980,0.9322033898305084,1.0727272727272728
13843,/images/345cb914-7583-49df-96e3-3cf19c2ba8f1.png,403,243,521,355,118,112,red blood cell,13216,0.9491525423728814,1.0535714285714286
68945,/images/bbaa004f-05dc-4cb8-8768-e148085bb0f9.png,525,866,639,968,114,102,red blood cell,11628,0.8947368421052632,1.1176470588235294
19255,/images/b4d22412-a495-43a9-bec0-73a2322f8dad.png,862,742,967,847,105,105,red blood cell,11025,1.0,1.0
23282,/images/157ac97a-396e-4f6c-94c6-72a4d06ccc5f.png,153,1,263,123,110,122,red blood cell,13420,1.1090909090909091,0.9016393442622951
167,/images/13099edb-35d9-438f-b093-2cf2ebf9d255.png,291,796,416,909,125,113,red blood cell,14125,0.904,1.1061946902654867
489,/images/f65a1633-9935-4984-a285-a60d30aa1707.png,720,723,844,843,124,120,red blood cell,14880,0.967741935483871,1.0333333333333334
31036,/images/b59dc3a0-3d54-4e3b-a485-33b3e43966de.png,520,942,646,1044,126,102,red blood cell,12852,0.8095238095238095,1.2352941176470589
71989,/images/6ad3efc9-4392-4cee-98a5-186564a96373.png,432,518,546,635,114,117,red blood cell,13338,1.0263157894736843,0.9743589743589743
75821,/images/c4c7ed75-dbdf-4bb6-b6ba-718903cf7264.png,351,227,464,348,113,121,red blood cell,13673,1.0707964601769913,0.9338842975206612
67290,/images/49c4dbd3-6269-4d4c-9648-a2146c57bab1.png,501,556,609,662,108,106,red blood cell,11448,0.9814814814814815,1.0188679245283019
35936,/images/f8242b97-b8d5-48b5-b808-0b0f75a5de97.png,569,917,697,1038,128,121,red blood cell,15488,0.9453125,1.0578512396694215
17252,/images/471f75c6-bd5d-4c20-bcc1-258e836f4d69.png,1072,1385,1177,1500,105,115,red blood cell,12075,1.0952380952380953,0.9130434782608695
39852,/images/af2e63a3-9fde-46aa-a867-81c5c259d1dc.png,763,534,866,626,103,92,red blood cell,9476,0.8932038834951457,1.1195652173913044
29813,/images/7ef90770-6aeb-45eb-9744-49c5247dde30.png,995,719,1104,815,109,96,red blood cell,10464,0.8807339449541285,1.1354166666666667
43659,/images/a4851ed0-1499-4eae-9157-dcd34773254f.png,555,171,662,281,107,110,red blood cell,11770,1.02803738317757,0.9727272727272728
8962,/images/04628a94-b674-469b-aff6-b476b70df87d.png,841,1128,950,1231,109,103,red blood cell,11227,0.944954128440367,1.058252427184466
16156,/images/1e978dfa-d339-4025-809d-09cee76728ed.png,867,1298,983,1411,116,113,red blood cell,13108,0.9741379310344828,1.0265486725663717
52769,/images/9dc6ed5d-6698-48cf-aab3-fd156673729c.png,862,660,962,747,100,87,red blood cell,8700,0.87,1.1494252873563218
17686,/images/b5143aae-6e98-4dc6-b546-980cb472de67.png,407,1195,514,1327,107,132,red blood cell,14124,1.233644859813084,0.8106060606060606
64360,/images/0a7bfa8a-ee52-4f7a-b9c5-2919ecfa93ef.png,713,385,796,479,83,94,red blood cell,7802,1.1325301204819278,0.8829787234042553
19333,/images/b4d22412-a495-43a9-bec0-73a2322f8dad.png,573,229,678,332,105,103,red blood cell,10815,0.9809523809523809,1.0194174757281553
1669,/images/5f783f43-0090-4f8a-bd75-9562f4aa2dd5.png,777,620,875,736,98,116,red blood cell,11368,1.183673469387755,0.8448275862068966
27166,/images/f232eec3-02c0-43f9-bf32-3e60245397e2.png,592,1481,694,1588,102,107,red blood cell,10914,1.0490196078431373,0.9532710280373832
37902,/images/56a57a8d-c9b9-432a-a3b0-32a09355806c.png,608,272,715,374,107,102,red blood cell,10914,0.9532710280373832,1.0490196078431373
27790,/images/e3c1442a-717f-41dd-bf97-81e1233ac9fa.png,108,928,214,1044,106,116,red blood cell,12296,1.0943396226415094,0.9137931034482759
19698,/images/627d6331-7bb9-4d1a-b20d-e6541af4d0f9.png,536,609,650,735,114,126,red blood cell,14364,1.105263157894737,0.9047619047619048
17366,/images/04018590-4e66-4cb9-ad2d-83570f1b29ae.png,111,1374,237,1508,126,134,red blood cell,16884,1.0634920634920635,0.9402985074626866
33243,/images/877d5e7f-19b6-40e7-81bd-c92f25e72503.png,553,1288,668,1405,115,117,red blood cell,13455,1.017391304347826,0.9829059829059829
23455,/images/8757be1e-b832-407a-8e95-62abae485b24.png,445,291,536,380,91,89,red blood cell,8099,0.978021978021978,1.0224719101123596
67875,/images/41ebf9a1-24dc-454e-8bf8-508218f5ee57.png,715,1033,824,1138,109,105,red blood cell,11445,0.963302752293578,1.0380952380952382
40351,/images/eb86033f-4f1c-4e8c-ae84-e8e4c7e08626.png,158,1373,278,1504,120,131,red blood cell,15720,1.0916666666666666,0.916030534351145
17176,/images/471f75c6-bd5d-4c20-bcc1-258e836f4d69.png,39,1091,147,1196,108,105,red blood cell,11340,0.9722222222222222,1.0285714285714285
63301,/images/43bc935a-f655-45e1-a64d-fcb8b78267a6.png,457,530,563,635,106,105,red blood cell,11130,0.9905660377358491,1.0095238095238095
68313,/images/0f735cca-051c-4048-a1fa-cb36f389e12f.png,526,832,631,952,105,120,red blood cell,12600,1.1428571428571428,0.875
79059,/images/036e008f-07a1-4e92-899d-1822dc390ccb.png,817,298,919,403,102,105,red blood cell,10710,1.0294117647058822,0.9714285714285714
75708,/images/d12c5f45-6b20-46d6-a66f-c5a4683c25b3.png,1031,997,1151,1113,120,116,red blood cell,13920,0.9666666666666667,1.0344827586206897
61370,/images/e16c0dab-780d-4035-872e-1bb91e49f9d2.png,575,826,677,921,102,95,red blood cell,9690,0.9313725490196079,1.0736842105263158
21805,/images/9b3fd401-dab0-440f-8498-eb3cc9ffa970.png,945,786,1060,913,115,127,red blood cell,14605,1.1043478260869566,0.905511811023622
56627,/images/4adcaa26-aa1f-47b5-bdf0-18c9f814f576.png,541,189,642,294,101,105,red blood cell,10605,1.0396039603960396,0.9619047619047619
16980,/images/8eeb378e-90f0-47ea-ac1c-2a201eb8d090.png,318,1065,421,1172,103,107,red blood cell,11021,1.0388349514563107,0.9626168224299065
78307,/images/24115f58-a7d6-4022-a95a-86b515a78d3e.png,551,1141,672,1253,121,112,red blood cell,13552,0.9256198347107438,1.0803571428571428
4104,/images/d3b79739-aea2-4804-8c7a-183b7ed07de3.png,501,261,619,361,118,100,red blood cell,11800,0.847457627118644,1.18
65680,/images/397f37bc-a3a4-4257-9430-c8fc5716f8b1.png,1068,1228,1184,1333,116,105,red blood cell,12180,0.9051724137931034,1.1047619047619048
53179,/images/801296d9-3403-426f-859e-5c532858e025.png,515,168,625,284,110,116,red blood cell,12760,1.0545454545454545,0.9482758620689655
15289,/images/2d0f600d-f94e-4907-b712-52fb37d9ed52.png,107,991,226,1094,119,103,red blood cell,12257,0.865546218487395,1.1553398058252426
20391,/images/11e517bf-943b-4928-929a-e9f72c097880.png,964,436,1079,551,115,115,red blood cell,13225,1.0,1.0
77553,/images/2d2e81f3-e329-4765-9ba1-2c95f12dc9f3.png,863,152,955,247,92,95,red blood cell,8740,1.0326086956521738,0.968421052631579
57579,/images/8190ec37-9a5e-419f-89ed-fbfb079370db.png,709,713,820,823,111,110,red blood cell,12210,0.990990990990991,1.009090909090909
42905,/images/7d4c2160-317f-48d1-a60a-788ec300b3e8.png,572,1425,700,1555,128,130,red blood cell,16640,1.015625,0.9846153846153847
59127,/images/4736f545-1f1f-4d77-9241-d69cbf4dae35.png,48,31,154,139,106,108,red blood cell,11448,1.0188679245283019,0.9814814814814815
57503,/images/00d04a90-80e5-4bce-9511-1b64eabb7a47.png,918,837,1002,927,84,90,red blood cell,7560,1.0714285714285714,0.9333333333333333
49211,/images/a9daf82a-a46d-4296-bd72-2c374ed0a193.png,0,664,101,780,101,116,red blood cell,11716,1.1485148514851484,0.8706896551724138
20868,/images/c2ec116f-f091-422c-926c-70b548a8f6ef.png,276,719,394,818,118,99,red blood cell,11682,0.8389830508474576,1.1919191919191918
17198,/images/471f75c6-bd5d-4c20-bcc1-258e836f4d69.png,1045,1164,1147,1258,102,94,red blood cell,9588,0.9215686274509803,1.0851063829787233
73982,/images/99a21c5c-f5a7-4c07-9cb6-5dda2d388f48.png,230,77,356,185,126,108,red blood cell,13608,0.8571428571428571,1.1666666666666667
73926,/images/2ae3e6e6-7482-4ab8-ad73-b530b5c2ee3b.png,1071,1384,1166,1499,95,115,red blood cell,10925,1.2105263157894737,0.8260869565217391
35664,/images/45f18ac0-f097-4b20-a99d-8837cf488822.png,546,1183,665,1289,119,106,red blood cell,12614,0.8907563025210085,1.1226415094339623
2488,/images/a23f5539-bfe6-4885-9a0e-dba972475ea9.png,621,1096,733,1197,112,101,red blood cell,11312,0.9017857142857143,1.108910891089109
72094,/images/64b0e49a-0e48-447d-8872-c1dd255e7a21.png,864,1155,946,1241,82,86,red blood cell,7052,1.048780487804878,0.9534883720930233
49648,/images/bd7937db-fca2-44d0-8538-460110210927.png,87,896,197,1012,110,116,red blood cell,12760,1.0545454545454545,0.9482758620689655
78917,/images/4d0a1598-e4dd-45c4-8a90-dd7c780fe1da.png,76,1228,166,1314,90,86,red blood cell,7740,0.9555555555555556,1.0465116279069768
36892,/images/b2e34f5f-904e-4473-9dc7-c6bc1ce12640.png,729,649,853,756,124,107,red blood cell,13268,0.8629032258064516,1.158878504672897
9695,/images/53afd70c-08a7-4b9a-b137-7003b2ecbeab.png,768,180,876,291,108,111,red blood cell,11988,1.0277777777777777,0.972972972972973
22173,/images/ca677c3c-083f-4d54-9dec-39f79f6a17d8.png,982,205,1091,315,109,110,red blood cell,11990,1.0091743119266054,0.990909090909091
61642,/images/a3c0a876-be12-4ede-8aed-18b32a64401b.png,30,745,134,848,104,103,red blood cell,10712,0.9903846153846154,1.0097087378640777
32216,/images/f4722a74-35e7-42bd-8ef6-dfff04b9cd22.png,663,96,790,225,127,129,red blood cell,16383,1.015748031496063,0.9844961240310077
28992,/images/4c13e22e-dfd1-4fa1-b373-be9d0c272c0f.png,874,488,978,590,104,102,red blood cell,10608,0.9807692307692307,1.0196078431372548
74369,/images/06a3effb-996c-4767-afd2-6aa3b697cb4e.png,44,1090,150,1189,106,99,red blood cell,10494,0.9339622641509434,1.0707070707070707
3788,/images/c9499a06-fb31-4552-a9e2-fb4ebb440859.png,578,563,694,668,116,105,red blood cell,12180,0.9051724137931034,1.1047619047619048
19083,/images/6e39fb0a-aa41-4b16-b783-7589e97bf289.png,925,1309,1061,1441,136,132,red blood cell,17952,0.9705882352941176,1.0303030303030303
47334,/images/1dd3e6dd-343f-4cc9-b0ed-e4d27fb36f0a.png,667,262,792,375,125,113,red blood cell,14125,0.904,1.1061946902654867
14082,/images/eaf4b781-b3aa-41ce-8c5e-287979b4e15a.png,90,1378,171,1475,81,97,red blood cell,7857,1.1975308641975309,0.8350515463917526
38744,/images/b426ef1d-4a59-4f90-b593-50226af60a60.png,673,743,784,855,111,112,red blood cell,12432,1.009009009009009,0.9910714285714286
24091,/images/505355c9-23bf-4f90-8ebc-6a7ef50964d0.png,967,672,1065,766,98,94,red blood cell,9212,0.9591836734693877,1.0425531914893618
77352,/images/3ff98212-7c2a-46cd-afb7-34a2479bed07.png,966,190,1076,306,110,116,red blood cell,12760,1.0545454545454545,0.9482758620689655
77009,/images/51e86aa9-caa0-4297-94e8-34a57d7f7e36.png,1,383,94,488,93,105,red blood cell,9765,1.1290322580645162,0.8857142857142857
39199,/images/2aeb7b85-7df9-4a63-8d37-2eecaaa190e7.png,855,1098,950,1204,95,106,red blood cell,10070,1.1157894736842104,0.8962264150943396
12819,/images/b634137b-bc8b-4e88-b0e3-b536ad6e7e18.png,778,1443,880,1555,102,112,red blood cell,11424,1.0980392156862746,0.9107142857142857
60383,/images/1c87b997-a8e6-48ca-bf40-19b9a7fd6a96.png,64,690,153,774,89,84,red blood cell,7476,0.9438202247191011,1.0595238095238095
4117,/images/d3b79739-aea2-4804-8c7a-183b7ed07de3.png,142,1127,270,1262,128,135,red blood cell,17280,1.0546875,0.9481481481481482
1408,/images/6d91d1f0-636b-4f5a-a526-7c17fc857190.png,315,1081,416,1193,101,112,red blood cell,11312,1.108910891089109,0.9017857142857143
22231,/images/3d4d7ba7-6c7c-4ddd-b282-31fb5d80edb5.png,670,728,771,831,101,103,red blood cell,10403,1.0198019801980198,0.9805825242718447
27838,/images/db3f4098-02e4-45a3-a7af-5dda37ac1526.png,152,695,281,816,129,121,red blood cell,15609,0.937984496124031,1.0661157024793388
45745,/images/584d62ed-4329-45dd-94ce-e929d8b2bb74.png,766,1494,869,1580,103,86,red blood cell,8858,0.8349514563106796,1.197674418604651
2941,/images/00a02700-2ea2-4590-9e15-ffc9160fd3de.png,502,143,621,262,119,119,red blood cell,14161,1.0,1.0
69703,/images/f0713bee-2a71-4ced-b953-4041ea99496a.png,382,812,469,903,87,91,red blood cell,7917,1.0459770114942528,0.9560439560439561
12835,/images/b10ea12f-cd36-4f2c-994a-67d1665269ab.png,691,1111,794,1214,103,103,red blood cell,10609,1.0,1.0
30342,/images/4aad9589-6b32-4522-bcd7-ca04687a02ca.png,971,820,1062,923,91,103,red blood cell,9373,1.1318681318681318,0.883495145631068
25083,/images/b02f6804-1697-4a5e-9be7-61931903ab55.png,703,1196,810,1322,107,126,red blood cell,13482,1.1775700934579438,0.8492063492063492
3834,/images/3e764461-22ee-44d3-925d-cd658ff7d154.png,676,1444,776,1542,100,98,red blood cell,9800,0.98,1.0204081632653061
72413,/images/a15e0fa8-2620-4f66-896e-175115c9dc3d.png,52,486,155,585,103,99,red blood cell,10197,0.9611650485436893,1.0404040404040404
16161,/images/1e978dfa-d339-4025-809d-09cee76728ed.png,543,270,656,377,113,107,red blood cell,12091,0.9469026548672567,1.0560747663551402
2205,/images/5bf91ff9-80df-49c0-9c3e-599357d95530.png,393,1348,502,1469,109,121,red blood cell,13189,1.110091743119266,0.9008264462809917
58313,/images/319c9c52-f316-49f3-baad-4444ab19f85b.png,168,0,271,106,103,106,red blood cell,10918,1.029126213592233,0.9716981132075472
6218,/images/effd6334-516f-4d48-9f3c-5272a99780fb.png,515,1286,634,1398,119,112,red blood cell,13328,0.9411764705882353,1.0625
24923,/images/ed0bee2f-05e0-4392-8357-19750cec577c.png,58,878,157,985,99,107,red blood cell,10593,1.0808080808080809,0.9252336448598131
68282,/images/a6391703-0820-4913-a7cd-e843ff0d84ba.png,361,69,473,170,112,101,red blood cell,11312,0.9017857142857143,1.108910891089109
72100,/images/64b0e49a-0e48-447d-8872-c1dd255e7a21.png,261,758,363,871,102,113,red blood cell,11526,1.107843137254902,0.9026548672566371
16223,/images/acdc6e12-73d9-44ba-be8c-2a56aaffef4f.png,359,1298,467,1428,108,130,red blood cell,14040,1.2037037037037037,0.8307692307692308
78422,/images/fe00fa09-d3c8-485b-9d0f-3cce556c9edd.png,238,792,344,897,106,105,red blood cell,11130,0.9905660377358491,1.0095238095238095
2942,/images/00a02700-2ea2-4590-9e15-ffc9160fd3de.png,1047,556,1155,667,108,111,red blood cell,11988,1.0277777777777777,0.972972972972973
14840,/images/f8b6a868-60e9-4569-ae69-638a0c39834d.png,982,794,1123,907,141,113,red blood cell,15933,0.8014184397163121,1.247787610619469
73696,/images/f11d05e4-538a-4024-8711-b08a4ce3c540.png,486,116,583,217,97,101,red blood cell,9797,1.041237113402062,0.9603960396039604
61750,/images/985627c9-7b85-40de-a106-eb9cc47b47cb.png,748,1037,849,1138,101,101,red blood cell,10201,1.0,1.0
57582,/images/8190ec37-9a5e-419f-89ed-fbfb079370db.png,772,424,864,532,92,108,red blood cell,9936,1.173913043478261,0.8518518518518519
59272,/images/03c8da48-04b9-4520-b674-44a0ecd35688.png,120,1004,227,1124,107,120,red blood cell,12840,1.1214953271028036,0.8916666666666667
73706,/images/f11d05e4-538a-4024-8711-b08a4ce3c540.png,415,1185,530,1292,115,107,red blood cell,12305,0.9304347826086956,1.074766355140187
46172,/images/d8632217-ec33-4d0a-98e6-427824c58869.png,224,1022,348,1136,124,114,red blood cell,14136,0.9193548387096774,1.087719298245614
35156,/images/bfc61c48-685d-470b-86b1-e4c7eb85c4fd.png,475,749,600,866,125,117,red blood cell,14625,0.936,1.0683760683760684
42853,/images/7029feb3-9ffe-46e4-9883-6a9df84f7b62.png,929,460,1045,562,116,102,red blood cell,11832,0.8793103448275862,1.1372549019607843
39431,/images/55f8c052-8e49-4423-a4c4-365fc6afb6e1.png,913,919,1032,1047,119,128,red blood cell,15232,1.0756302521008403,0.9296875
52815,/images/0a747cb3-c720-4572-a661-ab5670a5c42e.png,321,738,424,853,103,115,red blood cell,11845,1.116504854368932,0.8956521739130435
15652,/images/84d7545e-c3a8-4b1f-9a39-36aab78c8699.png,199,1219,322,1337,123,118,red blood cell,14514,0.959349593495935,1.0423728813559323
44956,/images/83ec8923-6232-40d7-ba1f-a1b8bf7cb66c.png,855,1236,955,1317,100,81,red blood cell,8100,0.81,1.2345679012345678
38849,/images/d79b4e90-c45d-4f5d-a498-49c3e323c291.png,1003,51,1104,173,101,122,red blood cell,12322,1.2079207920792079,0.8278688524590164
54152,/images/c415532c-4cce-4580-9fcd-623c172a1abd.png,139,677,254,797,115,120,red blood cell,13800,1.0434782608695652,0.9583333333333334
18998,/images/e9e78ff8-831b-46e9-9785-3eee9acbfcd8.png,325,1404,404,1486,79,82,red blood cell,6478,1.0379746835443038,0.9634146341463414
49363,/images/28c96a4a-4549-4761-99e4-ace4ea7e7ac9.png,108,1020,242,1145,134,125,red blood cell,16750,0.9328358208955224,1.072
42911,/images/7d4c2160-317f-48d1-a60a-788ec300b3e8.png,118,1069,242,1189,124,120,red blood cell,14880,0.967741935483871,1.0333333333333334
45702,/images/584d62ed-4329-45dd-94ce-e929d8b2bb74.png,172,1214,268,1301,96,87,red blood cell,8352,0.90625,1.103448275862069
31507,/images/83ec1cb9-1714-4bf1-81f6-115fde84564d.png,679,1153,802,1272,123,119,red blood cell,14637,0.967479674796748,1.0336134453781514
598,/images/065af549-320a-4862-b92a-8ef750d7b5fb.png,280,508,390,627,110,119,red blood cell,13090,1.0818181818181818,0.9243697478991597
48993,/images/df3d98b9-3dd7-4107-8d4a-ae1b7f247793.png,735,470,847,576,112,106,red blood cell,11872,0.9464285714285714,1.0566037735849056
69258,/images/f274b784-b995-4a7e-a2c2-6cc31c24c4b4.png,1099,137,1197,245,98,108,red blood cell,10584,1.1020408163265305,0.9074074074074074
60163,/images/214f1d15-a081-476e-992d-6c3a77f03d59.png,725,608,826,714,101,106,red blood cell,10706,1.0495049504950495,0.9528301886792453
66879,/images/9acf303a-fcba-4e52-be3e-8d061aa5e72a.png,36,663,137,762,101,99,red blood cell,9999,0.9801980198019802,1.02020202020202
78488,/images/c94827ce-d619-4705-a68a-df63a2c95ffa.png,703,784,816,891,113,107,red blood cell,12091,0.9469026548672567,1.0560747663551402
26312,/images/d33bc9fc-3444-4f26-8082-307f9fccc52b.png,488,1174,610,1285,122,111,red blood cell,13542,0.9098360655737705,1.0990990990990992
76792,/images/2165fe38-b474-467d-be11-d1d728085efd.png,921,1086,1033,1188,112,102,red blood cell,11424,0.9107142857142857,1.0980392156862746
3339,/images/b1100ae1-0ac8-4fc2-b0ff-8819f7fbe724.png,624,86,717,198,93,112,red blood cell,10416,1.2043010752688172,0.8303571428571429
48474,/images/e13f2327-fbf4-4d84-a8c1-09cb1e449c8c.png,151,1157,270,1274,119,117,red blood cell,13923,0.9831932773109243,1.017094017094017
18629,/images/c22f7031-9cf8-48ce-b03b-1b12d0db4951.png,818,1184,912,1291,94,107,red blood cell,10058,1.1382978723404256,0.8785046728971962
19280,/images/b4d22412-a495-43a9-bec0-73a2322f8dad.png,248,531,362,635,114,104,red blood cell,11856,0.9122807017543859,1.0961538461538463
54892,/images/8f84a2c9-ca38-4405-a488-12fcd101278b.png,879,320,988,426,109,106,red blood cell,11554,0.9724770642201835,1.028301886792453
69056,/images/b5246b58-6f40-4c9e-8024-f49b0ed6bdbd.png,6,130,101,206,95,76,red blood cell,7220,0.8,1.25
3478,/images/ad36bd67-594b-4f63-93e3-886af0bc618e.png,337,569,461,685,124,116,red blood cell,14384,0.9354838709677419,1.0689655172413792
20171,/images/bb337c84-f727-42a5-9c3d-934323a16c6a.png,956,1171,1070,1293,114,122,red blood cell,13908,1.0701754385964912,0.9344262295081968
54669,/images/6473ddb6-ad56-48a2-81e8-c7cb45f06825.png,175,884,271,987,96,103,red blood cell,9888,1.0729166666666667,0.9320388349514563
19824,/images/b318889c-3c60-477c-b8f6-d18cb01a59df.png,584,171,684,277,100,106,red blood cell,10600,1.06,0.9433962264150944
46093,/images/72088c26-d2dd-4906-b791-b8947fc7fbe4.png,610,720,704,816,94,96,red blood cell,9024,1.0212765957446808,0.9791666666666666
57419,/images/00d04a90-80e5-4bce-9511-1b64eabb7a47.png,621,1372,745,1477,124,105,red blood cell,13020,0.8467741935483871,1.180952380952381
28671,/images/151f3af5-5e6e-4bcd-9389-4974fc68813e.png,244,1076,349,1186,105,110,red blood cell,11550,1.0476190476190477,0.9545454545454546
71013,/images/deaa1931-5f97-45bf-8c00-be6ddeb37b9a.png,1103,564,1198,669,95,105,red blood cell,9975,1.105263157894737,0.9047619047619048
58295,/images/319c9c52-f316-49f3-baad-4444ab19f85b.png,452,217,553,313,101,96,red blood cell,9696,0.9504950495049505,1.0520833333333333
8844,/images/91827f1a-9b04-4ef0-972c-12e90e60c516.png,792,1100,934,1215,142,115,red blood cell,16330,0.8098591549295775,1.2347826086956522
16171,/images/1e978dfa-d339-4025-809d-09cee76728ed.png,713,1399,835,1512,122,113,red blood cell,13786,0.9262295081967213,1.079646017699115
61582,/images/4a717a39-80f8-4b75-a25e-c46d65d7dcd5.png,619,971,707,1056,88,85,red blood cell,7480,0.9659090909090909,1.035294117647059
52956,/images/e81bf478-27ff-458c-ac30-9e1f8480bc5c.png,76,717,184,826,108,109,red blood cell,11772,1.0092592592592593,0.9908256880733946
48452,/images/e13f2327-fbf4-4d84-a8c1-09cb1e449c8c.png,415,1107,530,1218,115,111,red blood cell,12765,0.9652173913043478,1.0360360360360361
36423,/images/cfe6086f-eb0b-4cb0-a430-8cd7de6556e2.png,206,804,307,899,101,95,red blood cell,9595,0.9405940594059405,1.063157894736842
41531,/images/2f3ebec8-ef64-420d-9aa0-c2fcadc27d74.png,124,230,261,345,137,115,red blood cell,15755,0.8394160583941606,1.191304347826087
3936,/images/f09acb0c-b270-4e91-99f8-410adfa7f34a.png,721,655,821,749,100,94,red blood cell,9400,0.94,1.0638297872340425
35763,/images/bb2042c5-35e1-43cc-8171-7de81b764361.png,175,992,290,1099,115,107,red blood cell,12305,0.9304347826086956,1.074766355140187
38214,/images/1d9d4dac-66f9-4c87-b714-d723d5b15fa9.png,780,565,901,702,121,137,red blood cell,16577,1.1322314049586777,0.8832116788321168
78327,/images/24115f58-a7d6-4022-a95a-86b515a78d3e.png,674,691,775,804,101,113,red blood cell,11413,1.118811881188119,0.8938053097345132
47259,/images/58ced55c-bf0d-4204-b6b2-4f8992d92779.png,503,900,612,993,109,93,red blood cell,10137,0.8532110091743119,1.1720430107526882
76472,/images/34df8890-272d-423a-ae78-ff8d068d3306.png,256,125,358,229,102,104,red blood cell,10608,1.0196078431372548,0.9807692307692307
375,/images/7c66d2fd-68ee-4628-b860-9d7ad25b2a80.png,73,1443,183,1548,110,105,red blood cell,11550,0.9545454545454546,1.0476190476190477
58210,/images/2f68686f-1fe8-46e7-ad92-a08e3523ea79.png,542,1287,653,1386,111,99,red blood cell,10989,0.8918918918918919,1.121212121212121
6203,/images/effd6334-516f-4d48-9f3c-5272a99780fb.png,98,529,218,650,120,121,red blood cell,14520,1.0083333333333333,0.9917355371900827
53849,/images/f24c8fe0-a534-44cf-9995-b2b314d945ba.png,651,1113,786,1236,135,123,red blood cell,16605,0.9111111111111111,1.0975609756097562
65130,/images/5e042380-6ef2-496f-8231-0ca550fbfa71.png,67,1220,172,1327,105,107,red blood cell,11235,1.019047619047619,0.9813084112149533
18043,/images/0f0c949e-018a-4f3f-ab02-3704f49c7754.png,393,583,494,686,101,103,red blood cell,10403,1.0198019801980198,0.9805825242718447
17477,/images/56077789-8580-41b4-89d6-deea227e5c60.png,791,1101,907,1212,116,111,red blood cell,12876,0.9568965517241379,1.045045045045045
46746,/images/da111ca5-520f-4ea8-97ad-ae5fce58ee91.png,52,1060,137,1148,85,88,red blood cell,7480,1.035294117647059,0.9659090909090909
73442,/images/58594235-0d32-4a4e-91cd-4c800eaaaa73.png,409,920,535,1024,126,104,red blood cell,13104,0.8253968253968254,1.2115384615384615
6334,/images/c6575e75-c8ce-4766-841f-1137b9e0956c.png,279,951,397,1081,118,130,red blood cell,15340,1.1016949152542372,0.9076923076923077
38670,/images/b5acf759-1115-42f0-a753-656736192528.png,878,1415,976,1532,98,117,red blood cell,11466,1.1938775510204083,0.8376068376068376
9830,/images/3859deaf-6ae1-49a3-9051-898d0f0d7de6.png,219,187,304,288,85,101,red blood cell,8585,1.188235294117647,0.8415841584158416
45952,/images/0d098413-6911-4535-b70a-3c3effd8cf49.png,1,410,105,523,104,113,red blood cell,11752,1.0865384615384615,0.9203539823008849
1562,/images/0ac747cd-ff32-49bf-bc1a-3e9b7702ce9c.png,978,36,1095,153,117,117,red blood cell,13689,1.0,1.0
30455,/images/5955289d-19e5-45ef-a012-c8ea08ef45e2.png,847,1086,963,1220,116,134,red blood cell,15544,1.1551724137931034,0.8656716417910447
34247,/images/259da25f-40f3-4d37-bca9-a9c807af1547.png,272,481,394,599,122,118,red blood cell,14396,0.9672131147540983,1.0338983050847457
22932,/images/ecd68ba2-48af-4866-826a-7cd1c147c055.png,315,1334,423,1462,108,128,red blood cell,13824,1.1851851851851851,0.84375
59173,/images/4736f545-1f1f-4d77-9241-d69cbf4dae35.png,611,844,703,926,92,82,red blood cell,7544,0.8913043478260869,1.1219512195121952
47868,/images/ab27173b-6e30-4957-bd68-29194328fd39.png,804,735,931,861,127,126,red blood cell,16002,0.9921259842519685,1.007936507936508
65376,/images/24418314-f7a4-49fc-a03e-ec597ca6796e.png,1079,263,1163,338,84,75,red blood cell,6300,0.8928571428571429,1.12
60964,/images/5397d8e2-bb09-42e7-9861-65ffad0fe94e.png,350,402,467,516,117,114,red blood cell,13338,0.9743589743589743,1.0263157894736843
28846,/images/686ed568-d5f8-475e-81ad-edab9dd473a0.png,660,878,774,972,114,94,red blood cell,10716,0.8245614035087719,1.2127659574468086
66856,/images/9106a6bb-1352-411f-ac26-0d6fe48c16a8.png,401,1384,506,1495,105,111,red blood cell,11655,1.0571428571428572,0.9459459459459459
71574,/images/b9c6db13-ca3a-4937-8ecf-e537047ed858.png,504,456,627,579,123,123,red blood cell,15129,1.0,1.0
25252,/images/90171428-f208-428a-b40e-f57ee3bea457.png,79,817,186,935,107,118,red blood cell,12626,1.102803738317757,0.9067796610169492
29939,/images/f2a8a483-b254-43aa-817f-7d525adb8911.png,678,178,796,312,118,134,red blood cell,15812,1.1355932203389831,0.8805970149253731
17028,/images/57e1879e-4294-45e7-9c1b-627e8cca0271.png,749,512,862,609,113,97,red blood cell,10961,0.8584070796460177,1.1649484536082475
45993,/images/72088c26-d2dd-4906-b791-b8947fc7fbe4.png,996,802,1105,900,109,98,red blood cell,10682,0.8990825688073395,1.1122448979591837
67680,/images/2b128a1a-95ed-408b-b9f8-8795cc814d80.png,817,528,925,639,108,111,red blood cell,11988,1.0277777777777777,0.972972972972973
53613,/images/7bcd3735-3134-46d1-8ca2-d4379f2d51c0.png,1048,695,1149,799,101,104,red blood cell,10504,1.0297029702970297,0.9711538461538461
52684,/images/9dc6ed5d-6698-48cf-aab3-fd156673729c.png,971,83,1072,187,101,104,red blood cell,10504,1.0297029702970297,0.9711538461538461
30691,/images/f939782b-f5a2-40a3-9c22-6c6d7e18edc3.png,422,374,539,478,117,104,red blood cell,12168,0.8888888888888888,1.125
68756,/images/eb5f4f2f-2275-4a80-84a5-78a1eaf4ce4d.png,923,981,1043,1100,120,119,red blood cell,14280,0.9916666666666667,1.0084033613445378
2465,/images/fe851c88-692d-4199-87e0-d19d9c4eb591.png,7,946,105,1058,98,112,red blood cell,10976,1.1428571428571428,0.875
932,/images/a8cb75ba-3f2f-40d8-8bc7-c79ebd1b9603.png,505,1224,623,1333,118,109,red blood cell,12862,0.923728813559322,1.0825688073394495
14671,/images/9d155086-acf5-4c86-a9e1-94b587c46e87.png,248,774,346,892,98,118,red blood cell,11564,1.2040816326530612,0.8305084745762712
25897,/images/4811fdf2-d7e8-475e-a840-45dda5282bf3.png,736,844,865,976,129,132,red blood cell,17028,1.0232558139534884,0.9772727272727273
47287,/images/1dd3e6dd-343f-4cc9-b0ed-e4d27fb36f0a.png,504,1496,619,1598,115,102,red blood cell,11730,0.8869565217391304,1.1274509803921569
65389,/images/24418314-f7a4-49fc-a03e-ec597ca6796e.png,70,1106,147,1192,77,86,red blood cell,6622,1.1168831168831168,0.8953488372093024
2135,/images/e94a811d-3145-4313-ba42-2d5ed283179f.png,940,1300,1038,1390,98,90,red blood cell,8820,0.9183673469387755,1.0888888888888888
46700,/images/da111ca5-520f-4ea8-97ad-ae5fce58ee91.png,425,11,521,108,96,97,red blood cell,9312,1.0104166666666667,0.9896907216494846
55181,/images/9c5f48c0-0544-4c0c-92b4-59b7d7b7814c.png,512,694,628,797,116,103,red blood cell,11948,0.8879310344827587,1.1262135922330097
33332,/images/5721e41b-90ef-4851-8587-8dc71227ef90.png,1060,96,1175,231,115,135,red blood cell,15525,1.173913043478261,0.8518518518518519
42484,/images/29648565-fe28-4517-ba72-68df0c82c9c5.png,396,252,502,361,106,109,red blood cell,11554,1.028301886792453,0.9724770642201835
57286,/images/aaade430-4c49-4038-97b7-f8cdd937db57.png,203,1105,308,1226,105,121,red blood cell,12705,1.1523809523809523,0.8677685950413223
50935,/images/ef8fcfa4-8466-4186-8c69-f5f4904eb489.png,986,568,1096,677,110,109,red blood cell,11990,0.990909090909091,1.0091743119266054
74635,/images/5ccca8ee-abea-458a-a891-bedd31c3ddc3.png,872,1465,975,1569,103,104,red blood cell,10712,1.0097087378640777,0.9903846153846154
69231,/images/f274b784-b995-4a7e-a2c2-6cc31c24c4b4.png,306,433,401,538,95,105,red blood cell,9975,1.105263157894737,0.9047619047619048
59983,/images/f0fe292d-85ae-4c3a-a676-037dde2594e6.png,908,1007,1010,1105,102,98,red blood cell,9996,0.9607843137254902,1.0408163265306123
14392,/images/f5eb7c5e-bd77-4638-ba9f-58d42f87476b.png,1011,933,1153,1067,142,134,red blood cell,19028,0.9436619718309859,1.0597014925373134
59058,/images/5e2cea49-0823-49d1-83cf-8fd1559cdd93.png,876,243,976,339,100,96,red blood cell,9600,0.96,1.0416666666666667
44960,/images/83ec8923-6232-40d7-ba1f-a1b8bf7cb66c.png,372,631,464,713,92,82,red blood cell,7544,0.8913043478260869,1.1219512195121952
63918,/images/5e974892-0ebe-4037-8427-ea8616d6d3b8.png,906,1375,1006,1458,100,83,red blood cell,8300,0.83,1.2048192771084338
47137,/images/3d1b889e-bb4a-4ee6-b899-974ee7d956a7.png,1086,1328,1188,1424,102,96,red blood cell,9792,0.9411764705882353,1.0625
39065,/images/8f96ee1f-4ef7-4279-a610-316319bedcf9.png,785,1032,906,1158,121,126,red blood cell,15246,1.0413223140495869,0.9603174603174603
6207,/images/effd6334-516f-4d48-9f3c-5272a99780fb.png,802,1354,924,1488,122,134,red blood cell,16348,1.098360655737705,0.9104477611940298
33173,/images/6231d81d-9e84-4a5a-8cb8-47c6a37a0176.png,1029,325,1122,412,93,87,red blood cell,8091,0.9354838709677419,1.0689655172413792
12822,/images/b634137b-bc8b-4e88-b0e3-b536ad6e7e18.png,941,1244,1047,1338,106,94,red blood cell,9964,0.8867924528301887,1.127659574468085
15677,/images/3892b776-f49a-4368-b0fa-7e855e76ccec.png,58,108,158,224,100,116,red blood cell,11600,1.16,0.8620689655172413
2730,/images/a89cace5-c818-4f23-a432-052b3433b81e.png,1026,319,1126,424,100,105,red blood cell,10500,1.05,0.9523809523809523
71496,/images/191071ab-6515-428c-9f05-8e4309542b75.png,367,1463,484,1570,117,107,red blood cell,12519,0.9145299145299145,1.0934579439252337
11465,/images/2f9f400d-2d67-4118-aaa1-9094bc4b0e47.png,665,737,784,864,119,127,red blood cell,15113,1.0672268907563025,0.937007874015748
30994,/images/b59dc3a0-3d54-4e3b-a485-33b3e43966de.png,83,903,192,1022,109,119,red blood cell,12971,1.091743119266055,0.9159663865546218
59762,/images/f77d7469-d083-4c2d-a4ea-5a9ff162e3e2.png,19,1205,112,1290,93,85,red blood cell,7905,0.9139784946236559,1.0941176470588236
48862,/images/fed6ba05-36a5-45dc-a4e1-9baa7de2c622.png,27,636,110,724,83,88,red blood cell,7304,1.0602409638554218,0.9431818181818182
6089,/images/c147584d-4c61-412a-bdaf-b02b22c18708.png,383,833,487,951,104,118,red blood cell,12272,1.1346153846153846,0.8813559322033898
69678,/images/f0713bee-2a71-4ced-b953-4041ea99496a.png,704,316,816,426,112,110,red blood cell,12320,0.9821428571428571,1.018181818181818
64558,/images/6ba5d0b8-cdc7-4266-9d78-db76faa312e9.png,785,333,864,412,79,79,red blood cell,6241,1.0,1.0
26795,/images/2518f6e4-29cc-4ae4-a914-b215a4c56099.png,484,136,610,253,126,117,red blood cell,14742,0.9285714285714286,1.0769230769230769
31539,/images/3130f950-8345-4315-9711-92f7af3f5c14.png,976,543,1097,645,121,102,red blood cell,12342,0.8429752066115702,1.1862745098039216
35052,/images/67582df6-bf13-4c83-a531-1214692b70de.png,74,1298,180,1410,106,112,red blood cell,11872,1.0566037735849056,0.9464285714285714
5611,/images/75c243e2-610d-4d5a-bc5a-4c53d99d9ae9.png,631,1087,757,1188,126,101,red blood cell,12726,0.8015873015873016,1.2475247524752475
28912,/images/686ed568-d5f8-475e-81ad-edab9dd473a0.png,702,1033,793,1109,91,76,red blood cell,6916,0.8351648351648352,1.1973684210526316
57606,/images/d32022fa-e492-4b31-a776-9435cfdef6d6.png,1053,547,1169,643,116,96,red blood cell,11136,0.8275862068965517,1.2083333333333333
54434,/images/22a464ef-c3da-4d56-b37e-e22e95d945e7.png,693,1072,787,1162,94,90,red blood cell,8460,0.9574468085106383,1.0444444444444445
37944,/images/56a57a8d-c9b9-432a-a3b0-32a09355806c.png,617,1472,708,1580,91,108,red blood cell,9828,1.1868131868131868,0.8425925925925926
79079,/images/036e008f-07a1-4e92-899d-1822dc390ccb.png,551,839,647,936,96,97,red blood cell,9312,1.0104166666666667,0.9896907216494846
63998,/images/5e974892-0ebe-4037-8427-ea8616d6d3b8.png,348,704,444,796,96,92,red blood cell,8832,0.9583333333333334,1.0434782608695652
25675,/images/c118ff18-f9f2-4617-bddb-dc4091fb8f5f.png,699,798,815,930,116,132,red blood cell,15312,1.1379310344827587,0.8787878787878788
21159,/images/fb05b297-180a-4171-b633-09d5616d7534.png,750,983,861,1099,111,116,red blood cell,12876,1.045045045045045,0.9568965517241379
5826,/images/143f5959-5b6d-4f95-bcee-9e110450fc22.png,735,341,830,437,95,96,red blood cell,9120,1.0105263157894737,0.9895833333333334
40562,/images/29861cf9-9a1e-4733-8309-4bd10706b4a3.png,866,889,978,1005,112,116,red blood cell,12992,1.0357142857142858,0.9655172413793104
80082,/images/99e979d4-ee97-4d7f-9da6-00bead40db4d.png,783,600,899,700,116,100,red blood cell,11600,0.8620689655172413,1.16
21829,/images/9b3fd401-dab0-440f-8498-eb3cc9ffa970.png,769,544,878,659,109,115,red blood cell,12535,1.055045871559633,0.9478260869565217
59007,/images/597bbff8-6592-41cf-8946-e59b0d1f289a.png,875,165,980,259,105,94,red blood cell,9870,0.8952380952380953,1.1170212765957446
71326,/images/bcb447c9-5d37-414f-a513-d7076b04a532.png,110,940,213,1046,103,106,red blood cell,10918,1.029126213592233,0.9716981132075472
46080,/images/72088c26-d2dd-4906-b791-b8947fc7fbe4.png,14,1321,105,1413,91,92,red blood cell,8372,1.010989010989011,0.9891304347826086
33170,/images/6231d81d-9e84-4a5a-8cb8-47c6a37a0176.png,1061,345,1154,430,93,85,red blood cell,7905,0.9139784946236559,1.0941176470588236
22417,/images/f97c7c87-5e27-45ea-9f93-3285d74091de.png,481,1277,608,1402,127,125,red blood cell,15875,0.984251968503937,1.016
25447,/images/5f742392-278d-461c-a848-08def2c28878.png,446,469,564,564,118,95,red blood cell,11210,0.8050847457627118,1.2421052631578948
66477,/images/5f66d20c-fbfe-44ec-a01b-8a09da24807e.png,1105,359,1187,455,82,96,red blood cell,7872,1.170731707317073,0.8541666666666666
31570,/images/a0b277cb-20bc-4921-a6bd-5ccd5b91d14f.png,1061,58,1190,170,129,112,red blood cell,14448,0.8682170542635659,1.1517857142857142
25499,/images/f6ab936d-924b-4038-aa47-71b07c26b4e2.png,777,1173,891,1305,114,132,red blood cell,15048,1.1578947368421053,0.8636363636363636
22414,/images/f97c7c87-5e27-45ea-9f93-3285d74091de.png,214,534,317,636,103,102,red blood cell,10506,0.9902912621359223,1.0098039215686274
23580,/images/79d7a014-21ff-40f1-9ac4-a69839390654.png,806,1023,908,1117,102,94,red blood cell,9588,0.9215686274509803,1.0851063829787233
49356,/images/28c96a4a-4549-4761-99e4-ace4ea7e7ac9.png,66,832,200,950,134,118,red blood cell,15812,0.8805970149253731,1.1355932203389831
40761,/images/252071ac-e9f2-41d2-abbb-87ef01b8a997.png,1072,1248,1173,1346,101,98,red blood cell,9898,0.9702970297029703,1.030612244897959
40963,/images/bbe65c18-8a56-4dfe-875c-94e124a84125.png,15,654,150,781,135,127,red blood cell,17145,0.9407407407407408,1.062992125984252
79294,/images/05ac7b2a-6a77-4464-926b-8570f7c01693.png,586,1067,672,1157,86,90,red blood cell,7740,1.0465116279069768,0.9555555555555556
47559,/images/adff132d-3af0-4cef-942c-58fc09729bee.png,482,162,596,279,114,117,red blood cell,13338,1.0263157894736843,0.9743589743589743
30614,/images/f939782b-f5a2-40a3-9c22-6c6d7e18edc3.png,764,1418,866,1512,102,94,red blood cell,9588,0.9215686274509803,1.0851063829787233
59919,/images/1519257c-e3e5-4474-908f-8665b3cf1258.png,222,7,317,100,95,93,red blood cell,8835,0.9789473684210527,1.021505376344086
47093,/images/820bbfea-3dae-46fc-b61a-3d0ed2ea01c2.png,424,721,523,825,99,104,red blood cell,10296,1.0505050505050506,0.9519230769230769
29052,/images/4c13e22e-dfd1-4fa1-b373-be9d0c272c0f.png,185,311,270,391,85,80,red blood cell,6800,0.9411764705882353,1.0625
43860,/images/679ae89f-4a02-4301-862e-1d844cc66cbf.png,313,607,447,731,134,124,red blood cell,16616,0.9253731343283582,1.0806451612903225
47183,/images/3d1b889e-bb4a-4ee6-b899-974ee7d956a7.png,1016,1056,1118,1162,102,106,red blood cell,10812,1.0392156862745099,0.9622641509433962
43890,/images/679ae89f-4a02-4301-862e-1d844cc66cbf.png,507,1317,642,1448,135,131,red blood cell,17685,0.9703703703703703,1.0305343511450382
42697,/images/3abbc4d3-1d7e-40c9-9963-33732da7cc50.png,155,1168,254,1274,99,106,red blood cell,10494,1.0707070707070707,0.9339622641509434
13680,/images/1e86933d-6a5a-4a3c-a0f2-ca22afd767b3.png,118,768,240,900,122,132,red blood cell,16104,1.0819672131147542,0.9242424242424242
63434,/images/b9d65ef3-1adc-4479-abee-2e422f5a613a.png,135,423,243,511,108,88,red blood cell,9504,0.8148148148148148,1.2272727272727273
58712,/images/e4827c85-311a-4df1-89c2-99dad0c3558c.png,690,1005,808,1114,118,109,red blood cell,12862,0.923728813559322,1.0825688073394495
69630,/images/4a49841f-216c-4815-8140-b8762c4f6603.png,494,1507,569,1595,75,88,red blood cell,6600,1.1733333333333333,0.8522727272727273
7312,/images/89f10192-d3dd-4996-a571-4c851dbdc983.png,725,706,820,796,95,90,red blood cell,8550,0.9473684210526315,1.0555555555555556
44003,/images/de81bf7a-7a56-437f-a068-4d9c3e01134c.png,217,1382,338,1492,121,110,red blood cell,13310,0.9090909090909091,1.1
53127,/images/04a567df-5463-4043-81f1-d726223c19a9.png,474,1134,575,1238,101,104,red blood cell,10504,1.0297029702970297,0.9711538461538461
58526,/images/5cac6ddf-c8c6-45de-bce0-a1db64b14fb5.png,3,780,113,888,110,108,red blood cell,11880,0.9818181818181818,1.0185185185185186
52126,/images/94d9fa50-d3e4-4eaf-acfc-92e7f2ed9ea5.png,736,1392,837,1492,101,100,red blood cell,10100,0.9900990099009901,1.01
65202,/images/50715879-2300-4dba-8f4a-3314ff8cfcce.png,1069,259,1190,385,121,126,red blood cell,15246,1.0413223140495869,0.9603174603174603
68370,/images/040112be-3c8d-49aa-93f1-522f94a592ff.png,204,499,297,596,93,97,red blood cell,9021,1.043010752688172,0.9587628865979382
32490,/images/d31dd2c0-ae8e-4499-86bb-7cabb6e438b9.png,361,911,490,1033,129,122,red blood cell,15738,0.9457364341085271,1.0573770491803278
72550,/images/01b99da8-b66b-464b-a7ee-1cadab8db18b.png,872,542,968,636,96,94,red blood cell,9024,0.9791666666666666,1.0212765957446808
30191,/images/a1669b59-fe09-4fe6-ba9f-06bec6725502.png,460,97,553,193,93,96,red blood cell,8928,1.032258064516129,0.96875
39929,/images/8271d0d8-9985-43eb-94b3-c702adca139f.png,391,1216,508,1337,117,121,red blood cell,14157,1.0341880341880343,0.9669421487603306
53989,/images/5e4f7425-11e6-4f9e-be2d-5a27deb9d1b4.png,867,555,978,657,111,102,red blood cell,11322,0.918918918918919,1.088235294117647
12242,/images/5a0628af-4c0a-4ba6-a935-4ec94c9c700e.png,282,802,398,908,116,106,red blood cell,12296,0.9137931034482759,1.0943396226415094
73935,/images/2ae3e6e6-7482-4ab8-ad73-b530b5c2ee3b.png,36,836,114,921,78,85,red blood cell,6630,1.0897435897435896,0.9176470588235294
20679,/images/e6d7c5e1-43fc-4712-86d5-aa70252b978f.png,321,1215,454,1325,133,110,red blood cell,14630,0.8270676691729323,1.209090909090909
21959,/images/393df10a-5d64-476b-88f5-14ac56d6ed60.png,369,366,490,480,121,114,red blood cell,13794,0.9421487603305785,1.0614035087719298
73565,/images/7624ac36-1cf9-42fb-844d-376078309553.png,617,574,750,695,133,121,red blood cell,16093,0.9097744360902256,1.0991735537190082
39695,/images/56adbb1e-96a8-40a5-a5a2-243c97ea889b.png,191,480,316,605,125,125,red blood cell,15625,1.0,1.0
10269,/images/f91670db-be74-474c-bd72-68120aed4756.png,660,1217,760,1314,100,97,red blood cell,9700,0.97,1.0309278350515463
44160,/images/8b494b40-cab5-49d3-893d-c805000fbe88.png,316,1220,416,1316,100,96,red blood cell,9600,0.96,1.0416666666666667
50914,/images/0906111b-bac7-4541-a6dc-da435c0724a8.png,7,1462,91,1548,84,86,red blood cell,7224,1.0238095238095237,0.9767441860465116
65897,/images/d7581cb0-7a12-471d-a3d8-68dcea362213.png,823,566,917,653,94,87,red blood cell,8178,0.925531914893617,1.0804597701149425
59029,/images/597bbff8-6592-41cf-8946-e59b0d1f289a.png,188,1198,311,1322,123,124,red blood cell,15252,1.008130081300813,0.9919354838709677
19947,/images/0ca25c88-457f-4f03-bbc1-98fb6663f1d1.png,794,1496,899,1599,105,103,red blood cell,10815,0.9809523809523809,1.0194174757281553
77959,/images/c691c8ef-d3c7-47b6-a941-f6a1089f21a9.png,390,1456,490,1552,100,96,red blood cell,9600,0.96,1.0416666666666667
43194,/images/fe1ee954-ba71-47b3-954a-d20ab940cd7b.png,653,47,780,161,127,114,red blood cell,14478,0.8976377952755905,1.1140350877192982
21235,/images/0ceb4539-5c4c-487d-9826-452a88b5d537.png,834,197,938,305,104,108,red blood cell,11232,1.0384615384615385,0.9629629629629629
62963,/images/f234a2de-f3c8-4521-a306-8cfdf52dd597.png,265,834,357,928,92,94,red blood cell,8648,1.0217391304347827,0.9787234042553191
73656,/images/a51d6c18-f9e8-4714-9dbb-38e1577445f2.png,710,1324,802,1418,92,94,red blood cell,8648,1.0217391304347827,0.9787234042553191
5638,/images/afa470d9-c74c-41cd-b4dc-7bf93fde8263.png,149,122,249,224,100,102,red blood cell,10200,1.02,0.9803921568627451
27052,/images/ec301f62-1302-4407-96f9-fcfe45c150ae.png,74,1165,200,1287,126,122,red blood cell,15372,0.9682539682539683,1.0327868852459017
16185,/images/1e978dfa-d339-4025-809d-09cee76728ed.png,922,857,1039,964,117,107,red blood cell,12519,0.9145299145299145,1.0934579439252337
38702,/images/b5acf759-1115-42f0-a753-656736192528.png,199,1134,331,1244,132,110,red blood cell,14520,0.8333333333333334,1.2
62785,/images/631340cc-cedf-4bca-a3d8-a0731a5482b4.png,817,559,916,670,99,111,red blood cell,10989,1.121212121212121,0.8918918918918919
38017,/images/e3e9c2de-0a24-4c7e-8a69-3d3093d5bdab.png,610,468,705,565,95,97,red blood cell,9215,1.0210526315789474,0.979381443298969
65923,/images/d7581cb0-7a12-471d-a3d8-68dcea362213.png,303,901,396,995,93,94,red blood cell,8742,1.010752688172043,0.9893617021276596
37391,/images/08f5a524-0554-49c2-83a8-ae9a6d51e8fd.png,1025,546,1121,647,96,101,red blood cell,9696,1.0520833333333333,0.9504950495049505
2515,/images/a23f5539-bfe6-4885-9a0e-dba972475ea9.png,38,997,140,1096,102,99,red blood cell,10098,0.9705882352941176,1.0303030303030303
38240,/images/b834cbf7-ff97-49d9-9561-566c9343735c.png,247,966,370,1084,123,118,red blood cell,14514,0.959349593495935,1.0423728813559323
9363,/images/261562a8-ffd8-4e0e-919b-22e267000b74.png,882,1342,1001,1465,119,123,red blood cell,14637,1.0336134453781514,0.967479674796748
18314,/images/9ca20b10-e2fd-4bd2-93ef-78298f763ed5.png,578,92,665,197,87,105,red blood cell,9135,1.206896551724138,0.8285714285714286
7679,/images/9f959520-e15e-45c2-bc29-ef3c19154d1c.png,860,14,957,115,97,101,red blood cell,9797,1.041237113402062,0.9603960396039604
46590,/images/edd09b2e-2673-4405-8ac0-e476e003e96a.png,371,1292,491,1398,120,106,red blood cell,12720,0.8833333333333333,1.1320754716981132
25531,/images/f6ab936d-924b-4038-aa47-71b07c26b4e2.png,1088,692,1183,808,95,116,red blood cell,11020,1.2210526315789474,0.8189655172413793
77632,/images/07d15855-eb9b-46a9-b894-7cfe4d097826.png,339,51,443,146,104,95,red blood cell,9880,0.9134615384615384,1.0947368421052632
13704,/images/0b04ec46-5119-4cda-8c35-c4e5b6f0eed0.png,1070,398,1174,516,104,118,red blood cell,12272,1.1346153846153846,0.8813559322033898
35994,/images/5836500a-221e-40ca-a8be-caaa37f7d300.png,694,558,793,655,99,97,red blood cell,9603,0.9797979797979798,1.0206185567010309
75452,/images/468c261d-f5d8-423f-883e-48af2bbbc5d1.png,546,1129,632,1217,86,88,red blood cell,7568,1.0232558139534884,0.9772727272727273
34838,/images/4fc9a597-aaa8-43b0-ad1c-2eabbe442e84.png,891,392,1006,508,115,116,red blood cell,13340,1.008695652173913,0.9913793103448276
46435,/images/bbecf1a8-a728-4c83-87f8-4dfbac0a1e03.png,541,835,659,950,118,115,red blood cell,13570,0.9745762711864406,1.0260869565217392
69035,/images/b5246b58-6f40-4c9e-8024-f49b0ed6bdbd.png,568,784,690,887,122,103,red blood cell,12566,0.8442622950819673,1.1844660194174756
20771,/images/eeac81a5-9202-4965-b7de-35b12910cdf6.png,805,1088,934,1212,129,124,red blood cell,15996,0.9612403100775194,1.0403225806451613
7484,/images/37a94c0f-e5d4-46fc-b4f8-994d477995fd.png,49,304,178,416,129,112,red blood cell,14448,0.8682170542635659,1.1517857142857142
51801,/images/f07174a5-f799-4286-ac43-5b0f5c5777ac.png,1071,1126,1171,1230,100,104,red blood cell,10400,1.04,0.9615384615384616
5190,/images/16a51468-9f93-45df-9ae2-5a74c25c5a4b.png,842,337,942,437,100,100,red blood cell,10000,1.0,1.0
52840,/images/58f7e1da-3478-48f4-958c-e9b1cb8696aa.png,525,1058,633,1169,108,111,red blood cell,11988,1.0277777777777777,0.972972972972973
5213,/images/729733ff-a349-4a96-b636-ccabe7d7e167.png,680,1077,764,1163,84,86,red blood cell,7224,1.0238095238095237,0.9767441860465116
33936,/images/1a332b2c-9d49-4ff2-810c-5633d2314527.png,560,924,663,1038,103,114,red blood cell,11742,1.1067961165048543,0.9035087719298246
79838,/images/a054a8e2-55f2-4508-97df-207f76b89be2.png,64,1352,167,1458,103,106,red blood cell,10918,1.029126213592233,0.9716981132075472
51521,/images/6afb3717-f197-4668-929a-4fab389ae6e8.png,550,831,655,937,105,106,red blood cell,11130,1.0095238095238095,0.9905660377358491
29759,/images/7ef90770-6aeb-45eb-9744-49c5247dde30.png,388,636,493,754,105,118,red blood cell,12390,1.1238095238095238,0.8898305084745762
17657,/images/b5143aae-6e98-4dc6-b546-980cb472de67.png,997,909,1120,1012,123,103,red blood cell,12669,0.8373983739837398,1.1941747572815533
48547,/images/f3d84be2-8af0-4d62-9f72-23d3dc08cbbe.png,487,629,589,739,102,110,red blood cell,11220,1.0784313725490196,0.9272727272727272
41006,/images/8e078333-8fa0-45be-a46e-fa05708cb365.png,445,860,572,989,127,129,red blood cell,16383,1.015748031496063,0.9844961240310077
2163,/images/e94a811d-3145-4313-ba42-2d5ed283179f.png,1033,151,1136,249,103,98,red blood cell,10094,0.9514563106796117,1.0510204081632653
35326,/images/516bf1d5-5d00-4985-926c-3993e9bc3ff5.png,676,1,799,129,123,128,red blood cell,15744,1.0406504065040652,0.9609375
58999,/images/597bbff8-6592-41cf-8946-e59b0d1f289a.png,364,672,464,774,100,102,red blood cell,10200,1.02,0.9803921568627451
71592,/images/390ad256-e1ed-476a-9f14-2dc34e0da632.png,346,1201,464,1319,118,118,red blood cell,13924,1.0,1.0
7252,/images/89f10192-d3dd-4996-a571-4c851dbdc983.png,105,67,217,158,112,91,red blood cell,10192,0.8125,1.2307692307692308
11973,/images/ca16a5ad-b106-4e84-8a43-178710e854ba.png,289,402,400,530,111,128,red blood cell,14208,1.1531531531531531,0.8671875
63424,/images/289ef1b7-02d5-42e9-a401-687688181306.png,6,485,103,596,97,111,red blood cell,10767,1.1443298969072164,0.8738738738738738
4018,/images/a5e05ba8-0c19-41e3-92d5-10e42a03b85e.png,395,1100,503,1213,108,113,red blood cell,12204,1.0462962962962963,0.9557522123893806
1976,/images/b95ceeeb-8870-4492-9037-2091ff268c5a.png,1010,196,1123,313,113,117,red blood cell,13221,1.0353982300884956,0.9658119658119658
70595,/images/4ce5a070-9ede-4bb1-9ca2-1bae5746776b.png,631,1218,734,1321,103,103,red blood cell,10609,1.0,1.0
57348,/images/a88a48b6-f85c-45c1-b42f-79716c8463f1.png,286,1032,377,1127,91,95,red blood cell,8645,1.043956043956044,0.9578947368421052
78710,/images/76a8a5f5-1328-4539-a131-baf877f40cf3.png,169,659,280,760,111,101,red blood cell,11211,0.9099099099099099,1.099009900990099
56302,/images/6b473806-e936-4b19-98cf-a2b94cac35ff.png,644,1077,756,1188,112,111,red blood cell,12432,0.9910714285714286,1.009009009009009
51940,/images/4f62b14e-c6f4-4155-8f50-881558f83fae.png,181,1385,280,1489,99,104,red blood cell,10296,1.0505050505050506,0.9519230769230769
